entry_date,country_icao_code,country_name,flt_daio,flt_o,flt_i,flt_c,flt_dai,flt_d,flt_a,flt_da,flt_i_excl_c
2025-01-01,LA,Albania,734,604,0,0,130,64,66,130,0
2025-01-02,LA,Albania,860,697,0,0,163,80,83,163,0
2025-01-03,LA,Albania,896,718,0,0,178,91,87,178,0
2025-01-04,LA,Albania,840,680,0,0,160,78,82,160,0
2025-01-05,LA,Albania,924,763,0,0,161,81,80,161,0
2025-01-06,LA,Albania,828,665,0,0,163,82,81,163,0
2025-01-07,LA,Albania,696,560,0,0,136,68,68,136,0
2025-01-08,LA,Albania,660,540,0,0,120,58,62,120,0
2025-01-09,LA,Albania,666,523,0,0,143,73,70,143,0
2025-01-10,LA,Albania,723,557,0,0,166,84,82,166,0
2025-01-11,LA,Albania,730,583,0,0,147,73,74,147,0
2025-01-12,LA,Albania,788,637,0,0,151,76,75,151,0
2025-01-13,LA,Albania,673,516,0,0,157,78,79,157,0
2025-01-14,LA,Albania,539,411,0,0,128,64,64,128,0
2025-01-15,LA,Albania,560,438,0,0,122,61,61,122,0
2025-01-16,LA,Albania,634,483,0,0,151,76,75,151,0
2025-01-17,LA,Albania,672,502,0,0,170,85,85,170,0
2025-01-18,LA,Albania,668,525,1,1,143,72,70,142,0
2025-01-19,LA,Albania,740,591,0,0,149,75,74,149,0
2025-01-20,LA,Albania,665,513,0,0,152,76,76,152,0
2025-01-21,LA,Albania,499,379,0,0,120,60,60,120,0
2025-01-22,LA,Albania,562,444,0,0,118,57,61,118,0
2025-01-23,LA,Albania,646,508,0,0,138,71,67,138,0
2025-01-24,LA,Albania,685,522,0,0,163,81,82,163,0
2025-01-25,LA,Albania,732,588,0,0,144,71,73,144,0
2025-01-26,LA,Albania,796,646,0,0,150,75,75,150,0
2025-01-27,LA,Albania,682,535,0,0,147,74,73,147,0
2025-01-28,LA,Albania,584,462,0,0,122,60,62,122,0
2025-01-29,LA,Albania,617,492,1,1,125,62,62,124,0
2025-01-30,LA,Albania,666,515,0,0,151,77,74,151,0
2025-01-31,LA,Albania,723,556,0,0,167,84,83,167,0
2025-02-01,LA,Albania,674,530,0,0,144,70,74,144,0
2025-02-02,LA,Albania,732,582,0,0,150,77,73,150,0
2025-02-03,LA,Albania,618,464,0,0,154,76,78,154,0
2025-02-04,LA,Albania,612,486,0,0,126,63,63,126,0
2025-02-05,LA,Albania,636,514,0,0,122,61,61,122,0
2025-02-06,LA,Albania,667,523,0,0,144,72,72,144,0
2025-02-07,LA,Albania,773,605,0,0,168,84,84,168,0
2025-02-08,LA,Albania,702,564,0,0,138,68,70,138,0
2025-02-09,LA,Albania,760,611,0,0,149,76,73,149,0
2025-02-10,LA,Albania,696,542,0,0,154,76,78,154,0
2025-02-11,LA,Albania,606,488,0,0,118,59,59,118,0
2025-02-12,LA,Albania,619,502,0,0,117,59,58,117,0
2025-02-13,LA,Albania,687,550,0,0,137,68,69,137,0
2025-02-14,LA,Albania,795,631,0,0,164,81,83,164,0
2025-02-15,LA,Albania,726,586,0,0,140,70,70,140,0
2025-02-16,LA,Albania,825,667,0,0,158,78,80,158,0
2025-02-17,LA,Albania,713,564,0,0,149,75,74,149,0
2025-02-18,LA,Albania,582,461,0,0,121,60,61,121,0
2025-02-19,LA,Albania,622,498,0,0,124,62,62,124,0
2025-02-20,LA,Albania,707,549,0,0,158,79,79,158,0
2025-02-21,LA,Albania,810,628,0,0,182,91,91,182,0
2025-02-22,LA,Albania,743,602,0,0,141,70,71,141,0
2025-02-23,LA,Albania,886,711,0,0,175,88,87,175,0
2025-02-24,LA,Albania,754,595,0,0,159,80,79,159,0
2025-02-25,LA,Albania,633,502,0,0,131,64,67,131,0
2025-02-26,LA,Albania,682,559,0,0,123,62,61,123,0
2025-02-27,LA,Albania,730,571,1,1,159,77,81,158,0
2025-02-28,LA,Albania,658,494,0,0,164,85,79,164,0
2025-03-01,LA,Albania,803,643,0,0,160,78,82,160,0
2025-03-02,LA,Albania,842,679,0,0,163,82,81,163,0
2025-03-03,LA,Albania,734,572,0,0,162,82,80,162,0
2025-03-04,LA,Albania,679,540,0,0,139,69,70,139,0
2025-03-05,LA,Albania,671,542,0,0,129,64,65,129,0
2025-03-06,LA,Albania,742,580,0,0,162,80,82,162,0
2025-03-07,LA,Albania,851,683,0,0,168,85,83,168,0
2025-03-08,LA,Albania,812,667,0,0,145,73,72,145,0
2025-03-09,LA,Albania,849,684,0,0,165,83,82,165,0
2025-03-10,LA,Albania,689,543,0,0,146,73,73,146,0
2025-03-11,LA,Albania,670,535,0,0,135,67,68,135,0
2025-03-12,LA,Albania,678,551,0,0,127,64,63,127,0
2025-03-13,LA,Albania,696,539,0,0,157,78,79,157,0
2025-03-14,LA,Albania,752,585,0,0,167,83,84,167,0
2025-03-15,LA,Albania,751,600,1,1,151,75,75,150,0
2025-03-16,LA,Albania,818,652,0,0,166,83,83,166,0
2025-03-17,LA,Albania,684,527,0,0,157,79,78,157,0
2025-03-18,LA,Albania,621,499,0,0,122,62,60,122,0
2025-03-19,LA,Albania,695,574,0,0,121,61,60,121,0
2025-03-20,LA,Albania,708,556,0,0,152,76,76,152,0
2025-03-21,LA,Albania,765,601,0,0,164,83,81,164,0
2025-03-22,LA,Albania,824,677,0,0,147,73,74,147,0
2025-03-23,LA,Albania,849,689,0,0,160,80,80,160,0
2025-03-24,LA,Albania,712,563,0,0,149,75,74,149,0
2025-03-25,LA,Albania,707,573,0,0,134,66,68,134,0
2025-03-26,LA,Albania,689,565,0,0,124,62,62,124,0
2025-03-27,LA,Albania,706,564,0,0,142,72,70,142,0
2025-03-28,LA,Albania,776,605,0,0,171,85,86,171,0
2025-03-29,LA,Albania,767,622,0,0,145,71,74,145,0
2025-03-30,LA,Albania,1035,845,0,0,190,94,96,190,0
2025-03-31,LA,Albania,857,671,0,0,186,96,90,186,0
2025-04-01,LA,Albania,776,619,0,0,157,79,78,157,0
2025-04-02,LA,Albania,887,703,0,0,184,91,93,184,0
2025-04-03,LA,Albania,871,700,0,0,171,86,85,171,0
2025-04-04,LA,Albania,920,724,0,0,196,96,100,196,0
2025-04-05,LA,Albania,1068,892,0,0,176,88,88,176,0
2025-04-06,LA,Albania,1099,912,0,0,187,94,93,187,0
2025-04-07,LA,Albania,930,738,0,0,192,96,96,192,0
2025-04-08,LA,Albania,792,630,0,0,162,82,80,162,0
2025-04-09,LA,Albania,718,533,0,0,185,92,93,185,0
2025-04-10,LA,Albania,1051,880,0,0,171,86,85,171,0
2025-04-11,LA,Albania,1038,843,0,0,195,96,99,195,0
2025-04-12,LA,Albania,1083,916,0,0,167,83,84,167,0
2025-04-13,LA,Albania,1084,896,0,0,188,95,93,188,0
2025-04-14,LA,Albania,999,808,0,0,191,96,95,191,0
2025-04-15,LA,Albania,894,729,0,0,165,84,81,165,0
2025-04-16,LA,Albania,980,789,0,0,191,95,96,191,0
2025-04-17,LA,Albania,904,742,0,0,162,82,80,162,0
2025-04-18,LA,Albania,1053,854,0,0,199,98,101,199,0
2025-04-19,LA,Albania,1098,923,0,0,175,88,87,175,0
2025-04-20,LA,Albania,1108,916,0,0,192,95,97,192,0
2025-04-21,LA,Albania,1071,881,0,0,190,97,93,190,0
2025-04-22,LA,Albania,897,728,0,0,169,84,85,169,0
2025-04-23,LA,Albania,968,776,0,0,192,95,97,192,0
2025-04-24,LA,Albania,949,784,0,0,165,83,82,165,0
2025-04-25,LA,Albania,1040,850,0,0,190,92,98,190,0
2025-04-26,LA,Albania,1166,990,0,0,176,89,87,176,0
2025-04-27,LA,Albania,1175,975,0,0,200,99,101,200,0
2025-04-28,LA,Albania,1003,807,0,0,196,98,98,196,0
2025-04-29,LA,Albania,941,777,0,0,164,83,81,164,0
2025-04-30,LA,Albania,959,761,0,0,198,99,99,198,0
2025-05-01,LA,Albania,1086,916,0,0,170,83,87,170,0
2025-05-02,LA,Albania,1085,888,0,0,197,100,97,197,0
2025-05-03,LA,Albania,1213,1023,0,0,190,95,95,190,0
2025-05-04,LA,Albania,1246,1056,0,0,190,94,96,190,0
2025-05-05,LA,Albania,1072,862,0,0,210,106,104,210,0
2025-05-06,LA,Albania,973,792,0,0,181,90,91,181,0
2025-05-07,LA,Albania,1031,833,1,1,198,98,99,197,0
2025-05-08,LA,Albania,1052,876,0,0,176,87,89,176,0
2025-05-09,LA,Albania,1122,917,1,1,205,104,100,204,0
2025-05-10,LA,Albania,1169,987,2,2,182,88,92,180,0
2025-05-11,LA,Albania,1237,1033,0,0,204,104,100,204,0
2025-05-12,LA,Albania,1058,844,0,0,214,107,107,214,0
2025-05-13,LA,Albania,931,788,0,0,143,73,70,143,0
2025-05-14,LA,Albania,1074,874,0,0,200,99,101,200,0
2025-05-15,LA,Albania,1033,839,0,0,194,89,105,194,0
2025-05-16,LA,Albania,1192,914,0,0,278,142,136,278,0
2025-05-17,LA,Albania,1302,1104,0,0,198,101,97,198,0
2025-05-18,LA,Albania,1193,991,0,0,202,104,98,202,0
2025-05-19,LA,Albania,1104,901,0,0,203,101,102,203,0
2025-05-20,LA,Albania,997,817,0,0,180,91,89,180,0
2025-05-21,LA,Albania,1061,862,0,0,199,99,100,199,0
2025-05-22,LA,Albania,1081,888,0,0,193,94,99,193,0
2025-05-23,LA,Albania,1220,1018,1,1,202,101,100,201,0
2025-05-24,LA,Albania,1378,1186,1,1,192,96,95,191,0
2025-05-25,LA,Albania,1299,1091,0,0,208,105,103,208,0
2025-05-26,LA,Albania,1233,1004,0,0,229,114,115,229,0
2025-05-27,LA,Albania,1095,907,0,0,188,95,93,188,0
2025-05-28,LA,Albania,1168,961,0,0,207,105,102,207,0
2025-05-29,LA,Albania,1199,997,0,0,202,97,105,202,0
2025-05-30,LA,Albania,1254,1026,0,0,228,115,113,228,0
2025-05-31,LA,Albania,1375,1176,0,0,199,98,101,199,0
2025-06-01,LA,Albania,1374,1152,0,0,222,113,109,222,0
2025-06-02,LA,Albania,1266,1023,0,0,243,120,123,243,0
2025-06-03,LA,Albania,1203,1001,0,0,202,103,99,202,0
2025-06-04,LA,Albania,1258,1052,0,0,206,104,102,206,0
2025-06-05,LA,Albania,1223,1016,2,2,207,100,105,205,0
2025-06-06,LA,Albania,1385,1147,1,1,238,117,120,237,0
2025-06-07,LA,Albania,1497,1293,0,0,204,105,99,204,0
2025-06-08,LA,Albania,1454,1227,0,0,227,113,114,227,0
2025-06-09,LA,Albania,1455,1195,1,1,260,128,131,259,0
2025-06-10,LA,Albania,1334,1126,1,1,208,106,101,207,0
2025-06-11,LA,Albania,1440,1216,0,0,224,111,113,224,0
2025-06-12,LA,Albania,1361,1153,0,0,208,102,106,208,0
2025-06-13,LA,Albania,1542,1305,0,0,237,119,118,237,0
2025-06-14,LA,Albania,1732,1523,0,0,209,105,104,209,0
2025-06-15,LA,Albania,1588,1368,0,0,220,111,109,220,0
2025-06-16,LA,Albania,1506,1242,0,0,264,130,134,264,0
2025-06-17,LA,Albania,1403,1191,0,0,212,109,103,212,0
2025-06-18,LA,Albania,1301,1080,0,0,221,109,112,221,0
2025-06-19,LA,Albania,1434,1234,0,0,200,99,101,200,0
2025-06-20,LA,Albania,1523,1274,0,0,249,125,124,249,0
2025-06-21,LA,Albania,1676,1453,0,0,223,112,111,223,0
2025-06-22,LA,Albania,1613,1376,0,0,237,118,119,237,0
2025-06-23,LA,Albania,1532,1270,1,1,262,129,132,261,0
2025-06-24,LA,Albania,1432,1204,0,0,228,115,113,228,0
2025-06-25,LA,Albania,1536,1308,0,0,228,113,115,228,0
2025-06-26,LA,Albania,1497,1275,0,0,222,112,110,222,0
2025-06-27,LA,Albania,1667,1422,0,0,245,122,123,245,0
2025-06-28,LA,Albania,1678,1461,0,0,217,108,109,217,0
2025-06-29,LA,Albania,1656,1417,0,0,239,120,119,239,0
2025-06-30,LA,Albania,1553,1281,0,0,272,134,138,272,0
2025-07-01,LA,Albania,1511,1281,0,0,230,119,111,230,0
2025-07-02,LA,Albania,1494,1256,1,1,238,119,118,237,0
2025-07-03,LA,Albania,1438,1214,0,0,224,110,114,224,0
2025-07-04,LA,Albania,1562,1302,0,0,260,129,131,260,0
2025-07-05,LA,Albania,1686,1465,0,0,221,112,109,221,0
2025-07-06,LA,Albania,1602,1362,1,1,240,119,120,239,0
2025-07-07,LA,Albania,1580,1307,0,0,273,134,139,273,0
2025-07-08,LA,Albania,1526,1293,0,0,233,119,114,233,0
2025-07-09,LA,Albania,1567,1317,0,0,250,126,124,250,0
2025-07-10,LA,Albania,1455,1211,0,0,244,120,124,244,0
2025-07-11,LA,Albania,1572,1313,0,0,259,130,129,259,0
2025-07-12,LA,Albania,1652,1429,0,0,223,113,110,223,0
2025-07-13,LA,Albania,1688,1433,0,0,255,129,126,255,0
2025-07-14,LA,Albania,1578,1307,0,0,271,134,137,271,0
2025-07-15,LA,Albania,1504,1267,0,0,237,118,119,237,0
2025-07-16,LA,Albania,1539,1280,0,0,259,128,131,259,0
2025-07-17,LA,Albania,1566,1311,0,0,255,127,128,255,0
2025-07-18,LA,Albania,1592,1327,0,0,265,134,131,265,0
2025-07-19,LA,Albania,1714,1485,0,0,229,114,115,229,0
2025-07-20,LA,Albania,1639,1388,0,0,251,126,125,251,0
2025-07-21,LA,Albania,1586,1306,0,0,280,138,142,280,0
2025-07-22,LA,Albania,1472,1226,0,0,246,123,123,246,0
2025-07-23,LA,Albania,1561,1312,0,0,249,126,123,249,0
2025-07-24,LA,Albania,1482,1238,1,1,244,119,124,243,0
2025-07-25,LA,Albania,1610,1350,0,0,260,132,128,260,0
2025-07-26,LA,Albania,1719,1484,0,0,235,118,117,235,0
2025-07-27,LA,Albania,1792,1534,0,0,258,129,129,258,0
2025-07-28,LA,Albania,1561,1279,0,0,282,138,144,282,0
2025-07-29,LA,Albania,1496,1248,0,0,248,124,124,248,0
2025-07-30,LA,Albania,1402,1153,0,0,249,125,124,249,0
2025-07-31,LA,Albania,1471,1220,0,0,251,125,126,251,0
2025-08-01,LA,Albania,1617,1336,0,0,281,140,141,281,0
2025-08-02,LA,Albania,1591,1347,0,0,244,126,118,244,0
2025-08-03,LA,Albania,1665,1402,0,0,263,131,132,263,0
2025-08-04,LA,Albania,1630,1327,0,0,303,148,155,303,0
2025-08-05,LA,Albania,1469,1224,0,0,245,124,121,245,0
2025-08-06,LA,Albania,1472,1217,0,0,255,130,125,255,0
2025-08-07,LA,Albania,1524,1271,0,0,253,125,128,253,0
2025-08-08,LA,Albania,1609,1333,0,0,276,137,139,276,0
2025-08-09,LA,Albania,1752,1512,0,0,240,124,116,240,0
2025-08-10,LA,Albania,1656,1400,0,0,256,126,130,256,0
2025-08-11,LA,Albania,1552,1257,0,0,295,145,150,295,0
2025-08-12,LA,Albania,1499,1253,0,0,246,125,121,246,0
2025-08-13,LA,Albania,1566,1302,0,0,264,133,131,264,0
2025-08-14,LA,Albania,1483,1232,1,1,251,120,130,250,0
2025-08-15,LA,Albania,1613,1322,0,0,291,147,144,291,0
2025-08-16,LA,Albania,1721,1475,1,1,246,128,117,245,0
2025-08-17,LA,Albania,1613,1351,0,0,262,129,133,262,0
2025-08-18,LA,Albania,1609,1316,0,0,293,146,147,293,0
2025-08-19,LA,Albania,1419,1175,0,0,244,121,123,244,0
2025-08-20,LA,Albania,1452,1202,0,0,250,127,123,250,0
2025-08-21,LA,Albania,1468,1211,0,0,257,127,130,257,0
2025-08-22,LA,Albania,1552,1280,0,0,272,135,137,272,0
2025-08-23,LA,Albania,1727,1484,0,0,243,125,118,243,0
2025-08-24,LA,Albania,1629,1366,0,0,263,129,134,263,0
2025-08-25,LA,Albania,1543,1255,0,0,288,143,145,288,0
2025-08-26,LA,Albania,1424,1173,0,0,251,127,124,251,0
2025-08-27,LA,Albania,1489,1236,0,0,253,126,127,253,0
2025-08-28,LA,Albania,1453,1197,0,0,256,126,130,256,0
2025-08-29,LA,Albania,1510,1228,0,0,282,140,142,282,0
2025-01-01,UD,Armenia,279,164,0,0,115,57,58,115,0
2025-01-02,UD,Armenia,367,250,0,0,117,57,60,117,0
2025-01-03,UD,Armenia,381,263,0,0,118,61,57,118,0
2025-01-04,UD,Armenia,368,251,0,0,117,60,57,117,0
2025-01-05,UD,Armenia,361,235,0,0,126,60,66,126,0
2025-01-06,UD,Armenia,365,247,0,0,118,62,56,118,0
2025-01-07,UD,Armenia,356,227,0,0,129,63,66,129,0
2025-01-08,UD,Armenia,382,244,0,0,138,69,69,138,0
2025-01-09,UD,Armenia,366,257,0,0,109,54,55,109,0
2025-01-10,UD,Armenia,360,242,1,1,118,57,60,117,0
2025-01-11,UD,Armenia,342,224,1,1,118,63,54,117,0
2025-01-12,UD,Armenia,333,216,0,0,117,56,61,117,0
2025-01-13,UD,Armenia,352,247,0,0,105,54,51,105,0
2025-01-14,UD,Armenia,355,265,0,0,90,43,47,90,0
2025-01-15,UD,Armenia,346,249,0,0,97,49,48,97,0
2025-01-16,UD,Armenia,323,236,0,0,87,43,44,87,0
2025-01-17,UD,Armenia,372,277,0,0,95,48,47,95,0
2025-01-18,UD,Armenia,330,231,0,0,99,50,49,99,0
2025-01-19,UD,Armenia,343,231,0,0,112,55,57,112,0
2025-01-20,UD,Armenia,353,265,0,0,88,46,42,88,0
2025-01-21,UD,Armenia,330,251,0,0,79,39,40,79,0
2025-01-22,UD,Armenia,326,245,0,0,81,40,41,81,0
2025-01-23,UD,Armenia,351,268,0,0,83,43,40,83,0
2025-01-24,UD,Armenia,364,267,0,0,97,46,51,97,0
2025-01-25,UD,Armenia,369,286,0,0,83,43,40,83,0
2025-01-26,UD,Armenia,381,274,0,0,107,52,55,107,0
2025-01-27,UD,Armenia,344,264,0,0,80,42,38,80,0
2025-01-28,UD,Armenia,333,264,0,0,69,33,36,69,0
2025-01-29,UD,Armenia,311,233,0,0,78,40,38,78,0
2025-01-30,UD,Armenia,308,229,0,0,79,40,39,79,0
2025-01-31,UD,Armenia,337,245,0,0,92,45,47,92,0
2025-02-01,UD,Armenia,311,236,1,1,75,39,35,74,0
2025-02-02,UD,Armenia,329,228,0,0,101,50,51,101,0
2025-02-03,UD,Armenia,326,250,0,0,76,39,37,76,0
2025-02-04,UD,Armenia,281,209,0,0,72,36,36,72,0
2025-02-05,UD,Armenia,309,228,0,0,81,40,41,81,0
2025-02-06,UD,Armenia,300,224,0,0,76,38,38,76,0
2025-02-07,UD,Armenia,325,237,0,0,88,42,46,88,0
2025-02-08,UD,Armenia,316,233,0,0,83,43,40,83,0
2025-02-09,UD,Armenia,321,221,0,0,100,50,50,100,0
2025-02-10,UD,Armenia,335,253,0,0,82,45,37,82,0
2025-02-11,UD,Armenia,299,230,0,0,69,31,38,69,0
2025-02-12,UD,Armenia,321,237,0,0,84,43,41,84,0
2025-02-13,UD,Armenia,343,259,0,0,84,43,41,84,0
2025-02-14,UD,Armenia,355,270,0,0,85,42,43,85,0
2025-02-15,UD,Armenia,353,272,0,0,81,41,40,81,0
2025-02-16,UD,Armenia,366,267,0,0,99,48,51,99,0
2025-02-17,UD,Armenia,379,299,0,0,80,42,38,80,0
2025-02-18,UD,Armenia,350,276,0,0,74,36,38,74,0
2025-02-19,UD,Armenia,362,277,1,1,85,44,40,84,0
2025-02-20,UD,Armenia,314,231,0,0,83,42,41,83,0
2025-02-21,UD,Armenia,332,242,0,0,90,43,47,90,0
2025-02-22,UD,Armenia,331,243,0,0,88,45,43,88,0
2025-02-23,UD,Armenia,332,237,0,0,95,47,48,95,0
2025-02-24,UD,Armenia,335,253,0,0,82,44,38,82,0
2025-02-25,UD,Armenia,316,241,0,0,75,36,39,75,0
2025-02-26,UD,Armenia,340,252,0,0,88,44,44,88,0
2025-02-27,UD,Armenia,333,249,0,0,84,43,41,84,0
2025-02-28,UD,Armenia,361,272,0,0,89,43,46,89,0
2025-03-01,UD,Armenia,334,247,0,0,87,45,42,87,0
2025-03-02,UD,Armenia,350,253,0,0,97,47,50,97,0
2025-03-03,UD,Armenia,329,252,0,0,77,40,37,77,0
2025-03-04,UD,Armenia,321,250,0,0,71,34,37,71,0
2025-03-05,UD,Armenia,322,238,1,0,84,42,41,83,1
2025-03-06,UD,Armenia,344,265,0,0,79,40,39,79,0
2025-03-07,UD,Armenia,364,273,0,0,91,45,46,91,0
2025-03-08,UD,Armenia,357,276,0,0,81,41,40,81,0
2025-03-09,UD,Armenia,374,280,0,0,94,46,48,94,0
2025-03-10,UD,Armenia,318,239,0,0,79,40,39,79,0
2025-03-11,UD,Armenia,331,255,0,0,76,37,39,76,0
2025-03-12,UD,Armenia,344,254,0,0,90,45,45,90,0
2025-03-13,UD,Armenia,338,259,0,0,79,40,39,79,0
2025-03-14,UD,Armenia,377,287,0,0,90,45,45,90,0
2025-03-15,UD,Armenia,367,279,0,0,88,43,45,88,0
2025-03-16,UD,Armenia,384,276,0,0,108,55,53,108,0
2025-03-17,UD,Armenia,360,272,0,0,88,44,44,88,0
2025-03-18,UD,Armenia,318,242,0,0,76,37,39,76,0
2025-03-19,UD,Armenia,334,242,0,0,92,47,45,92,0
2025-03-20,UD,Armenia,366,270,0,0,96,47,49,96,0
2025-03-21,UD,Armenia,362,262,0,0,100,51,49,100,0
2025-03-22,UD,Armenia,361,264,0,0,97,50,47,97,0
2025-03-23,UD,Armenia,406,290,0,0,116,56,60,116,0
2025-03-24,UD,Armenia,370,280,0,0,90,45,45,90,0
2025-03-25,UD,Armenia,367,282,0,0,85,42,43,85,0
2025-03-26,UD,Armenia,366,272,0,0,94,48,46,94,0
2025-03-27,UD,Armenia,361,276,0,0,85,43,42,85,0
2025-03-28,UD,Armenia,373,270,0,0,103,51,52,103,0
2025-03-29,UD,Armenia,371,273,0,0,98,50,48,98,0
2025-03-30,UD,Armenia,389,271,0,0,118,58,60,118,0
2025-03-31,UD,Armenia,390,291,0,0,99,51,48,99,0
2025-04-01,UD,Armenia,368,257,0,0,111,55,56,111,0
2025-04-02,UD,Armenia,417,314,0,0,103,50,53,103,0
2025-04-03,UD,Armenia,412,300,0,0,112,56,56,112,0
2025-04-04,UD,Armenia,418,311,0,0,107,53,54,107,0
2025-04-05,UD,Armenia,414,299,0,0,115,58,57,115,0
2025-04-06,UD,Armenia,414,295,0,0,119,60,59,119,0
2025-04-07,UD,Armenia,389,286,0,0,103,53,50,103,0
2025-04-08,UD,Armenia,355,258,0,0,97,49,48,97,0
2025-04-09,UD,Armenia,343,259,0,0,84,39,45,84,0
2025-04-10,UD,Armenia,351,237,0,0,114,57,57,114,0
2025-04-11,UD,Armenia,385,273,0,0,112,54,58,112,0
2025-04-12,UD,Armenia,404,286,1,1,118,60,57,117,0
2025-04-13,UD,Armenia,435,321,0,0,114,57,57,114,0
2025-04-14,UD,Armenia,390,288,0,0,102,54,48,102,0
2025-04-15,UD,Armenia,376,277,0,0,99,48,51,99,0
2025-04-16,UD,Armenia,400,309,0,0,91,46,45,91,0
2025-04-17,UD,Armenia,413,304,0,0,109,54,55,109,0
2025-04-18,UD,Armenia,443,330,0,0,113,58,55,113,0
2025-04-19,UD,Armenia,323,212,0,0,111,54,57,111,0
2025-04-20,UD,Armenia,385,270,0,0,115,58,57,115,0
2025-04-21,UD,Armenia,366,263,0,0,103,54,49,103,0
2025-04-22,UD,Armenia,352,255,0,0,97,48,49,97,0
2025-04-23,UD,Armenia,368,276,0,0,92,42,50,92,0
2025-04-24,UD,Armenia,394,279,0,0,115,60,55,115,0
2025-04-25,UD,Armenia,432,314,0,0,118,58,60,118,0
2025-04-26,UD,Armenia,379,261,0,0,118,59,59,118,0
2025-04-27,UD,Armenia,362,246,0,0,116,59,57,116,0
2025-04-28,UD,Armenia,358,247,0,0,111,57,54,111,0
2025-04-29,UD,Armenia,323,215,0,0,108,53,55,108,0
2025-04-30,UD,Armenia,375,277,0,0,98,50,48,98,0
2025-05-01,UD,Armenia,382,263,0,0,119,58,61,119,0
2025-05-02,UD,Armenia,421,307,0,0,114,58,56,114,0
2025-05-03,UD,Armenia,362,250,0,0,112,55,57,112,0
2025-05-04,UD,Armenia,371,244,0,0,127,63,64,127,0
2025-05-05,UD,Armenia,354,243,0,0,111,58,53,111,0
2025-05-06,UD,Armenia,334,236,0,0,98,50,48,98,0
2025-05-07,UD,Armenia,288,197,0,0,91,46,45,91,0
2025-05-08,UD,Armenia,315,190,0,0,125,62,63,125,0
2025-05-09,UD,Armenia,322,205,0,0,117,55,62,117,0
2025-05-10,UD,Armenia,319,199,0,0,120,62,58,120,0
2025-05-11,UD,Armenia,343,217,0,0,126,61,65,126,0
2025-05-12,UD,Armenia,318,203,0,0,115,61,54,115,0
2025-05-13,UD,Armenia,328,228,0,0,100,50,50,100,0
2025-05-14,UD,Armenia,314,214,0,0,100,48,52,100,0
2025-05-15,UD,Armenia,314,189,0,0,125,63,62,125,0
2025-05-16,UD,Armenia,317,205,0,0,112,56,56,112,0
2025-05-17,UD,Armenia,305,187,0,0,118,59,59,118,0
2025-05-18,UD,Armenia,359,226,0,0,133,67,66,133,0
2025-05-19,UD,Armenia,330,217,0,0,113,56,57,113,0
2025-05-20,UD,Armenia,352,241,0,0,111,56,55,111,0
2025-05-21,UD,Armenia,335,238,0,0,97,47,50,97,0
2025-05-22,UD,Armenia,352,236,0,0,116,55,61,116,0
2025-05-23,UD,Armenia,390,278,0,0,112,57,55,112,0
2025-05-24,UD,Armenia,380,254,0,0,126,60,66,126,0
2025-05-25,UD,Armenia,382,253,0,0,129,63,66,129,0
2025-05-26,UD,Armenia,386,261,0,0,125,68,57,125,0
2025-05-27,UD,Armenia,425,310,0,0,115,59,56,115,0
2025-05-28,UD,Armenia,387,288,0,0,99,49,50,99,0
2025-05-29,UD,Armenia,472,343,0,0,129,64,65,129,0
2025-05-30,UD,Armenia,433,312,0,0,121,59,62,121,0
2025-05-31,UD,Armenia,423,302,0,0,121,60,61,121,0
2025-06-01,UD,Armenia,481,349,0,0,132,65,67,132,0
2025-06-02,UD,Armenia,489,356,0,0,133,69,64,133,0
2025-06-03,UD,Armenia,435,313,0,0,122,60,62,122,0
2025-06-04,UD,Armenia,422,302,0,0,120,60,60,120,0
2025-06-05,UD,Armenia,433,293,0,0,140,70,70,140,0
2025-06-06,UD,Armenia,479,348,0,0,131,65,66,131,0
2025-06-07,UD,Armenia,420,288,0,0,132,66,66,132,0
2025-06-08,UD,Armenia,410,276,0,0,134,68,66,134,0
2025-06-09,UD,Armenia,432,290,0,0,142,72,70,142,0
2025-06-10,UD,Armenia,418,280,0,0,138,71,67,138,0
2025-06-11,UD,Armenia,420,293,0,0,127,63,64,127,0
2025-06-12,UD,Armenia,421,281,1,0,140,68,71,139,1
2025-06-13,UD,Armenia,507,382,0,0,125,61,64,125,0
2025-06-14,UD,Armenia,466,337,0,0,129,65,64,129,0
2025-06-15,UD,Armenia,471,351,0,0,120,60,60,120,0
2025-06-16,UD,Armenia,461,335,0,0,126,63,63,126,0
2025-06-17,UD,Armenia,474,344,0,0,130,67,63,130,0
2025-06-18,UD,Armenia,444,317,0,0,127,62,65,127,0
2025-06-19,UD,Armenia,452,326,0,0,126,65,61,126,0
2025-06-20,UD,Armenia,473,340,0,0,133,64,69,133,0
2025-06-21,UD,Armenia,480,348,0,0,132,65,67,132,0
2025-06-22,UD,Armenia,449,317,0,0,132,68,64,132,0
2025-06-23,UD,Armenia,429,308,0,0,121,59,62,121,0
2025-06-24,UD,Armenia,432,314,0,0,118,60,58,118,0
2025-06-25,UD,Armenia,453,333,0,0,120,59,61,120,0
2025-06-26,UD,Armenia,444,320,0,0,124,62,62,124,0
2025-06-27,UD,Armenia,510,368,0,0,142,71,71,142,0
2025-06-28,UD,Armenia,498,360,0,0,138,69,69,138,0
2025-06-29,UD,Armenia,480,350,0,0,130,68,62,130,0
2025-06-30,UD,Armenia,492,366,0,0,126,62,64,126,0
2025-07-01,UD,Armenia,507,365,0,0,142,72,70,142,0
2025-07-02,UD,Armenia,528,399,0,0,129,60,69,129,0
2025-07-03,UD,Armenia,549,399,0,0,150,77,73,150,0
2025-07-04,UD,Armenia,531,389,0,0,142,70,72,142,0
2025-07-05,UD,Armenia,484,346,0,0,138,68,70,138,0
2025-07-06,UD,Armenia,462,318,0,0,144,73,71,144,0
2025-07-07,UD,Armenia,476,346,0,0,130,65,65,130,0
2025-07-08,UD,Armenia,486,337,1,1,149,75,73,148,0
2025-07-09,UD,Armenia,515,380,0,0,135,68,67,135,0
2025-07-10,UD,Armenia,529,385,0,0,144,72,72,144,0
2025-07-11,UD,Armenia,547,397,0,0,150,75,75,150,0
2025-07-12,UD,Armenia,568,414,0,0,154,76,78,154,0
2025-07-13,UD,Armenia,520,375,0,0,145,76,69,145,0
2025-07-14,UD,Armenia,543,409,0,0,134,64,70,134,0
2025-07-15,UD,Armenia,553,406,0,0,147,74,73,147,0
2025-07-16,UD,Armenia,554,414,0,0,140,69,71,140,0
2025-07-17,UD,Armenia,568,423,0,0,145,74,71,145,0
2025-07-18,UD,Armenia,581,428,0,0,153,76,77,153,0
2025-07-19,UD,Armenia,487,336,1,1,151,74,76,150,0
2025-07-20,UD,Armenia,469,316,0,0,153,79,74,153,0
2025-07-21,UD,Armenia,545,411,0,0,134,65,69,134,0
2025-07-22,UD,Armenia,568,412,0,0,156,80,76,156,0
2025-07-23,UD,Armenia,511,368,1,1,143,68,74,142,0
2025-07-24,UD,Armenia,534,379,0,0,155,80,75,155,0
2025-07-25,UD,Armenia,497,347,0,0,150,75,75,150,0
2025-07-26,UD,Armenia,493,339,0,0,154,73,81,154,0
2025-07-27,UD,Armenia,476,332,0,0,144,75,69,144,0
2025-07-28,UD,Armenia,457,313,0,0,144,72,72,144,0
2025-07-29,UD,Armenia,520,368,0,0,152,76,76,152,0
2025-07-30,UD,Armenia,492,354,0,0,138,67,71,138,0
2025-07-31,UD,Armenia,560,400,0,0,160,81,79,160,0
2025-08-01,UD,Armenia,545,391,0,0,154,77,77,154,0
2025-08-02,UD,Armenia,527,357,0,0,170,82,88,170,0
2025-08-03,UD,Armenia,499,341,0,0,158,82,76,158,0
2025-08-04,UD,Armenia,452,305,0,0,147,76,71,147,0
2025-08-05,UD,Armenia,485,333,0,0,152,75,77,152,0
2025-08-06,UD,Armenia,489,342,0,0,147,73,74,147,0
2025-08-07,UD,Armenia,492,336,0,0,156,78,78,156,0
2025-08-08,UD,Armenia,558,407,0,0,151,76,75,151,0
2025-08-09,UD,Armenia,556,401,0,0,155,74,81,155,0
2025-08-10,UD,Armenia,560,407,0,0,153,80,73,153,0
2025-08-11,UD,Armenia,566,420,0,0,146,72,74,146,0
2025-08-12,UD,Armenia,586,434,0,0,152,77,75,152,0
2025-08-13,UD,Armenia,488,344,0,0,144,69,75,144,0
2025-08-14,UD,Armenia,498,338,0,0,160,83,77,160,0
2025-08-15,UD,Armenia,539,382,0,0,157,78,79,157,0
2025-08-16,UD,Armenia,530,365,0,0,165,79,86,165,0
2025-08-17,UD,Armenia,500,353,0,0,147,78,69,147,0
2025-08-18,UD,Armenia,510,366,0,0,144,70,74,144,0
2025-08-19,UD,Armenia,532,377,0,0,155,78,77,155,0
2025-08-20,UD,Armenia,521,372,0,0,149,74,75,149,0
2025-08-21,UD,Armenia,497,341,0,0,156,78,78,156,0
2025-08-22,UD,Armenia,475,312,0,0,163,81,82,163,0
2025-08-23,UD,Armenia,449,294,0,0,155,76,79,155,0
2025-08-24,UD,Armenia,481,326,0,0,155,79,76,155,0
2025-08-25,UD,Armenia,471,333,0,0,138,69,69,138,0
2025-08-26,UD,Armenia,495,338,0,0,157,79,78,157,0
2025-08-27,UD,Armenia,484,343,0,0,141,70,71,141,0
2025-08-28,UD,Armenia,473,324,0,0,149,75,74,149,0
2025-08-29,UD,Armenia,539,384,0,0,155,79,76,155,0
2025-01-01,LO,Austria,2874,2292,10,1,582,295,277,572,9
2025-01-02,LO,Austria,3604,2806,19,4,798,391,388,779,15
2025-01-03,LO,Austria,3783,2922,22,4,861,421,418,839,18
2025-01-04,LO,Austria,3809,2907,25,2,902,436,441,877,23
2025-01-05,LO,Austria,3690,2869,11,0,821,407,403,810,11
2025-01-06,LO,Austria,3633,2852,11,1,781,383,387,770,10
2025-01-07,LO,Austria,3185,2536,16,0,649,313,320,633,16
2025-01-08,LO,Austria,2904,2267,19,1,637,313,305,618,18
2025-01-09,LO,Austria,3062,2391,26,0,671,321,324,645,26
2025-01-10,LO,Austria,3533,2743,21,2,790,385,384,769,19
2025-01-11,LO,Austria,3368,2601,16,1,767,374,377,751,15
2025-01-12,LO,Austria,3540,2771,18,3,769,377,374,751,15
2025-01-13,LO,Austria,3261,2525,32,3,736,348,356,704,29
2025-01-14,LO,Austria,2669,2082,32,2,587,278,277,555,30
2025-01-15,LO,Austria,2801,2153,29,1,648,311,308,619,28
2025-01-16,LO,Austria,3008,2315,25,2,693,332,336,668,23
2025-01-17,LO,Austria,3517,2713,22,0,804,397,385,782,22
2025-01-18,LO,Austria,3283,2512,11,0,771,378,382,760,11
2025-01-19,LO,Austria,3352,2580,20,0,772,378,374,752,20
2025-01-20,LO,Austria,3425,2691,25,5,734,350,359,709,20
2025-01-21,LO,Austria,2762,2179,20,1,583,278,285,563,19
2025-01-22,LO,Austria,2977,2322,23,2,655,325,307,632,21
2025-01-23,LO,Austria,3201,2506,24,5,695,326,345,671,19
2025-01-24,LO,Austria,3654,2816,30,3,838,401,407,808,27
2025-01-25,LO,Austria,3407,2603,15,2,804,396,393,789,13
2025-01-26,LO,Austria,3504,2707,23,1,797,396,378,774,22
2025-01-27,LO,Austria,3325,2578,25,1,747,361,361,722,24
2025-01-28,LO,Austria,2684,2123,22,1,561,267,272,539,21
2025-01-29,LO,Austria,2951,2271,33,3,680,322,325,647,30
2025-01-30,LO,Austria,3072,2317,32,3,755,356,367,723,29
2025-01-31,LO,Austria,3630,2771,29,2,859,416,414,830,27
2025-02-01,LO,Austria,3530,2656,23,1,874,422,429,851,22
2025-02-02,LO,Austria,3572,2760,20,1,812,402,390,792,19
2025-02-03,LO,Austria,3385,2610,28,1,775,374,373,747,27
2025-02-04,LO,Austria,2793,2178,19,0,615,300,296,596,19
2025-02-05,LO,Austria,3082,2345,36,0,737,358,343,701,36
2025-02-06,LO,Austria,3214,2480,24,3,734,355,355,710,21
2025-02-07,LO,Austria,3649,2814,22,1,835,400,413,813,21
2025-02-08,LO,Austria,3536,2657,20,0,879,428,431,859,20
2025-02-09,LO,Austria,3656,2835,26,2,821,400,395,795,24
2025-02-10,LO,Austria,3526,2734,31,0,792,381,380,761,31
2025-02-11,LO,Austria,3000,2362,26,0,638,316,296,612,26
2025-02-12,LO,Austria,3199,2506,25,1,693,336,332,668,24
2025-02-13,LO,Austria,3220,2510,19,0,710,347,344,691,19
2025-02-14,LO,Austria,3848,2991,22,5,857,407,428,835,17
2025-02-15,LO,Austria,3818,2860,27,1,958,467,464,931,26
2025-02-16,LO,Austria,3788,2969,21,1,819,404,394,798,20
2025-02-17,LO,Austria,3578,2803,32,2,775,373,370,743,30
2025-02-18,LO,Austria,3182,2530,28,0,652,310,314,624,28
2025-02-19,LO,Austria,3423,2657,29,0,766,368,369,737,29
2025-02-20,LO,Austria,3395,2633,26,2,762,369,367,736,24
2025-02-21,LO,Austria,3787,2866,33,0,921,434,454,888,33
2025-02-22,LO,Austria,3736,2764,27,1,972,475,470,945,26
2025-02-23,LO,Austria,3837,2968,33,1,869,418,418,836,32
2025-02-24,LO,Austria,3605,2802,35,2,803,384,384,768,33
2025-02-25,LO,Austria,3145,2468,21,2,677,329,327,656,19
2025-02-26,LO,Austria,3357,2588,27,6,769,371,371,742,21
2025-02-27,LO,Austria,3242,2451,31,3,791,374,386,760,28
2025-02-28,LO,Austria,3504,2635,21,1,869,429,419,848,20
2025-03-01,LO,Austria,3792,2854,22,2,938,456,460,916,20
2025-03-02,LO,Austria,3817,2978,25,0,839,410,404,814,25
2025-03-03,LO,Austria,3589,2765,25,1,824,399,400,799,24
2025-03-04,LO,Austria,3268,2519,50,7,749,349,350,699,43
2025-03-05,LO,Austria,3508,2685,57,4,823,384,382,766,53
2025-03-06,LO,Austria,3531,2705,39,3,826,394,393,787,36
2025-03-07,LO,Austria,3951,2989,46,2,962,460,456,916,44
2025-03-08,LO,Austria,3767,2843,22,2,924,450,452,902,20
2025-03-09,LO,Austria,3857,2997,19,1,860,416,425,841,18
2025-03-10,LO,Austria,2941,2210,39,3,731,357,335,692,36
2025-03-11,LO,Austria,3298,2587,26,0,711,346,339,685,26
2025-03-12,LO,Austria,3402,2614,38,3,788,378,372,750,35
2025-03-13,LO,Austria,3520,2724,33,1,796,379,384,763,32
2025-03-14,LO,Austria,3936,3046,21,0,890,435,434,869,21
2025-03-15,LO,Austria,3678,2825,20,3,853,411,422,833,17
2025-03-16,LO,Austria,3867,3032,18,0,835,408,409,817,18
2025-03-17,LO,Austria,3719,2886,30,1,833,398,405,803,29
2025-03-18,LO,Austria,3332,2578,39,0,754,360,355,715,39
2025-03-19,LO,Austria,3482,2686,33,0,796,383,380,763,33
2025-03-20,LO,Austria,3620,2764,39,2,856,410,407,817,37
2025-03-21,LO,Austria,3780,2880,42,4,900,426,432,858,38
2025-03-22,LO,Austria,3661,2843,21,0,818,392,405,797,21
2025-03-23,LO,Austria,3885,3017,22,2,868,430,416,846,20
2025-03-24,LO,Austria,3686,2865,36,3,821,395,390,785,33
2025-03-25,LO,Austria,3338,2627,29,1,711,342,340,682,28
2025-03-26,LO,Austria,3526,2741,32,2,785,373,380,753,30
2025-03-27,LO,Austria,3583,2791,39,3,792,376,377,753,36
2025-03-28,LO,Austria,3955,3068,37,4,887,425,425,850,33
2025-03-29,LO,Austria,3589,2847,19,4,742,360,363,723,15
2025-03-30,LO,Austria,4356,3502,22,3,854,422,410,832,19
2025-03-31,LO,Austria,4003,3160,22,1,843,410,411,821,21
2025-04-01,LO,Austria,4240,3396,22,3,844,416,406,822,19
2025-04-02,LO,Austria,4278,3395,25,3,883,427,431,858,22
2025-04-03,LO,Austria,4424,3509,41,3,915,439,435,874,38
2025-04-04,LO,Austria,4641,3701,44,4,940,450,446,896,40
2025-04-05,LO,Austria,4516,3657,33,3,859,409,417,826,30
2025-04-06,LO,Austria,4601,3755,18,1,846,413,415,828,17
2025-04-07,LO,Austria,4482,3638,25,2,844,408,411,819,23
2025-04-08,LO,Austria,4375,3507,44,2,868,411,413,824,42
2025-04-09,LO,Austria,4380,3453,39,1,927,444,444,888,38
2025-04-10,LO,Austria,4585,3637,40,7,948,457,451,908,33
2025-04-11,LO,Austria,4870,3896,33,4,974,469,472,941,29
2025-04-12,LO,Austria,4790,3911,20,0,879,425,434,859,20
2025-04-13,LO,Austria,4768,3890,17,0,878,433,428,861,17
2025-04-14,LO,Austria,4607,3735,31,2,872,425,416,841,29
2025-04-15,LO,Austria,4484,3653,34,5,831,396,401,797,29
2025-04-16,LO,Austria,4754,3849,33,3,905,442,430,872,30
2025-04-17,LO,Austria,4466,3573,23,1,893,437,433,870,22
2025-04-18,LO,Austria,4733,3855,19,4,878,431,428,859,15
2025-04-19,LO,Austria,4740,3932,32,2,808,383,393,776,30
2025-04-20,LO,Austria,4664,3899,6,0,765,380,379,759,6
2025-04-21,LO,Austria,4607,3770,21,1,837,408,408,816,20
2025-04-22,LO,Austria,4545,3670,31,1,875,424,420,844,30
2025-04-23,LO,Austria,4590,3712,38,0,878,418,422,840,38
2025-04-24,LO,Austria,4693,3819,30,3,874,425,419,844,27
2025-04-25,LO,Austria,4816,3901,26,1,915,444,445,889,25
2025-04-26,LO,Austria,4928,4092,24,1,836,405,407,812,23
2025-04-27,LO,Austria,5079,4165,28,1,914,436,450,886,27
2025-04-28,LO,Austria,4658,3746,27,1,912,449,436,885,26
2025-04-29,LO,Austria,4553,3631,31,3,922,444,447,891,28
2025-04-30,LO,Austria,4734,3761,38,4,973,473,462,935,34
2025-05-01,LO,Austria,4967,4038,30,0,929,451,448,899,30
2025-05-02,LO,Austria,4948,4041,28,1,907,439,440,879,27
2025-05-03,LO,Austria,4977,4163,24,3,814,391,399,790,21
2025-05-04,LO,Austria,5232,4279,20,0,953,459,474,933,20
2025-05-05,LO,Austria,4866,3982,21,2,884,431,432,863,19
2025-05-06,LO,Austria,4872,3938,31,2,934,457,446,903,29
2025-05-07,LO,Austria,4923,3972,46,4,951,445,460,905,42
2025-05-08,LO,Austria,5008,4033,24,1,975,484,467,951,23
2025-05-09,LO,Austria,5091,4112,35,2,979,472,472,944,33
2025-05-10,LO,Austria,5165,4317,29,0,848,399,420,819,29
2025-05-11,LO,Austria,5338,4391,30,3,947,468,449,917,27
2025-05-12,LO,Austria,4903,4002,28,1,901,438,435,873,27
2025-05-13,LO,Austria,4866,3918,43,2,948,457,448,905,41
2025-05-14,LO,Austria,4998,4046,44,0,952,449,459,908,44
2025-05-15,LO,Austria,5065,4082,38,1,983,477,468,945,37
2025-05-16,LO,Austria,5193,4203,33,1,990,479,478,957,32
2025-05-17,LO,Austria,5293,4444,24,2,849,409,416,825,22
2025-05-18,LO,Austria,5270,4331,22,1,939,460,457,917,21
2025-05-19,LO,Austria,4998,4063,39,2,935,447,449,896,37
2025-05-20,LO,Austria,4935,4007,44,1,928,447,437,884,43
2025-05-21,LO,Austria,4928,3991,43,1,937,437,457,894,42
2025-05-22,LO,Austria,5200,4249,25,2,951,469,457,926,23
2025-05-23,LO,Austria,5347,4355,32,3,992,480,480,960,29
2025-05-24,LO,Austria,5429,4538,38,1,891,424,429,853,37
2025-05-25,LO,Austria,5477,4522,21,0,955,463,471,934,21
2025-05-26,LO,Austria,5253,4317,35,3,936,448,453,901,32
2025-05-27,LO,Austria,5161,4209,39,1,952,456,457,913,38
2025-05-28,LO,Austria,5303,4319,41,0,984,477,466,943,41
2025-05-29,LO,Austria,5241,4335,21,2,906,457,428,885,19
2025-05-30,LO,Austria,5228,4327,16,2,901,438,447,885,14
2025-05-31,LO,Austria,5436,4517,24,2,919,438,457,895,22
2025-06-01,LO,Austria,5247,4227,23,0,1020,504,493,997,23
2025-06-02,LO,Austria,5103,4177,36,3,926,445,445,890,33
2025-06-03,LO,Austria,5237,4255,30,1,982,476,476,952,29
2025-06-04,LO,Austria,5322,4317,35,0,1005,491,479,970,35
2025-06-05,LO,Austria,5443,4431,36,1,1012,482,494,976,35
2025-06-06,LO,Austria,5703,4614,39,2,1089,536,514,1050,37
2025-06-07,LO,Austria,5672,4746,26,1,926,451,449,900,25
2025-06-08,LO,Austria,5493,4616,12,4,877,434,431,865,8
2025-06-09,LO,Austria,5376,4431,29,1,945,441,475,916,28
2025-06-10,LO,Austria,5276,4268,36,1,1008,492,480,972,35
2025-06-11,LO,Austria,5322,4319,24,2,1003,484,495,979,22
2025-06-12,LO,Austria,5543,4498,41,3,1045,499,505,1004,38
2025-06-13,LO,Austria,5553,4549,35,4,1004,482,487,969,31
2025-06-14,LO,Austria,5557,4618,24,0,939,457,458,915,24
2025-06-15,LO,Austria,5355,4374,31,1,981,473,477,950,30
2025-06-16,LO,Austria,5320,4390,28,4,930,449,453,902,24
2025-06-17,LO,Austria,5188,4231,33,2,957,463,461,924,31
2025-06-18,LO,Austria,5158,4140,41,2,1018,488,489,977,39
2025-06-19,LO,Austria,5252,4308,24,0,944,461,459,920,24
2025-06-20,LO,Austria,5363,4395,28,0,968,474,466,940,28
2025-06-21,LO,Austria,5688,4790,18,1,898,434,446,880,17
2025-06-22,LO,Austria,5642,4614,25,0,1028,495,508,1003,25
2025-06-23,LO,Austria,5072,4092,30,3,980,467,483,950,27
2025-06-24,LO,Austria,5296,4278,37,1,1018,503,478,981,36
2025-06-25,LO,Austria,5355,4323,41,3,1032,493,498,991,38
2025-06-26,LO,Austria,5055,4050,24,5,1005,484,497,981,19
2025-06-27,LO,Austria,5619,4562,37,2,1057,507,513,1020,35
2025-06-28,LO,Austria,5671,4711,25,0,960,463,472,935,25
2025-06-29,LO,Austria,5728,4634,40,0,1094,540,514,1054,40
2025-06-30,LO,Austria,5515,4530,33,3,985,479,473,952,30
2025-07-01,LO,Austria,5474,4481,46,8,993,472,475,947,38
2025-07-02,LO,Austria,5473,4473,43,4,1000,477,480,957,39
2025-07-03,LO,Austria,5343,4356,34,5,987,479,474,953,29
2025-07-04,LO,Austria,5630,4600,29,1,1030,505,496,1001,28
2025-07-05,LO,Austria,5735,4816,19,3,919,444,456,900,16
2025-07-06,LO,Austria,5581,4629,21,0,952,464,467,931,21
2025-07-07,LO,Austria,5655,4704,29,5,951,459,463,922,24
2025-07-08,LO,Austria,5423,4465,24,1,958,463,471,934,23
2025-07-09,LO,Austria,5673,4663,40,5,1010,486,484,970,35
2025-07-10,LO,Austria,5735,4740,31,5,995,483,481,964,26
2025-07-11,LO,Austria,5792,4790,27,6,1002,499,476,975,21
2025-07-12,LO,Austria,5857,4914,24,3,943,458,461,919,21
2025-07-13,LO,Austria,5870,4876,28,2,994,473,493,966,26
2025-07-14,LO,Austria,5579,4631,33,2,948,463,452,915,31
2025-07-15,LO,Austria,5675,4677,28,2,998,475,495,970,26
2025-07-16,LO,Austria,5642,4656,33,3,986,480,473,953,30
2025-07-17,LO,Austria,5756,4741,34,1,1015,490,491,981,33
2025-07-18,LO,Austria,5898,4830,39,8,1068,515,514,1029,31
2025-07-19,LO,Austria,5704,4756,17,2,948,462,469,931,15
2025-07-20,LO,Austria,5864,4836,30,5,1028,506,492,998,25
2025-07-21,LO,Austria,5691,4737,33,1,954,454,467,921,32
2025-07-22,LO,Austria,5724,4720,32,2,1004,489,483,972,30
2025-07-23,LO,Austria,5676,4671,40,3,1005,478,487,965,37
2025-07-24,LO,Austria,5324,4354,33,3,970,466,471,937,30
2025-07-25,LO,Austria,5330,4322,32,2,1008,494,482,976,30
2025-07-26,LO,Austria,5325,4362,25,2,963,461,477,938,23
2025-07-27,LO,Austria,5475,4525,21,0,950,467,462,929,21
2025-07-28,LO,Austria,5412,4421,36,4,991,479,476,955,32
2025-07-29,LO,Austria,5455,4495,22,1,960,471,467,938,21
2025-07-30,LO,Austria,5559,4569,46,3,990,473,471,944,43
2025-07-31,LO,Austria,5732,4730,32,4,1002,490,480,970,28
2025-08-01,LO,Austria,5294,4314,22,3,980,486,472,958,19
2025-08-02,LO,Austria,5416,4461,20,2,955,462,473,935,18
2025-08-03,LO,Austria,5670,4673,27,1,997,482,488,970,26
2025-08-04,LO,Austria,5772,4806,22,2,966,470,474,944,20
2025-08-05,LO,Austria,5691,4715,36,2,976,471,469,940,34
2025-08-06,LO,Austria,5785,4786,33,2,999,482,484,966,31
2025-08-07,LO,Austria,5724,4749,36,4,975,470,469,939,32
2025-08-08,LO,Austria,5739,4696,29,1,1043,510,504,1014,28
2025-08-09,LO,Austria,5838,4848,17,2,990,479,494,973,15
2025-08-10,LO,Austria,5773,4765,32,1,1008,481,495,976,31
2025-08-11,LO,Austria,5714,4742,55,5,972,468,449,917,50
2025-08-12,LO,Austria,5613,4592,56,2,1021,473,492,965,54
2025-08-13,LO,Austria,5714,4660,63,5,1054,494,497,991,58
2025-08-14,LO,Austria,5573,4546,38,6,1027,494,495,989,32
2025-08-15,LO,Austria,5647,4636,17,0,1011,502,492,994,17
2025-08-16,LO,Austria,5409,4457,20,0,952,467,465,932,20
2025-08-17,LO,Austria,5836,4824,25,1,1012,500,487,987,24
2025-08-18,LO,Austria,5700,4739,36,1,961,465,460,925,35
2025-08-19,LO,Austria,5619,4620,38,2,999,474,487,961,36
2025-08-20,LO,Austria,5583,4582,38,3,1001,480,483,963,35
2025-08-21,LO,Austria,5486,4517,30,1,969,473,466,939,29
2025-08-22,LO,Austria,5798,4733,34,3,1065,509,522,1031,31
2025-08-23,LO,Austria,5850,4905,20,0,945,464,461,925,20
2025-08-24,LO,Austria,5874,4843,28,1,1031,508,495,1003,27
2025-08-25,LO,Austria,5639,4686,35,0,953,449,469,918,35
2025-08-26,LO,Austria,5525,4535,37,2,990,478,475,953,35
2025-08-27,LO,Austria,5535,4520,32,3,1015,487,496,983,29
2025-08-28,LO,Austria,5645,4669,31,0,976,477,468,945,31
2025-08-29,LO,Austria,5792,4736,31,0,1056,524,501,1025,31
2025-01-01,EB,Belgium and Luxembourg,2604,1800,1,0,804,407,396,803,1
2025-01-02,EB,Belgium and Luxembourg,3053,2055,11,7,998,486,501,987,4
2025-01-03,EB,Belgium and Luxembourg,3288,2241,12,6,1047,527,508,1035,6
2025-01-04,EB,Belgium and Luxembourg,3098,2198,5,2,900,448,447,895,3
2025-01-05,EB,Belgium and Luxembourg,3145,2158,11,2,987,487,489,976,9
2025-01-06,EB,Belgium and Luxembourg,3095,2103,6,3,992,478,508,986,3
2025-01-07,EB,Belgium and Luxembourg,2739,1822,6,4,917,459,452,911,2
2025-01-08,EB,Belgium and Luxembourg,2538,1725,13,6,813,396,404,800,7
2025-01-09,EB,Belgium and Luxembourg,2647,1779,15,1,868,427,426,853,14
2025-01-10,EB,Belgium and Luxembourg,2958,1998,14,6,960,494,452,946,8
2025-01-11,EB,Belgium and Luxembourg,2807,2061,13,0,746,369,364,733,13
2025-01-12,EB,Belgium and Luxembourg,3001,2140,7,3,861,422,432,854,4
2025-01-13,EB,Belgium and Luxembourg,2768,1921,16,5,847,394,437,831,11
2025-01-14,EB,Belgium and Luxembourg,2354,1547,26,6,807,398,383,781,20
2025-01-15,EB,Belgium and Luxembourg,2402,1605,4,0,797,395,398,793,4
2025-01-16,EB,Belgium and Luxembourg,2709,1788,13,7,921,460,448,908,6
2025-01-17,EB,Belgium and Luxembourg,2954,2031,2,0,923,473,448,921,2
2025-01-18,EB,Belgium and Luxembourg,2850,2119,2,0,731,361,368,729,2
2025-01-19,EB,Belgium and Luxembourg,3034,2171,3,0,863,430,430,860,3
2025-01-20,EB,Belgium and Luxembourg,2954,2000,15,4,954,454,485,939,11
2025-01-21,EB,Belgium and Luxembourg,2452,1663,11,5,789,397,381,778,6
2025-01-22,EB,Belgium and Luxembourg,2647,1768,13,7,879,429,437,866,6
2025-01-23,EB,Belgium and Luxembourg,2763,1836,22,14,927,458,447,905,8
2025-01-24,EB,Belgium and Luxembourg,3050,2086,9,5,964,489,466,955,4
2025-01-25,EB,Belgium and Luxembourg,2872,2101,13,5,771,379,379,758,8
2025-01-26,EB,Belgium and Luxembourg,3079,2174,10,3,905,443,452,895,7
2025-01-27,EB,Belgium and Luxembourg,2864,1899,12,4,965,459,494,953,8
2025-01-28,EB,Belgium and Luxembourg,2442,1636,12,5,806,396,398,794,7
2025-01-29,EB,Belgium and Luxembourg,2627,1732,12,9,895,446,437,883,3
2025-01-30,EB,Belgium and Luxembourg,2664,1732,16,6,932,464,452,916,10
2025-01-31,EB,Belgium and Luxembourg,3062,2069,20,12,993,494,479,973,8
2025-02-01,EB,Belgium and Luxembourg,2923,2146,11,2,777,378,388,766,9
2025-02-02,EB,Belgium and Luxembourg,3138,2222,10,1,916,453,453,906,9
2025-02-03,EB,Belgium and Luxembourg,3028,2006,22,10,1022,483,517,1000,12
2025-02-04,EB,Belgium and Luxembourg,2572,1709,18,11,863,428,417,845,7
2025-02-05,EB,Belgium and Luxembourg,2709,1845,6,1,864,438,420,858,5
2025-02-06,EB,Belgium and Luxembourg,2850,1879,8,3,971,481,482,963,5
2025-02-07,EB,Belgium and Luxembourg,3207,2168,13,5,1039,525,501,1026,8
2025-02-08,EB,Belgium and Luxembourg,3077,2273,10,3,804,393,401,794,7
2025-02-09,EB,Belgium and Luxembourg,3261,2284,8,2,977,481,488,969,6
2025-02-10,EB,Belgium and Luxembourg,3168,2157,12,3,1011,488,511,999,9
2025-02-11,EB,Belgium and Luxembourg,2707,1842,7,4,865,424,434,858,3
2025-02-12,EB,Belgium and Luxembourg,3006,2026,17,4,980,499,464,963,13
2025-02-13,EB,Belgium and Luxembourg,2110,1762,2,0,348,171,175,346,2
2025-02-14,EB,Belgium and Luxembourg,3420,2327,16,9,1093,554,523,1077,7
2025-02-15,EB,Belgium and Luxembourg,3350,2494,7,4,856,418,431,849,3
2025-02-16,EB,Belgium and Luxembourg,3403,2406,6,1,997,495,496,991,5
2025-02-17,EB,Belgium and Luxembourg,3244,2188,7,3,1056,506,543,1049,4
2025-02-18,EB,Belgium and Luxembourg,2935,1980,19,10,955,467,469,936,9
2025-02-19,EB,Belgium and Luxembourg,3102,2065,21,12,1037,510,506,1016,9
2025-02-20,EB,Belgium and Luxembourg,3173,2094,21,12,1079,530,528,1058,9
2025-02-21,EB,Belgium and Luxembourg,3392,2299,11,8,1093,557,525,1082,3
2025-02-22,EB,Belgium and Luxembourg,3285,2412,8,3,873,434,431,865,5
2025-02-23,EB,Belgium and Luxembourg,3470,2454,8,3,1016,492,516,1008,5
2025-02-24,EB,Belgium and Luxembourg,3219,2137,11,6,1082,527,544,1071,5
2025-02-25,EB,Belgium and Luxembourg,2875,1942,13,8,933,463,457,920,5
2025-02-26,EB,Belgium and Luxembourg,3075,2061,13,9,1014,497,504,1001,4
2025-02-27,EB,Belgium and Luxembourg,3054,2027,15,6,1027,509,503,1012,9
2025-02-28,EB,Belgium and Luxembourg,3221,2121,19,8,1100,552,529,1081,11
2025-03-01,EB,Belgium and Luxembourg,3261,2332,9,3,929,465,455,920,6
2025-03-02,EB,Belgium and Luxembourg,3313,2309,8,4,1004,495,501,996,4
2025-03-03,EB,Belgium and Luxembourg,3227,2141,13,9,1086,522,551,1073,4
2025-03-04,EB,Belgium and Luxembourg,2884,1929,10,5,955,482,463,945,5
2025-03-05,EB,Belgium and Luxembourg,3146,2096,15,4,1050,512,523,1035,11
2025-03-06,EB,Belgium and Luxembourg,3207,2121,2,0,1086,546,538,1084,2
2025-03-07,EB,Belgium and Luxembourg,3315,2237,14,8,1078,550,514,1064,6
2025-03-08,EB,Belgium and Luxembourg,3237,2293,14,3,944,448,482,930,11
2025-03-09,EB,Belgium and Luxembourg,3427,2376,13,6,1051,524,514,1038,7
2025-03-10,EB,Belgium and Luxembourg,2935,1857,21,10,1078,516,541,1057,11
2025-03-11,EB,Belgium and Luxembourg,3033,2041,14,8,992,497,481,978,6
2025-03-12,EB,Belgium and Luxembourg,3097,2067,9,2,1030,511,510,1021,7
2025-03-13,EB,Belgium and Luxembourg,3322,2215,13,7,1107,538,556,1094,6
2025-03-14,EB,Belgium and Luxembourg,3393,2310,13,4,1083,547,523,1070,9
2025-03-15,EB,Belgium and Luxembourg,3130,2284,4,1,846,425,417,842,3
2025-03-16,EB,Belgium and Luxembourg,3400,2399,6,1,1001,488,507,995,5
2025-03-17,EB,Belgium and Luxembourg,3357,2254,18,7,1103,541,544,1085,11
2025-03-18,EB,Belgium and Luxembourg,2991,2009,15,9,982,481,486,967,6
2025-03-19,EB,Belgium and Luxembourg,3113,2052,12,7,1061,524,525,1049,5
2025-03-20,EB,Belgium and Luxembourg,3358,2240,10,8,1118,550,558,1108,2
2025-03-21,EB,Belgium and Luxembourg,3136,2047,16,9,1089,552,521,1073,7
2025-03-22,EB,Belgium and Luxembourg,3150,2300,3,2,850,416,431,847,1
2025-03-23,EB,Belgium and Luxembourg,3300,2302,4,2,998,496,498,994,2
2025-03-24,EB,Belgium and Luxembourg,3231,2144,14,8,1087,526,547,1073,6
2025-03-25,EB,Belgium and Luxembourg,2960,1963,14,10,997,486,497,983,4
2025-03-26,EB,Belgium and Luxembourg,3115,2046,18,11,1069,533,518,1051,7
2025-03-27,EB,Belgium and Luxembourg,3230,2119,10,2,1111,552,549,1101,8
2025-03-28,EB,Belgium and Luxembourg,3449,2332,18,7,1117,565,534,1099,11
2025-03-29,EB,Belgium and Luxembourg,3033,2175,12,3,858,417,429,846,9
2025-03-30,EB,Belgium and Luxembourg,3455,2401,11,4,1054,520,523,1043,7
2025-03-31,EB,Belgium and Luxembourg,2867,2370,14,8,497,233,250,483,6
2025-04-01,EB,Belgium and Luxembourg,3367,2262,18,9,1105,538,549,1087,9
2025-04-02,EB,Belgium and Luxembourg,3605,2438,10,5,1167,582,575,1157,5
2025-04-03,EB,Belgium and Luxembourg,3697,2480,26,9,1217,592,599,1191,17
2025-04-04,EB,Belgium and Luxembourg,3769,2555,18,7,1214,616,580,1196,11
2025-04-05,EB,Belgium and Luxembourg,3506,2527,8,2,979,486,485,971,6
2025-04-06,EB,Belgium and Luxembourg,3644,2534,15,4,1110,544,551,1095,11
2025-04-07,EB,Belgium and Luxembourg,3622,2465,11,8,1157,565,581,1146,3
2025-04-08,EB,Belgium and Luxembourg,3533,2404,13,8,1129,558,558,1116,5
2025-04-09,EB,Belgium and Luxembourg,3555,2360,10,7,1195,592,593,1185,3
2025-04-10,EB,Belgium and Luxembourg,3727,2526,7,4,1201,595,599,1194,3
2025-04-11,EB,Belgium and Luxembourg,3741,2527,9,3,1214,616,589,1205,6
2025-04-12,EB,Belgium and Luxembourg,3576,2559,11,2,1017,498,508,1006,9
2025-04-13,EB,Belgium and Luxembourg,3682,2567,19,9,1115,544,552,1096,10
2025-04-14,EB,Belgium and Luxembourg,3527,2393,17,9,1134,551,566,1117,8
2025-04-15,EB,Belgium and Luxembourg,3529,2452,8,3,1077,530,539,1069,5
2025-04-16,EB,Belgium and Luxembourg,3699,2521,18,8,1178,588,572,1160,10
2025-04-17,EB,Belgium and Luxembourg,3542,2381,15,8,1161,577,569,1146,7
2025-04-18,EB,Belgium and Luxembourg,3602,2448,18,7,1154,573,563,1136,11
2025-04-19,EB,Belgium and Luxembourg,3438,2457,9,7,981,483,489,972,2
2025-04-20,EB,Belgium and Luxembourg,3528,2475,5,1,1053,522,526,1048,4
2025-04-21,EB,Belgium and Luxembourg,3521,2417,10,4,1104,536,558,1094,6
2025-04-22,EB,Belgium and Luxembourg,3536,2388,19,10,1148,565,564,1129,9
2025-04-23,EB,Belgium and Luxembourg,3546,2353,13,8,1193,591,589,1180,5
2025-04-24,EB,Belgium and Luxembourg,3586,2424,12,7,1162,578,572,1150,5
2025-04-25,EB,Belgium and Luxembourg,3708,2510,33,14,1198,588,577,1165,19
2025-04-26,EB,Belgium and Luxembourg,3493,2485,9,6,1008,496,503,999,3
2025-04-27,EB,Belgium and Luxembourg,3751,2620,20,14,1131,565,546,1111,6
2025-04-28,EB,Belgium and Luxembourg,3501,2348,15,9,1153,560,578,1138,6
2025-04-29,EB,Belgium and Luxembourg,3138,2422,36,15,716,326,354,680,21
2025-04-30,EB,Belgium and Luxembourg,3730,2452,11,5,1278,645,622,1267,6
2025-05-01,EB,Belgium and Luxembourg,3646,2528,10,1,1118,557,551,1108,9
2025-05-02,EB,Belgium and Luxembourg,3737,2629,5,5,1108,559,544,1103,0
2025-05-03,EB,Belgium and Luxembourg,3358,2387,5,3,971,483,483,966,2
2025-05-04,EB,Belgium and Luxembourg,3730,2616,3,0,1114,548,563,1111,3
2025-05-05,EB,Belgium and Luxembourg,3651,2484,21,7,1167,563,583,1146,14
2025-05-06,EB,Belgium and Luxembourg,3565,2460,10,1,1105,545,550,1095,9
2025-05-07,EB,Belgium and Luxembourg,3738,2543,20,8,1195,594,581,1175,12
2025-05-08,EB,Belgium and Luxembourg,3726,2511,8,3,1215,600,607,1207,5
2025-05-09,EB,Belgium and Luxembourg,3796,2603,9,3,1193,606,578,1184,6
2025-05-10,EB,Belgium and Luxembourg,3606,2591,6,2,1015,511,498,1009,4
2025-05-11,EB,Belgium and Luxembourg,3898,2747,5,0,1151,564,582,1146,5
2025-05-12,EB,Belgium and Luxembourg,3748,2549,13,8,1199,582,604,1186,5
2025-05-13,EB,Belgium and Luxembourg,3693,2499,28,9,1194,578,588,1166,19
2025-05-14,EB,Belgium and Luxembourg,3860,2600,21,13,1260,625,614,1239,8
2025-05-15,EB,Belgium and Luxembourg,3792,2509,32,23,1283,634,617,1251,9
2025-05-16,EB,Belgium and Luxembourg,3841,2583,25,15,1258,628,605,1233,10
2025-05-17,EB,Belgium and Luxembourg,3599,2608,9,4,991,490,492,982,5
2025-05-18,EB,Belgium and Luxembourg,3824,2694,8,0,1130,562,560,1122,8
2025-05-19,EB,Belgium and Luxembourg,3693,2474,34,21,1219,571,614,1185,13
2025-05-20,EB,Belgium and Luxembourg,3783,2578,24,17,1205,593,588,1181,7
2025-05-21,EB,Belgium and Luxembourg,3818,2554,27,13,1264,619,618,1237,14
2025-05-22,EB,Belgium and Luxembourg,3936,2646,22,17,1290,641,627,1268,5
2025-05-23,EB,Belgium and Luxembourg,3904,2651,32,21,1253,614,607,1221,11
2025-05-24,EB,Belgium and Luxembourg,3620,2602,7,1,1018,510,501,1011,6
2025-05-25,EB,Belgium and Luxembourg,3833,2687,8,2,1146,560,578,1138,6
2025-05-26,EB,Belgium and Luxembourg,3796,2584,15,12,1212,587,610,1197,3
2025-05-27,EB,Belgium and Luxembourg,3764,2582,28,22,1182,589,565,1154,6
2025-05-28,EB,Belgium and Luxembourg,3877,2616,24,18,1261,617,620,1237,6
2025-05-29,EB,Belgium and Luxembourg,3762,2591,11,6,1171,586,574,1160,5
2025-05-30,EB,Belgium and Luxembourg,3773,2623,8,6,1150,583,559,1142,2
2025-05-31,EB,Belgium and Luxembourg,3431,2406,7,3,1025,501,517,1018,4
2025-06-01,EB,Belgium and Luxembourg,3873,2670,4,2,1203,587,612,1199,2
2025-06-02,EB,Belgium and Luxembourg,3805,2616,18,17,1189,576,595,1171,1
2025-06-03,EB,Belgium and Luxembourg,3773,2578,32,21,1195,582,581,1163,11
2025-06-04,EB,Belgium and Luxembourg,3860,2618,16,14,1242,610,616,1226,2
2025-06-05,EB,Belgium and Luxembourg,3916,2645,18,10,1271,629,624,1253,8
2025-06-06,EB,Belgium and Luxembourg,3910,2647,20,18,1263,645,598,1243,2
2025-06-07,EB,Belgium and Luxembourg,3613,2588,10,4,1025,502,513,1015,6
2025-06-08,EB,Belgium and Luxembourg,3688,2604,5,2,1084,543,536,1079,3
2025-06-09,EB,Belgium and Luxembourg,3773,2644,6,1,1129,545,578,1123,5
2025-06-10,EB,Belgium and Luxembourg,3736,2550,17,10,1186,582,587,1169,7
2025-06-11,EB,Belgium and Luxembourg,3863,2600,28,20,1263,624,611,1235,8
2025-06-12,EB,Belgium and Luxembourg,3988,2705,20,11,1283,633,630,1263,9
2025-06-13,EB,Belgium and Luxembourg,3913,2690,19,12,1223,612,592,1204,7
2025-06-14,EB,Belgium and Luxembourg,3448,2417,12,4,1031,513,506,1019,8
2025-06-15,EB,Belgium and Luxembourg,3744,2612,9,0,1132,552,571,1123,9
2025-06-16,EB,Belgium and Luxembourg,3715,2510,24,14,1205,581,600,1181,10
2025-06-17,EB,Belgium and Luxembourg,3651,2448,15,9,1203,590,598,1188,6
2025-06-18,EB,Belgium and Luxembourg,3764,2532,23,12,1232,606,603,1209,11
2025-06-19,EB,Belgium and Luxembourg,3841,2570,27,18,1271,628,616,1244,9
2025-06-20,EB,Belgium and Luxembourg,3866,2643,21,13,1223,614,588,1202,8
2025-06-21,EB,Belgium and Luxembourg,3708,2654,15,13,1054,517,522,1039,2
2025-06-22,EB,Belgium and Luxembourg,3791,2621,8,2,1170,574,588,1162,6
2025-06-23,EB,Belgium and Luxembourg,3655,2438,22,15,1217,580,615,1195,7
2025-06-24,EB,Belgium and Luxembourg,3625,2362,29,17,1263,626,608,1234,12
2025-06-25,EB,Belgium and Luxembourg,3186,2360,33,21,826,377,416,793,12
2025-06-26,EB,Belgium and Luxembourg,3808,2494,18,12,1314,666,630,1296,6
2025-06-27,EB,Belgium and Luxembourg,3996,2670,25,20,1326,666,635,1301,5
2025-06-28,EB,Belgium and Luxembourg,3728,2643,11,7,1085,539,535,1074,4
2025-06-29,EB,Belgium and Luxembourg,3904,2722,10,3,1182,583,589,1172,7
2025-06-30,EB,Belgium and Luxembourg,3979,2730,20,15,1249,597,632,1229,5
2025-07-01,EB,Belgium and Luxembourg,3908,2647,25,19,1261,619,617,1236,6
2025-07-02,EB,Belgium and Luxembourg,3893,2608,28,18,1285,624,633,1257,10
2025-07-03,EB,Belgium and Luxembourg,4035,2747,25,20,1288,636,627,1263,5
2025-07-04,EB,Belgium and Luxembourg,4263,2972,28,22,1291,641,622,1263,6
2025-07-05,EB,Belgium and Luxembourg,3777,2675,8,1,1102,560,534,1094,7
2025-07-06,EB,Belgium and Luxembourg,3848,2673,10,0,1175,576,589,1165,10
2025-07-07,EB,Belgium and Luxembourg,3850,2619,18,15,1231,591,622,1213,3
2025-07-08,EB,Belgium and Luxembourg,3773,2524,35,29,1249,613,601,1214,6
2025-07-09,EB,Belgium and Luxembourg,3861,2582,36,30,1279,620,623,1243,6
2025-07-10,EB,Belgium and Luxembourg,3914,2650,30,21,1264,623,611,1234,9
2025-07-11,EB,Belgium and Luxembourg,3956,2710,12,7,1246,623,611,1234,5
2025-07-12,EB,Belgium and Luxembourg,3756,2675,12,2,1081,536,533,1069,10
2025-07-13,EB,Belgium and Luxembourg,3984,2816,10,1,1168,575,583,1158,9
2025-07-14,EB,Belgium and Luxembourg,3839,2594,19,15,1245,600,626,1226,4
2025-07-15,EB,Belgium and Luxembourg,3880,2630,23,17,1250,615,612,1227,6
2025-07-16,EB,Belgium and Luxembourg,3814,2595,20,14,1219,606,593,1199,6
2025-07-17,EB,Belgium and Luxembourg,3945,2650,23,17,1295,634,638,1272,6
2025-07-18,EB,Belgium and Luxembourg,3987,2685,17,13,1302,646,639,1285,4
2025-07-19,EB,Belgium and Luxembourg,3733,2655,9,2,1078,539,530,1069,7
2025-07-20,EB,Belgium and Luxembourg,3767,2580,8,1,1187,586,593,1179,7
2025-07-21,EB,Belgium and Luxembourg,3817,2590,9,1,1227,594,624,1218,8
2025-07-22,EB,Belgium and Luxembourg,3846,2611,17,8,1235,615,603,1218,9
2025-07-23,EB,Belgium and Luxembourg,3883,2633,27,17,1250,612,611,1223,10
2025-07-24,EB,Belgium and Luxembourg,3857,2553,26,14,1304,631,647,1278,12
2025-07-25,EB,Belgium and Luxembourg,3965,2683,23,15,1282,631,628,1259,8
2025-07-26,EB,Belgium and Luxembourg,3789,2670,7,3,1119,554,558,1112,4
2025-07-27,EB,Belgium and Luxembourg,3813,2605,10,1,1208,611,587,1198,9
2025-07-28,EB,Belgium and Luxembourg,3874,2590,31,20,1284,624,629,1253,11
2025-07-29,EB,Belgium and Luxembourg,3794,2563,23,22,1231,599,609,1208,1
2025-07-30,EB,Belgium and Luxembourg,3704,2443,28,22,1261,626,607,1233,6
2025-07-31,EB,Belgium and Luxembourg,3795,2543,23,17,1252,610,619,1229,6
2025-08-01,EB,Belgium and Luxembourg,3786,2565,16,12,1221,613,592,1205,4
2025-08-02,EB,Belgium and Luxembourg,3704,2659,1,0,1045,526,518,1044,1
2025-08-03,EB,Belgium and Luxembourg,3936,2771,5,0,1165,569,591,1160,5
2025-08-04,EB,Belgium and Luxembourg,3852,2651,27,22,1201,575,599,1174,5
2025-08-05,EB,Belgium and Luxembourg,3724,2534,36,32,1190,578,576,1154,4
2025-08-06,EB,Belgium and Luxembourg,3839,2615,38,33,1224,598,588,1186,5
2025-08-07,EB,Belgium and Luxembourg,3761,2550,17,16,1211,597,597,1194,1
2025-08-08,EB,Belgium and Luxembourg,3850,2617,23,16,1233,615,595,1210,7
2025-08-09,EB,Belgium and Luxembourg,3678,2606,4,2,1072,535,533,1068,2
2025-08-10,EB,Belgium and Luxembourg,3882,2746,5,0,1136,565,566,1131,5
2025-08-11,EB,Belgium and Luxembourg,3757,2556,22,20,1201,570,609,1179,2
2025-08-12,EB,Belgium and Luxembourg,3769,2558,30,24,1211,596,585,1181,6
2025-08-13,EB,Belgium and Luxembourg,3778,2566,24,18,1212,598,590,1188,6
2025-08-14,EB,Belgium and Luxembourg,3874,2638,16,13,1236,605,615,1220,3
2025-08-15,EB,Belgium and Luxembourg,3838,2635,11,1,1203,611,581,1192,10
2025-08-16,EB,Belgium and Luxembourg,3733,2647,14,6,1086,534,538,1072,8
2025-08-17,EB,Belgium and Luxembourg,3922,2745,3,0,1177,584,590,1174,3
2025-08-18,EB,Belgium and Luxembourg,3865,2660,25,18,1205,584,596,1180,7
2025-08-19,EB,Belgium and Luxembourg,3787,2560,22,16,1227,602,603,1205,6
2025-08-20,EB,Belgium and Luxembourg,3839,2599,19,12,1240,609,612,1221,7
2025-08-21,EB,Belgium and Luxembourg,3859,2599,25,17,1260,615,620,1235,8
2025-08-22,EB,Belgium and Luxembourg,3960,2697,21,16,1263,637,605,1242,5
2025-08-23,EB,Belgium and Luxembourg,3773,2690,6,1,1083,536,541,1077,5
2025-08-24,EB,Belgium and Luxembourg,3918,2746,4,1,1172,585,583,1168,3
2025-08-25,EB,Belgium and Luxembourg,3889,2664,17,13,1225,595,613,1208,4
2025-08-26,EB,Belgium and Luxembourg,3845,2618,17,14,1227,606,604,1210,3
2025-08-27,EB,Belgium and Luxembourg,3855,2617,19,12,1238,611,608,1219,7
2025-08-28,EB,Belgium and Luxembourg,3977,2719,23,20,1258,616,619,1235,3
2025-08-29,EB,Belgium and Luxembourg,3937,2684,13,9,1253,631,609,1240,4
2025-01-01,LQ,Bosnia-Herzegovina,1126,1086,1,0,40,19,20,39,1
2025-01-02,LQ,Bosnia-Herzegovina,1256,1207,0,0,49,23,26,49,0
2025-01-03,LQ,Bosnia-Herzegovina,1247,1180,1,0,67,34,32,66,1
2025-01-04,LQ,Bosnia-Herzegovina,1241,1193,0,0,48,23,25,48,0
2025-01-05,LQ,Bosnia-Herzegovina,1354,1301,1,1,53,26,26,52,0
2025-01-06,LQ,Bosnia-Herzegovina,1215,1142,1,1,73,36,36,72,0
2025-01-07,LQ,Bosnia-Herzegovina,992,951,0,0,41,19,22,41,0
2025-01-08,LQ,Bosnia-Herzegovina,1040,978,1,1,62,32,29,61,0
2025-01-09,LQ,Bosnia-Herzegovina,1016,970,0,0,46,23,23,46,0
2025-01-10,LQ,Bosnia-Herzegovina,1093,1031,0,0,62,32,30,62,0
2025-01-11,LQ,Bosnia-Herzegovina,1084,1041,0,0,43,21,22,43,0
2025-01-12,LQ,Bosnia-Herzegovina,1181,1139,0,0,42,21,21,42,0
2025-01-13,LQ,Bosnia-Herzegovina,1090,1017,0,0,73,36,37,73,0
2025-01-14,LQ,Bosnia-Herzegovina,923,878,0,0,45,22,23,45,0
2025-01-15,LQ,Bosnia-Herzegovina,927,882,0,0,45,23,22,45,0
2025-01-16,LQ,Bosnia-Herzegovina,1020,974,1,1,46,22,23,45,0
2025-01-17,LQ,Bosnia-Herzegovina,1122,1053,1,1,69,35,33,68,0
2025-01-18,LQ,Bosnia-Herzegovina,1042,999,0,0,43,21,22,43,0
2025-01-19,LQ,Bosnia-Herzegovina,1076,1032,0,0,44,22,22,44,0
2025-01-20,LQ,Bosnia-Herzegovina,1049,984,0,0,65,32,33,65,0
2025-01-21,LQ,Bosnia-Herzegovina,894,847,0,0,47,24,23,47,0
2025-01-22,LQ,Bosnia-Herzegovina,971,923,2,0,48,23,23,46,2
2025-01-23,LQ,Bosnia-Herzegovina,1050,1006,1,1,44,21,22,43,0
2025-01-24,LQ,Bosnia-Herzegovina,1117,1049,0,0,68,35,33,68,0
2025-01-25,LQ,Bosnia-Herzegovina,1057,1010,1,1,47,24,22,46,0
2025-01-26,LQ,Bosnia-Herzegovina,1151,1103,0,0,48,22,26,48,0
2025-01-27,LQ,Bosnia-Herzegovina,1071,1002,0,0,69,36,33,69,0
2025-01-28,LQ,Bosnia-Herzegovina,849,805,1,0,44,20,23,43,1
2025-01-29,LQ,Bosnia-Herzegovina,900,850,2,0,50,26,22,48,2
2025-01-30,LQ,Bosnia-Herzegovina,975,930,0,0,45,21,24,45,0
2025-01-31,LQ,Bosnia-Herzegovina,1135,1066,2,1,69,35,32,67,1
2025-02-01,LQ,Bosnia-Herzegovina,1094,1046,1,1,48,23,24,47,0
2025-02-02,LQ,Bosnia-Herzegovina,1182,1135,1,0,47,23,23,46,1
2025-02-03,LQ,Bosnia-Herzegovina,1108,1041,0,0,67,33,34,67,0
2025-02-04,LQ,Bosnia-Herzegovina,954,905,2,1,49,24,23,47,1
2025-02-05,LQ,Bosnia-Herzegovina,1000,949,2,1,51,25,24,49,1
2025-02-06,LQ,Bosnia-Herzegovina,937,888,3,1,49,21,25,46,2
2025-02-07,LQ,Bosnia-Herzegovina,1136,1066,0,0,70,37,33,70,0
2025-02-08,LQ,Bosnia-Herzegovina,1136,1094,0,0,42,20,22,42,0
2025-02-09,LQ,Bosnia-Herzegovina,1207,1160,0,0,47,23,24,47,0
2025-02-10,LQ,Bosnia-Herzegovina,1156,1089,0,0,67,34,33,67,0
2025-02-11,LQ,Bosnia-Herzegovina,931,889,0,0,42,21,21,42,0
2025-02-12,LQ,Bosnia-Herzegovina,988,940,0,0,48,25,23,48,0
2025-02-13,LQ,Bosnia-Herzegovina,978,929,2,0,49,22,25,47,2
2025-02-14,LQ,Bosnia-Herzegovina,1178,1101,2,0,77,39,36,75,2
2025-02-15,LQ,Bosnia-Herzegovina,1147,1103,0,0,44,22,22,44,0
2025-02-16,LQ,Bosnia-Herzegovina,1203,1159,0,0,44,21,23,44,0
2025-02-17,LQ,Bosnia-Herzegovina,1147,1079,0,0,68,34,34,68,0
2025-02-18,LQ,Bosnia-Herzegovina,962,924,0,0,38,20,18,38,0
2025-02-19,LQ,Bosnia-Herzegovina,1053,1003,4,0,50,23,23,46,4
2025-02-20,LQ,Bosnia-Herzegovina,1013,969,2,0,44,19,23,42,2
2025-02-21,LQ,Bosnia-Herzegovina,1194,1129,2,0,65,33,30,63,2
2025-02-22,LQ,Bosnia-Herzegovina,1162,1122,0,0,40,20,20,40,0
2025-02-23,LQ,Bosnia-Herzegovina,1251,1209,0,0,42,21,21,42,0
2025-02-24,LQ,Bosnia-Herzegovina,1129,1057,1,0,72,35,36,71,1
2025-02-25,LQ,Bosnia-Herzegovina,999,954,3,1,45,21,21,42,2
2025-02-26,LQ,Bosnia-Herzegovina,977,928,2,1,49,25,22,47,1
2025-02-27,LQ,Bosnia-Herzegovina,960,915,1,0,45,21,23,44,1
2025-02-28,LQ,Bosnia-Herzegovina,1026,958,0,0,68,34,34,68,0
2025-03-01,LQ,Bosnia-Herzegovina,1182,1134,0,0,48,24,24,48,0
2025-03-02,LQ,Bosnia-Herzegovina,1300,1255,0,0,45,23,22,45,0
2025-03-03,LQ,Bosnia-Herzegovina,1158,1089,0,0,69,35,34,69,0
2025-03-04,LQ,Bosnia-Herzegovina,1025,982,0,0,43,21,22,43,0
2025-03-05,LQ,Bosnia-Herzegovina,1028,984,0,0,44,22,22,44,0
2025-03-06,LQ,Bosnia-Herzegovina,1057,1010,0,0,47,22,25,47,0
2025-03-07,LQ,Bosnia-Herzegovina,1230,1160,1,1,70,37,32,69,0
2025-03-08,LQ,Bosnia-Herzegovina,1205,1160,1,1,45,22,22,44,0
2025-03-09,LQ,Bosnia-Herzegovina,1284,1240,1,1,44,21,22,43,0
2025-03-10,LQ,Bosnia-Herzegovina,1028,964,0,0,64,32,32,64,0
2025-03-11,LQ,Bosnia-Herzegovina,1061,1012,0,0,49,24,25,49,0
2025-03-12,LQ,Bosnia-Herzegovina,1006,957,3,1,49,24,22,46,2
2025-03-13,LQ,Bosnia-Herzegovina,991,945,0,0,46,22,24,46,0
2025-03-14,LQ,Bosnia-Herzegovina,1137,1066,0,0,71,37,34,71,0
2025-03-15,LQ,Bosnia-Herzegovina,1088,1041,0,0,47,23,24,47,0
2025-03-16,LQ,Bosnia-Herzegovina,1224,1179,0,0,45,22,23,45,0
2025-03-17,LQ,Bosnia-Herzegovina,1147,1079,0,0,68,34,34,68,0
2025-03-18,LQ,Bosnia-Herzegovina,1027,989,1,1,38,19,18,37,0
2025-03-19,LQ,Bosnia-Herzegovina,1144,1097,1,1,47,23,23,46,0
2025-03-20,LQ,Bosnia-Herzegovina,1092,1046,1,1,46,21,24,45,0
2025-03-21,LQ,Bosnia-Herzegovina,1224,1151,1,1,73,37,35,72,0
2025-03-22,LQ,Bosnia-Herzegovina,1191,1142,0,0,49,24,25,49,0
2025-03-23,LQ,Bosnia-Herzegovina,1180,1134,0,0,46,23,23,46,0
2025-03-24,LQ,Bosnia-Herzegovina,1081,1020,1,1,61,30,30,60,0
2025-03-25,LQ,Bosnia-Herzegovina,1004,960,0,0,44,23,21,44,0
2025-03-26,LQ,Bosnia-Herzegovina,1056,1009,0,0,47,24,23,47,0
2025-03-27,LQ,Bosnia-Herzegovina,1115,1061,0,0,54,26,28,54,0
2025-03-28,LQ,Bosnia-Herzegovina,1214,1143,0,0,71,36,35,71,0
2025-03-29,LQ,Bosnia-Herzegovina,1205,1155,1,1,50,25,24,49,0
2025-03-30,LQ,Bosnia-Herzegovina,1581,1526,3,1,55,26,26,52,2
2025-03-31,LQ,Bosnia-Herzegovina,1347,1269,1,1,78,38,39,77,0
2025-04-01,LQ,Bosnia-Herzegovina,1317,1242,1,0,75,36,38,74,1
2025-04-02,LQ,Bosnia-Herzegovina,1430,1354,3,2,76,38,35,73,1
2025-04-03,LQ,Bosnia-Herzegovina,1398,1320,3,1,78,36,39,75,2
2025-04-04,LQ,Bosnia-Herzegovina,1516,1443,0,0,73,38,35,73,0
2025-04-05,LQ,Bosnia-Herzegovina,1683,1621,1,0,62,30,31,61,1
2025-04-06,LQ,Bosnia-Herzegovina,1585,1525,0,0,60,30,30,60,0
2025-04-07,LQ,Bosnia-Herzegovina,1458,1375,0,0,83,41,42,83,0
2025-04-08,LQ,Bosnia-Herzegovina,1435,1358,0,0,77,38,39,77,0
2025-04-09,LQ,Bosnia-Herzegovina,1367,1296,3,0,71,36,32,68,3
2025-04-10,LQ,Bosnia-Herzegovina,1616,1541,1,0,75,36,38,74,1
2025-04-11,LQ,Bosnia-Herzegovina,1697,1626,0,0,71,35,36,71,0
2025-04-12,LQ,Bosnia-Herzegovina,1724,1655,0,0,69,34,35,69,0
2025-04-13,LQ,Bosnia-Herzegovina,1711,1652,0,0,59,29,30,59,0
2025-04-14,LQ,Bosnia-Herzegovina,1524,1438,0,0,86,44,42,86,0
2025-04-15,LQ,Bosnia-Herzegovina,1489,1422,0,0,67,34,33,67,0
2025-04-16,LQ,Bosnia-Herzegovina,1593,1519,0,0,74,37,37,74,0
2025-04-17,LQ,Bosnia-Herzegovina,1456,1390,0,0,66,33,33,66,0
2025-04-18,LQ,Bosnia-Herzegovina,1657,1573,0,0,84,42,42,84,0
2025-04-19,LQ,Bosnia-Herzegovina,1726,1662,0,0,64,31,33,64,0
2025-04-20,LQ,Bosnia-Herzegovina,1723,1666,0,0,57,29,28,57,0
2025-04-21,LQ,Bosnia-Herzegovina,1589,1511,0,0,78,40,38,78,0
2025-04-22,LQ,Bosnia-Herzegovina,1547,1479,0,0,68,34,34,68,0
2025-04-23,LQ,Bosnia-Herzegovina,1593,1520,0,0,73,37,36,73,0
2025-04-24,LQ,Bosnia-Herzegovina,1545,1471,0,0,74,36,38,74,0
2025-04-25,LQ,Bosnia-Herzegovina,1637,1565,1,0,72,35,36,71,1
2025-04-26,LQ,Bosnia-Herzegovina,1793,1723,0,0,70,36,34,70,0
2025-04-27,LQ,Bosnia-Herzegovina,1823,1763,0,0,60,29,31,60,0
2025-04-28,LQ,Bosnia-Herzegovina,1608,1521,0,0,87,45,42,87,0
2025-04-29,LQ,Bosnia-Herzegovina,1603,1536,0,0,67,33,34,67,0
2025-04-30,LQ,Bosnia-Herzegovina,1770,1704,0,0,66,34,32,66,0
2025-05-01,LQ,Bosnia-Herzegovina,1804,1736,0,0,68,33,35,68,0
2025-05-02,LQ,Bosnia-Herzegovina,1772,1711,0,0,61,30,31,61,0
2025-05-03,LQ,Bosnia-Herzegovina,1896,1828,0,0,68,34,34,68,0
2025-05-04,LQ,Bosnia-Herzegovina,1960,1903,0,0,57,29,28,57,0
2025-05-05,LQ,Bosnia-Herzegovina,1623,1534,1,0,89,44,44,88,1
2025-05-06,LQ,Bosnia-Herzegovina,1597,1518,1,0,79,39,39,78,1
2025-05-07,LQ,Bosnia-Herzegovina,1708,1633,0,0,75,38,37,75,0
2025-05-08,LQ,Bosnia-Herzegovina,1691,1614,0,0,77,37,40,77,0
2025-05-09,LQ,Bosnia-Herzegovina,1781,1708,0,0,73,38,35,73,0
2025-05-10,LQ,Bosnia-Herzegovina,1880,1812,0,0,68,33,35,68,0
2025-05-11,LQ,Bosnia-Herzegovina,1917,1857,0,0,60,30,30,60,0
2025-05-12,LQ,Bosnia-Herzegovina,1785,1695,1,0,90,45,44,89,1
2025-05-13,LQ,Bosnia-Herzegovina,1717,1637,0,0,80,39,41,80,0
2025-05-14,LQ,Bosnia-Herzegovina,1771,1699,0,0,72,36,36,72,0
2025-05-15,LQ,Bosnia-Herzegovina,1709,1616,1,0,93,45,47,92,1
2025-05-16,LQ,Bosnia-Herzegovina,1750,1674,0,0,76,39,37,76,0
2025-05-17,LQ,Bosnia-Herzegovina,1895,1830,0,0,65,34,31,65,0
2025-05-18,LQ,Bosnia-Herzegovina,1911,1849,0,0,62,29,33,62,0
2025-05-19,LQ,Bosnia-Herzegovina,1695,1605,0,0,90,46,44,90,0
2025-05-20,LQ,Bosnia-Herzegovina,1730,1646,0,0,84,42,42,84,0
2025-05-21,LQ,Bosnia-Herzegovina,1691,1619,0,0,72,36,36,72,0
2025-05-22,LQ,Bosnia-Herzegovina,1797,1713,0,0,84,40,44,84,0
2025-05-23,LQ,Bosnia-Herzegovina,1785,1701,0,0,84,44,40,84,0
2025-05-24,LQ,Bosnia-Herzegovina,1947,1874,0,0,73,36,37,73,0
2025-05-25,LQ,Bosnia-Herzegovina,1980,1915,0,0,65,32,33,65,0
2025-05-26,LQ,Bosnia-Herzegovina,1932,1834,0,0,98,50,48,98,0
2025-05-27,LQ,Bosnia-Herzegovina,1895,1808,0,0,87,44,43,87,0
2025-05-28,LQ,Bosnia-Herzegovina,1871,1792,0,0,79,40,39,79,0
2025-05-29,LQ,Bosnia-Herzegovina,1954,1870,0,0,84,41,43,84,0
2025-05-30,LQ,Bosnia-Herzegovina,1967,1886,0,0,81,41,40,81,0
2025-05-31,LQ,Bosnia-Herzegovina,2046,1972,0,0,74,38,36,74,0
2025-06-01,LQ,Bosnia-Herzegovina,2060,1987,0,0,73,35,38,73,0
2025-06-02,LQ,Bosnia-Herzegovina,1906,1803,0,0,103,51,52,103,0
2025-06-03,LQ,Bosnia-Herzegovina,1903,1814,1,0,89,43,45,88,1
2025-06-04,LQ,Bosnia-Herzegovina,1906,1818,0,0,88,46,42,88,0
2025-06-05,LQ,Bosnia-Herzegovina,1914,1831,0,0,83,41,42,83,0
2025-06-06,LQ,Bosnia-Herzegovina,2029,1934,0,0,95,47,48,95,0
2025-06-07,LQ,Bosnia-Herzegovina,2125,2040,0,0,85,44,41,85,0
2025-06-08,LQ,Bosnia-Herzegovina,2040,1968,0,0,72,36,36,72,0
2025-06-09,LQ,Bosnia-Herzegovina,2141,2037,0,0,104,51,53,104,0
2025-06-10,LQ,Bosnia-Herzegovina,2051,1953,0,0,98,49,49,98,0
2025-06-11,LQ,Bosnia-Herzegovina,2050,1963,0,0,87,44,43,87,0
2025-06-12,LQ,Bosnia-Herzegovina,1951,1860,0,0,91,44,47,91,0
2025-06-13,LQ,Bosnia-Herzegovina,2109,2014,0,0,95,49,46,95,0
2025-06-14,LQ,Bosnia-Herzegovina,2299,2206,0,0,93,47,46,93,0
2025-06-15,LQ,Bosnia-Herzegovina,2098,2025,0,0,73,36,37,73,0
2025-06-16,LQ,Bosnia-Herzegovina,1984,1873,0,0,111,55,56,111,0
2025-06-17,LQ,Bosnia-Herzegovina,2041,1938,0,0,103,52,51,103,0
2025-06-18,LQ,Bosnia-Herzegovina,2066,1976,0,0,90,46,44,90,0
2025-06-19,LQ,Bosnia-Herzegovina,2119,2025,0,0,94,45,49,94,0
2025-06-20,LQ,Bosnia-Herzegovina,2132,2028,0,0,104,52,52,104,0
2025-06-21,LQ,Bosnia-Herzegovina,2274,2186,0,0,88,44,44,88,0
2025-06-22,LQ,Bosnia-Herzegovina,2191,2112,0,0,79,39,40,79,0
2025-06-23,LQ,Bosnia-Herzegovina,2087,1976,2,2,111,53,56,109,0
2025-06-24,LQ,Bosnia-Herzegovina,2059,1963,0,0,96,48,48,96,0
2025-06-25,LQ,Bosnia-Herzegovina,2106,2011,1,1,95,49,45,94,0
2025-06-26,LQ,Bosnia-Herzegovina,1992,1903,0,0,89,43,46,89,0
2025-06-27,LQ,Bosnia-Herzegovina,2034,1921,0,0,113,58,55,113,0
2025-06-28,LQ,Bosnia-Herzegovina,2103,2021,0,0,82,42,40,82,0
2025-06-29,LQ,Bosnia-Herzegovina,1991,1913,0,0,78,38,40,78,0
2025-06-30,LQ,Bosnia-Herzegovina,2031,1921,0,0,110,56,54,110,0
2025-07-01,LQ,Bosnia-Herzegovina,2053,1950,0,0,103,51,52,103,0
2025-07-02,LQ,Bosnia-Herzegovina,2147,2061,0,0,86,44,42,86,0
2025-07-03,LQ,Bosnia-Herzegovina,1980,1872,2,0,108,51,55,106,2
2025-07-04,LQ,Bosnia-Herzegovina,2013,1909,0,0,104,53,51,104,0
2025-07-05,LQ,Bosnia-Herzegovina,2149,2052,0,0,97,50,47,97,0
2025-07-06,LQ,Bosnia-Herzegovina,1998,1910,0,0,88,44,44,88,0
2025-07-07,LQ,Bosnia-Herzegovina,1861,1741,1,0,120,59,60,119,1
2025-07-08,LQ,Bosnia-Herzegovina,1946,1850,0,0,96,49,47,96,0
2025-07-09,LQ,Bosnia-Herzegovina,1942,1846,0,0,96,48,48,96,0
2025-07-10,LQ,Bosnia-Herzegovina,2094,1977,3,1,117,53,61,114,2
2025-07-11,LQ,Bosnia-Herzegovina,2097,1972,3,0,125,64,58,122,3
2025-07-12,LQ,Bosnia-Herzegovina,2197,2094,0,0,103,53,50,103,0
2025-07-13,LQ,Bosnia-Herzegovina,2113,2031,0,0,82,40,42,82,0
2025-07-14,LQ,Bosnia-Herzegovina,2071,1955,0,0,116,58,58,116,0
2025-07-15,LQ,Bosnia-Herzegovina,2022,1919,0,0,103,51,52,103,0
2025-07-16,LQ,Bosnia-Herzegovina,2072,1974,0,0,98,50,48,98,0
2025-07-17,LQ,Bosnia-Herzegovina,1941,1842,1,0,99,48,50,98,1
2025-07-18,LQ,Bosnia-Herzegovina,2128,2014,0,0,114,57,57,114,0
2025-07-19,LQ,Bosnia-Herzegovina,2231,2132,0,0,99,50,49,99,0
2025-07-20,LQ,Bosnia-Herzegovina,2167,2079,0,0,88,43,45,88,0
2025-07-21,LQ,Bosnia-Herzegovina,2104,1986,0,0,118,59,59,118,0
2025-07-22,LQ,Bosnia-Herzegovina,2179,2069,0,0,110,55,55,110,0
2025-07-23,LQ,Bosnia-Herzegovina,2174,2079,1,1,95,46,48,94,0
2025-07-24,LQ,Bosnia-Herzegovina,2065,1963,0,0,102,51,51,102,0
2025-07-25,LQ,Bosnia-Herzegovina,2120,2004,0,0,116,59,57,116,0
2025-07-26,LQ,Bosnia-Herzegovina,2080,1973,0,0,107,55,52,107,0
2025-07-27,LQ,Bosnia-Herzegovina,2068,1985,0,0,83,41,42,83,0
2025-07-28,LQ,Bosnia-Herzegovina,1885,1771,0,0,114,56,58,114,0
2025-07-29,LQ,Bosnia-Herzegovina,2126,2011,0,0,115,58,57,115,0
2025-07-30,LQ,Bosnia-Herzegovina,2170,2069,0,0,101,51,50,101,0
2025-07-31,LQ,Bosnia-Herzegovina,2135,2028,0,0,107,53,54,107,0
2025-08-01,LQ,Bosnia-Herzegovina,2132,2023,0,0,109,55,54,109,0
2025-08-02,LQ,Bosnia-Herzegovina,2206,2098,0,0,108,54,54,108,0
2025-08-03,LQ,Bosnia-Herzegovina,2041,1951,1,0,90,44,45,89,1
2025-08-04,LQ,Bosnia-Herzegovina,2063,1944,0,0,119,59,60,119,0
2025-08-05,LQ,Bosnia-Herzegovina,2177,2065,0,0,112,56,56,112,0
2025-08-06,LQ,Bosnia-Herzegovina,2205,2092,0,0,113,57,56,113,0
2025-08-07,LQ,Bosnia-Herzegovina,2238,2131,0,0,107,53,54,107,0
2025-08-08,LQ,Bosnia-Herzegovina,2225,2116,0,0,109,55,54,109,0
2025-08-09,LQ,Bosnia-Herzegovina,2278,2164,2,1,114,56,56,112,1
2025-08-10,LQ,Bosnia-Herzegovina,2156,2073,0,0,83,41,42,83,0
2025-08-11,LQ,Bosnia-Herzegovina,2127,2014,0,0,113,58,55,113,0
2025-08-12,LQ,Bosnia-Herzegovina,2163,2054,0,0,109,53,56,109,0
2025-08-13,LQ,Bosnia-Herzegovina,2199,2098,0,0,101,52,49,101,0
2025-08-14,LQ,Bosnia-Herzegovina,2080,1970,0,0,110,53,57,110,0
2025-08-15,LQ,Bosnia-Herzegovina,2172,2055,0,0,117,59,58,117,0
2025-08-16,LQ,Bosnia-Herzegovina,2259,2155,1,0,104,52,51,103,1
2025-08-17,LQ,Bosnia-Herzegovina,2012,1927,0,0,85,42,43,85,0
2025-08-18,LQ,Bosnia-Herzegovina,2111,1983,0,0,128,65,63,128,0
2025-08-19,LQ,Bosnia-Herzegovina,2250,2131,3,0,119,58,58,116,3
2025-08-20,LQ,Bosnia-Herzegovina,2109,2009,1,0,100,49,50,99,1
2025-08-21,LQ,Bosnia-Herzegovina,1826,1714,1,0,112,54,57,111,1
2025-08-22,LQ,Bosnia-Herzegovina,2066,1951,0,0,115,60,55,115,0
2025-08-23,LQ,Bosnia-Herzegovina,2233,2126,0,0,107,54,53,107,0
2025-08-24,LQ,Bosnia-Herzegovina,2100,2021,0,0,79,38,41,79,0
2025-08-25,LQ,Bosnia-Herzegovina,2093,1984,0,0,109,54,55,109,0
2025-08-26,LQ,Bosnia-Herzegovina,2163,2052,0,0,111,57,54,111,0
2025-08-27,LQ,Bosnia-Herzegovina,2141,2048,0,0,93,47,46,93,0
2025-08-28,LQ,Bosnia-Herzegovina,2041,1945,1,0,96,46,49,95,1
2025-08-29,LQ,Bosnia-Herzegovina,2034,1926,0,0,108,54,54,108,0
2025-01-01,LB,Bulgaria,2107,1969,5,0,138,64,69,133,5
2025-01-02,LB,Bulgaria,2482,2193,14,1,289,135,140,275,13
2025-01-03,LB,Bulgaria,2527,2307,6,0,220,108,106,214,6
2025-01-04,LB,Bulgaria,2612,2383,3,1,229,113,113,226,2
2025-01-05,LB,Bulgaria,2642,2427,7,0,215,99,109,208,7
2025-01-06,LB,Bulgaria,2398,2208,6,0,190,92,92,184,6
2025-01-07,LB,Bulgaria,2285,2121,8,0,164,77,79,156,8
2025-01-08,LB,Bulgaria,2300,2142,8,0,158,75,75,150,8
2025-01-09,LB,Bulgaria,2333,2162,8,0,171,82,81,163,8
2025-01-10,LB,Bulgaria,2451,2267,8,2,184,91,85,176,6
2025-01-11,LB,Bulgaria,2457,2277,4,0,180,87,89,176,4
2025-01-12,LB,Bulgaria,2510,2310,8,1,200,96,96,192,7
2025-01-13,LB,Bulgaria,2287,2106,8,1,181,84,89,173,7
2025-01-14,LB,Bulgaria,2208,2060,19,3,148,64,65,129,16
2025-01-15,LB,Bulgaria,2273,2113,15,3,160,74,71,145,12
2025-01-16,LB,Bulgaria,2401,2206,8,0,195,95,92,187,8
2025-01-17,LB,Bulgaria,2437,2248,8,1,189,91,90,181,7
2025-01-18,LB,Bulgaria,2394,2224,2,0,170,86,82,168,2
2025-01-19,LB,Bulgaria,2472,2275,6,0,197,93,98,191,6
2025-01-20,LB,Bulgaria,2257,2077,13,3,180,86,81,167,10
2025-01-21,LB,Bulgaria,2224,2070,18,3,154,69,67,136,15
2025-01-22,LB,Bulgaria,2268,2112,16,3,156,66,74,140,13
2025-01-23,LB,Bulgaria,2303,2100,17,2,203,95,91,186,15
2025-01-24,LB,Bulgaria,2328,2140,7,0,188,92,89,181,7
2025-01-25,LB,Bulgaria,2372,2187,4,0,185,89,92,181,4
2025-01-26,LB,Bulgaria,2393,2178,10,0,215,100,105,205,10
2025-01-27,LB,Bulgaria,2148,1975,6,0,173,86,81,167,6
2025-01-28,LB,Bulgaria,2143,1992,18,0,151,65,68,133,18
2025-01-29,LB,Bulgaria,2200,2034,16,2,166,77,73,150,14
2025-01-30,LB,Bulgaria,2292,2094,16,1,198,92,90,182,15
2025-01-31,LB,Bulgaria,2340,2143,10,3,197,92,95,187,7
2025-02-01,LB,Bulgaria,2385,2173,9,3,212,101,102,203,6
2025-02-02,LB,Bulgaria,2458,2248,8,1,210,100,102,202,7
2025-02-03,LB,Bulgaria,2194,2000,18,8,194,90,86,176,10
2025-02-04,LB,Bulgaria,2152,1982,16,0,170,77,77,154,16
2025-02-05,LB,Bulgaria,2174,2004,16,1,170,78,76,154,15
2025-02-06,LB,Bulgaria,2199,1999,17,2,200,92,91,183,15
2025-02-07,LB,Bulgaria,2314,2136,9,0,178,83,86,169,9
2025-02-08,LB,Bulgaria,2434,2234,3,0,200,100,97,197,3
2025-02-09,LB,Bulgaria,2424,2214,7,1,210,98,105,203,6
2025-02-10,LB,Bulgaria,2168,1989,6,0,179,88,85,173,6
2025-02-11,LB,Bulgaria,2136,1963,12,0,173,76,85,161,12
2025-02-12,LB,Bulgaria,2230,2047,15,1,183,86,82,168,14
2025-02-13,LB,Bulgaria,2319,2121,14,1,198,94,90,184,13
2025-02-14,LB,Bulgaria,2440,2250,8,0,190,92,90,182,8
2025-02-15,LB,Bulgaria,2503,2291,2,0,212,105,105,210,2
2025-02-16,LB,Bulgaria,2485,2279,11,1,206,97,98,195,10
2025-02-17,LB,Bulgaria,2275,2100,8,2,175,81,86,167,6
2025-02-18,LB,Bulgaria,2268,2083,12,4,185,87,86,173,8
2025-02-19,LB,Bulgaria,2282,2115,9,1,167,80,78,158,8
2025-02-20,LB,Bulgaria,2302,2091,15,4,211,99,97,196,11
2025-02-21,LB,Bulgaria,2147,1968,10,1,179,84,85,169,9
2025-02-22,LB,Bulgaria,2264,2067,5,1,197,97,95,192,4
2025-02-23,LB,Bulgaria,2444,2230,6,0,214,103,105,208,6
2025-02-24,LB,Bulgaria,2229,2024,14,0,205,94,97,191,14
2025-02-25,LB,Bulgaria,2214,2039,10,0,175,81,84,165,10
2025-02-26,LB,Bulgaria,2337,2165,14,0,172,78,80,158,14
2025-02-27,LB,Bulgaria,2363,2152,15,1,211,98,98,196,14
2025-02-28,LB,Bulgaria,2381,2189,6,0,192,95,91,186,6
2025-03-01,LB,Bulgaria,2492,2287,3,0,205,104,98,202,3
2025-03-02,LB,Bulgaria,2615,2400,6,0,215,102,107,209,6
2025-03-03,LB,Bulgaria,2334,2148,7,1,186,89,90,179,6
2025-03-04,LB,Bulgaria,2263,2082,14,2,181,86,81,167,12
2025-03-05,LB,Bulgaria,2342,2169,11,1,173,81,81,162,10
2025-03-06,LB,Bulgaria,2317,2119,8,0,198,95,95,190,8
2025-03-07,LB,Bulgaria,2352,2151,10,1,201,97,94,191,9
2025-03-08,LB,Bulgaria,2414,2204,9,1,210,99,102,201,8
2025-03-09,LB,Bulgaria,2489,2264,6,1,225,107,112,219,5
2025-03-10,LB,Bulgaria,2002,1823,14,1,179,83,82,165,13
2025-03-11,LB,Bulgaria,2253,2080,8,2,173,80,85,165,6
2025-03-12,LB,Bulgaria,2325,2136,8,0,189,92,89,181,8
2025-03-13,LB,Bulgaria,2371,2168,7,0,203,101,95,196,7
2025-03-14,LB,Bulgaria,2536,2337,8,0,199,96,95,191,8
2025-03-15,LB,Bulgaria,2531,2341,3,0,190,93,94,187,3
2025-03-16,LB,Bulgaria,2585,2372,12,4,213,98,103,201,8
2025-03-17,LB,Bulgaria,2376,2204,10,2,172,81,81,162,8
2025-03-18,LB,Bulgaria,2279,2109,6,0,170,81,83,164,6
2025-03-19,LB,Bulgaria,2375,2184,10,2,191,94,87,181,8
2025-03-20,LB,Bulgaria,2366,2155,15,0,211,100,96,196,15
2025-03-21,LB,Bulgaria,2381,2166,6,0,215,102,107,209,6
2025-03-22,LB,Bulgaria,2444,2262,7,0,182,90,85,175,7
2025-03-23,LB,Bulgaria,2588,2378,4,0,210,97,109,206,4
2025-03-24,LB,Bulgaria,2386,2187,14,1,199,92,93,185,13
2025-03-25,LB,Bulgaria,2306,2122,10,1,184,90,84,174,9
2025-03-26,LB,Bulgaria,2395,2207,14,1,188,84,90,174,13
2025-03-27,LB,Bulgaria,2480,2273,9,0,207,100,98,198,9
2025-03-28,LB,Bulgaria,2613,2402,7,0,211,99,105,204,7
2025-03-29,LB,Bulgaria,2634,2412,9,3,222,113,100,213,6
2025-03-30,LB,Bulgaria,2672,2453,6,1,219,108,105,213,5
2025-03-31,LB,Bulgaria,2564,2342,7,0,222,108,107,215,7
2025-04-01,LB,Bulgaria,2587,2373,6,0,214,106,102,208,6
2025-04-02,LB,Bulgaria,2712,2477,12,1,235,111,112,223,11
2025-04-03,LB,Bulgaria,2726,2499,11,1,227,105,111,216,10
2025-04-04,LB,Bulgaria,2793,2566,6,0,227,115,106,221,6
2025-04-05,LB,Bulgaria,2826,2628,4,0,198,97,97,194,4
2025-04-06,LB,Bulgaria,2910,2695,4,0,215,103,108,211,4
2025-04-07,LB,Bulgaria,2772,2556,7,1,216,105,104,209,6
2025-04-08,LB,Bulgaria,2762,2538,9,1,224,103,112,215,8
2025-04-09,LB,Bulgaria,2756,2520,9,1,236,116,111,227,8
2025-04-10,LB,Bulgaria,2718,2491,8,1,227,111,108,219,7
2025-04-11,LB,Bulgaria,2881,2651,10,1,230,109,111,220,9
2025-04-12,LB,Bulgaria,3054,2843,7,1,211,102,102,204,6
2025-04-13,LB,Bulgaria,2925,2717,4,0,208,102,102,204,4
2025-04-14,LB,Bulgaria,2804,2583,7,0,221,106,108,214,7
2025-04-15,LB,Bulgaria,2793,2573,9,1,220,105,106,211,8
2025-04-16,LB,Bulgaria,2966,2717,6,0,249,122,121,243,6
2025-04-17,LB,Bulgaria,3077,2835,11,1,242,116,115,231,10
2025-04-18,LB,Bulgaria,3098,2884,6,0,214,106,102,208,6
2025-04-19,LB,Bulgaria,3216,3010,4,0,206,100,102,202,4
2025-04-20,LB,Bulgaria,3133,2901,6,0,232,113,113,226,6
2025-04-21,LB,Bulgaria,2931,2696,11,1,235,112,112,224,10
2025-04-22,LB,Bulgaria,2936,2695,17,4,241,108,116,224,13
2025-04-23,LB,Bulgaria,2986,2741,13,2,245,119,113,232,11
2025-04-24,LB,Bulgaria,3020,2779,26,8,241,107,108,215,18
2025-04-25,LB,Bulgaria,3110,2888,15,6,222,105,102,207,9
2025-04-26,LB,Bulgaria,3326,3107,10,6,219,105,104,209,4
2025-04-27,LB,Bulgaria,3346,3117,10,4,229,107,112,219,6
2025-04-28,LB,Bulgaria,2969,2734,21,9,235,109,105,214,12
2025-04-29,LB,Bulgaria,2823,2601,21,9,222,102,99,201,12
2025-04-30,LB,Bulgaria,3054,2779,32,13,275,122,121,243,19
2025-05-01,LB,Bulgaria,3048,2809,11,3,239,116,112,228,8
2025-05-02,LB,Bulgaria,3073,2844,6,0,229,114,109,223,6
2025-05-03,LB,Bulgaria,3313,3101,5,1,212,104,103,207,4
2025-05-04,LB,Bulgaria,3253,3032,7,0,221,105,109,214,7
2025-05-05,LB,Bulgaria,2936,2696,14,3,240,113,113,226,11
2025-05-06,LB,Bulgaria,2880,2672,7,1,208,97,104,201,6
2025-05-07,LB,Bulgaria,2906,2676,8,2,230,110,112,222,6
2025-05-08,LB,Bulgaria,2953,2718,10,2,235,111,114,225,8
2025-05-09,LB,Bulgaria,3090,2840,19,4,250,118,113,231,15
2025-05-10,LB,Bulgaria,3326,3104,4,0,222,112,106,218,4
2025-05-11,LB,Bulgaria,3283,3062,5,0,221,106,110,216,5
2025-05-12,LB,Bulgaria,2956,2711,16,1,245,116,113,229,15
2025-05-13,LB,Bulgaria,2869,2640,18,4,229,107,104,211,14
2025-05-14,LB,Bulgaria,2982,2745,13,1,237,109,115,224,12
2025-05-15,LB,Bulgaria,3144,2877,12,1,267,131,124,255,11
2025-05-16,LB,Bulgaria,3188,2925,6,0,263,128,129,257,6
2025-05-17,LB,Bulgaria,3436,3211,4,0,225,111,110,221,4
2025-05-18,LB,Bulgaria,3440,3202,6,0,238,114,118,232,6
2025-05-19,LB,Bulgaria,2997,2736,23,6,261,120,118,238,17
2025-05-20,LB,Bulgaria,2928,2693,12,6,235,111,112,223,6
2025-05-21,LB,Bulgaria,3062,2796,14,7,266,125,127,252,7
2025-05-22,LB,Bulgaria,3141,2855,18,6,286,134,134,268,12
2025-05-23,LB,Bulgaria,3260,2953,14,8,307,148,145,293,6
2025-05-24,LB,Bulgaria,3542,3297,11,7,245,120,114,234,4
2025-05-25,LB,Bulgaria,3599,3338,12,7,261,120,129,249,5
2025-05-26,LB,Bulgaria,3241,2953,9,0,288,139,140,279,9
2025-05-27,LB,Bulgaria,3111,2838,18,8,273,127,128,255,10
2025-05-28,LB,Bulgaria,3317,3033,20,6,284,129,135,264,14
2025-05-29,LB,Bulgaria,3228,2935,24,9,293,136,133,269,15
2025-05-30,LB,Bulgaria,3290,3019,7,0,271,132,132,264,7
2025-05-31,LB,Bulgaria,3560,3319,7,1,241,121,113,234,6
2025-06-01,LB,Bulgaria,3551,3296,4,0,255,121,130,251,4
2025-06-02,LB,Bulgaria,3388,3093,12,1,295,144,139,283,11
2025-06-03,LB,Bulgaria,3375,3054,14,2,321,157,150,307,12
2025-06-04,LB,Bulgaria,3404,3132,15,4,272,128,129,257,11
2025-06-05,LB,Bulgaria,3407,3102,13,0,305,144,148,292,13
2025-06-06,LB,Bulgaria,3596,3237,13,1,359,168,178,346,12
2025-06-07,LB,Bulgaria,3772,3516,7,1,256,128,121,249,6
2025-06-08,LB,Bulgaria,3741,3451,5,0,290,140,145,285,5
2025-06-09,LB,Bulgaria,3488,3167,12,0,321,159,150,309,12
2025-06-10,LB,Bulgaria,3485,3131,8,0,354,173,173,346,8
2025-06-11,LB,Bulgaria,3495,3201,10,1,294,144,140,284,9
2025-06-12,LB,Bulgaria,3555,3244,8,0,311,148,155,303,8
2025-06-13,LB,Bulgaria,3298,2911,8,0,387,190,189,379,8
2025-06-14,LB,Bulgaria,3405,3129,15,8,276,129,132,261,7
2025-06-15,LB,Bulgaria,3264,2980,18,7,284,131,135,266,11
2025-06-16,LB,Bulgaria,3161,2834,20,8,327,153,154,307,12
2025-06-17,LB,Bulgaria,3103,2733,11,2,370,178,181,359,9
2025-06-18,LB,Bulgaria,3147,2846,16,1,301,142,143,285,15
2025-06-19,LB,Bulgaria,3108,2769,6,0,339,166,167,333,6
2025-06-20,LB,Bulgaria,3380,2966,11,1,414,202,201,403,10
2025-06-21,LB,Bulgaria,3655,3359,12,7,296,143,141,284,5
2025-06-22,LB,Bulgaria,3367,3050,18,6,317,147,152,299,12
2025-06-23,LB,Bulgaria,3141,2815,22,10,326,152,152,304,12
2025-06-24,LB,Bulgaria,3169,2770,10,0,399,200,189,389,10
2025-06-25,LB,Bulgaria,3212,2886,15,1,326,155,156,311,14
2025-06-26,LB,Bulgaria,3381,3027,11,0,354,173,170,343,11
2025-06-27,LB,Bulgaria,3648,3229,13,3,419,203,203,406,10
2025-06-28,LB,Bulgaria,3818,3519,10,5,299,147,142,289,5
2025-06-29,LB,Bulgaria,3791,3462,13,4,329,156,160,316,9
2025-06-30,LB,Bulgaria,3587,3252,13,0,335,166,156,322,13
2025-07-01,LB,Bulgaria,3686,3271,10,0,415,200,205,405,10
2025-07-02,LB,Bulgaria,3611,3274,16,0,337,160,161,321,16
2025-07-03,LB,Bulgaria,3685,3320,16,2,365,176,173,349,14
2025-07-04,LB,Bulgaria,3773,3357,10,0,416,200,206,406,10
2025-07-05,LB,Bulgaria,3965,3667,10,0,298,146,142,288,10
2025-07-06,LB,Bulgaria,3849,3537,9,0,312,149,154,303,9
2025-07-07,LB,Bulgaria,3680,3330,17,2,350,167,166,333,15
2025-07-08,LB,Bulgaria,3780,3359,14,3,421,206,201,407,11
2025-07-09,LB,Bulgaria,3836,3483,18,2,353,165,170,335,16
2025-07-10,LB,Bulgaria,3805,3449,14,0,356,168,174,342,14
2025-07-11,LB,Bulgaria,3929,3497,11,1,432,209,212,421,10
2025-07-12,LB,Bulgaria,3989,3679,13,4,310,149,148,297,9
2025-07-13,LB,Bulgaria,3932,3589,12,4,343,166,165,331,8
2025-07-14,LB,Bulgaria,3820,3464,18,2,356,170,168,338,16
2025-07-15,LB,Bulgaria,3879,3462,23,3,417,200,194,394,20
2025-07-16,LB,Bulgaria,3903,3554,13,2,349,167,169,336,11
2025-07-17,LB,Bulgaria,3798,3429,20,3,369,174,175,349,17
2025-07-18,LB,Bulgaria,3952,3535,10,0,417,204,203,407,10
2025-07-19,LB,Bulgaria,4009,3702,12,4,307,147,148,295,8
2025-07-20,LB,Bulgaria,3940,3616,18,4,324,150,156,306,14
2025-07-21,LB,Bulgaria,3793,3451,18,2,342,163,161,324,16
2025-07-22,LB,Bulgaria,3918,3508,18,4,410,194,198,392,14
2025-07-23,LB,Bulgaria,3897,3542,16,4,355,171,168,339,12
2025-07-24,LB,Bulgaria,3841,3486,10,0,355,173,172,345,10
2025-07-25,LB,Bulgaria,3919,3486,15,5,433,212,206,418,10
2025-07-26,LB,Bulgaria,4044,3730,16,4,314,149,149,298,12
2025-07-27,LB,Bulgaria,3862,3516,13,4,346,164,169,333,9
2025-07-28,LB,Bulgaria,3877,3520,19,4,357,173,165,338,15
2025-07-29,LB,Bulgaria,3908,3489,13,1,419,201,205,406,12
2025-07-30,LB,Bulgaria,3930,3566,22,0,364,169,173,342,22
2025-07-31,LB,Bulgaria,3952,3586,11,0,366,178,177,355,11
2025-08-01,LB,Bulgaria,3968,3533,17,0,435,208,210,418,17
2025-08-02,LB,Bulgaria,4149,3848,7,0,301,147,147,294,7
2025-08-03,LB,Bulgaria,4044,3713,12,1,331,160,159,319,11
2025-08-04,LB,Bulgaria,3900,3554,15,1,346,171,160,331,14
2025-08-05,LB,Bulgaria,4022,3588,18,1,434,205,211,416,17
2025-08-06,LB,Bulgaria,3979,3617,16,1,362,177,169,346,15
2025-08-07,LB,Bulgaria,3860,3489,15,1,371,173,183,356,14
2025-08-08,LB,Bulgaria,3916,3485,12,0,431,209,210,419,12
2025-08-09,LB,Bulgaria,4079,3770,10,0,309,151,148,299,10
2025-08-10,LB,Bulgaria,4066,3723,13,0,343,162,168,330,13
2025-08-11,LB,Bulgaria,3840,3492,19,0,348,167,162,329,19
2025-08-12,LB,Bulgaria,3932,3513,17,1,419,204,198,402,16
2025-08-13,LB,Bulgaria,3841,3492,17,0,349,164,168,332,17
2025-08-14,LB,Bulgaria,3857,3495,15,0,362,168,179,347,15
2025-08-15,LB,Bulgaria,3956,3535,12,0,421,207,202,409,12
2025-08-16,LB,Bulgaria,4058,3750,16,5,308,146,146,292,11
2025-08-17,LB,Bulgaria,3912,3578,13,0,334,158,163,321,13
2025-08-18,LB,Bulgaria,3768,3444,14,1,324,159,151,310,13
2025-08-19,LB,Bulgaria,3855,3448,11,1,407,197,199,396,10
2025-08-20,LB,Bulgaria,3842,3490,18,3,352,168,166,334,15
2025-08-21,LB,Bulgaria,3783,3415,20,0,368,172,176,348,20
2025-08-22,LB,Bulgaria,3831,3405,19,2,426,201,206,407,17
2025-08-23,LB,Bulgaria,4089,3786,15,6,303,150,138,288,9
2025-08-24,LB,Bulgaria,4042,3711,15,1,331,154,162,316,14
2025-08-25,LB,Bulgaria,3820,3489,14,1,331,160,157,317,13
2025-08-26,LB,Bulgaria,3828,3417,11,0,411,197,203,400,11
2025-08-27,LB,Bulgaria,3778,3417,15,1,361,175,171,346,14
2025-08-28,LB,Bulgaria,3813,3452,12,0,361,174,175,349,12
2025-08-29,LB,Bulgaria,3903,3480,12,0,423,205,206,411,12
2025-01-01,LD,Croatia,1754,1628,14,0,126,57,55,112,14
2025-01-02,LD,Croatia,2038,1879,25,0,159,70,64,134,25
2025-01-03,LD,Croatia,2082,1903,28,0,179,75,76,151,28
2025-01-04,LD,Croatia,2003,1844,19,1,159,70,70,140,18
2025-01-05,LD,Croatia,2203,2054,18,0,149,66,65,131,18
2025-01-06,LD,Croatia,1965,1806,25,0,159,68,66,134,25
2025-01-07,LD,Croatia,1701,1551,23,1,150,63,64,127,22
2025-01-08,LD,Croatia,1628,1498,19,1,130,53,58,111,18
2025-01-09,LD,Croatia,1651,1528,24,1,123,51,48,99,23
2025-01-10,LD,Croatia,1896,1721,29,1,175,75,71,146,28
2025-01-11,LD,Croatia,1755,1632,12,0,123,54,57,111,12
2025-01-12,LD,Croatia,1956,1816,15,0,140,63,62,125,15
2025-01-13,LD,Croatia,1705,1561,16,0,144,65,63,128,16
2025-01-14,LD,Croatia,1389,1266,17,0,123,54,52,106,17
2025-01-15,LD,Croatia,1435,1310,20,1,125,50,55,105,19
2025-01-16,LD,Croatia,1580,1432,29,0,148,60,59,119,29
2025-01-17,LD,Croatia,1790,1612,28,1,178,75,75,150,27
2025-01-18,LD,Croatia,1700,1570,11,0,130,60,59,119,11
2025-01-19,LD,Croatia,1806,1663,18,0,143,63,62,125,18
2025-01-20,LD,Croatia,1618,1459,23,0,159,68,68,136,23
2025-01-21,LD,Croatia,1330,1211,23,2,119,49,47,96,21
2025-01-22,LD,Croatia,1454,1330,20,1,124,50,54,104,19
2025-01-23,LD,Croatia,1596,1465,24,1,131,53,54,107,23
2025-01-24,LD,Croatia,1819,1640,27,1,179,73,79,152,26
2025-01-25,LD,Croatia,1726,1600,11,0,126,57,58,115,11
2025-01-26,LD,Croatia,1906,1761,18,0,145,66,61,127,18
2025-01-27,LD,Croatia,1699,1525,25,0,174,74,75,149,25
2025-01-28,LD,Croatia,1387,1262,21,1,125,54,50,104,20
2025-01-29,LD,Croatia,1455,1324,21,1,131,54,56,110,20
2025-01-30,LD,Croatia,1559,1415,26,1,144,61,57,118,25
2025-01-31,LD,Croatia,1890,1718,25,0,172,71,76,147,25
2025-02-01,LD,Croatia,1757,1625,12,1,132,62,58,120,11
2025-02-02,LD,Croatia,1938,1766,24,2,172,77,71,148,22
2025-02-03,LD,Croatia,1710,1541,31,0,169,66,72,138,31
2025-02-04,LD,Croatia,1475,1344,23,0,131,54,54,108,23
2025-02-05,LD,Croatia,1560,1421,17,1,139,60,62,122,16
2025-02-06,LD,Croatia,1570,1451,21,1,119,52,46,98,20
2025-02-07,LD,Croatia,1856,1695,23,0,161,69,69,138,23
2025-02-08,LD,Croatia,1754,1633,11,0,121,54,56,110,11
2025-02-09,LD,Croatia,1922,1773,19,0,149,65,65,130,19
2025-02-10,LD,Croatia,1774,1610,27,0,164,68,69,137,27
2025-02-11,LD,Croatia,1438,1316,22,0,122,50,50,100,22
2025-02-12,LD,Croatia,1576,1441,21,0,135,60,54,114,21
2025-02-13,LD,Croatia,1563,1432,23,1,131,53,55,108,22
2025-02-14,LD,Croatia,1934,1757,26,0,177,79,72,151,26
2025-02-15,LD,Croatia,1817,1685,14,0,132,57,61,118,14
2025-02-16,LD,Croatia,1993,1843,15,0,150,67,68,135,15
2025-02-17,LD,Croatia,1779,1612,27,0,167,70,70,140,27
2025-02-18,LD,Croatia,1543,1413,24,1,130,52,54,106,23
2025-02-19,LD,Croatia,1693,1559,18,0,134,58,58,116,18
2025-02-20,LD,Croatia,1676,1536,27,0,140,54,59,113,27
2025-02-21,LD,Croatia,1937,1758,29,0,179,76,74,150,29
2025-02-22,LD,Croatia,1814,1682,12,0,132,61,59,120,12
2025-02-23,LD,Croatia,2052,1896,17,0,156,70,69,139,17
2025-02-24,LD,Croatia,1864,1696,27,0,168,69,72,141,27
2025-02-25,LD,Croatia,1574,1440,21,0,134,56,57,113,21
2025-02-26,LD,Croatia,1627,1497,16,0,130,57,57,114,16
2025-02-27,LD,Croatia,1643,1512,23,0,131,56,52,108,23
2025-02-28,LD,Croatia,1727,1561,27,1,166,71,68,139,26
2025-03-01,LD,Croatia,1911,1772,12,0,139,61,66,127,12
2025-03-02,LD,Croatia,2107,1937,19,0,170,78,73,151,19
2025-03-03,LD,Croatia,1813,1638,26,0,175,68,81,149,26
2025-03-04,LD,Croatia,1646,1512,21,0,134,58,55,113,21
2025-03-05,LD,Croatia,1609,1463,18,0,146,65,63,128,18
2025-03-06,LD,Croatia,1700,1550,26,1,150,64,60,124,25
2025-03-07,LD,Croatia,2034,1837,26,0,197,84,87,171,26
2025-03-08,LD,Croatia,1912,1762,11,0,150,69,70,139,11
2025-03-09,LD,Croatia,2070,1894,18,0,176,79,79,158,18
2025-03-10,LD,Croatia,1586,1432,24,0,154,65,65,130,24
2025-03-11,LD,Croatia,1684,1528,22,1,156,68,66,134,21
2025-03-12,LD,Croatia,1666,1504,22,1,162,67,73,140,21
2025-03-13,LD,Croatia,1700,1559,26,2,141,59,56,115,24
2025-03-14,LD,Croatia,1934,1756,22,1,178,78,78,156,21
2025-03-15,LD,Croatia,1807,1658,12,0,149,66,71,137,12
2025-03-16,LD,Croatia,2031,1864,20,0,167,72,75,147,20
2025-03-17,LD,Croatia,1847,1667,26,1,180,75,79,154,25
2025-03-18,LD,Croatia,1605,1463,22,0,142,60,60,120,22
2025-03-19,LD,Croatia,1714,1559,18,0,155,71,66,137,18
2025-03-20,LD,Croatia,1717,1561,24,0,156,64,68,132,24
2025-03-21,LD,Croatia,1989,1783,27,0,206,91,88,179,27
2025-03-22,LD,Croatia,1955,1800,15,1,155,70,70,140,14
2025-03-23,LD,Croatia,2019,1855,19,0,164,74,71,145,19
2025-03-24,LD,Croatia,1871,1699,26,0,172,70,76,146,26
2025-03-25,LD,Croatia,1759,1605,22,0,154,63,69,132,22
2025-03-26,LD,Croatia,1667,1514,20,0,153,68,65,133,20
2025-03-27,LD,Croatia,1744,1596,25,0,148,63,60,123,25
2025-03-28,LD,Croatia,1958,1754,25,0,204,89,90,179,25
2025-03-29,LD,Croatia,1910,1740,20,2,170,74,76,150,18
2025-03-30,LD,Croatia,2499,2237,24,0,262,122,116,238,24
2025-03-31,LD,Croatia,2225,1975,32,1,250,109,109,218,31
2025-04-01,LD,Croatia,2163,1896,28,2,267,117,122,239,26
2025-04-02,LD,Croatia,2345,2094,20,2,251,116,115,231,18
2025-04-03,LD,Croatia,2337,2076,24,0,261,119,118,237,24
2025-04-04,LD,Croatia,2479,2175,34,1,304,132,138,270,33
2025-04-05,LD,Croatia,2735,2423,22,1,312,143,147,290,21
2025-04-06,LD,Croatia,2663,2380,33,1,283,126,124,250,32
2025-04-07,LD,Croatia,2452,2167,30,0,285,128,127,255,30
2025-04-08,LD,Croatia,2315,2023,30,1,292,131,131,262,29
2025-04-09,LD,Croatia,2189,1924,21,1,265,124,120,244,20
2025-04-10,LD,Croatia,2628,2319,28,1,309,140,141,281,27
2025-04-11,LD,Croatia,2698,2374,39,0,324,142,143,285,39
2025-04-12,LD,Croatia,2866,2544,23,0,322,149,150,299,23
2025-04-13,LD,Croatia,2743,2426,32,0,317,146,139,285,32
2025-04-14,LD,Croatia,2490,2194,27,0,296,130,139,269,27
2025-04-15,LD,Croatia,2460,2165,33,3,295,133,129,262,30
2025-04-16,LD,Croatia,2560,2271,13,0,289,138,138,276,13
2025-04-17,LD,Croatia,2501,2162,30,0,339,156,153,309,30
2025-04-18,LD,Croatia,2881,2557,33,1,324,143,148,291,32
2025-04-19,LD,Croatia,2848,2486,26,0,362,162,174,336,26
2025-04-20,LD,Croatia,2815,2459,34,0,356,163,159,322,34
2025-04-21,LD,Croatia,2648,2315,32,0,333,156,145,301,32
2025-04-22,LD,Croatia,2577,2266,26,0,311,145,140,285,26
2025-04-23,LD,Croatia,2558,2253,17,0,305,144,144,288,17
2025-04-24,LD,Croatia,2752,2400,27,0,352,162,163,325,27
2025-04-25,LD,Croatia,2779,2439,34,1,340,150,156,306,33
2025-04-26,LD,Croatia,3011,2631,26,0,380,174,180,354,26
2025-04-27,LD,Croatia,2978,2605,39,0,373,170,164,334,39
2025-04-28,LD,Croatia,2652,2340,34,0,312,141,137,278,34
2025-04-29,LD,Croatia,2555,2241,27,0,314,142,145,287,27
2025-04-30,LD,Croatia,2670,2338,22,2,332,154,156,310,20
2025-05-01,LD,Croatia,3024,2626,27,0,398,176,195,371,27
2025-05-02,LD,Croatia,2975,2593,37,0,382,173,172,345,37
2025-05-03,LD,Croatia,3246,2811,21,0,435,210,204,414,21
2025-05-04,LD,Croatia,3333,2887,37,0,446,214,195,409,37
2025-05-05,LD,Croatia,2771,2421,32,0,350,160,158,318,32
2025-05-06,LD,Croatia,2730,2357,31,0,373,168,174,342,31
2025-05-07,LD,Croatia,2806,2445,17,0,361,172,172,344,17
2025-05-08,LD,Croatia,2971,2549,33,1,422,192,197,389,32
2025-05-09,LD,Croatia,2979,2583,30,1,396,180,186,366,29
2025-05-10,LD,Croatia,3229,2746,26,0,483,228,229,457,26
2025-05-11,LD,Croatia,3278,2819,34,1,459,218,207,425,33
2025-05-12,LD,Croatia,2937,2556,30,0,381,178,173,351,30
2025-05-13,LD,Croatia,2804,2420,29,0,384,181,174,355,29
2025-05-14,LD,Croatia,2960,2573,17,0,387,183,187,370,17
2025-05-15,LD,Croatia,3003,2579,27,0,424,196,201,397,27
2025-05-16,LD,Croatia,3056,2659,30,0,397,179,188,367,30
2025-05-17,LD,Croatia,3386,2868,24,0,518,244,250,494,24
2025-05-18,LD,Croatia,3331,2868,32,0,463,223,208,431,32
2025-05-19,LD,Croatia,2930,2548,31,0,382,177,174,351,31
2025-05-20,LD,Croatia,2951,2538,31,0,413,192,190,382,31
2025-05-21,LD,Croatia,2897,2488,18,0,409,194,197,391,18
2025-05-22,LD,Croatia,3097,2666,29,0,431,198,204,402,29
2025-05-23,LD,Croatia,3062,2635,29,0,427,195,203,398,29
2025-05-24,LD,Croatia,3497,2976,22,1,521,254,245,499,21
2025-05-25,LD,Croatia,3409,2911,29,0,498,241,228,469,29
2025-05-26,LD,Croatia,3217,2826,33,0,391,178,180,358,33
2025-05-27,LD,Croatia,3091,2643,32,1,448,209,207,416,31
2025-05-28,LD,Croatia,3085,2656,20,2,429,202,207,409,18
2025-05-29,LD,Croatia,3324,2864,41,0,460,197,222,419,41
2025-05-30,LD,Croatia,3233,2807,34,1,426,195,197,392,33
2025-05-31,LD,Croatia,3532,2977,24,0,555,271,260,531,24
2025-06-01,LD,Croatia,3647,3072,39,1,575,273,263,536,38
2025-06-02,LD,Croatia,3211,2749,32,0,462,215,215,430,32
2025-06-03,LD,Croatia,3252,2758,36,3,494,230,228,458,33
2025-06-04,LD,Croatia,3276,2776,23,2,500,238,239,477,21
2025-06-05,LD,Croatia,3301,2779,33,0,522,241,248,489,33
2025-06-06,LD,Croatia,3502,2955,50,1,547,242,255,497,49
2025-06-07,LD,Croatia,3734,3103,31,0,631,295,305,600,31
2025-06-08,LD,Croatia,3560,3073,28,0,487,231,228,459,28
2025-06-09,LD,Croatia,3449,2912,44,0,537,254,239,493,44
2025-06-10,LD,Croatia,3353,2826,34,1,527,251,242,493,33
2025-06-11,LD,Croatia,3441,2937,23,0,504,243,238,481,23
2025-06-12,LD,Croatia,3449,2914,37,0,535,248,250,498,37
2025-06-13,LD,Croatia,3640,3101,43,0,539,245,251,496,43
2025-06-14,LD,Croatia,3946,3310,30,0,636,303,303,606,30
2025-06-15,LD,Croatia,3704,3132,42,0,572,266,264,530,42
2025-06-16,LD,Croatia,3202,2725,35,0,477,219,223,442,35
2025-06-17,LD,Croatia,3337,2823,35,1,514,241,238,479,34
2025-06-18,LD,Croatia,3441,2924,21,2,517,245,251,496,19
2025-06-19,LD,Croatia,3556,3014,34,0,542,252,256,508,34
2025-06-20,LD,Croatia,3656,3088,45,0,568,250,273,523,45
2025-06-21,LD,Croatia,4003,3309,31,1,694,338,325,663,30
2025-06-22,LD,Croatia,3921,3289,42,0,632,308,282,590,42
2025-06-23,LD,Croatia,3584,3011,40,1,573,267,266,533,39
2025-06-24,LD,Croatia,3455,2868,34,0,587,280,273,553,34
2025-06-25,LD,Croatia,3485,2933,24,1,552,266,262,528,23
2025-06-26,LD,Croatia,3566,2964,34,1,602,281,287,568,33
2025-06-27,LD,Croatia,3647,3034,37,1,613,285,291,576,36
2025-06-28,LD,Croatia,3918,3208,28,0,710,338,344,682,28
2025-06-29,LD,Croatia,3787,3117,37,1,670,326,307,633,36
2025-06-30,LD,Croatia,3479,2895,36,0,584,275,273,548,36
2025-07-01,LD,Croatia,3559,2920,35,0,639,303,301,604,35
2025-07-02,LD,Croatia,3550,2958,19,0,592,280,293,573,19
2025-07-03,LD,Croatia,3524,2895,39,0,629,296,294,590,39
2025-07-04,LD,Croatia,3618,2996,39,1,622,288,295,583,38
2025-07-05,LD,Croatia,3993,3251,26,0,742,359,357,716,26
2025-07-06,LD,Croatia,3814,3133,40,0,681,323,318,641,40
2025-07-07,LD,Croatia,3468,2849,40,0,619,293,286,579,40
2025-07-08,LD,Croatia,3558,2934,28,0,624,301,295,596,28
2025-07-09,LD,Croatia,3492,2886,27,0,606,289,290,579,27
2025-07-10,LD,Croatia,3613,2964,40,0,649,292,317,609,40
2025-07-11,LD,Croatia,3776,3108,43,0,668,310,315,625,43
2025-07-12,LD,Croatia,4105,3328,29,0,777,377,371,748,29
2025-07-13,LD,Croatia,3876,3183,39,1,693,334,320,654,38
2025-07-14,LD,Croatia,3644,3015,41,0,629,297,291,588,41
2025-07-15,LD,Croatia,3586,2951,36,1,635,311,288,599,35
2025-07-16,LD,Croatia,3642,3012,25,0,630,296,309,605,25
2025-07-17,LD,Croatia,3513,2882,41,0,631,289,301,590,41
2025-07-18,LD,Croatia,3770,3102,34,0,668,308,326,634,34
2025-07-19,LD,Croatia,4005,3266,35,3,739,353,351,704,32
2025-07-20,LD,Croatia,3878,3185,42,2,693,334,317,651,40
2025-07-21,LD,Croatia,3629,3012,38,2,617,286,293,579,36
2025-07-22,LD,Croatia,3707,3051,35,0,656,315,306,621,35
2025-07-23,LD,Croatia,3714,3083,23,1,631,307,301,608,22
2025-07-24,LD,Croatia,3568,2948,36,0,620,288,296,584,36
2025-07-25,LD,Croatia,3822,3161,41,0,661,316,304,620,41
2025-07-26,LD,Croatia,3775,3045,32,0,730,348,350,698,32
2025-07-27,LD,Croatia,3863,3185,43,0,678,325,310,635,43
2025-07-28,LD,Croatia,3330,2734,37,0,596,282,277,559,37
2025-07-29,LD,Croatia,3701,3076,36,0,625,294,295,589,36
2025-07-30,LD,Croatia,3741,3108,27,1,633,302,304,606,26
2025-07-31,LD,Croatia,3741,3094,42,1,647,298,307,605,41
2025-08-01,LD,Croatia,3828,3155,41,0,673,311,321,632,41
2025-08-02,LD,Croatia,3918,3204,29,1,714,344,341,685,28
2025-08-03,LD,Croatia,3812,3134,46,0,678,322,310,632,46
2025-08-04,LD,Croatia,3700,3048,46,1,652,301,305,606,45
2025-08-05,LD,Croatia,3680,3047,35,2,633,304,294,598,33
2025-08-06,LD,Croatia,3720,3102,21,0,618,293,304,597,21
2025-08-07,LD,Croatia,3852,3211,41,1,641,295,305,600,40
2025-08-08,LD,Croatia,3846,3179,46,1,667,305,316,621,45
2025-08-09,LD,Croatia,4064,3305,36,2,759,366,357,723,34
2025-08-10,LD,Croatia,3948,3252,41,1,696,339,316,655,40
2025-08-11,LD,Croatia,3666,3082,39,2,584,275,270,545,37
2025-08-12,LD,Croatia,3728,3120,32,2,608,291,285,576,30
2025-08-13,LD,Croatia,3687,3091,23,1,596,284,289,573,22
2025-08-14,LD,Croatia,3671,3047,39,0,624,296,289,585,39
2025-08-15,LD,Croatia,3755,3138,40,1,617,292,285,577,39
2025-08-16,LD,Croatia,4075,3348,28,0,727,339,360,699,28
2025-08-17,LD,Croatia,3936,3269,36,0,667,321,310,631,36
2025-08-18,LD,Croatia,3657,3076,35,0,581,267,279,546,35
2025-08-19,LD,Croatia,3708,3097,29,0,611,295,287,582,29
2025-08-20,LD,Croatia,3564,2957,24,0,607,291,292,583,24
2025-08-21,LD,Croatia,3469,2880,36,0,589,276,277,553,36
2025-08-22,LD,Croatia,3663,3041,40,0,622,281,301,582,40
2025-08-23,LD,Croatia,3981,3268,30,0,713,341,342,683,30
2025-08-24,LD,Croatia,3916,3247,39,1,669,323,307,630,38
2025-08-25,LD,Croatia,3596,3019,36,1,577,267,274,541,35
2025-08-26,LD,Croatia,3664,3057,32,0,607,295,280,575,32
2025-08-27,LD,Croatia,3626,3068,22,0,558,268,268,536,22
2025-08-28,LD,Croatia,3620,3023,34,0,597,279,284,563,34
2025-08-29,LD,Croatia,3541,2918,40,0,623,294,289,583,40
2025-01-01,LC,Cyprus,960,794,0,0,166,80,86,166,0
2025-01-02,LC,Cyprus,1130,922,8,8,208,99,101,200,0
2025-01-03,LC,Cyprus,955,724,10,10,231,110,111,221,0
2025-01-04,LC,Cyprus,965,757,5,5,208,102,101,203,0
2025-01-05,LC,Cyprus,1088,869,3,3,219,105,111,216,0
2025-01-06,LC,Cyprus,983,777,7,7,206,99,100,199,0
2025-01-07,LC,Cyprus,925,738,6,6,187,92,89,181,0
2025-01-08,LC,Cyprus,911,744,7,7,167,81,79,160,0
2025-01-09,LC,Cyprus,966,782,10,8,184,82,92,174,2
2025-01-10,LC,Cyprus,854,659,8,6,195,95,92,187,2
2025-01-11,LC,Cyprus,841,680,4,3,161,80,77,157,1
2025-01-12,LC,Cyprus,983,766,6,6,217,104,107,211,0
2025-01-13,LC,Cyprus,889,707,7,7,182,89,86,175,0
2025-01-14,LC,Cyprus,826,679,10,9,147,66,71,137,1
2025-01-15,LC,Cyprus,893,740,5,5,153,78,70,148,0
2025-01-16,LC,Cyprus,1042,867,7,7,175,84,84,168,0
2025-01-17,LC,Cyprus,878,705,7,6,173,82,84,166,1
2025-01-18,LC,Cyprus,873,726,2,1,147,75,70,145,1
2025-01-19,LC,Cyprus,1117,914,4,4,203,97,102,199,0
2025-01-20,LC,Cyprus,945,771,5,5,174,86,83,169,0
2025-01-21,LC,Cyprus,867,721,4,4,146,74,68,142,0
2025-01-22,LC,Cyprus,878,726,3,3,152,69,80,149,0
2025-01-23,LC,Cyprus,1046,858,2,2,188,99,87,186,0
2025-01-24,LC,Cyprus,822,643,6,5,179,83,90,173,1
2025-01-25,LC,Cyprus,860,712,2,2,148,76,70,146,0
2025-01-26,LC,Cyprus,1032,842,3,2,190,95,92,187,1
2025-01-27,LC,Cyprus,927,755,3,3,172,83,86,169,0
2025-01-28,LC,Cyprus,839,699,3,3,140,69,68,137,0
2025-01-29,LC,Cyprus,887,740,4,4,147,71,72,143,0
2025-01-30,LC,Cyprus,992,830,6,5,162,78,78,156,1
2025-01-31,LC,Cyprus,957,790,4,3,167,82,81,163,1
2025-02-01,LC,Cyprus,971,819,2,2,152,77,73,150,0
2025-02-02,LC,Cyprus,1145,958,3,2,187,92,92,184,1
2025-02-03,LC,Cyprus,962,791,4,4,171,82,85,167,0
2025-02-04,LC,Cyprus,945,799,3,2,146,70,73,143,1
2025-02-05,LC,Cyprus,938,776,4,4,162,80,78,158,0
2025-02-06,LC,Cyprus,1011,845,3,3,166,82,81,163,0
2025-02-07,LC,Cyprus,923,745,3,3,178,87,88,175,0
2025-02-08,LC,Cyprus,918,752,1,1,166,81,84,165,0
2025-02-09,LC,Cyprus,1099,904,3,3,195,96,96,192,0
2025-02-10,LC,Cyprus,927,751,6,6,176,85,85,170,0
2025-02-11,LC,Cyprus,903,762,3,3,141,71,67,138,0
2025-02-12,LC,Cyprus,920,758,6,6,162,79,77,156,0
2025-02-13,LC,Cyprus,996,819,4,4,177,83,90,173,0
2025-02-14,LC,Cyprus,897,705,5,5,192,94,93,187,0
2025-02-15,LC,Cyprus,921,749,1,1,172,87,84,171,0
2025-02-16,LC,Cyprus,1066,859,4,4,207,101,102,203,0
2025-02-17,LC,Cyprus,957,779,8,7,178,85,85,170,1
2025-02-18,LC,Cyprus,934,759,10,10,175,81,84,165,0
2025-02-19,LC,Cyprus,1006,809,5,5,197,99,93,192,0
2025-02-20,LC,Cyprus,1112,922,6,6,190,90,94,184,0
2025-02-21,LC,Cyprus,963,774,7,6,189,90,92,182,1
2025-02-22,LC,Cyprus,985,813,4,4,172,88,80,168,0
2025-02-23,LC,Cyprus,1158,961,4,4,197,92,101,193,0
2025-02-24,LC,Cyprus,1050,858,7,6,192,94,91,185,1
2025-02-25,LC,Cyprus,968,799,6,6,169,82,81,163,0
2025-02-26,LC,Cyprus,971,770,8,8,201,97,96,193,0
2025-02-27,LC,Cyprus,1066,879,7,7,187,87,93,180,0
2025-02-28,LC,Cyprus,901,756,5,5,145,71,69,140,0
2025-03-01,LC,Cyprus,991,792,0,0,199,99,100,199,0
2025-03-02,LC,Cyprus,1030,832,5,5,198,97,96,193,0
2025-03-03,LC,Cyprus,919,726,8,8,193,91,94,185,0
2025-03-04,LC,Cyprus,872,691,11,11,181,84,86,170,0
2025-03-05,LC,Cyprus,970,748,4,4,222,112,106,218,0
2025-03-06,LC,Cyprus,987,801,7,6,186,89,90,179,1
2025-03-07,LC,Cyprus,918,736,7,7,182,86,89,175,0
2025-03-08,LC,Cyprus,930,750,1,1,180,92,87,179,0
2025-03-09,LC,Cyprus,1123,900,7,7,223,107,109,216,0
2025-03-10,LC,Cyprus,909,735,5,5,174,87,82,169,0
2025-03-11,LC,Cyprus,898,743,5,5,155,75,75,150,0
2025-03-12,LC,Cyprus,957,733,8,8,224,110,106,216,0
2025-03-13,LC,Cyprus,1020,843,8,8,177,83,86,169,0
2025-03-14,LC,Cyprus,853,661,9,9,192,90,93,183,0
2025-03-15,LC,Cyprus,934,749,2,2,185,95,88,183,0
2025-03-16,LC,Cyprus,1117,903,8,8,214,101,105,206,0
2025-03-17,LC,Cyprus,988,792,5,5,196,94,97,191,0
2025-03-18,LC,Cyprus,909,740,5,5,169,79,85,164,0
2025-03-19,LC,Cyprus,1037,800,5,5,237,119,113,232,0
2025-03-20,LC,Cyprus,1147,953,8,8,194,97,89,186,0
2025-03-21,LC,Cyprus,971,762,6,6,209,97,106,203,0
2025-03-22,LC,Cyprus,1021,818,0,0,203,103,100,203,0
2025-03-23,LC,Cyprus,1101,873,5,4,228,111,112,223,1
2025-03-24,LC,Cyprus,950,761,6,6,189,95,88,183,0
2025-03-25,LC,Cyprus,929,767,6,6,162,75,81,156,0
2025-03-26,LC,Cyprus,977,757,8,7,220,108,104,212,1
2025-03-27,LC,Cyprus,1036,842,8,8,194,93,93,186,0
2025-03-28,LC,Cyprus,941,743,7,7,198,96,95,191,0
2025-03-29,LC,Cyprus,1012,800,1,1,212,102,109,211,0
2025-03-30,LC,Cyprus,1374,1110,6,5,264,127,131,258,1
2025-03-31,LC,Cyprus,1151,909,10,10,242,120,112,232,0
2025-04-01,LC,Cyprus,1193,939,4,4,254,126,124,250,0
2025-04-02,LC,Cyprus,1274,952,8,8,322,158,156,314,0
2025-04-03,LC,Cyprus,1328,1052,9,8,276,133,134,267,1
2025-04-04,LC,Cyprus,1206,945,5,5,261,130,126,256,0
2025-04-05,LC,Cyprus,1213,930,0,0,283,138,145,283,0
2025-04-06,LC,Cyprus,1321,1022,6,6,299,148,145,293,0
2025-04-07,LC,Cyprus,1170,906,9,8,264,128,127,255,1
2025-04-08,LC,Cyprus,1190,923,7,6,267,129,131,260,1
2025-04-09,LC,Cyprus,1212,905,7,7,307,147,153,300,0
2025-04-10,LC,Cyprus,1509,1211,8,7,298,147,143,290,1
2025-04-11,LC,Cyprus,1357,1049,6,6,308,148,154,302,0
2025-04-12,LC,Cyprus,1256,969,0,0,287,148,139,287,0
2025-04-13,LC,Cyprus,1364,1071,7,7,293,145,141,286,0
2025-04-14,LC,Cyprus,1379,1075,8,8,304,148,148,296,0
2025-04-15,LC,Cyprus,1321,1026,7,7,295,142,146,288,0
2025-04-16,LC,Cyprus,1359,1020,7,7,339,165,167,332,0
2025-04-17,LC,Cyprus,1371,1051,7,7,320,154,159,313,0
2025-04-18,LC,Cyprus,1259,972,6,6,287,138,143,281,0
2025-04-19,LC,Cyprus,1273,958,0,0,315,160,155,315,0
2025-04-20,LC,Cyprus,1388,1087,6,6,301,145,150,295,0
2025-04-21,LC,Cyprus,1320,1015,8,7,305,152,145,297,1
2025-04-22,LC,Cyprus,1257,967,8,8,290,139,143,282,0
2025-04-23,LC,Cyprus,1298,951,8,7,347,172,167,339,1
2025-04-24,LC,Cyprus,1250,965,6,5,285,139,140,279,1
2025-04-25,LC,Cyprus,1203,903,8,7,300,142,150,292,1
2025-04-26,LC,Cyprus,1230,899,1,1,331,170,160,330,0
2025-04-27,LC,Cyprus,1302,991,6,6,311,153,152,305,0
2025-04-28,LC,Cyprus,1164,874,8,8,290,144,138,282,0
2025-04-29,LC,Cyprus,1148,882,4,4,266,130,132,262,0
2025-04-30,LC,Cyprus,1235,883,10,9,352,169,173,342,1
2025-05-01,LC,Cyprus,1245,969,7,7,276,133,136,269,0
2025-05-02,LC,Cyprus,1128,845,4,4,283,139,140,279,0
2025-05-03,LC,Cyprus,1142,797,1,1,345,175,169,344,0
2025-05-04,LC,Cyprus,1283,951,6,5,332,161,165,326,1
2025-05-05,LC,Cyprus,1126,818,3,3,308,154,151,305,0
2025-05-06,LC,Cyprus,1054,792,7,6,262,126,129,255,1
2025-05-07,LC,Cyprus,1093,747,6,6,346,168,172,340,0
2025-05-08,LC,Cyprus,1130,846,9,7,284,137,138,275,2
2025-05-09,LC,Cyprus,988,714,3,3,274,136,135,271,0
2025-05-10,LC,Cyprus,1051,729,2,2,322,161,159,320,0
2025-05-11,LC,Cyprus,1223,918,2,2,305,151,152,303,0
2025-05-12,LC,Cyprus,1124,820,10,8,304,145,149,294,2
2025-05-13,LC,Cyprus,1072,799,7,7,273,129,137,266,0
2025-05-14,LC,Cyprus,1243,893,4,4,350,176,170,346,0
2025-05-15,LC,Cyprus,1210,922,9,8,288,138,141,279,1
2025-05-16,LC,Cyprus,1060,766,7,6,294,141,146,287,1
2025-05-17,LC,Cyprus,1068,728,1,1,340,175,164,339,0
2025-05-18,LC,Cyprus,1254,925,5,5,329,161,163,324,0
2025-05-19,LC,Cyprus,1100,803,8,8,297,145,144,289,0
2025-05-20,LC,Cyprus,1077,800,11,9,277,134,132,266,2
2025-05-21,LC,Cyprus,1139,789,10,9,350,170,170,340,1
2025-05-22,LC,Cyprus,1189,882,12,11,307,147,148,295,1
2025-05-23,LC,Cyprus,1050,760,6,5,290,140,144,284,1
2025-05-24,LC,Cyprus,1087,739,3,1,348,175,170,345,2
2025-05-25,LC,Cyprus,1298,948,10,9,350,169,171,340,1
2025-05-26,LC,Cyprus,1207,884,11,7,323,158,154,312,4
2025-05-27,LC,Cyprus,1178,878,12,10,300,147,141,288,2
2025-05-28,LC,Cyprus,1203,841,12,11,362,173,177,350,1
2025-05-29,LC,Cyprus,1315,979,12,12,336,158,166,324,0
2025-05-30,LC,Cyprus,1134,807,13,13,327,155,159,314,0
2025-05-31,LC,Cyprus,1124,764,5,5,360,185,170,355,0
2025-06-01,LC,Cyprus,1200,852,1,1,348,174,173,347,0
2025-06-02,LC,Cyprus,1106,765,10,10,341,172,159,331,0
2025-06-03,LC,Cyprus,1218,867,8,8,351,168,175,343,0
2025-06-04,LC,Cyprus,1321,917,9,9,404,198,197,395,0
2025-06-05,LC,Cyprus,1295,974,6,6,321,155,160,315,0
2025-06-06,LC,Cyprus,1102,787,4,4,315,154,157,311,0
2025-06-07,LC,Cyprus,1129,755,0,0,374,190,184,374,0
2025-06-08,LC,Cyprus,1341,981,12,9,360,175,173,348,3
2025-06-09,LC,Cyprus,1222,884,4,3,338,165,169,334,1
2025-06-10,LC,Cyprus,1245,909,5,4,336,166,165,331,1
2025-06-11,LC,Cyprus,1309,920,6,4,389,192,191,383,2
2025-06-12,LC,Cyprus,1348,1009,6,4,339,161,172,333,2
2025-06-13,LC,Cyprus,1473,1174,4,2,299,135,160,295,2
2025-06-14,LC,Cyprus,1413,1079,4,4,334,169,161,330,0
2025-06-15,LC,Cyprus,1475,1153,3,3,322,153,166,319,0
2025-06-16,LC,Cyprus,1444,1114,8,7,330,162,160,322,1
2025-06-17,LC,Cyprus,1389,1070,5,5,319,159,155,314,0
2025-06-18,LC,Cyprus,1581,1171,4,4,410,203,203,406,0
2025-06-19,LC,Cyprus,1573,1198,5,5,375,186,184,370,0
2025-06-20,LC,Cyprus,1647,1257,7,4,390,193,190,383,3
2025-06-21,LC,Cyprus,1609,1180,3,1,429,211,215,426,2
2025-06-22,LC,Cyprus,1467,1104,5,5,363,184,174,358,0
2025-06-23,LC,Cyprus,1394,1020,10,8,374,180,184,364,2
2025-06-24,LC,Cyprus,1372,1007,4,3,365,189,172,361,1
2025-06-25,LC,Cyprus,1412,1001,6,4,411,205,200,405,2
2025-06-26,LC,Cyprus,1257,926,6,5,331,164,161,325,1
2025-06-27,LC,Cyprus,1090,741,7,6,349,173,169,342,1
2025-06-28,LC,Cyprus,1093,735,0,0,358,176,182,358,0
2025-06-29,LC,Cyprus,1167,789,2,2,378,186,190,376,0
2025-06-30,LC,Cyprus,1099,760,6,6,339,166,167,333,0
2025-07-01,LC,Cyprus,1248,906,6,6,342,172,164,336,0
2025-07-02,LC,Cyprus,1323,923,6,5,400,195,199,394,1
2025-07-03,LC,Cyprus,1306,965,5,5,341,164,172,336,0
2025-07-04,LC,Cyprus,1161,805,6,5,356,178,172,350,1
2025-07-05,LC,Cyprus,1173,801,0,0,372,188,184,372,0
2025-07-06,LC,Cyprus,1370,976,5,5,394,198,191,389,0
2025-07-07,LC,Cyprus,1271,924,6,5,347,167,174,341,1
2025-07-08,LC,Cyprus,1258,904,7,7,354,172,175,347,0
2025-07-09,LC,Cyprus,1340,939,7,7,401,198,196,394,0
2025-07-10,LC,Cyprus,1342,985,5,5,357,179,173,352,0
2025-07-11,LC,Cyprus,1179,834,6,6,345,167,172,339,0
2025-07-12,LC,Cyprus,1199,814,0,0,385,194,191,385,0
2025-07-13,LC,Cyprus,1394,992,5,5,402,200,197,397,0
2025-07-14,LC,Cyprus,1267,924,7,6,343,166,170,336,1
2025-07-15,LC,Cyprus,1312,947,6,6,365,176,183,359,0
2025-07-16,LC,Cyprus,1390,984,5,5,406,198,203,401,0
2025-07-17,LC,Cyprus,1354,982,7,7,372,187,178,365,0
2025-07-18,LC,Cyprus,1271,904,7,7,367,179,181,360,0
2025-07-19,LC,Cyprus,1211,824,1,1,387,196,190,386,0
2025-07-20,LC,Cyprus,1441,1051,4,4,390,192,194,386,0
2025-07-21,LC,Cyprus,1327,971,9,9,356,172,175,347,0
2025-07-22,LC,Cyprus,1361,986,7,7,375,184,184,368,0
2025-07-23,LC,Cyprus,1401,979,8,7,422,210,204,414,1
2025-07-24,LC,Cyprus,1400,1030,8,8,370,175,187,362,0
2025-07-25,LC,Cyprus,1265,901,4,4,364,179,181,360,0
2025-07-26,LC,Cyprus,1284,874,9,0,410,205,196,401,9
2025-07-27,LC,Cyprus,1439,1041,4,4,398,195,199,394,0
2025-07-28,LC,Cyprus,1331,962,9,9,369,185,175,360,0
2025-07-29,LC,Cyprus,1327,970,8,7,357,172,177,349,1
2025-07-30,LC,Cyprus,1402,1003,6,6,399,195,198,393,0
2025-07-31,LC,Cyprus,1437,1063,8,8,374,182,184,366,0
2025-08-01,LC,Cyprus,1289,927,4,3,362,178,180,358,1
2025-08-02,LC,Cyprus,1267,865,1,0,402,200,201,401,1
2025-08-03,LC,Cyprus,1476,1074,6,5,402,200,196,396,1
2025-08-04,LC,Cyprus,1362,984,7,5,378,184,187,371,2
2025-08-05,LC,Cyprus,1394,1029,5,5,365,176,184,360,0
2025-08-06,LC,Cyprus,1451,1027,7,7,424,213,204,417,0
2025-08-07,LC,Cyprus,1456,1067,5,5,389,192,192,384,0
2025-08-08,LC,Cyprus,1335,974,5,5,361,178,178,356,0
2025-08-09,LC,Cyprus,1243,854,0,0,389,197,192,389,0
2025-08-10,LC,Cyprus,1507,1084,5,5,423,207,211,418,0
2025-08-11,LC,Cyprus,1365,997,5,5,368,186,177,363,0
2025-08-12,LC,Cyprus,1460,1081,7,7,379,183,189,372,0
2025-08-13,LC,Cyprus,1459,1044,5,5,415,205,205,410,0
2025-08-14,LC,Cyprus,1480,1104,4,4,376,185,187,372,0
2025-08-15,LC,Cyprus,1385,1013,5,5,372,180,187,367,0
2025-08-16,LC,Cyprus,1311,903,0,0,408,206,202,408,0
2025-08-17,LC,Cyprus,1552,1126,5,5,426,212,209,421,0
2025-08-18,LC,Cyprus,1411,1040,2,1,371,187,182,369,1
2025-08-19,LC,Cyprus,1397,1036,4,4,361,178,179,357,0
2025-08-20,LC,Cyprus,1463,1043,6,5,420,206,208,414,1
2025-08-21,LC,Cyprus,1465,1092,6,6,373,182,185,367,0
2025-08-22,LC,Cyprus,1367,989,4,3,378,185,189,374,1
2025-08-23,LC,Cyprus,1317,906,0,0,411,209,202,411,0
2025-08-24,LC,Cyprus,1533,1106,5,5,427,207,215,422,0
2025-08-25,LC,Cyprus,1432,1045,5,5,387,191,191,382,0
2025-08-26,LC,Cyprus,1430,1041,5,5,389,190,194,384,0
2025-08-27,LC,Cyprus,1507,1068,5,5,439,219,215,434,0
2025-08-28,LC,Cyprus,1483,1094,6,5,389,188,195,383,1
2025-08-29,LC,Cyprus,1349,983,5,5,366,182,179,361,0
2025-01-01,LK,Czech Republic,1584,1316,1,0,268,131,136,267,1
2025-01-02,LK,Czech Republic,1892,1491,6,1,401,192,203,395,5
2025-01-03,LK,Czech Republic,2002,1600,5,2,402,198,199,397,3
2025-01-04,LK,Czech Republic,1874,1557,9,4,317,159,149,308,5
2025-01-05,LK,Czech Republic,1739,1472,6,0,267,129,132,261,6
2025-01-06,LK,Czech Republic,1979,1568,8,4,411,198,205,403,4
2025-01-07,LK,Czech Republic,1655,1366,9,1,289,142,138,280,8
2025-01-08,LK,Czech Republic,1549,1314,3,1,235,114,118,232,2
2025-01-09,LK,Czech Republic,1602,1297,23,9,305,137,145,282,14
2025-01-10,LK,Czech Republic,1871,1526,14,9,345,164,167,331,5
2025-01-11,LK,Czech Republic,1667,1432,8,1,235,116,111,227,7
2025-01-12,LK,Czech Republic,1778,1451,2,2,327,163,162,325,0
2025-01-13,LK,Czech Republic,1728,1391,12,10,337,164,161,325,2
2025-01-14,LK,Czech Republic,1433,1172,18,9,261,122,121,243,9
2025-01-15,LK,Czech Republic,1459,1219,5,0,240,117,118,235,5
2025-01-16,LK,Czech Republic,1642,1324,12,1,318,150,156,306,11
2025-01-17,LK,Czech Republic,1833,1488,4,0,345,174,167,341,4
2025-01-18,LK,Czech Republic,1643,1407,4,4,236,113,119,232,0
2025-01-19,LK,Czech Republic,1779,1450,4,3,329,160,165,325,1
2025-01-20,LK,Czech Republic,1776,1425,16,9,351,171,164,335,7
2025-01-21,LK,Czech Republic,1423,1169,8,1,254,123,123,246,7
2025-01-22,LK,Czech Republic,1557,1291,13,3,266,128,125,253,10
2025-01-23,LK,Czech Republic,1557,1245,8,3,312,150,154,304,5
2025-01-24,LK,Czech Republic,1847,1465,14,5,382,183,185,368,9
2025-01-25,LK,Czech Republic,1736,1481,20,8,255,116,119,235,12
2025-01-26,LK,Czech Republic,1698,1365,9,6,333,156,168,324,3
2025-01-27,LK,Czech Republic,1824,1477,15,8,347,166,166,332,7
2025-01-28,LK,Czech Republic,1412,1161,14,3,251,126,111,237,11
2025-01-29,LK,Czech Republic,1470,1218,21,11,252,114,117,231,10
2025-01-30,LK,Czech Republic,1649,1276,29,17,373,173,171,344,12
2025-01-31,LK,Czech Republic,1822,1456,13,3,366,175,178,353,10
2025-02-01,LK,Czech Republic,1711,1428,23,8,283,136,124,260,15
2025-02-02,LK,Czech Republic,1837,1471,14,7,366,170,182,352,7
2025-02-03,LK,Czech Republic,1819,1436,19,11,383,186,178,364,8
2025-02-04,LK,Czech Republic,1518,1242,16,10,276,127,133,260,6
2025-02-05,LK,Czech Republic,1597,1310,22,4,287,134,131,265,18
2025-02-06,LK,Czech Republic,1702,1367,14,8,335,157,164,321,6
2025-02-07,LK,Czech Republic,1942,1552,15,6,390,193,182,375,9
2025-02-08,LK,Czech Republic,1752,1484,3,2,268,135,130,265,1
2025-02-09,LK,Czech Republic,1813,1432,18,5,381,172,191,363,13
2025-02-10,LK,Czech Republic,1777,1388,26,11,389,187,176,363,15
2025-02-11,LK,Czech Republic,1492,1192,17,9,300,143,140,283,8
2025-02-12,LK,Czech Republic,1661,1349,10,5,312,151,151,302,5
2025-02-13,LK,Czech Republic,1708,1349,14,5,359,174,171,345,9
2025-02-14,LK,Czech Republic,1965,1580,3,0,385,192,190,382,3
2025-02-15,LK,Czech Republic,1816,1531,5,4,285,140,140,280,1
2025-02-16,LK,Czech Republic,1857,1481,17,7,376,178,181,359,10
2025-02-17,LK,Czech Republic,1829,1451,16,11,378,183,179,362,5
2025-02-18,LK,Czech Republic,1606,1284,21,7,322,152,149,301,14
2025-02-19,LK,Czech Republic,1752,1417,17,9,335,156,162,318,8
2025-02-20,LK,Czech Republic,1794,1404,18,7,390,181,191,372,11
2025-02-21,LK,Czech Republic,1888,1470,15,7,418,205,198,403,8
2025-02-22,LK,Czech Republic,1787,1494,11,9,293,141,141,282,2
2025-02-23,LK,Czech Republic,1805,1420,8,2,385,188,189,377,6
2025-02-24,LK,Czech Republic,1849,1450,17,10,399,194,188,382,7
2025-02-25,LK,Czech Republic,1594,1270,20,14,324,152,152,304,6
2025-02-26,LK,Czech Republic,1696,1364,9,4,332,161,162,323,5
2025-02-27,LK,Czech Republic,1720,1348,16,5,372,175,181,356,11
2025-02-28,LK,Czech Republic,1883,1477,19,2,406,197,190,387,17
2025-03-01,LK,Czech Republic,1836,1553,7,3,283,140,136,276,4
2025-03-02,LK,Czech Republic,1914,1505,17,8,409,189,203,392,9
2025-03-03,LK,Czech Republic,1926,1521,29,12,405,187,189,376,17
2025-03-04,LK,Czech Republic,1628,1303,19,7,325,157,149,306,12
2025-03-05,LK,Czech Republic,1799,1452,15,5,347,166,166,332,10
2025-03-06,LK,Czech Republic,1890,1469,31,9,421,198,192,390,22
2025-03-07,LK,Czech Republic,1983,1528,24,9,455,213,218,431,15
2025-03-08,LK,Czech Republic,1830,1509,28,9,321,148,145,293,19
2025-03-09,LK,Czech Republic,1854,1439,18,8,415,195,202,397,10
2025-03-10,LK,Czech Republic,1593,1206,22,7,387,185,180,365,15
2025-03-11,LK,Czech Republic,1702,1354,25,10,348,161,162,323,15
2025-03-12,LK,Czech Republic,1818,1454,19,7,364,172,173,345,12
2025-03-13,LK,Czech Republic,1827,1431,15,2,396,194,187,381,13
2025-03-14,LK,Czech Republic,2020,1617,8,1,403,194,201,395,7
2025-03-15,LK,Czech Republic,1897,1611,12,9,286,136,138,274,3
2025-03-16,LK,Czech Republic,1932,1506,27,8,426,193,206,399,19
2025-03-17,LK,Czech Republic,1953,1518,18,7,435,215,202,417,11
2025-03-18,LK,Czech Republic,1730,1365,33,17,365,167,165,332,16
2025-03-19,LK,Czech Republic,1785,1438,23,6,347,162,162,324,17
2025-03-20,LK,Czech Republic,1859,1438,29,13,421,194,198,392,16
2025-03-21,LK,Czech Republic,1955,1509,20,9,446,212,214,426,11
2025-03-22,LK,Czech Republic,1779,1486,10,7,293,140,143,283,3
2025-03-23,LK,Czech Republic,1918,1537,3,2,381,184,194,378,1
2025-03-24,LK,Czech Republic,1926,1539,11,4,387,190,186,376,7
2025-03-25,LK,Czech Republic,1669,1332,20,11,337,159,158,317,9
2025-03-26,LK,Czech Republic,1814,1465,16,5,349,168,165,333,11
2025-03-27,LK,Czech Republic,1918,1530,14,7,388,190,184,374,7
2025-03-28,LK,Czech Republic,2051,1614,18,9,437,208,211,419,9
2025-03-29,LK,Czech Republic,1796,1521,10,3,275,132,133,265,7
2025-03-30,LK,Czech Republic,2018,1611,13,4,407,193,201,394,9
2025-03-31,LK,Czech Republic,2064,1668,9,4,396,193,194,387,5
2025-04-01,LK,Czech Republic,2100,1722,10,8,378,186,182,368,2
2025-04-02,LK,Czech Republic,2144,1727,16,4,417,207,194,401,12
2025-04-03,LK,Czech Republic,2165,1724,27,10,441,215,199,414,17
2025-04-04,LK,Czech Republic,2291,1811,16,6,480,223,241,464,10
2025-04-05,LK,Czech Republic,2075,1713,13,3,362,182,167,349,10
2025-04-06,LK,Czech Republic,2242,1817,12,3,425,199,214,413,9
2025-04-07,LK,Czech Republic,2235,1814,10,3,421,213,198,411,7
2025-04-08,LK,Czech Republic,2115,1724,13,3,391,193,185,378,10
2025-04-09,LK,Czech Republic,2177,1765,20,6,412,199,193,392,14
2025-04-10,LK,Czech Republic,2203,1749,17,7,454,218,219,437,10
2025-04-11,LK,Czech Republic,2306,1828,18,10,478,231,229,460,8
2025-04-12,LK,Czech Republic,2227,1842,20,10,385,177,188,365,10
2025-04-13,LK,Czech Republic,2156,1741,10,6,415,194,211,405,4
2025-04-14,LK,Czech Republic,2224,1799,19,10,425,205,201,406,9
2025-04-15,LK,Czech Republic,2139,1724,27,10,415,194,194,388,17
2025-04-16,LK,Czech Republic,2283,1842,28,8,441,207,206,413,20
2025-04-17,LK,Czech Republic,2386,1923,14,4,463,231,218,449,10
2025-04-18,LK,Czech Republic,2320,1904,8,3,416,207,201,408,5
2025-04-19,LK,Czech Republic,2180,1829,15,10,351,171,165,336,5
2025-04-20,LK,Czech Republic,2202,1784,17,5,418,192,209,401,12
2025-04-21,LK,Czech Republic,2270,1828,11,1,442,206,225,431,10
2025-04-22,LK,Czech Republic,2194,1783,16,6,411,200,195,395,10
2025-04-23,LK,Czech Republic,2243,1812,19,7,431,207,205,412,12
2025-04-24,LK,Czech Republic,2305,1881,9,4,424,203,212,415,5
2025-04-25,LK,Czech Republic,2407,1947,16,4,460,224,220,444,12
2025-04-26,LK,Czech Republic,2294,1916,21,8,378,184,173,357,13
2025-04-27,LK,Czech Republic,2447,1983,17,12,464,216,231,447,5
2025-04-28,LK,Czech Republic,2302,1868,24,7,434,203,207,410,17
2025-04-29,LK,Czech Republic,2197,1797,16,6,400,192,192,384,10
2025-04-30,LK,Czech Republic,2313,1839,29,9,474,224,221,445,20
2025-05-01,LK,Czech Republic,2310,1865,16,8,445,226,203,429,8
2025-05-02,LK,Czech Republic,2270,1810,22,11,460,218,220,438,11
2025-05-03,LK,Czech Republic,2307,1952,10,5,355,172,173,345,5
2025-05-04,LK,Czech Republic,2523,2054,8,2,469,217,244,461,6
2025-05-05,LK,Czech Republic,2369,1917,11,8,452,225,216,441,3
2025-05-06,LK,Czech Republic,2292,1881,21,10,411,191,199,390,11
2025-05-07,LK,Czech Republic,2336,1874,24,8,462,227,211,438,16
2025-05-08,LK,Czech Republic,2389,1930,14,7,459,229,216,445,7
2025-05-09,LK,Czech Republic,2500,2029,16,6,471,230,225,455,10
2025-05-10,LK,Czech Republic,2345,1974,11,4,371,180,180,360,7
2025-05-11,LK,Czech Republic,2467,1966,23,5,501,226,252,478,18
2025-05-12,LK,Czech Republic,2407,1938,14,8,469,228,227,455,6
2025-05-13,LK,Czech Republic,2266,1837,29,15,429,198,202,400,14
2025-05-14,LK,Czech Republic,2339,1881,27,8,458,220,211,431,19
2025-05-15,LK,Czech Republic,2513,2018,26,4,495,237,232,469,22
2025-05-16,LK,Czech Republic,2522,2020,20,4,502,236,246,482,16
2025-05-17,LK,Czech Republic,2502,2095,13,4,407,198,196,394,9
2025-05-18,LK,Czech Republic,2559,2070,6,3,489,238,245,483,3
2025-05-19,LK,Czech Republic,2439,1980,19,8,459,226,214,440,11
2025-05-20,LK,Czech Republic,2270,1852,24,11,418,198,196,394,13
2025-05-21,LK,Czech Republic,2447,1963,31,8,484,228,225,453,23
2025-05-22,LK,Czech Republic,2489,1982,22,4,507,239,246,485,18
2025-05-23,LK,Czech Republic,2578,2050,28,14,528,253,247,500,14
2025-05-24,LK,Czech Republic,2525,2112,17,4,413,199,197,396,13
2025-05-25,LK,Czech Republic,2616,2110,19,12,506,231,256,487,7
2025-05-26,LK,Czech Republic,2516,2027,16,5,489,236,237,473,11
2025-05-27,LK,Czech Republic,2382,1913,25,9,469,223,221,444,16
2025-05-28,LK,Czech Republic,2645,2119,20,4,526,253,253,506,16
2025-05-29,LK,Czech Republic,2577,2045,23,13,532,257,252,509,10
2025-05-30,LK,Czech Republic,2540,1989,24,9,551,268,259,527,15
2025-05-31,LK,Czech Republic,2675,2224,5,2,451,224,222,446,3
2025-06-01,LK,Czech Republic,2789,2237,14,5,552,264,274,538,9
2025-06-02,LK,Czech Republic,2775,2222,17,10,553,268,268,536,7
2025-06-03,LK,Czech Republic,2539,2051,30,7,488,233,225,458,23
2025-06-04,LK,Czech Republic,2642,2065,28,13,577,269,280,549,15
2025-06-05,LK,Czech Republic,2677,2089,23,10,588,293,272,565,13
2025-06-06,LK,Czech Republic,2761,2136,21,8,625,306,298,604,13
2025-06-07,LK,Czech Republic,2528,2069,9,1,459,221,229,450,8
2025-06-08,LK,Czech Republic,2726,2158,9,1,568,270,289,559,8
2025-06-09,LK,Czech Republic,2637,2039,17,6,598,293,288,581,11
2025-06-10,LK,Czech Republic,2498,1965,18,5,533,257,258,515,13
2025-06-11,LK,Czech Republic,2580,2011,29,11,569,268,272,540,18
2025-06-12,LK,Czech Republic,2704,2099,23,7,605,298,284,582,16
2025-06-13,LK,Czech Republic,2682,2047,31,12,635,297,307,604,19
2025-06-14,LK,Czech Republic,2592,2060,19,10,532,258,255,513,9
2025-06-15,LK,Czech Republic,2735,2151,19,8,584,271,294,565,11
2025-06-16,LK,Czech Republic,2677,2102,16,9,575,289,270,559,7
2025-06-17,LK,Czech Republic,2475,1930,23,10,545,262,260,522,13
2025-06-18,LK,Czech Republic,2564,2003,24,11,561,270,267,537,13
2025-06-19,LK,Czech Republic,2606,2014,23,12,592,286,283,569,11
2025-06-20,LK,Czech Republic,2663,2049,24,9,614,299,291,590,15
2025-06-21,LK,Czech Republic,2627,2086,11,2,541,261,269,530,9
2025-06-22,LK,Czech Republic,2658,2067,14,9,591,285,292,577,5
2025-06-23,LK,Czech Republic,2795,2252,15,6,543,266,262,528,9
2025-06-24,LK,Czech Republic,2525,1937,36,13,588,275,277,552,23
2025-06-25,LK,Czech Republic,2652,2059,39,18,593,277,277,554,21
2025-06-26,LK,Czech Republic,2872,2292,25,10,580,281,274,555,15
2025-06-27,LK,Czech Republic,2876,2242,27,9,634,302,305,607,18
2025-06-28,LK,Czech Republic,2767,2214,19,8,553,267,267,534,11
2025-06-29,LK,Czech Republic,2787,2190,19,4,597,293,285,578,15
2025-06-30,LK,Czech Republic,2821,2251,23,15,570,274,273,547,8
2025-07-01,LK,Czech Republic,2741,2191,27,11,550,268,255,523,16
2025-07-02,LK,Czech Republic,2836,2267,25,9,569,267,277,544,16
2025-07-03,LK,Czech Republic,2984,2407,26,5,577,284,267,551,21
2025-07-04,LK,Czech Republic,2889,2295,34,11,594,276,284,560,23
2025-07-05,LK,Czech Republic,2778,2245,16,7,533,253,264,517,9
2025-07-06,LK,Czech Republic,2952,2342,19,5,610,280,311,591,14
2025-07-07,LK,Czech Republic,2964,2359,29,9,605,295,281,576,20
2025-07-08,LK,Czech Republic,2797,2261,21,3,536,262,253,515,18
2025-07-09,LK,Czech Republic,2933,2360,24,11,573,274,275,549,13
2025-07-10,LK,Czech Republic,2952,2355,34,12,597,292,271,563,22
2025-07-11,LK,Czech Republic,2995,2393,24,13,602,291,287,578,11
2025-07-12,LK,Czech Republic,2869,2326,9,3,543,260,274,534,6
2025-07-13,LK,Czech Republic,3017,2402,21,8,615,292,302,594,13
2025-07-14,LK,Czech Republic,2960,2381,31,9,579,275,273,548,22
2025-07-15,LK,Czech Republic,2798,2261,27,7,537,255,255,510,20
2025-07-16,LK,Czech Republic,2912,2345,24,8,567,263,280,543,16
2025-07-17,LK,Czech Republic,2974,2378,26,7,596,297,273,570,19
2025-07-18,LK,Czech Republic,2990,2359,32,7,631,301,298,599,25
2025-07-19,LK,Czech Republic,2926,2398,16,6,528,257,255,512,10
2025-07-20,LK,Czech Republic,2999,2384,27,16,615,288,300,588,11
2025-07-21,LK,Czech Republic,2953,2378,21,4,575,280,274,554,17
2025-07-22,LK,Czech Republic,2846,2287,23,11,559,273,263,536,12
2025-07-23,LK,Czech Republic,2891,2315,22,6,576,270,284,554,16
2025-07-24,LK,Czech Republic,3022,2436,31,13,586,284,271,555,18
2025-07-25,LK,Czech Republic,3021,2443,15,7,578,282,281,563,8
2025-07-26,LK,Czech Republic,3007,2473,17,4,534,256,261,517,13
2025-07-27,LK,Czech Republic,3050,2460,21,7,590,278,291,569,14
2025-07-28,LK,Czech Republic,3117,2567,18,8,550,269,263,532,10
2025-07-29,LK,Czech Republic,2835,2305,21,14,530,256,253,509,7
2025-07-30,LK,Czech Republic,2887,2341,20,7,546,264,262,526,13
2025-07-31,LK,Czech Republic,2894,2327,28,16,567,270,269,539,12
2025-08-01,LK,Czech Republic,3003,2438,20,7,565,274,271,545,13
2025-08-02,LK,Czech Republic,3016,2499,6,4,517,250,261,511,2
2025-08-03,LK,Czech Republic,3031,2451,11,6,580,280,289,569,5
2025-08-04,LK,Czech Republic,2867,2299,29,14,568,267,272,539,15
2025-08-05,LK,Czech Republic,2752,2235,18,10,517,247,252,499,8
2025-08-06,LK,Czech Republic,2853,2285,25,10,568,268,275,543,15
2025-08-07,LK,Czech Republic,2841,2256,32,13,585,284,269,553,19
2025-08-08,LK,Czech Republic,2841,2253,28,10,588,288,272,560,18
2025-08-09,LK,Czech Republic,2806,2267,20,11,539,259,260,519,9
2025-08-10,LK,Czech Republic,2897,2318,15,8,579,277,287,564,7
2025-08-11,LK,Czech Republic,2808,2227,26,9,581,274,281,555,17
2025-08-12,LK,Czech Republic,2606,2064,35,13,542,256,251,507,22
2025-08-13,LK,Czech Republic,2724,2153,32,12,571,273,266,539,20
2025-08-14,LK,Czech Republic,2759,2206,29,14,553,268,256,524,15
2025-08-15,LK,Czech Republic,2939,2355,28,11,584,273,283,556,17
2025-08-16,LK,Czech Republic,3025,2495,16,8,530,259,255,514,8
2025-08-17,LK,Czech Republic,2898,2299,22,10,599,282,295,577,12
2025-08-18,LK,Czech Republic,2874,2293,25,12,581,277,279,556,13
2025-08-19,LK,Czech Republic,2713,2187,24,13,526,250,252,502,11
2025-08-20,LK,Czech Republic,2846,2295,26,13,551,266,259,525,13
2025-08-21,LK,Czech Republic,2884,2332,19,8,552,269,264,533,11
2025-08-22,LK,Czech Republic,2816,2205,28,12,611,296,287,583,16
2025-08-23,LK,Czech Republic,2805,2300,15,10,505,242,248,490,5
2025-08-24,LK,Czech Republic,2895,2325,13,3,570,275,282,557,10
2025-08-25,LK,Czech Republic,2817,2279,15,8,538,263,260,523,7
2025-08-26,LK,Czech Republic,2726,2194,26,13,532,253,253,506,13
2025-08-27,LK,Czech Republic,2757,2193,22,12,564,271,271,542,10
2025-08-28,LK,Czech Republic,2905,2313,25,10,592,286,281,567,15
2025-08-29,LK,Czech Republic,2925,2343,19,5,582,281,282,563,14
2025-01-01,EK,Denmark,1115,594,45,1,521,238,238,476,44
2025-01-02,EK,Denmark,1485,758,72,15,727,328,327,655,57
2025-01-03,EK,Denmark,1530,767,59,5,763,355,349,704,54
2025-01-04,EK,Denmark,1425,783,40,7,642,303,299,602,33
2025-01-05,EK,Denmark,1489,783,49,3,706,326,331,657,46
2025-01-06,EK,Denmark,1480,711,72,4,769,355,342,697,68
2025-01-07,EK,Denmark,1303,682,59,3,621,281,281,562,56
2025-01-08,EK,Denmark,1260,645,76,6,615,268,271,539,70
2025-01-09,EK,Denmark,1315,640,76,5,675,302,297,599,71
2025-01-10,EK,Denmark,1479,724,77,8,755,332,346,678,69
2025-01-11,EK,Denmark,1275,703,27,3,572,271,274,545,24
2025-01-12,EK,Denmark,1339,665,49,5,674,310,315,625,44
2025-01-13,EK,Denmark,1409,643,83,9,766,347,336,683,74
2025-01-14,EK,Denmark,1167,558,84,13,609,261,264,525,71
2025-01-15,EK,Denmark,1145,522,86,6,623,264,273,537,80
2025-01-16,EK,Denmark,1290,606,90,12,684,300,294,594,78
2025-01-17,EK,Denmark,1457,685,94,7,772,338,340,678,87
2025-01-18,EK,Denmark,1193,629,29,3,564,266,269,535,26
2025-01-19,EK,Denmark,1316,653,43,0,663,307,313,620,43
2025-01-20,EK,Denmark,1398,652,73,6,746,343,330,673,67
2025-01-21,EK,Denmark,1184,586,76,4,598,259,263,522,72
2025-01-22,EK,Denmark,1314,662,88,5,652,279,285,564,83
2025-01-23,EK,Denmark,1379,653,95,2,726,319,312,631,93
2025-01-24,EK,Denmark,1484,723,88,6,761,336,337,673,82
2025-01-25,EK,Denmark,1292,690,38,7,602,281,283,564,31
2025-01-26,EK,Denmark,1415,727,50,2,688,315,323,638,48
2025-01-27,EK,Denmark,1498,716,86,5,782,353,343,696,81
2025-01-28,EK,Denmark,1242,589,98,18,653,276,279,555,80
2025-01-29,EK,Denmark,1330,659,98,10,671,286,287,573,88
2025-01-30,EK,Denmark,1373,648,91,11,725,319,315,634,80
2025-01-31,EK,Denmark,1517,719,80,5,798,360,358,718,75
2025-02-01,EK,Denmark,1322,716,33,1,606,284,289,573,32
2025-02-02,EK,Denmark,1420,707,54,4,713,323,336,659,50
2025-02-03,EK,Denmark,1474,685,73,6,789,364,352,716,67
2025-02-04,EK,Denmark,1272,601,98,12,671,285,288,573,86
2025-02-05,EK,Denmark,1329,626,97,14,703,301,305,606,83
2025-02-06,EK,Denmark,1383,627,89,16,756,338,329,667,73
2025-02-07,EK,Denmark,1560,722,82,1,838,377,379,756,81
2025-02-08,EK,Denmark,1414,752,28,1,662,318,316,634,27
2025-02-09,EK,Denmark,1461,731,44,2,730,346,340,686,42
2025-02-10,EK,Denmark,1425,670,61,4,755,350,344,694,57
2025-02-11,EK,Denmark,1291,633,58,8,658,301,299,600,50
2025-02-12,EK,Denmark,1367,681,59,3,686,312,315,627,56
2025-02-13,EK,Denmark,1377,667,55,0,710,328,327,655,55
2025-02-14,EK,Denmark,1601,754,76,15,847,380,391,771,61
2025-02-15,EK,Denmark,1478,788,22,0,690,329,339,668,22
2025-02-16,EK,Denmark,1511,731,63,4,780,355,362,717,59
2025-02-17,EK,Denmark,1544,710,73,6,834,385,376,761,67
2025-02-18,EK,Denmark,1334,630,78,13,704,314,312,626,65
2025-02-19,EK,Denmark,1472,701,99,24,771,334,338,672,75
2025-02-20,EK,Denmark,1516,709,95,13,807,359,353,712,82
2025-02-21,EK,Denmark,1586,763,76,3,823,375,372,747,73
2025-02-22,EK,Denmark,1495,816,38,7,679,318,323,641,31
2025-02-23,EK,Denmark,1549,809,51,2,740,342,347,689,49
2025-02-24,EK,Denmark,1559,702,103,11,857,377,377,754,92
2025-02-25,EK,Denmark,1361,655,93,8,706,305,308,613,85
2025-02-26,EK,Denmark,1411,684,82,6,727,326,319,645,76
2025-02-27,EK,Denmark,1468,693,94,8,775,340,341,681,86
2025-02-28,EK,Denmark,1571,724,102,8,847,371,374,745,94
2025-03-01,EK,Denmark,1451,809,35,4,642,302,305,607,31
2025-03-02,EK,Denmark,1542,793,63,14,749,338,348,686,49
2025-03-03,EK,Denmark,1613,727,105,21,886,398,383,781,84
2025-03-04,EK,Denmark,1417,674,94,11,743,321,328,649,83
2025-03-05,EK,Denmark,1475,689,106,18,786,339,341,680,88
2025-03-06,EK,Denmark,1551,723,112,14,828,357,359,716,98
2025-03-07,EK,Denmark,1642,767,93,13,875,393,389,782,80
2025-03-08,EK,Denmark,1390,742,37,9,648,306,305,611,28
2025-03-09,EK,Denmark,1500,733,60,5,767,349,358,707,55
2025-03-10,EK,Denmark,1506,671,115,28,835,367,353,720,87
2025-03-11,EK,Denmark,1438,672,112,12,766,323,331,654,100
2025-03-12,EK,Denmark,1452,689,85,6,763,338,340,678,79
2025-03-13,EK,Denmark,1527,721,89,12,806,359,358,717,77
2025-03-14,EK,Denmark,1618,735,96,9,883,395,392,787,87
2025-03-15,EK,Denmark,1392,747,42,3,645,302,301,603,39
2025-03-16,EK,Denmark,1513,765,54,3,748,349,345,694,51
2025-03-17,EK,Denmark,1597,716,94,20,881,398,389,787,74
2025-03-18,EK,Denmark,1371,640,90,8,731,319,322,641,82
2025-03-19,EK,Denmark,1425,674,92,13,751,326,333,659,79
2025-03-20,EK,Denmark,1552,711,99,12,841,370,372,742,87
2025-03-21,EK,Denmark,1562,708,96,16,854,379,379,758,80
2025-03-22,EK,Denmark,1316,718,30,4,598,281,287,568,26
2025-03-23,EK,Denmark,1494,734,60,7,760,348,352,700,53
2025-03-24,EK,Denmark,1608,717,101,17,891,398,392,790,84
2025-03-25,EK,Denmark,1385,635,94,10,750,326,330,656,84
2025-03-26,EK,Denmark,1492,684,109,15,808,348,351,699,94
2025-03-27,EK,Denmark,1535,710,97,12,825,365,363,728,85
2025-03-28,EK,Denmark,1702,789,117,20,913,394,402,796,97
2025-03-29,EK,Denmark,1341,728,37,2,613,287,289,576,35
2025-03-30,EK,Denmark,1559,717,69,2,842,384,389,773,67
2025-03-31,EK,Denmark,1675,710,119,19,965,425,421,846,100
2025-04-01,EK,Denmark,1545,689,95,12,856,378,383,761,83
2025-04-02,EK,Denmark,1623,705,108,20,918,407,403,810,88
2025-04-03,EK,Denmark,1717,743,113,14,974,428,433,861,99
2025-04-04,EK,Denmark,1681,704,112,17,977,435,430,865,95
2025-04-05,EK,Denmark,1426,712,54,8,714,327,333,660,46
2025-04-06,EK,Denmark,1688,802,74,7,886,400,412,812,67
2025-04-07,EK,Denmark,1745,745,113,11,1000,458,429,887,102
2025-04-08,EK,Denmark,1596,718,113,19,878,382,383,765,94
2025-04-09,EK,Denmark,1609,688,103,12,921,404,414,818,91
2025-04-10,EK,Denmark,1761,773,125,20,988,433,430,863,105
2025-04-11,EK,Denmark,1774,740,122,13,1034,461,451,912,109
2025-04-12,EK,Denmark,1460,705,56,9,755,345,354,699,47
2025-04-13,EK,Denmark,1737,826,82,4,911,409,420,829,78
2025-04-14,EK,Denmark,1737,777,93,11,960,439,428,867,82
2025-04-15,EK,Denmark,1595,731,85,15,864,392,387,779,70
2025-04-16,EK,Denmark,1672,766,98,13,906,404,404,808,85
2025-04-17,EK,Denmark,1693,810,79,4,883,400,404,804,75
2025-04-18,EK,Denmark,1586,771,68,4,815,371,376,747,64
2025-04-19,EK,Denmark,1477,770,52,0,707,326,329,655,52
2025-04-20,EK,Denmark,1568,743,67,4,825,382,376,758,63
2025-04-21,EK,Denmark,1633,724,88,11,909,409,412,821,77
2025-04-22,EK,Denmark,1644,718,116,13,926,409,401,810,103
2025-04-23,EK,Denmark,1674,720,109,15,954,420,425,845,94
2025-04-24,EK,Denmark,1748,751,122,22,997,439,436,875,100
2025-04-25,EK,Denmark,1735,724,114,15,1011,446,451,897,99
2025-04-26,EK,Denmark,1458,725,53,3,733,337,343,680,50
2025-04-27,EK,Denmark,1646,745,72,5,901,411,418,829,67
2025-04-28,EK,Denmark,1684,709,102,10,975,438,435,873,92
2025-04-29,EK,Denmark,1626,681,109,14,945,421,415,836,95
2025-04-30,EK,Denmark,1715,753,114,16,962,427,421,848,98
2025-05-01,EK,Denmark,1703,779,102,17,924,410,412,822,85
2025-05-02,EK,Denmark,1672,709,117,8,963,417,429,846,109
2025-05-03,EK,Denmark,1447,695,47,2,752,349,356,705,45
2025-05-04,EK,Denmark,1679,774,69,5,905,420,416,836,64
2025-05-05,EK,Denmark,1672,704,112,17,968,430,426,856,95
2025-05-06,EK,Denmark,1627,681,111,16,946,418,417,835,95
2025-05-07,EK,Denmark,1694,730,116,23,964,425,423,848,93
2025-05-08,EK,Denmark,1809,797,108,12,1012,455,449,904,96
2025-05-09,EK,Denmark,1791,752,123,14,1039,454,462,916,109
2025-05-10,EK,Denmark,1486,714,54,6,772,358,360,718,48
2025-05-11,EK,Denmark,1687,762,67,2,925,430,428,858,65
2025-05-12,EK,Denmark,1740,728,99,13,1012,453,460,913,86
2025-05-13,EK,Denmark,1647,675,104,12,972,437,431,868,92
2025-05-14,EK,Denmark,1636,672,100,10,964,435,429,864,90
2025-05-15,EK,Denmark,1785,756,128,10,1029,453,448,901,118
2025-05-16,EK,Denmark,1736,714,118,14,1022,448,456,904,104
2025-05-17,EK,Denmark,1529,727,57,7,802,371,374,745,50
2025-05-18,EK,Denmark,1745,806,76,5,939,429,434,863,71
2025-05-19,EK,Denmark,1769,754,114,18,1015,457,444,901,96
2025-05-20,EK,Denmark,1721,742,126,18,979,426,427,853,108
2025-05-21,EK,Denmark,1743,751,122,19,992,438,432,870,103
2025-05-22,EK,Denmark,1832,827,110,7,1005,448,447,895,103
2025-05-23,EK,Denmark,1825,798,114,10,1027,454,459,913,104
2025-05-24,EK,Denmark,1589,787,46,2,802,374,382,756,44
2025-05-25,EK,Denmark,1816,854,75,1,962,440,447,887,74
2025-05-26,EK,Denmark,1884,851,124,14,1033,465,444,909,110
2025-05-27,EK,Denmark,1752,792,121,16,960,413,426,839,105
2025-05-28,EK,Denmark,1886,879,130,26,1007,443,434,877,104
2025-05-29,EK,Denmark,1689,775,73,4,914,424,417,841,69
2025-05-30,EK,Denmark,1637,713,82,7,924,414,428,842,75
2025-05-31,EK,Denmark,1571,758,51,1,813,380,382,762,50
2025-06-01,EK,Denmark,1831,881,70,0,950,435,445,880,70
2025-06-02,EK,Denmark,1858,834,101,10,1024,467,456,923,91
2025-06-03,EK,Denmark,1813,823,112,19,990,437,441,878,93
2025-06-04,EK,Denmark,1780,765,139,12,1015,439,437,876,127
2025-06-05,EK,Denmark,1845,845,114,9,1000,441,445,886,105
2025-06-06,EK,Denmark,1839,804,103,9,1035,468,464,932,94
2025-06-07,EK,Denmark,1642,786,55,7,856,394,407,801,48
2025-06-08,EK,Denmark,1800,846,71,1,954,444,439,883,70
2025-06-09,EK,Denmark,1792,819,77,9,973,448,448,896,68
2025-06-10,EK,Denmark,1745,771,110,4,974,428,436,864,106
2025-06-11,EK,Denmark,1868,826,155,17,1042,444,443,887,138
2025-06-12,EK,Denmark,1967,879,157,18,1088,468,463,931,139
2025-06-13,EK,Denmark,1917,813,163,12,1104,477,464,941,151
2025-06-14,EK,Denmark,1672,755,106,6,917,399,412,811,100
2025-06-15,EK,Denmark,1912,908,83,2,1004,457,464,921,81
2025-06-16,EK,Denmark,1909,839,116,13,1070,483,471,954,103
2025-06-17,EK,Denmark,1814,797,120,10,1017,453,444,897,110
2025-06-18,EK,Denmark,1827,793,121,10,1034,449,464,913,111
2025-06-19,EK,Denmark,1868,814,117,11,1054,468,469,937,106
2025-06-20,EK,Denmark,1878,784,121,17,1094,486,487,973,104
2025-06-21,EK,Denmark,1637,771,48,7,866,410,408,818,41
2025-06-22,EK,Denmark,1851,865,79,4,986,456,451,907,75
2025-06-23,EK,Denmark,1915,885,96,10,1030,470,464,934,86
2025-06-24,EK,Denmark,1817,807,121,10,1010,439,450,889,111
2025-06-25,EK,Denmark,1779,760,123,14,1019,451,445,896,109
2025-06-26,EK,Denmark,1969,909,125,22,1060,466,469,935,103
2025-06-27,EK,Denmark,1909,876,98,9,1033,463,472,935,89
2025-06-28,EK,Denmark,1721,845,37,0,876,421,418,839,37
2025-06-29,EK,Denmark,1849,881,60,5,968,453,455,908,55
2025-06-30,EK,Denmark,1895,892,85,14,1003,463,455,918,71
2025-07-01,EK,Denmark,1865,880,98,12,985,442,445,887,86
2025-07-02,EK,Denmark,1815,855,93,18,960,436,431,867,75
2025-07-03,EK,Denmark,1888,885,109,15,1003,451,443,894,94
2025-07-04,EK,Denmark,1852,867,81,6,985,451,453,904,75
2025-07-05,EK,Denmark,1695,854,41,0,841,404,396,800,41
2025-07-06,EK,Denmark,1833,921,57,0,912,420,435,855,57
2025-07-07,EK,Denmark,1866,872,93,5,994,453,448,901,88
2025-07-08,EK,Denmark,1790,854,105,18,936,413,418,831,87
2025-07-09,EK,Denmark,1817,836,102,17,981,440,439,879,85
2025-07-10,EK,Denmark,1890,902,94,21,988,445,449,894,73
2025-07-11,EK,Denmark,1893,905,86,11,988,452,450,902,75
2025-07-12,EK,Denmark,1723,840,53,6,883,417,413,830,47
2025-07-13,EK,Denmark,1806,869,59,2,937,436,442,878,57
2025-07-14,EK,Denmark,1857,884,87,10,973,443,443,886,77
2025-07-15,EK,Denmark,1820,890,90,8,930,419,421,840,82
2025-07-16,EK,Denmark,1877,919,88,11,958,441,429,870,77
2025-07-17,EK,Denmark,1942,951,102,12,991,443,446,889,90
2025-07-18,EK,Denmark,1893,908,90,7,985,446,449,895,83
2025-07-19,EK,Denmark,1708,852,47,4,856,403,406,809,43
2025-07-20,EK,Denmark,1832,901,56,1,931,436,439,875,55
2025-07-21,EK,Denmark,1918,921,84,4,997,459,454,913,80
2025-07-22,EK,Denmark,1835,914,86,9,921,415,420,835,77
2025-07-23,EK,Denmark,1841,882,87,11,959,438,434,872,76
2025-07-24,EK,Denmark,1907,913,95,11,994,450,449,899,84
2025-07-25,EK,Denmark,1849,841,96,13,1008,456,456,912,83
2025-07-26,EK,Denmark,1724,846,43,4,878,421,414,835,39
2025-07-27,EK,Denmark,1855,917,62,6,938,437,439,876,56
2025-07-28,EK,Denmark,1966,951,91,16,1015,462,462,924,75
2025-07-29,EK,Denmark,1784,848,90,13,936,421,425,846,77
2025-07-30,EK,Denmark,1885,910,88,15,975,447,440,887,73
2025-07-31,EK,Denmark,1937,937,104,13,1000,450,446,896,91
2025-08-01,EK,Denmark,1852,887,86,5,965,439,440,879,81
2025-08-02,EK,Denmark,1726,872,42,2,854,405,407,812,40
2025-08-03,EK,Denmark,1900,961,65,2,939,435,439,874,63
2025-08-04,EK,Denmark,1914,911,104,23,1003,453,446,899,81
2025-08-05,EK,Denmark,1795,884,86,14,911,411,414,825,72
2025-08-06,EK,Denmark,1836,889,96,9,947,422,429,851,87
2025-08-07,EK,Denmark,1917,929,100,15,988,449,439,888,85
2025-08-08,EK,Denmark,1872,852,104,13,1020,453,463,916,91
2025-08-09,EK,Denmark,1715,845,36,3,870,412,422,834,33
2025-08-10,EK,Denmark,1830,877,59,6,953,446,448,894,53
2025-08-11,EK,Denmark,1890,845,100,18,1045,477,468,945,82
2025-08-12,EK,Denmark,1764,794,107,19,970,431,432,863,88
2025-08-13,EK,Denmark,1819,836,107,19,983,440,436,876,88
2025-08-14,EK,Denmark,1882,871,104,14,1011,457,450,907,90
2025-08-15,EK,Denmark,1895,862,112,17,1033,460,461,921,95
2025-08-16,EK,Denmark,1649,801,46,1,848,401,401,802,45
2025-08-17,EK,Denmark,1781,843,64,1,938,436,438,874,63
2025-08-18,EK,Denmark,1822,759,109,20,1063,480,474,954,89
2025-08-19,EK,Denmark,1741,739,127,22,1002,434,441,875,105
2025-08-20,EK,Denmark,1780,767,107,17,1013,454,452,906,90
2025-08-21,EK,Denmark,1852,821,117,22,1031,458,456,914,95
2025-08-22,EK,Denmark,1810,762,109,16,1048,459,480,939,93
2025-08-23,EK,Denmark,1652,790,45,4,862,410,407,817,41
2025-08-24,EK,Denmark,1856,875,74,2,981,458,449,907,72
2025-08-25,EK,Denmark,1825,766,94,5,1059,489,476,965,89
2025-08-26,EK,Denmark,1779,802,110,13,977,431,436,867,97
2025-08-27,EK,Denmark,1884,877,102,7,1007,452,453,905,95
2025-08-28,EK,Denmark,1979,915,118,18,1064,475,471,946,100
2025-08-29,EK,Denmark,1937,855,100,3,1082,493,489,982,97
2025-01-01,EE,Estonia,347,276,10,2,71,28,33,61,8
2025-01-02,EE,Estonia,453,360,9,1,93,41,43,84,8
2025-01-03,EE,Estonia,421,328,8,2,93,43,42,85,6
2025-01-04,EE,Estonia,434,352,5,1,82,38,39,77,4
2025-01-05,EE,Estonia,458,355,4,0,103,48,51,99,4
2025-01-06,EE,Estonia,438,331,9,1,107,50,48,98,8
2025-01-07,EE,Estonia,385,312,7,1,73,33,33,66,6
2025-01-08,EE,Estonia,392,302,9,1,90,41,40,81,8
2025-01-09,EE,Estonia,407,324,10,2,83,35,38,73,8
2025-01-10,EE,Estonia,390,307,7,1,83,38,38,76,6
2025-01-11,EE,Estonia,401,324,4,1,77,37,36,73,3
2025-01-12,EE,Estonia,409,308,4,0,101,47,50,97,4
2025-01-13,EE,Estonia,428,327,9,1,101,46,46,92,8
2025-01-14,EE,Estonia,358,275,8,0,83,38,37,75,8
2025-01-15,EE,Estonia,369,275,8,0,94,43,43,86,8
2025-01-16,EE,Estonia,399,312,9,1,87,39,39,78,8
2025-01-17,EE,Estonia,404,304,8,2,100,47,45,92,6
2025-01-18,EE,Estonia,411,334,7,3,77,36,34,70,4
2025-01-19,EE,Estonia,431,325,5,1,106,49,52,101,4
2025-01-20,EE,Estonia,413,306,15,5,107,47,45,92,10
2025-01-21,EE,Estonia,336,251,10,2,85,37,38,75,8
2025-01-22,EE,Estonia,350,260,10,2,90,41,39,80,8
2025-01-23,EE,Estonia,372,287,9,1,85,37,39,76,8
2025-01-24,EE,Estonia,392,288,9,1,104,50,45,95,8
2025-01-25,EE,Estonia,380,309,5,1,71,33,33,66,4
2025-01-26,EE,Estonia,399,299,4,0,100,46,50,96,4
2025-01-27,EE,Estonia,381,279,11,3,102,46,45,91,8
2025-01-28,EE,Estonia,309,231,7,3,78,35,36,71,4
2025-01-29,EE,Estonia,349,246,11,3,103,45,47,92,8
2025-01-30,EE,Estonia,362,275,10,2,87,40,37,77,8
2025-01-31,EE,Estonia,374,269,11,3,105,48,46,94,8
2025-02-01,EE,Estonia,363,286,6,2,77,36,35,71,4
2025-02-02,EE,Estonia,387,287,4,0,100,46,50,96,4
2025-02-03,EE,Estonia,376,275,9,1,101,46,46,92,8
2025-02-04,EE,Estonia,358,265,9,1,93,41,43,84,8
2025-02-05,EE,Estonia,364,264,10,2,100,48,42,90,8
2025-02-06,EE,Estonia,384,298,10,1,86,37,39,76,9
2025-02-07,EE,Estonia,396,277,15,7,119,52,52,104,8
2025-02-08,EE,Estonia,375,301,6,2,74,34,34,68,4
2025-02-09,EE,Estonia,420,308,5,1,112,52,55,107,4
2025-02-10,EE,Estonia,388,283,12,4,105,47,46,93,8
2025-02-11,EE,Estonia,335,253,7,3,82,37,38,75,4
2025-02-12,EE,Estonia,365,270,14,4,95,40,41,81,10
2025-02-13,EE,Estonia,379,291,10,2,88,39,39,78,8
2025-02-14,EE,Estonia,397,287,9,1,110,50,51,101,8
2025-02-15,EE,Estonia,381,305,6,2,76,38,32,70,4
2025-02-16,EE,Estonia,398,297,4,0,101,45,52,97,4
2025-02-17,EE,Estonia,392,282,11,2,110,50,49,99,9
2025-02-18,EE,Estonia,338,254,10,2,84,37,37,74,8
2025-02-19,EE,Estonia,357,250,14,5,107,46,47,93,9
2025-02-20,EE,Estonia,420,317,13,5,103,47,43,90,8
2025-02-21,EE,Estonia,410,289,11,3,121,54,56,110,8
2025-02-22,EE,Estonia,396,316,5,1,80,39,36,75,4
2025-02-23,EE,Estonia,419,318,5,1,101,48,48,96,4
2025-02-24,EE,Estonia,381,274,10,2,107,47,50,97,8
2025-02-25,EE,Estonia,348,251,10,0,97,45,42,87,10
2025-02-26,EE,Estonia,351,256,8,1,95,43,44,87,7
2025-02-27,EE,Estonia,373,280,7,0,93,43,43,86,7
2025-02-28,EE,Estonia,410,298,10,2,112,52,50,102,8
2025-03-01,EE,Estonia,407,322,5,3,85,40,40,80,2
2025-03-02,EE,Estonia,433,325,4,0,108,50,54,104,4
2025-03-03,EE,Estonia,418,304,11,3,114,54,49,103,8
2025-03-04,EE,Estonia,355,256,11,3,99,44,44,88,8
2025-03-05,EE,Estonia,382,278,9,1,104,47,48,95,8
2025-03-06,EE,Estonia,407,300,10,2,107,46,51,97,8
2025-03-07,EE,Estonia,413,295,12,4,118,54,52,106,8
2025-03-08,EE,Estonia,392,310,8,2,82,36,38,74,6
2025-03-09,EE,Estonia,419,315,6,2,104,49,49,98,4
2025-03-10,EE,Estonia,380,271,11,2,109,49,49,98,9
2025-03-11,EE,Estonia,372,269,11,2,103,47,45,92,9
2025-03-12,EE,Estonia,370,266,10,2,104,47,47,94,8
2025-03-13,EE,Estonia,400,294,13,4,106,46,47,93,9
2025-03-14,EE,Estonia,421,300,12,2,121,54,55,109,10
2025-03-15,EE,Estonia,399,319,6,2,80,38,36,74,4
2025-03-16,EE,Estonia,407,305,4,0,102,47,51,98,4
2025-03-17,EE,Estonia,410,298,12,4,112,53,47,100,8
2025-03-18,EE,Estonia,376,273,12,4,103,45,46,91,8
2025-03-19,EE,Estonia,395,288,13,4,107,47,47,94,9
2025-03-20,EE,Estonia,415,308,10,2,107,47,50,97,8
2025-03-21,EE,Estonia,406,283,13,5,123,54,56,110,8
2025-03-22,EE,Estonia,405,326,7,3,79,37,35,72,4
2025-03-23,EE,Estonia,423,317,8,3,106,49,49,98,5
2025-03-24,EE,Estonia,413,307,10,2,106,48,48,96,8
2025-03-25,EE,Estonia,398,295,13,3,103,43,47,90,10
2025-03-26,EE,Estonia,393,278,13,4,115,52,50,102,9
2025-03-27,EE,Estonia,426,314,15,6,112,46,51,97,9
2025-03-28,EE,Estonia,443,328,9,1,115,54,52,106,8
2025-03-29,EE,Estonia,382,305,8,4,77,35,34,69,4
2025-03-30,EE,Estonia,432,323,7,3,109,49,53,102,4
2025-03-31,EE,Estonia,412,303,9,1,109,51,49,100,8
2025-04-01,EE,Estonia,422,303,12,3,119,54,53,107,9
2025-04-02,EE,Estonia,436,321,12,2,115,50,53,103,10
2025-04-03,EE,Estonia,464,335,12,2,129,58,59,117,10
2025-04-04,EE,Estonia,449,339,11,3,110,51,48,99,8
2025-04-05,EE,Estonia,428,339,4,0,89,42,43,85,4
2025-04-06,EE,Estonia,446,336,7,3,110,49,54,103,4
2025-04-07,EE,Estonia,435,325,9,1,110,52,49,101,8
2025-04-08,EE,Estonia,427,316,10,2,111,51,50,101,8
2025-04-09,EE,Estonia,439,321,11,0,118,53,54,107,11
2025-04-10,EE,Estonia,464,342,12,1,122,53,57,110,11
2025-04-11,EE,Estonia,465,344,8,0,121,55,58,113,8
2025-04-12,EE,Estonia,450,353,6,1,97,46,45,91,5
2025-04-13,EE,Estonia,466,354,7,3,112,54,51,105,4
2025-04-14,EE,Estonia,464,343,10,2,121,53,58,111,8
2025-04-15,EE,Estonia,461,330,12,4,131,60,59,119,8
2025-04-16,EE,Estonia,455,340,12,2,115,51,52,103,10
2025-04-17,EE,Estonia,476,350,11,3,126,58,57,115,8
2025-04-18,EE,Estonia,458,349,9,1,109,50,50,100,8
2025-04-19,EE,Estonia,443,360,5,1,83,39,39,78,4
2025-04-20,EE,Estonia,464,358,5,1,106,52,49,101,4
2025-04-21,EE,Estonia,446,336,12,2,110,49,49,98,10
2025-04-22,EE,Estonia,468,339,12,3,129,57,60,117,9
2025-04-23,EE,Estonia,459,336,14,2,123,56,53,109,12
2025-04-24,EE,Estonia,485,363,13,3,122,56,53,109,10
2025-04-25,EE,Estonia,492,372,11,2,120,54,55,109,9
2025-04-26,EE,Estonia,515,415,5,1,100,48,47,95,4
2025-04-27,EE,Estonia,522,410,4,0,112,53,55,108,4
2025-04-28,EE,Estonia,515,389,10,2,126,59,57,116,8
2025-04-29,EE,Estonia,487,369,8,0,118,55,55,110,8
2025-04-30,EE,Estonia,504,377,12,3,127,56,59,115,9
2025-05-01,EE,Estonia,517,400,12,2,117,54,51,105,10
2025-05-02,EE,Estonia,457,351,9,0,106,51,46,97,9
2025-05-03,EE,Estonia,512,412,4,0,100,46,50,96,4
2025-05-04,EE,Estonia,556,429,6,1,127,58,63,121,5
2025-05-05,EE,Estonia,484,363,11,3,121,57,53,110,8
2025-05-06,EE,Estonia,497,377,9,1,120,55,56,111,8
2025-05-07,EE,Estonia,498,381,9,1,117,55,53,108,8
2025-05-08,EE,Estonia,535,417,8,0,118,55,55,110,8
2025-05-09,EE,Estonia,528,402,10,2,126,59,57,116,8
2025-05-10,EE,Estonia,517,428,5,1,89,43,41,84,4
2025-05-11,EE,Estonia,558,436,6,2,122,57,59,116,4
2025-05-12,EE,Estonia,573,437,9,1,136,63,64,127,8
2025-05-13,EE,Estonia,523,397,11,2,126,59,56,115,9
2025-05-14,EE,Estonia,526,404,9,1,122,57,56,113,8
2025-05-15,EE,Estonia,552,420,13,4,132,56,63,119,9
2025-05-16,EE,Estonia,515,391,8,0,124,60,56,116,8
2025-05-17,EE,Estonia,549,443,4,0,106,53,49,102,4
2025-05-18,EE,Estonia,531,406,4,0,125,59,62,121,4
2025-05-19,EE,Estonia,518,381,10,2,137,63,64,127,8
2025-05-20,EE,Estonia,511,388,9,1,123,56,58,114,8
2025-05-21,EE,Estonia,516,385,9,1,131,60,62,122,8
2025-05-22,EE,Estonia,560,429,10,2,131,61,60,121,8
2025-05-23,EE,Estonia,557,422,11,3,135,65,59,124,8
2025-05-24,EE,Estonia,530,438,4,0,92,43,45,88,4
2025-05-25,EE,Estonia,539,418,6,2,121,58,57,115,4
2025-05-26,EE,Estonia,582,456,11,1,126,59,56,115,10
2025-05-27,EE,Estonia,531,413,8,0,118,54,56,110,8
2025-05-28,EE,Estonia,548,417,10,0,131,59,62,121,10
2025-05-29,EE,Estonia,566,433,14,1,133,59,60,119,13
2025-05-30,EE,Estonia,529,410,10,1,119,56,53,109,9
2025-05-31,EE,Estonia,569,469,5,1,100,45,50,95,4
2025-06-01,EE,Estonia,599,471,6,2,128,61,61,122,4
2025-06-02,EE,Estonia,534,414,9,0,120,57,54,111,9
2025-06-03,EE,Estonia,523,399,14,5,124,54,56,110,9
2025-06-04,EE,Estonia,521,397,10,2,124,56,58,114,8
2025-06-05,EE,Estonia,559,430,14,6,129,57,58,115,8
2025-06-06,EE,Estonia,558,428,12,3,130,61,57,118,9
2025-06-07,EE,Estonia,560,461,6,1,99,46,47,93,5
2025-06-08,EE,Estonia,568,438,6,2,130,60,64,124,4
2025-06-09,EE,Estonia,545,409,9,0,136,66,61,127,9
2025-06-10,EE,Estonia,539,415,10,1,124,56,58,114,9
2025-06-11,EE,Estonia,547,430,9,1,117,54,54,108,8
2025-06-12,EE,Estonia,547,428,10,2,119,55,54,109,8
2025-06-13,EE,Estonia,573,430,17,5,143,65,61,126,12
2025-06-14,EE,Estonia,552,454,5,1,98,44,49,93,4
2025-06-15,EE,Estonia,574,445,6,1,129,63,60,123,5
2025-06-16,EE,Estonia,562,433,9,0,129,58,62,120,9
2025-06-17,EE,Estonia,474,370,10,0,104,46,48,94,10
2025-06-18,EE,Estonia,544,415,11,1,129,61,57,118,10
2025-06-19,EE,Estonia,522,399,9,0,123,54,60,114,9
2025-06-20,EE,Estonia,562,432,11,1,130,60,59,119,10
2025-06-21,EE,Estonia,553,452,4,0,101,50,47,97,4
2025-06-22,EE,Estonia,552,437,5,1,115,54,56,110,4
2025-06-23,EE,Estonia,529,420,10,2,109,50,49,99,8
2025-06-24,EE,Estonia,539,433,9,1,106,50,47,97,8
2025-06-25,EE,Estonia,546,427,9,1,119,57,53,110,8
2025-06-26,EE,Estonia,557,442,11,3,115,52,52,104,8
2025-06-27,EE,Estonia,554,445,11,3,109,50,48,98,8
2025-06-28,EE,Estonia,563,459,6,1,104,47,51,98,5
2025-06-29,EE,Estonia,583,462,5,1,121,57,59,116,4
2025-06-30,EE,Estonia,531,417,10,1,114,55,49,104,9
2025-07-01,EE,Estonia,561,445,11,2,116,49,56,105,9
2025-07-02,EE,Estonia,565,434,12,1,131,58,61,119,11
2025-07-03,EE,Estonia,570,450,10,1,120,54,56,110,9
2025-07-04,EE,Estonia,525,408,9,1,117,57,51,108,8
2025-07-05,EE,Estonia,530,439,4,0,91,44,43,87,4
2025-07-06,EE,Estonia,546,427,6,1,119,54,59,113,5
2025-07-07,EE,Estonia,550,428,11,1,122,58,53,111,10
2025-07-08,EE,Estonia,564,450,10,2,114,53,51,104,8
2025-07-09,EE,Estonia,543,431,13,2,112,49,50,99,11
2025-07-10,EE,Estonia,566,448,13,3,118,52,53,105,10
2025-07-11,EE,Estonia,554,435,11,3,119,55,53,108,8
2025-07-12,EE,Estonia,557,459,4,0,98,46,48,94,4
2025-07-13,EE,Estonia,570,454,5,0,116,58,53,111,5
2025-07-14,EE,Estonia,552,434,12,3,118,51,55,106,9
2025-07-15,EE,Estonia,559,441,10,2,118,54,54,108,8
2025-07-16,EE,Estonia,567,452,11,2,115,54,50,104,9
2025-07-17,EE,Estonia,573,454,12,4,119,53,54,107,8
2025-07-18,EE,Estonia,544,425,12,4,119,53,54,107,8
2025-07-19,EE,Estonia,553,460,6,2,93,44,43,87,4
2025-07-20,EE,Estonia,556,438,6,2,118,57,55,112,4
2025-07-21,EE,Estonia,551,441,9,1,110,52,49,101,8
2025-07-22,EE,Estonia,550,435,12,4,115,48,55,103,8
2025-07-23,EE,Estonia,566,443,10,2,123,57,56,113,8
2025-07-24,EE,Estonia,560,444,10,2,116,52,54,106,8
2025-07-25,EE,Estonia,565,444,11,3,121,56,54,110,8
2025-07-26,EE,Estonia,572,485,6,2,87,39,42,81,4
2025-07-27,EE,Estonia,563,447,4,0,116,57,55,112,4
2025-07-28,EE,Estonia,569,456,11,2,113,51,51,102,9
2025-07-29,EE,Estonia,546,432,10,2,114,52,52,104,8
2025-07-30,EE,Estonia,565,449,12,3,116,51,53,104,9
2025-07-31,EE,Estonia,574,454,15,2,120,52,53,105,13
2025-08-01,EE,Estonia,574,443,13,4,131,62,56,118,9
2025-08-02,EE,Estonia,569,475,4,0,94,44,46,90,4
2025-08-03,EE,Estonia,566,451,8,0,115,52,55,107,8
2025-08-04,EE,Estonia,604,479,12,2,125,57,56,113,10
2025-08-05,EE,Estonia,560,451,9,1,109,50,50,100,8
2025-08-06,EE,Estonia,563,444,9,1,119,56,54,110,8
2025-08-07,EE,Estonia,585,472,9,1,113,50,54,104,8
2025-08-08,EE,Estonia,567,444,9,1,123,60,54,114,8
2025-08-09,EE,Estonia,565,472,7,0,93,43,43,86,7
2025-08-10,EE,Estonia,580,467,5,0,113,53,55,108,5
2025-08-11,EE,Estonia,592,473,10,2,119,52,57,109,8
2025-08-12,EE,Estonia,583,456,11,2,127,58,58,116,9
2025-08-13,EE,Estonia,575,450,12,4,125,58,55,113,8
2025-08-14,EE,Estonia,581,464,11,3,117,53,53,106,8
2025-08-15,EE,Estonia,595,468,10,2,127,57,60,117,8
2025-08-16,EE,Estonia,579,480,4,0,99,48,47,95,4
2025-08-17,EE,Estonia,562,441,4,0,121,57,60,117,4
2025-08-18,EE,Estonia,587,464,9,1,123,57,57,114,8
2025-08-19,EE,Estonia,574,453,9,1,121,54,58,112,8
2025-08-20,EE,Estonia,564,440,10,2,124,58,56,114,8
2025-08-21,EE,Estonia,579,456,9,1,123,58,56,114,8
2025-08-22,EE,Estonia,561,436,11,2,125,57,57,114,9
2025-08-23,EE,Estonia,544,441,8,3,103,44,51,95,5
2025-08-24,EE,Estonia,588,459,6,2,129,63,60,123,4
2025-08-25,EE,Estonia,582,460,9,1,122,58,55,113,8
2025-08-26,EE,Estonia,566,437,11,2,129,58,60,118,9
2025-08-27,EE,Estonia,569,450,11,3,119,55,53,108,8
2025-08-28,EE,Estonia,601,462,12,2,139,64,63,127,10
2025-08-29,EE,Estonia,585,453,10,2,132,62,60,122,8
2025-01-01,EF,Finland,517,127,68,0,390,158,164,322,68
2025-01-02,EF,Finland,696,179,95,1,517,214,208,422,94
2025-01-03,EF,Finland,648,173,98,0,475,187,190,377,98
2025-01-04,EF,Finland,669,161,92,0,508,208,208,416,92
2025-01-05,EF,Finland,693,174,91,2,519,213,215,428,89
2025-01-06,EF,Finland,604,165,72,0,439,182,185,367,72
2025-01-07,EF,Finland,626,159,99,1,467,186,182,368,98
2025-01-08,EF,Finland,629,139,112,1,490,186,192,378,111
2025-01-09,EF,Finland,644,162,123,0,482,180,179,359,123
2025-01-10,EF,Finland,614,151,113,0,463,173,177,350,113
2025-01-11,EF,Finland,594,129,75,0,465,196,194,390,75
2025-01-12,EF,Finland,629,144,90,0,485,199,196,395,90
2025-01-13,EF,Finland,609,142,113,2,467,178,176,354,111
2025-01-14,EF,Finland,580,114,120,1,466,176,170,346,119
2025-01-15,EF,Finland,597,112,132,1,485,173,180,353,131
2025-01-16,EF,Finland,639,126,145,2,513,186,182,368,143
2025-01-17,EF,Finland,628,131,130,1,497,180,187,367,129
2025-01-18,EF,Finland,564,107,69,0,457,192,196,388,69
2025-01-19,EF,Finland,612,135,86,0,477,196,195,391,86
2025-01-20,EF,Finland,620,134,139,1,486,177,170,347,138
2025-01-21,EF,Finland,558,101,123,0,457,169,165,334,123
2025-01-22,EF,Finland,600,100,131,0,500,182,187,369,131
2025-01-23,EF,Finland,626,127,134,4,499,181,184,365,130
2025-01-24,EF,Finland,664,175,126,0,489,180,183,363,126
2025-01-25,EF,Finland,596,117,75,0,479,198,206,404,75
2025-01-26,EF,Finland,644,137,100,1,507,207,200,407,99
2025-01-27,EF,Finland,604,126,128,1,478,177,173,350,127
2025-01-28,EF,Finland,579,118,110,0,461,178,173,351,110
2025-01-29,EF,Finland,594,108,116,0,486,184,186,370,116
2025-01-30,EF,Finland,627,141,116,2,486,188,182,370,114
2025-01-31,EF,Finland,633,138,120,4,495,179,196,375,116
2025-02-01,EF,Finland,607,125,79,0,482,202,201,403,79
2025-02-02,EF,Finland,660,159,95,2,501,206,200,406,93
2025-02-03,EF,Finland,588,122,113,2,466,178,175,353,111
2025-02-04,EF,Finland,610,116,124,3,494,184,186,370,121
2025-02-05,EF,Finland,646,121,129,2,525,197,199,396,127
2025-02-06,EF,Finland,642,127,129,1,515,196,190,386,128
2025-02-07,EF,Finland,638,146,126,2,492,182,184,366,124
2025-02-08,EF,Finland,619,127,77,0,492,206,209,415,77
2025-02-09,EF,Finland,663,146,90,0,517,214,213,427,90
2025-02-10,EF,Finland,629,127,137,2,502,184,181,365,135
2025-02-11,EF,Finland,641,127,127,2,514,196,191,387,125
2025-02-12,EF,Finland,643,116,121,1,527,200,206,406,120
2025-02-13,EF,Finland,662,130,131,1,532,200,201,401,130
2025-02-14,EF,Finland,661,143,135,0,518,191,192,383,135
2025-02-15,EF,Finland,638,120,94,0,518,210,214,424,94
2025-02-16,EF,Finland,645,139,97,0,506,205,204,409,97
2025-02-17,EF,Finland,639,147,122,1,492,186,184,370,121
2025-02-18,EF,Finland,629,119,125,1,510,193,192,385,124
2025-02-19,EF,Finland,658,126,129,1,532,199,204,403,128
2025-02-20,EF,Finland,655,139,124,3,516,199,193,392,121
2025-02-21,EF,Finland,671,161,116,0,510,198,196,394,116
2025-02-22,EF,Finland,645,125,90,1,520,213,217,430,89
2025-02-23,EF,Finland,701,154,108,1,547,223,216,439,107
2025-02-24,EF,Finland,631,148,125,1,483,179,179,358,124
2025-02-25,EF,Finland,646,145,116,1,501,192,193,385,115
2025-02-26,EF,Finland,629,120,133,1,509,188,188,376,132
2025-02-27,EF,Finland,644,130,133,1,514,193,188,381,132
2025-02-28,EF,Finland,661,162,130,0,499,179,190,369,130
2025-03-01,EF,Finland,640,133,87,0,507,211,209,420,87
2025-03-02,EF,Finland,673,155,96,1,518,210,212,422,95
2025-03-03,EF,Finland,653,133,144,0,520,187,189,376,144
2025-03-04,EF,Finland,642,129,121,0,513,197,195,392,121
2025-03-05,EF,Finland,636,122,122,1,514,196,196,392,121
2025-03-06,EF,Finland,673,141,135,0,532,201,196,397,135
2025-03-07,EF,Finland,694,157,147,2,537,196,194,390,145
2025-03-08,EF,Finland,588,107,88,1,481,193,200,393,87
2025-03-09,EF,Finland,665,156,99,0,509,202,208,410,99
2025-03-10,EF,Finland,616,140,127,0,476,180,169,349,127
2025-03-11,EF,Finland,646,122,132,0,524,195,197,392,132
2025-03-12,EF,Finland,654,129,144,0,525,193,188,381,144
2025-03-13,EF,Finland,692,146,143,2,546,201,202,403,141
2025-03-14,EF,Finland,675,155,132,1,520,190,198,388,131
2025-03-15,EF,Finland,614,123,96,1,491,196,199,395,95
2025-03-16,EF,Finland,647,145,95,0,502,202,205,407,95
2025-03-17,EF,Finland,669,143,146,1,526,195,185,380,145
2025-03-18,EF,Finland,654,131,137,2,523,193,193,386,135
2025-03-19,EF,Finland,663,129,137,1,534,197,200,397,136
2025-03-20,EF,Finland,707,153,151,2,554,206,197,403,149
2025-03-21,EF,Finland,664,147,127,1,517,191,199,390,126
2025-03-22,EF,Finland,556,114,81,0,442,180,181,361,81
2025-03-23,EF,Finland,643,159,94,0,484,195,195,390,94
2025-03-24,EF,Finland,664,159,139,0,505,186,180,366,139
2025-03-25,EF,Finland,665,150,140,3,515,187,188,375,137
2025-03-26,EF,Finland,675,144,136,0,531,199,196,395,136
2025-03-27,EF,Finland,592,157,110,0,435,160,165,325,110
2025-03-28,EF,Finland,658,155,127,1,503,191,185,376,126
2025-03-29,EF,Finland,545,118,85,0,427,170,172,342,85
2025-03-30,EF,Finland,617,163,85,1,454,182,187,369,84
2025-03-31,EF,Finland,645,148,119,0,497,190,188,378,119
2025-04-01,EF,Finland,662,145,126,2,517,200,191,391,124
2025-04-02,EF,Finland,664,164,105,0,500,195,200,395,105
2025-04-03,EF,Finland,682,181,118,1,501,190,193,383,117
2025-04-04,EF,Finland,666,159,115,0,507,196,196,392,115
2025-04-05,EF,Finland,546,130,63,0,416,178,175,353,63
2025-04-06,EF,Finland,615,176,69,0,439,187,183,370,69
2025-04-07,EF,Finland,629,153,100,1,476,185,191,376,99
2025-04-08,EF,Finland,650,145,93,0,505,208,204,412,93
2025-04-09,EF,Finland,659,163,109,4,496,190,197,387,105
2025-04-10,EF,Finland,672,170,106,0,502,200,196,396,106
2025-04-11,EF,Finland,682,168,105,0,514,204,205,409,105
2025-04-12,EF,Finland,517,123,60,1,394,168,166,334,59
2025-04-13,EF,Finland,624,181,71,0,443,184,188,372,71
2025-04-14,EF,Finland,659,148,108,0,511,203,200,403,108
2025-04-15,EF,Finland,642,154,102,1,488,195,191,386,101
2025-04-16,EF,Finland,661,154,115,0,507,193,199,392,115
2025-04-17,EF,Finland,650,150,101,0,500,204,195,399,101
2025-04-18,EF,Finland,575,136,63,1,439,187,189,376,62
2025-04-19,EF,Finland,517,113,59,1,404,173,172,345,58
2025-04-20,EF,Finland,592,169,59,0,423,184,180,364,59
2025-04-21,EF,Finland,588,132,70,1,456,188,198,386,69
2025-04-22,EF,Finland,657,147,98,0,510,207,205,412,98
2025-04-23,EF,Finland,652,155,98,2,497,195,204,399,96
2025-04-24,EF,Finland,684,183,89,2,501,208,204,412,87
2025-04-25,EF,Finland,686,167,115,4,519,200,204,404,111
2025-04-26,EF,Finland,594,152,75,1,442,187,180,367,74
2025-04-27,EF,Finland,657,184,73,2,473,196,204,400,71
2025-04-28,EF,Finland,679,170,101,6,509,206,202,408,95
2025-04-29,EF,Finland,683,170,103,6,513,205,205,410,97
2025-04-30,EF,Finland,663,179,89,0,484,201,194,395,89
2025-05-01,EF,Finland,620,173,49,0,447,199,199,398,49
2025-05-02,EF,Finland,518,168,59,2,350,143,148,291,57
2025-05-03,EF,Finland,567,158,53,0,409,177,179,356,53
2025-05-04,EF,Finland,663,204,60,1,459,199,200,399,59
2025-05-05,EF,Finland,630,174,86,2,456,183,187,370,84
2025-05-06,EF,Finland,688,181,90,0,507,213,204,417,90
2025-05-07,EF,Finland,696,182,96,0,514,209,209,418,96
2025-05-08,EF,Finland,762,216,103,0,546,221,222,443,103
2025-05-09,EF,Finland,709,191,101,0,518,207,210,417,101
2025-05-10,EF,Finland,606,159,53,1,447,198,196,394,52
2025-05-11,EF,Finland,666,200,63,0,466,197,206,403,63
2025-05-12,EF,Finland,758,194,116,3,564,226,222,448,113
2025-05-13,EF,Finland,724,169,111,1,555,224,220,444,110
2025-05-14,EF,Finland,683,171,88,1,512,213,211,424,87
2025-05-15,EF,Finland,752,209,95,1,543,224,224,448,94
2025-05-16,EF,Finland,651,199,81,1,452,184,187,371,80
2025-05-17,EF,Finland,631,164,56,1,467,204,207,411,55
2025-05-18,EF,Finland,670,178,71,0,492,211,210,421,71
2025-05-19,EF,Finland,616,179,83,2,437,175,179,354,81
2025-05-20,EF,Finland,714,170,98,0,544,225,221,446,98
2025-05-21,EF,Finland,710,178,98,2,532,218,216,434,96
2025-05-22,EF,Finland,750,192,108,0,558,224,226,450,108
2025-05-23,EF,Finland,744,189,103,0,555,225,227,452,103
2025-05-24,EF,Finland,624,170,58,2,454,198,198,396,56
2025-05-25,EF,Finland,675,185,70,2,490,207,213,420,68
2025-05-26,EF,Finland,760,185,111,3,575,232,232,464,108
2025-05-27,EF,Finland,716,173,108,5,543,223,212,435,103
2025-05-28,EF,Finland,709,174,97,0,535,220,218,438,97
2025-05-29,EF,Finland,669,184,59,2,485,213,213,426,57
2025-05-30,EF,Finland,583,172,70,0,411,169,172,341,70
2025-05-31,EF,Finland,642,185,53,0,457,202,202,404,53
2025-06-01,EF,Finland,704,215,73,4,489,206,210,416,69
2025-06-02,EF,Finland,670,181,93,0,489,197,199,396,93
2025-06-03,EF,Finland,722,177,102,7,545,223,220,443,95
2025-06-04,EF,Finland,623,190,78,3,433,175,180,355,75
2025-06-05,EF,Finland,739,194,101,0,545,221,223,444,101
2025-06-06,EF,Finland,710,189,100,1,521,215,206,421,99
2025-06-07,EF,Finland,623,168,49,1,455,200,206,406,48
2025-06-08,EF,Finland,722,215,65,2,507,220,222,442,63
2025-06-09,EF,Finland,735,190,105,2,545,226,214,440,103
2025-06-10,EF,Finland,745,201,100,3,544,218,226,444,97
2025-06-11,EF,Finland,704,190,89,1,514,213,212,425,88
2025-06-12,EF,Finland,760,201,101,1,559,225,233,458,100
2025-06-13,EF,Finland,725,194,100,1,531,211,220,431,99
2025-06-14,EF,Finland,642,166,65,2,476,204,207,411,63
2025-06-15,EF,Finland,702,195,79,3,507,210,218,428,76
2025-06-16,EF,Finland,722,185,101,2,537,220,216,436,99
2025-06-17,EF,Finland,586,181,73,1,405,166,166,332,72
2025-06-18,EF,Finland,703,169,102,1,534,218,214,432,101
2025-06-19,EF,Finland,596,191,74,0,405,168,163,331,74
2025-06-20,EF,Finland,642,195,44,3,447,202,201,403,41
2025-06-21,EF,Finland,577,169,33,1,408,186,189,375,32
2025-06-22,EF,Finland,677,203,59,4,474,207,208,415,55
2025-06-23,EF,Finland,673,174,81,1,499,209,209,418,80
2025-06-24,EF,Finland,691,171,85,2,520,218,217,435,83
2025-06-25,EF,Finland,686,188,82,3,498,207,209,416,79
2025-06-26,EF,Finland,739,196,91,1,543,228,224,452,90
2025-06-27,EF,Finland,682,194,72,1,488,215,201,416,71
2025-06-28,EF,Finland,596,168,52,0,428,190,186,376,52
2025-06-29,EF,Finland,637,186,55,0,451,199,197,396,55
2025-06-30,EF,Finland,666,185,77,1,481,203,201,404,76
2025-07-01,EF,Finland,698,197,65,3,501,220,216,436,62
2025-07-02,EF,Finland,565,189,59,1,376,159,158,317,58
2025-07-03,EF,Finland,685,193,62,0,492,214,216,430,62
2025-07-04,EF,Finland,578,185,62,0,393,163,168,331,62
2025-07-05,EF,Finland,590,157,57,0,433,191,185,376,57
2025-07-06,EF,Finland,656,182,65,3,474,204,205,409,62
2025-07-07,EF,Finland,564,190,51,1,374,160,163,323,50
2025-07-08,EF,Finland,700,201,71,2,499,215,213,428,69
2025-07-09,EF,Finland,662,198,66,3,464,199,199,398,63
2025-07-10,EF,Finland,685,196,60,3,489,214,215,429,57
2025-07-11,EF,Finland,666,181,69,3,485,206,210,416,66
2025-07-12,EF,Finland,622,189,63,3,433,185,185,370,60
2025-07-13,EF,Finland,644,188,62,3,456,197,197,394,59
2025-07-14,EF,Finland,665,178,81,2,487,203,203,406,79
2025-07-15,EF,Finland,681,184,64,3,497,217,216,433,61
2025-07-16,EF,Finland,663,189,63,3,474,204,207,411,60
2025-07-17,EF,Finland,695,201,68,5,494,217,209,426,63
2025-07-18,EF,Finland,688,207,72,2,481,204,205,409,70
2025-07-19,EF,Finland,630,190,51,3,440,192,197,389,48
2025-07-20,EF,Finland,669,196,62,3,473,206,205,411,59
2025-07-21,EF,Finland,663,181,67,1,482,208,207,415,66
2025-07-22,EF,Finland,694,195,71,2,499,216,212,428,69
2025-07-23,EF,Finland,658,200,60,2,458,199,199,398,58
2025-07-24,EF,Finland,705,209,60,1,496,217,219,436,59
2025-07-25,EF,Finland,686,199,70,1,487,211,206,417,69
2025-07-26,EF,Finland,616,189,53,2,427,187,187,374,51
2025-07-27,EF,Finland,660,194,63,2,466,199,204,403,61
2025-07-28,EF,Finland,670,186,69,2,484,208,207,415,67
2025-07-29,EF,Finland,686,192,70,0,494,213,211,424,70
2025-07-30,EF,Finland,672,195,72,2,477,199,206,405,70
2025-07-31,EF,Finland,688,203,67,2,485,212,206,418,65
2025-08-01,EF,Finland,681,195,77,4,486,202,207,409,73
2025-08-02,EF,Finland,628,183,53,4,445,197,195,392,49
2025-08-03,EF,Finland,670,207,60,1,463,203,200,403,59
2025-08-04,EF,Finland,716,222,82,0,494,205,207,412,82
2025-08-05,EF,Finland,697,205,75,1,492,205,212,417,74
2025-08-06,EF,Finland,681,197,71,0,484,209,204,413,71
2025-08-07,EF,Finland,710,204,75,0,506,215,216,431,75
2025-08-08,EF,Finland,696,213,80,0,483,203,200,403,80
2025-08-09,EF,Finland,631,185,68,2,446,190,188,378,66
2025-08-10,EF,Finland,692,227,64,1,465,203,198,401,63
2025-08-11,EF,Finland,719,207,84,0,512,214,214,428,84
2025-08-12,EF,Finland,721,213,84,1,508,210,214,424,83
2025-08-13,EF,Finland,723,207,89,2,516,212,215,427,87
2025-08-14,EF,Finland,749,206,97,2,543,226,220,446,95
2025-08-15,EF,Finland,696,189,76,0,507,214,217,431,76
2025-08-16,EF,Finland,622,182,51,0,440,194,195,389,51
2025-08-17,EF,Finland,699,214,66,1,485,211,208,419,65
2025-08-18,EF,Finland,744,203,100,0,541,221,220,441,100
2025-08-19,EF,Finland,727,200,91,1,527,218,218,436,90
2025-08-20,EF,Finland,731,212,90,2,519,217,212,429,88
2025-08-21,EF,Finland,750,213,92,0,537,219,226,445,92
2025-08-22,EF,Finland,740,209,100,0,531,215,216,431,100
2025-08-23,EF,Finland,621,178,56,1,443,193,194,387,55
2025-08-24,EF,Finland,696,206,70,0,490,210,210,420,70
2025-08-25,EF,Finland,759,219,96,0,540,220,224,444,96
2025-08-26,EF,Finland,749,230,98,1,519,209,212,421,97
2025-08-27,EF,Finland,731,210,97,5,521,211,213,424,92
2025-08-28,EF,Finland,773,220,101,1,553,228,224,452,100
2025-08-29,EF,Finland,739,211,85,2,528,221,222,443,83
2025-01-01,LF,France,7111,4188,395,2,2923,1256,1272,2528,393
2025-01-02,LF,France,8467,4774,623,18,3693,1540,1530,3070,605
2025-01-03,LF,France,8930,4963,736,33,3967,1598,1633,3231,703
2025-01-04,LF,France,8768,5143,480,13,3625,1585,1560,3145,467
2025-01-05,LF,France,8819,5049,585,9,3770,1594,1591,3185,576
2025-01-06,LF,France,8540,4710,814,15,3830,1504,1512,3016,799
2025-01-07,LF,France,7113,3988,801,30,3125,1165,1159,2324,771
2025-01-08,LF,France,6439,3397,806,34,3042,1123,1113,2236,772
2025-01-09,LF,France,6895,3582,925,33,3313,1197,1191,2388,892
2025-01-10,LF,France,7844,4259,891,33,3585,1350,1344,2694,858
2025-01-11,LF,France,7261,4300,429,8,2961,1250,1282,2532,421
2025-01-12,LF,France,7685,4492,485,3,3193,1370,1338,2708,482
2025-01-13,LF,France,7461,3949,917,35,3512,1293,1302,2595,882
2025-01-14,LF,France,6147,3180,932,48,2967,1017,1018,2035,884
2025-01-15,LF,France,6088,3175,796,35,2913,1049,1068,2117,761
2025-01-16,LF,France,6746,3501,924,56,3245,1147,1174,2321,868
2025-01-17,LF,France,7796,4233,905,51,3563,1327,1331,2658,854
2025-01-18,LF,France,7041,4252,342,11,2789,1225,1222,2447,331
2025-01-19,LF,France,7554,4367,515,11,3187,1333,1339,2672,504
2025-01-20,LF,France,7559,4008,886,37,3551,1311,1354,2665,849
2025-01-21,LF,France,6035,3134,826,30,2901,1027,1048,2075,796
2025-01-22,LF,France,6426,3320,847,40,3106,1138,1121,2259,807
2025-01-23,LF,France,7048,3615,1030,103,3433,1195,1208,2403,927
2025-01-24,LF,France,7885,4125,972,68,3760,1398,1390,2788,904
2025-01-25,LF,France,7161,4261,395,21,2900,1272,1233,2505,374
2025-01-26,LF,France,7613,4417,502,9,3196,1352,1342,2694,493
2025-01-27,LF,France,7388,3877,849,75,3511,1326,1336,2662,774
2025-01-28,LF,France,6103,3162,856,99,2941,1049,1036,2085,757
2025-01-29,LF,France,6377,3184,934,80,3193,1127,1132,2259,854
2025-01-30,LF,France,6945,3594,966,89,3351,1200,1185,2385,877
2025-01-31,LF,France,8072,4317,920,69,3755,1417,1418,2835,851
2025-02-01,LF,France,7483,4509,429,22,2974,1280,1265,2545,407
2025-02-02,LF,France,8039,4668,578,20,3371,1393,1400,2793,558
2025-02-03,LF,France,7788,4152,917,68,3636,1358,1361,2719,849
2025-02-04,LF,France,6753,3615,920,96,3138,1114,1104,2218,824
2025-02-05,LF,France,7015,3764,931,62,3251,1150,1170,2320,869
2025-02-06,LF,France,7759,4110,1046,125,3649,1303,1300,2603,921
2025-02-07,LF,France,8552,4581,971,84,3971,1493,1507,3000,887
2025-02-08,LF,France,7844,4732,371,19,3112,1378,1363,2741,352
2025-02-09,LF,France,8260,4832,534,10,3428,1448,1446,2894,524
2025-02-10,LF,France,8175,4329,979,85,3846,1405,1462,2867,894
2025-02-11,LF,France,7208,3878,929,103,3330,1210,1191,2401,826
2025-02-12,LF,France,7436,3897,901,81,3539,1326,1312,2638,820
2025-02-13,LF,France,7866,3946,1126,91,3920,1388,1406,2794,1035
2025-02-14,LF,France,9219,4921,1089,62,4298,1602,1607,3209,1027
2025-02-15,LF,France,8745,5116,537,18,3629,1552,1540,3092,519
2025-02-16,LF,France,8718,5024,585,15,3694,1562,1547,3109,570
2025-02-17,LF,France,8655,4639,984,82,4016,1523,1509,3032,902
2025-02-18,LF,France,7785,4328,923,88,3457,1266,1268,2534,835
2025-02-19,LF,France,8042,4335,989,76,3707,1358,1360,2718,913
2025-02-20,LF,France,8546,4637,1036,94,3909,1437,1436,2873,942
2025-02-21,LF,France,9082,4929,1023,76,4153,1547,1583,3130,947
2025-02-22,LF,France,8662,5101,474,16,3561,1576,1511,3087,458
2025-02-23,LF,France,9030,5257,572,10,3773,1587,1614,3201,562
2025-02-24,LF,France,8710,4663,973,87,4047,1536,1538,3074,886
2025-02-25,LF,France,7438,4041,896,96,3397,1235,1266,2501,800
2025-02-26,LF,France,7690,4144,911,76,3546,1326,1309,2635,835
2025-02-27,LF,France,8374,4468,1065,100,3906,1422,1419,2841,965
2025-02-28,LF,France,8977,4896,1020,75,4081,1516,1545,3061,945
2025-03-01,LF,France,8663,5162,486,21,3501,1514,1501,3015,465
2025-03-02,LF,France,8903,5150,644,17,3753,1560,1549,3109,627
2025-03-03,LF,France,8718,4639,991,80,4079,1542,1546,3088,911
2025-03-04,LF,France,7946,4343,977,101,3603,1307,1319,2626,876
2025-03-05,LF,France,8081,4355,983,85,3726,1361,1382,2743,898
2025-03-06,LF,France,8547,4657,1018,79,3890,1441,1431,2872,939
2025-03-07,LF,France,9132,4945,983,61,4187,1590,1614,3204,922
2025-03-08,LF,France,8465,5041,464,21,3424,1486,1474,2960,443
2025-03-09,LF,France,8866,5112,561,10,3754,1603,1590,3193,551
2025-03-10,LF,France,8292,4315,1023,84,3977,1460,1494,2954,939
2025-03-11,LF,France,7880,4271,988,107,3609,1313,1308,2621,881
2025-03-12,LF,France,8035,4362,1013,97,3673,1326,1334,2660,916
2025-03-13,LF,France,8720,4685,1142,78,4035,1456,1437,2893,1064
2025-03-14,LF,France,9134,5005,1018,64,4129,1554,1557,3111,954
2025-03-15,LF,France,8341,5029,507,14,3312,1423,1382,2805,493
2025-03-16,LF,France,8749,5142,582,19,3607,1515,1510,3025,563
2025-03-17,LF,France,8884,4748,1127,73,4136,1495,1514,3009,1054
2025-03-18,LF,France,7957,4315,1082,83,3642,1280,1280,2560,999
2025-03-19,LF,France,8087,4381,1069,83,3706,1317,1320,2637,986
2025-03-20,LF,France,8815,4718,1184,101,4097,1455,1458,2913,1083
2025-03-21,LF,France,8811,4711,1003,65,4100,1551,1546,3097,938
2025-03-22,LF,France,8170,4974,413,11,3196,1410,1373,2783,402
2025-03-23,LF,France,8765,5100,604,11,3665,1536,1525,3061,593
2025-03-24,LF,France,8699,4665,1030,71,4034,1496,1508,3004,959
2025-03-25,LF,France,7914,4297,1030,87,3617,1298,1289,2587,943
2025-03-26,LF,France,8110,4336,1111,103,3774,1310,1353,2663,1008
2025-03-27,LF,France,8937,4718,1175,112,4219,1526,1518,3044,1063
2025-03-28,LF,France,9293,4994,1133,78,4299,1567,1599,3166,1055
2025-03-29,LF,France,8384,5068,463,18,3316,1433,1420,2853,445
2025-03-30,LF,France,9563,5697,637,10,3866,1633,1596,3229,627
2025-03-31,LF,France,9487,5150,1139,73,4337,1591,1607,3198,1066
2025-04-01,LF,France,9351,5201,1074,107,4150,1541,1535,3076,967
2025-04-02,LF,France,9563,5317,1110,95,4246,1557,1579,3136,1015
2025-04-03,LF,France,10079,5484,1221,101,4595,1682,1692,3374,1120
2025-04-04,LF,France,10515,5804,1173,80,4711,1766,1772,3538,1093
2025-04-05,LF,France,9844,5996,534,9,3848,1679,1635,3314,525
2025-04-06,LF,France,10066,5977,641,14,4089,1737,1711,3448,627
2025-04-07,LF,France,10195,5655,1127,85,4540,1704,1709,3413,1042
2025-04-08,LF,France,9758,5432,1142,105,4326,1600,1584,3184,1037
2025-04-09,LF,France,9781,5356,1148,77,4425,1624,1653,3277,1071
2025-04-10,LF,France,10506,5749,1190,88,4757,1792,1775,3567,1102
2025-04-11,LF,France,10768,5931,1183,66,4837,1812,1842,3654,1117
2025-04-12,LF,France,10192,6152,610,23,4040,1716,1714,3430,587
2025-04-13,LF,France,10163,6036,652,13,4127,1757,1718,3475,639
2025-04-14,LF,France,10281,5666,1143,90,4615,1734,1738,3472,1053
2025-04-15,LF,France,9776,5472,1025,92,4304,1635,1644,3279,933
2025-04-16,LF,France,10181,5682,1103,112,4499,1703,1693,3396,991
2025-04-17,LF,France,10671,6003,1072,91,4668,1781,1815,3596,981
2025-04-18,LF,France,10620,5858,1154,93,4762,1794,1814,3608,1061
2025-04-19,LF,France,9964,6077,565,24,3887,1682,1640,3322,541
2025-04-20,LF,France,9852,5911,555,15,3941,1698,1688,3386,540
2025-04-21,LF,France,10324,5952,785,25,4372,1792,1795,3587,760
2025-04-22,LF,France,10240,5707,1122,101,4533,1702,1709,3411,1021
2025-04-23,LF,France,10035,5629,1029,103,4406,1692,1685,3377,926
2025-04-24,LF,France,10435,5764,1185,104,4671,1733,1753,3486,1081
2025-04-25,LF,France,10710,5959,1126,90,4751,1814,1811,3625,1036
2025-04-26,LF,France,10057,6063,616,18,3994,1697,1681,3378,598
2025-04-27,LF,France,10358,6081,682,17,4277,1799,1796,3595,665
2025-04-28,LF,France,9818,5347,1091,78,4471,1676,1704,3380,1013
2025-04-29,LF,France,9913,5496,1116,113,4417,1651,1650,3301,1003
2025-04-30,LF,France,10454,5841,1082,86,4613,1752,1779,3531,996
2025-05-01,LF,France,10109,6017,676,17,4092,1692,1724,3416,659
2025-05-02,LF,France,10518,6087,836,45,4431,1775,1820,3595,791
2025-05-03,LF,France,10118,6262,566,16,3856,1672,1618,3290,550
2025-05-04,LF,France,10662,6315,690,5,4347,1851,1806,3657,685
2025-05-05,LF,France,10697,6003,1078,76,4694,1803,1813,3616,1002
2025-05-06,LF,France,10194,5776,1015,99,4418,1699,1704,3403,916
2025-05-07,LF,France,10522,5893,1088,96,4629,1754,1787,3541,992
2025-05-08,LF,France,10431,6205,694,24,4226,1773,1759,3532,670
2025-05-09,LF,France,10587,6091,860,50,4496,1797,1839,3636,810
2025-05-10,LF,France,10234,6288,568,14,3946,1706,1672,3378,554
2025-05-11,LF,France,10691,6256,749,9,4435,1837,1849,3686,740
2025-05-12,LF,France,10818,6022,1159,77,4796,1824,1813,3637,1082
2025-05-13,LF,France,10168,5747,1072,102,4421,1669,1680,3349,970
2025-05-14,LF,France,10510,5993,1093,73,4517,1703,1721,3424,1020
2025-05-15,LF,France,11000,6146,1266,104,4854,1776,1812,3588,1162
2025-05-16,LF,France,11168,6150,1217,88,5018,1874,1927,3801,1129
2025-05-17,LF,France,10386,6349,635,18,4037,1699,1703,3402,617
2025-05-18,LF,France,10683,6310,689,15,4373,1862,1822,3684,674
2025-05-19,LF,France,10887,6060,1159,95,4827,1822,1846,3668,1064
2025-05-20,LF,France,10492,5904,1095,126,4588,1764,1729,3493,969
2025-05-21,LF,France,10861,6063,1161,103,4798,1800,1837,3637,1058
2025-05-22,LF,France,11384,6340,1197,85,5044,1907,1940,3847,1112
2025-05-23,LF,France,11638,6485,1200,47,5153,1950,2003,3953,1153
2025-05-24,LF,France,10853,6643,627,22,4210,1797,1786,3583,605
2025-05-25,LF,France,10995,6473,713,13,4522,1933,1876,3809,700
2025-05-26,LF,France,11465,6251,1204,82,5214,2032,1978,4010,1122
2025-05-27,LF,France,10819,6075,1140,114,4744,1796,1808,3604,1026
2025-05-28,LF,France,11217,6271,1209,89,4946,1846,1891,3737,1120
2025-05-29,LF,France,10907,6486,773,8,4421,1810,1838,3648,765
2025-05-30,LF,France,10955,6499,782,33,4456,1836,1838,3674,749
2025-05-31,LF,France,10875,6719,594,12,4156,1804,1758,3562,582
2025-06-01,LF,France,11562,6849,806,6,4713,1940,1967,3907,800
2025-06-02,LF,France,11365,6375,1178,57,4990,1907,1905,3812,1121
2025-06-03,LF,France,11015,6197,1181,111,4818,1821,1816,3637,1070
2025-06-04,LF,France,11040,6265,1113,75,4775,1831,1831,3662,1038
2025-06-05,LF,France,11455,6264,1307,104,5191,1913,1971,3884,1203
2025-06-06,LF,France,11776,6507,1195,54,5269,2023,2051,4074,1141
2025-06-07,LF,France,10881,6675,623,7,4206,1792,1791,3583,616
2025-06-08,LF,France,11108,6577,714,10,4531,1908,1909,3817,704
2025-06-09,LF,France,11353,6533,923,18,4820,1958,1939,3897,905
2025-06-10,LF,France,11221,6317,1200,94,4904,1857,1847,3704,1106
2025-06-11,LF,France,11380,6419,1240,90,4961,1857,1864,3721,1150
2025-06-12,LF,France,11602,6473,1258,90,5129,1932,1939,3871,1168
2025-06-13,LF,France,11574,6460,1153,68,5114,1967,1994,3961,1085
2025-06-14,LF,France,11148,6779,669,24,4369,1843,1857,3700,645
2025-06-15,LF,France,11502,6729,773,6,4773,2010,1990,4000,767
2025-06-16,LF,France,11726,6418,1263,81,5308,1992,2053,4045,1182
2025-06-17,LF,France,11287,6334,1191,85,4953,1885,1877,3762,1106
2025-06-18,LF,France,11569,6516,1181,77,5053,1942,1930,3872,1104
2025-06-19,LF,France,11903,6637,1307,92,5266,1962,1997,3959,1215
2025-06-20,LF,France,11865,6602,1205,46,5263,2031,2027,4058,1159
2025-06-21,LF,France,11252,6907,629,17,4345,1887,1829,3716,612
2025-06-22,LF,France,11534,6860,776,16,4674,1966,1932,3898,760
2025-06-23,LF,France,11739,6575,1217,53,5164,1974,1973,3947,1164
2025-06-24,LF,France,11358,6450,1141,107,4908,1883,1884,3767,1034
2025-06-25,LF,France,11131,6265,1139,76,4866,1863,1864,3727,1063
2025-06-26,LF,France,11907,6799,1236,72,5108,1926,1946,3872,1164
2025-06-27,LF,France,12102,6812,1173,67,5290,2056,2061,4117,1106
2025-06-28,LF,France,11505,6959,671,14,4546,1948,1927,3875,657
2025-06-29,LF,France,11721,7048,709,15,4673,2008,1956,3964,694
2025-06-30,LF,France,11865,6712,1168,66,5153,1985,2000,3985,1102
2025-07-01,LF,France,11724,6683,1132,82,5041,1932,1977,3909,1050
2025-07-02,LF,France,11621,6483,1162,64,5138,2023,1953,3976,1098
2025-07-03,LF,France,9382,5779,702,61,3603,1451,1450,2901,641
2025-07-04,LF,France,10090,6578,664,46,3512,1398,1450,2848,618
2025-07-05,LF,France,11917,7081,801,19,4836,1994,2041,4035,782
2025-07-06,LF,France,11804,6980,723,20,4824,2070,2031,4101,703
2025-07-07,LF,France,11993,6723,1144,75,5270,2040,2086,4126,1069
2025-07-08,LF,France,11677,6675,1091,91,5002,1957,1954,3911,1000
2025-07-09,LF,France,11959,6699,1190,67,5260,2057,2013,4070,1123
2025-07-10,LF,France,12073,6756,1216,86,5317,2030,2071,4101,1130
2025-07-11,LF,France,12262,6828,1186,78,5434,2126,2122,4248,1108
2025-07-12,LF,France,11703,6983,740,10,4720,1999,1981,3980,730
2025-07-13,LF,France,11779,7042,646,15,4737,2067,2024,4091,631
2025-07-14,LF,France,11665,6916,756,17,4749,1973,2020,3993,739
2025-07-15,LF,France,11487,6513,1035,74,4974,1969,1970,3939,961
2025-07-16,LF,France,11711,6593,1135,87,5118,1995,1988,3983,1048
2025-07-17,LF,France,11793,6698,1113,102,5095,1975,2007,3982,1011
2025-07-18,LF,France,12315,6862,1129,68,5453,2150,2174,4324,1061
2025-07-19,LF,France,11603,6952,709,11,4651,1973,1969,3942,698
2025-07-20,LF,France,11674,6965,680,3,4709,2023,2006,4029,677
2025-07-21,LF,France,11866,6811,1005,59,5055,2029,2021,4050,946
2025-07-22,LF,France,11612,6687,1054,99,4925,1938,1933,3871,955
2025-07-23,LF,France,11477,6548,998,69,4929,1964,1967,3931,929
2025-07-24,LF,France,11621,6592,1085,108,5029,1981,1963,3944,977
2025-07-25,LF,France,12163,6897,1092,70,5266,2075,2099,4174,1022
2025-07-26,LF,France,11758,7122,720,11,4636,1966,1950,3916,709
2025-07-27,LF,France,11815,7164,654,10,4651,2009,1988,3997,644
2025-07-28,LF,France,11689,6682,967,69,5007,1998,2042,4040,898
2025-07-29,LF,France,11418,6608,954,79,4810,1937,1919,3856,875
2025-07-30,LF,France,11595,6612,1012,89,4983,1976,1995,3971,923
2025-07-31,LF,France,11764,6792,989,91,4972,1999,1984,3983,898
2025-08-01,LF,France,11978,6853,1001,56,5125,2047,2077,4124,945
2025-08-02,LF,France,11805,7161,714,10,4644,1974,1956,3930,704
2025-08-03,LF,France,11683,7001,665,9,4682,2029,1988,4017,656
2025-08-04,LF,France,11562,6702,906,63,4860,1977,1977,3954,843
2025-08-05,LF,France,11151,6482,894,73,4669,1878,1897,3775,821
2025-08-06,LF,France,11267,6491,906,67,4776,1939,1931,3870,839
2025-08-07,LF,France,11515,6815,936,74,4700,1872,1892,3764,862
2025-08-08,LF,France,11747,6840,861,48,4907,2014,2032,4046,813
2025-08-09,LF,France,11724,7077,705,14,4647,1979,1963,3942,691
2025-08-10,LF,France,11613,7021,639,12,4592,1986,1967,3953,627
2025-08-11,LF,France,11432,6637,912,58,4795,1934,1949,3883,854
2025-08-12,LF,France,11079,6483,862,96,4596,1876,1858,3734,766
2025-08-13,LF,France,11098,6478,839,44,4620,1892,1889,3781,795
2025-08-14,LF,France,11252,6662,834,54,4590,1874,1882,3756,780
2025-08-15,LF,France,11296,6705,657,23,4591,1948,1986,3934,634
2025-08-16,LF,France,11521,7016,662,14,4505,1927,1916,3843,648
2025-08-17,LF,France,11530,6903,685,11,4627,1994,1948,3942,674
2025-08-18,LF,France,11516,6680,904,60,4836,1964,1968,3932,844
2025-08-19,LF,France,11050,6471,860,72,4579,1851,1868,3719,788
2025-08-20,LF,France,11281,6569,869,59,4712,1916,1927,3843,810
2025-08-21,LF,France,11422,6699,910,71,4723,1897,1916,3813,839
2025-08-22,LF,France,11773,6719,945,44,5054,2039,2070,4109,901
2025-08-23,LF,France,11524,6981,734,19,4543,1905,1904,3809,715
2025-08-24,LF,France,11700,6955,716,6,4745,2020,2009,4029,710
2025-08-25,LF,France,11529,6553,994,68,4976,2003,1979,3982,926
2025-08-26,LF,France,11272,6471,951,65,4801,1926,1924,3850,886
2025-08-27,LF,France,11336,6490,949,63,4846,1951,1946,3897,886
2025-08-28,LF,France,11456,6564,963,82,4892,1947,1982,3929,881
2025-08-29,LF,France,11760,6758,924,50,5002,2041,2037,4078,874
2025-01-01,UG,Georgia,646,513,0,0,133,65,68,133,0
2025-01-02,UG,Georgia,744,574,0,0,170,85,85,170,0
2025-01-03,UG,Georgia,787,616,0,0,171,85,86,171,0
2025-01-04,UG,Georgia,787,625,0,0,162,81,81,162,0
2025-01-05,UG,Georgia,799,617,0,0,182,89,93,182,0
2025-01-06,UG,Georgia,760,589,2,0,171,90,79,169,2
2025-01-07,UG,Georgia,743,586,0,0,157,76,81,157,0
2025-01-08,UG,Georgia,733,580,0,0,153,75,78,153,0
2025-01-09,UG,Georgia,743,571,0,0,172,88,84,172,0
2025-01-10,UG,Georgia,793,636,2,0,157,76,79,155,2
2025-01-11,UG,Georgia,785,627,0,0,158,81,77,158,0
2025-01-12,UG,Georgia,757,578,0,0,179,86,93,179,0
2025-01-13,UG,Georgia,695,544,0,0,151,81,70,151,0
2025-01-14,UG,Georgia,708,553,0,0,155,77,78,155,0
2025-01-15,UG,Georgia,693,547,0,0,146,71,75,146,0
2025-01-16,UG,Georgia,716,566,0,0,150,76,74,150,0
2025-01-17,UG,Georgia,726,569,3,1,157,75,79,154,2
2025-01-18,UG,Georgia,770,611,0,0,159,80,79,159,0
2025-01-19,UG,Georgia,747,574,3,0,173,86,84,170,3
2025-01-20,UG,Georgia,659,525,2,0,134,69,63,132,2
2025-01-21,UG,Georgia,658,519,0,0,139,67,72,139,0
2025-01-22,UG,Georgia,671,529,0,0,142,71,71,142,0
2025-01-23,UG,Georgia,682,532,0,0,150,73,77,150,0
2025-01-24,UG,Georgia,727,569,2,0,158,77,79,156,2
2025-01-25,UG,Georgia,706,549,0,0,157,77,80,157,0
2025-01-26,UG,Georgia,696,527,2,0,169,85,82,167,2
2025-01-27,UG,Georgia,668,524,0,0,144,77,67,144,0
2025-01-28,UG,Georgia,643,504,2,0,139,64,73,137,2
2025-01-29,UG,Georgia,653,523,0,0,130,67,63,130,0
2025-01-30,UG,Georgia,680,524,0,0,156,77,79,156,0
2025-01-31,UG,Georgia,692,545,0,0,147,71,76,147,0
2025-02-01,UG,Georgia,687,531,0,0,156,81,75,156,0
2025-02-02,UG,Georgia,699,535,2,0,164,80,82,162,2
2025-02-03,UG,Georgia,619,484,2,0,135,71,62,133,2
2025-02-04,UG,Georgia,672,530,1,0,142,66,75,141,1
2025-02-05,UG,Georgia,648,508,3,1,140,72,65,137,2
2025-02-06,UG,Georgia,672,509,0,0,163,80,83,163,0
2025-02-07,UG,Georgia,694,540,0,0,154,74,80,154,0
2025-02-08,UG,Georgia,749,579,2,0,170,82,86,168,2
2025-02-09,UG,Georgia,704,543,0,0,161,81,80,161,0
2025-02-10,UG,Georgia,644,505,5,1,139,70,64,134,4
2025-02-11,UG,Georgia,654,511,2,0,143,68,73,141,2
2025-02-12,UG,Georgia,628,494,0,0,134,72,62,134,0
2025-02-13,UG,Georgia,656,497,1,0,159,75,83,158,1
2025-02-14,UG,Georgia,693,542,0,0,151,75,76,151,0
2025-02-15,UG,Georgia,709,549,0,0,160,80,80,160,0
2025-02-16,UG,Georgia,719,548,0,0,171,85,86,171,0
2025-02-17,UG,Georgia,628,485,1,0,143,74,68,142,1
2025-02-18,UG,Georgia,635,489,2,0,146,70,74,144,2
2025-02-19,UG,Georgia,643,507,0,0,136,69,67,136,0
2025-02-20,UG,Georgia,677,528,0,0,149,75,74,149,0
2025-02-21,UG,Georgia,701,557,0,0,144,71,73,144,0
2025-02-22,UG,Georgia,720,572,0,0,148,75,73,148,0
2025-02-23,UG,Georgia,688,529,0,0,159,75,84,159,0
2025-02-24,UG,Georgia,645,519,0,0,126,63,63,126,0
2025-02-25,UG,Georgia,693,558,0,0,135,67,68,135,0
2025-02-26,UG,Georgia,701,546,3,0,155,77,75,152,3
2025-02-27,UG,Georgia,699,544,2,0,155,78,75,153,2
2025-02-28,UG,Georgia,725,571,1,0,154,75,78,153,1
2025-03-01,UG,Georgia,728,576,0,0,152,77,75,152,0
2025-03-02,UG,Georgia,723,554,0,0,169,84,85,169,0
2025-03-03,UG,Georgia,627,500,2,0,127,67,58,125,2
2025-03-04,UG,Georgia,634,493,0,0,141,68,73,141,0
2025-03-05,UG,Georgia,677,526,2,0,151,74,75,149,2
2025-03-06,UG,Georgia,656,503,2,0,153,78,73,151,2
2025-03-07,UG,Georgia,691,536,0,0,155,74,81,155,0
2025-03-08,UG,Georgia,697,533,0,0,164,85,79,164,0
2025-03-09,UG,Georgia,684,524,0,0,160,76,84,160,0
2025-03-10,UG,Georgia,616,472,2,0,144,74,68,142,2
2025-03-11,UG,Georgia,682,531,0,0,151,76,75,151,0
2025-03-12,UG,Georgia,676,532,0,0,144,73,71,144,0
2025-03-13,UG,Georgia,651,500,2,0,151,72,77,149,2
2025-03-14,UG,Georgia,723,558,0,0,165,82,83,165,0
2025-03-15,UG,Georgia,717,550,0,0,167,85,82,167,0
2025-03-16,UG,Georgia,731,566,0,0,165,79,86,165,0
2025-03-17,UG,Georgia,670,522,0,0,148,76,72,148,0
2025-03-18,UG,Georgia,706,549,2,0,157,77,78,155,2
2025-03-19,UG,Georgia,713,554,2,0,159,81,76,157,2
2025-03-20,UG,Georgia,723,554,3,1,169,82,84,166,2
2025-03-21,UG,Georgia,702,532,1,0,170,85,84,169,1
2025-03-22,UG,Georgia,709,549,0,0,160,80,80,160,0
2025-03-23,UG,Georgia,730,547,0,0,183,89,94,183,0
2025-03-24,UG,Georgia,681,531,2,0,150,78,70,148,2
2025-03-25,UG,Georgia,689,532,0,0,157,76,81,157,0
2025-03-26,UG,Georgia,674,518,2,0,156,79,75,154,2
2025-03-27,UG,Georgia,684,518,2,0,166,83,81,164,2
2025-03-28,UG,Georgia,759,579,0,0,180,87,93,180,0
2025-03-29,UG,Georgia,760,587,0,0,173,87,86,173,0
2025-03-30,UG,Georgia,788,579,0,0,209,104,105,209,0
2025-03-31,UG,Georgia,718,537,3,1,181,93,85,178,2
2025-04-01,UG,Georgia,786,591,0,0,195,93,102,195,0
2025-04-02,UG,Georgia,810,588,2,0,222,110,110,220,2
2025-04-03,UG,Georgia,727,539,0,0,188,94,94,188,0
2025-04-04,UG,Georgia,813,605,2,0,208,102,104,206,2
2025-04-05,UG,Georgia,767,583,1,1,184,94,89,183,0
2025-04-06,UG,Georgia,784,580,2,0,204,100,102,202,2
2025-04-07,UG,Georgia,729,554,2,0,175,88,85,173,2
2025-04-08,UG,Georgia,742,571,2,0,171,82,87,169,2
2025-04-09,UG,Georgia,782,598,2,0,184,92,90,182,2
2025-04-10,UG,Georgia,785,593,0,0,192,96,96,192,0
2025-04-11,UG,Georgia,825,623,2,0,202,100,100,200,2
2025-04-12,UG,Georgia,762,591,0,0,171,86,85,171,0
2025-04-13,UG,Georgia,749,560,2,0,189,93,94,187,2
2025-04-14,UG,Georgia,716,551,0,0,165,85,80,165,0
2025-04-15,UG,Georgia,733,555,0,0,178,86,92,178,0
2025-04-16,UG,Georgia,772,586,0,0,186,93,93,186,0
2025-04-17,UG,Georgia,735,547,0,0,188,94,94,188,0
2025-04-18,UG,Georgia,807,614,1,0,193,96,96,192,1
2025-04-19,UG,Georgia,847,658,0,0,189,93,96,189,0
2025-04-20,UG,Georgia,826,613,4,0,213,105,104,209,4
2025-04-21,UG,Georgia,767,591,2,0,176,90,84,174,2
2025-04-22,UG,Georgia,771,607,0,0,164,80,84,164,0
2025-04-23,UG,Georgia,748,569,0,0,179,92,87,179,0
2025-04-24,UG,Georgia,782,598,4,0,184,90,90,180,4
2025-04-25,UG,Georgia,854,648,2,0,206,96,108,204,2
2025-04-26,UG,Georgia,803,622,0,0,181,90,91,181,0
2025-04-27,UG,Georgia,860,638,2,0,222,111,109,220,2
2025-04-28,UG,Georgia,756,586,2,0,170,88,80,168,2
2025-04-29,UG,Georgia,797,621,1,0,176,85,90,175,1
2025-04-30,UG,Georgia,837,642,2,0,195,96,97,193,2
2025-05-01,UG,Georgia,773,564,0,0,209,105,104,209,0
2025-05-02,UG,Georgia,769,580,2,0,189,92,95,187,2
2025-05-03,UG,Georgia,766,577,0,0,189,94,95,189,0
2025-05-04,UG,Georgia,752,549,2,0,203,105,96,201,2
2025-05-05,UG,Georgia,731,546,2,0,185,91,92,183,2
2025-05-06,UG,Georgia,726,545,0,0,181,90,91,181,0
2025-05-07,UG,Georgia,675,489,2,0,186,94,90,184,2
2025-05-08,UG,Georgia,760,552,2,0,208,102,104,206,2
2025-05-09,UG,Georgia,760,566,0,0,194,94,100,194,0
2025-05-10,UG,Georgia,777,580,1,0,197,99,97,196,1
2025-05-11,UG,Georgia,765,560,2,0,205,102,101,203,2
2025-05-12,UG,Georgia,691,508,0,0,183,92,91,183,0
2025-05-13,UG,Georgia,721,545,1,1,176,85,90,175,0
2025-05-14,UG,Georgia,727,527,2,0,200,99,99,198,2
2025-05-15,UG,Georgia,747,551,2,0,196,98,96,194,2
2025-05-16,UG,Georgia,771,565,4,0,206,99,103,202,4
2025-05-17,UG,Georgia,782,589,1,1,193,96,96,192,0
2025-05-18,UG,Georgia,790,566,3,0,224,112,109,221,3
2025-05-19,UG,Georgia,724,534,2,0,190,96,92,188,2
2025-05-20,UG,Georgia,724,551,0,0,173,84,89,173,0
2025-05-21,UG,Georgia,764,575,2,0,189,92,95,187,2
2025-05-22,UG,Georgia,764,572,0,0,192,95,97,192,0
2025-05-23,UG,Georgia,851,648,3,1,203,100,100,200,2
2025-05-24,UG,Georgia,859,651,2,2,208,106,100,206,0
2025-05-25,UG,Georgia,838,618,3,0,220,108,109,217,3
2025-05-26,UG,Georgia,799,612,1,1,187,97,89,186,0
2025-05-27,UG,Georgia,810,616,2,0,194,93,99,192,2
2025-05-28,UG,Georgia,862,654,3,0,208,105,100,205,3
2025-05-29,UG,Georgia,822,613,0,0,209,103,106,209,0
2025-05-30,UG,Georgia,862,652,3,0,210,102,105,207,3
2025-05-31,UG,Georgia,860,638,1,0,222,109,112,221,1
2025-06-01,UG,Georgia,829,596,3,0,233,115,115,230,3
2025-06-02,UG,Georgia,792,570,2,0,222,112,108,220,2
2025-06-03,UG,Georgia,856,633,0,0,223,110,113,223,0
2025-06-04,UG,Georgia,909,668,3,0,241,117,121,238,3
2025-06-05,UG,Georgia,944,682,2,1,262,132,128,260,1
2025-06-06,UG,Georgia,927,674,2,0,253,124,127,251,2
2025-06-07,UG,Georgia,950,705,0,0,245,122,123,245,0
2025-06-08,UG,Georgia,946,687,2,0,259,130,127,257,2
2025-06-09,UG,Georgia,939,683,5,0,256,128,123,251,5
2025-06-10,UG,Georgia,936,692,0,0,244,123,121,244,0
2025-06-11,UG,Georgia,915,684,2,0,231,114,115,229,2
2025-06-12,UG,Georgia,989,732,0,0,257,128,129,257,0
2025-06-13,UG,Georgia,949,759,1,1,190,93,96,189,0
2025-06-14,UG,Georgia,991,776,1,0,215,104,110,214,1
2025-06-15,UG,Georgia,961,749,2,0,212,104,106,210,2
2025-06-16,UG,Georgia,913,711,2,0,202,106,94,200,2
2025-06-17,UG,Georgia,944,743,0,0,201,98,103,201,0
2025-06-18,UG,Georgia,955,742,2,0,213,105,106,211,2
2025-06-19,UG,Georgia,961,749,3,1,212,105,104,209,2
2025-06-20,UG,Georgia,949,755,2,0,194,96,96,192,2
2025-06-21,UG,Georgia,976,755,0,0,221,110,111,221,0
2025-06-22,UG,Georgia,952,734,2,0,218,110,106,216,2
2025-06-23,UG,Georgia,906,711,1,0,195,98,96,194,1
2025-06-24,UG,Georgia,936,732,0,0,204,101,103,204,0
2025-06-25,UG,Georgia,957,744,2,0,213,105,106,211,2
2025-06-26,UG,Georgia,999,785,2,0,214,105,107,212,2
2025-06-27,UG,Georgia,977,757,2,0,220,111,107,218,2
2025-06-28,UG,Georgia,1010,785,0,0,225,111,114,225,0
2025-06-29,UG,Georgia,978,751,2,0,227,113,112,225,2
2025-06-30,UG,Georgia,899,695,4,0,204,101,99,200,4
2025-07-01,UG,Georgia,966,736,0,0,230,113,117,230,0
2025-07-02,UG,Georgia,942,701,2,0,241,119,120,239,2
2025-07-03,UG,Georgia,990,743,2,0,247,122,123,245,2
2025-07-04,UG,Georgia,989,756,2,0,233,116,115,231,2
2025-07-05,UG,Georgia,992,763,0,0,229,114,115,229,0
2025-07-06,UG,Georgia,988,734,2,0,254,130,122,252,2
2025-07-07,UG,Georgia,947,712,5,1,235,117,113,230,4
2025-07-08,UG,Georgia,1018,771,1,0,247,119,127,246,1
2025-07-09,UG,Georgia,958,712,1,0,246,124,121,245,1
2025-07-10,UG,Georgia,982,731,2,0,251,123,126,249,2
2025-07-11,UG,Georgia,1006,767,2,0,239,119,118,237,2
2025-07-12,UG,Georgia,975,732,0,0,243,122,121,243,0
2025-07-13,UG,Georgia,940,697,0,0,243,122,121,243,0
2025-07-14,UG,Georgia,917,682,2,0,235,118,115,233,2
2025-07-15,UG,Georgia,940,699,0,0,241,116,125,241,0
2025-07-16,UG,Georgia,942,689,2,0,253,126,125,251,2
2025-07-17,UG,Georgia,939,677,2,0,262,135,125,260,2
2025-07-18,UG,Georgia,938,703,0,0,235,112,123,235,0
2025-07-19,UG,Georgia,988,737,1,0,251,128,122,250,1
2025-07-20,UG,Georgia,943,700,2,0,243,118,123,241,2
2025-07-21,UG,Georgia,916,672,2,0,244,124,118,242,2
2025-07-22,UG,Georgia,971,715,0,0,256,125,131,256,0
2025-07-23,UG,Georgia,970,719,2,0,251,124,125,249,2
2025-07-24,UG,Georgia,961,704,2,0,257,128,127,255,2
2025-07-25,UG,Georgia,1003,752,2,0,251,125,124,249,2
2025-07-26,UG,Georgia,992,741,0,0,251,125,126,251,0
2025-07-27,UG,Georgia,988,727,2,0,261,130,129,259,2
2025-07-28,UG,Georgia,962,715,2,0,247,125,120,245,2
2025-07-29,UG,Georgia,944,694,0,0,250,124,126,250,0
2025-07-30,UG,Georgia,922,679,2,0,243,117,124,241,2
2025-07-31,UG,Georgia,966,699,0,0,267,136,131,267,0
2025-08-01,UG,Georgia,963,716,0,0,247,120,127,247,0
2025-08-02,UG,Georgia,1043,775,0,0,268,131,137,268,0
2025-08-03,UG,Georgia,1000,744,2,0,256,131,123,254,2
2025-08-04,UG,Georgia,969,731,0,0,238,122,116,238,0
2025-08-05,UG,Georgia,987,727,0,0,260,128,132,260,0
2025-08-06,UG,Georgia,1013,757,2,0,256,126,128,254,2
2025-08-07,UG,Georgia,1033,759,2,0,274,138,134,272,2
2025-08-08,UG,Georgia,978,734,2,0,244,119,123,242,2
2025-08-09,UG,Georgia,991,737,1,0,254,125,128,253,1
2025-08-10,UG,Georgia,988,716,3,0,272,135,134,269,3
2025-08-11,UG,Georgia,923,672,0,0,251,129,122,251,0
2025-08-12,UG,Georgia,976,707,2,0,269,131,136,267,2
2025-08-13,UG,Georgia,960,702,2,0,258,129,127,256,2
2025-08-14,UG,Georgia,988,716,2,0,272,136,134,270,2
2025-08-15,UG,Georgia,987,731,2,0,256,125,129,254,2
2025-08-16,UG,Georgia,1002,741,1,0,261,129,131,260,1
2025-08-17,UG,Georgia,990,716,2,0,274,136,136,272,2
2025-08-18,UG,Georgia,903,661,2,0,242,122,118,240,2
2025-08-19,UG,Georgia,966,691,0,0,275,135,140,275,0
2025-08-20,UG,Georgia,940,678,3,1,262,129,130,259,2
2025-08-21,UG,Georgia,972,701,3,0,271,135,133,268,3
2025-08-22,UG,Georgia,1029,768,3,0,261,130,128,258,3
2025-08-23,UG,Georgia,1012,763,0,0,249,122,127,249,0
2025-08-24,UG,Georgia,1032,755,2,0,277,140,135,275,2
2025-08-25,UG,Georgia,951,687,2,0,264,132,130,262,2
2025-08-26,UG,Georgia,991,726,0,0,265,131,134,265,0
2025-08-27,UG,Georgia,980,715,2,0,265,133,130,263,2
2025-08-28,UG,Georgia,979,724,0,0,255,127,128,255,0
2025-08-29,UG,Georgia,957,705,2,0,252,124,126,250,2
2025-01-01,ED,Germany,5603,2681,196,4,2922,1395,1331,2726,192
2025-01-02,ED,Germany,7129,3241,312,7,3888,1811,1765,3576,305
2025-01-03,ED,Germany,7384,3423,322,5,3961,1826,1813,3639,317
2025-01-04,ED,Germany,7087,3359,302,5,3728,1705,1721,3426,297
2025-01-05,ED,Germany,6891,3297,216,4,3594,1674,1704,3378,212
2025-01-06,ED,Germany,7305,3400,401,23,3905,1737,1767,3504,378
2025-01-07,ED,Germany,6615,2853,494,57,3762,1624,1644,3268,437
2025-01-08,ED,Germany,6230,2554,536,69,3676,1577,1563,3140,467
2025-01-09,ED,Germany,6427,2714,481,24,3713,1608,1624,3232,457
2025-01-10,ED,Germany,7130,3197,486,27,3933,1726,1721,3447,459
2025-01-11,ED,Germany,6439,3082,362,12,3357,1517,1478,2995,350
2025-01-12,ED,Germany,6761,3174,390,5,3587,1589,1608,3197,385
2025-01-13,ED,Germany,7086,3181,631,55,3905,1613,1661,3274,576
2025-01-14,ED,Germany,6031,2438,681,37,3593,1454,1458,2912,644
2025-01-15,ED,Germany,6018,2459,467,20,3559,1552,1540,3092,447
2025-01-16,ED,Germany,6611,2789,617,51,3822,1598,1607,3205,566
2025-01-17,ED,Germany,7104,3192,505,11,3912,1703,1704,3407,494
2025-01-18,ED,Germany,6230,3038,324,8,3192,1454,1414,2868,316
2025-01-19,ED,Germany,6769,3245,411,12,3524,1545,1568,3113,399
2025-01-20,ED,Germany,7077,3251,546,36,3826,1607,1673,3280,510
2025-01-21,ED,Germany,5986,2533,584,47,3453,1435,1434,2869,537
2025-01-22,ED,Germany,6616,2714,705,52,3902,1605,1592,3197,653
2025-01-23,ED,Germany,6711,2806,623,58,3905,1653,1629,3282,565
2025-01-24,ED,Germany,7270,3214,604,38,4056,1728,1724,3452,566
2025-01-25,ED,Germany,6357,3110,343,5,3247,1474,1430,2904,338
2025-01-26,ED,Germany,6754,3195,379,13,3559,1582,1598,3180,366
2025-01-27,ED,Germany,6887,3107,533,39,3780,1618,1629,3247,494
2025-01-28,ED,Germany,6063,2433,675,60,3630,1466,1489,2955,615
2025-01-29,ED,Germany,6425,2609,679,54,3816,1581,1556,3137,625
2025-01-30,ED,Germany,6734,2782,667,49,3952,1648,1637,3285,618
2025-01-31,ED,Germany,7452,3222,668,28,4230,1772,1790,3562,640
2025-02-01,ED,Germany,6559,3167,407,9,3392,1517,1468,2985,398
2025-02-02,ED,Germany,6990,3268,424,5,3722,1641,1657,3298,419
2025-02-03,ED,Germany,7185,3232,592,45,3953,1660,1701,3361,547
2025-02-04,ED,Germany,6334,2632,654,68,3702,1519,1529,3048,586
2025-02-05,ED,Germany,6640,2744,629,51,3896,1639,1628,3267,578
2025-02-06,ED,Germany,6802,2847,586,43,3955,1683,1686,3369,543
2025-02-07,ED,Germany,7541,3313,593,38,4228,1829,1806,3635,555
2025-02-08,ED,Germany,6821,3313,428,10,3508,1553,1527,3080,418
2025-02-09,ED,Germany,7202,3319,479,13,3883,1690,1714,3404,466
2025-02-10,ED,Germany,7264,3271,557,20,3993,1705,1731,3436,537
2025-02-11,ED,Germany,6468,2683,614,47,3785,1588,1583,3171,567
2025-02-12,ED,Germany,6982,2894,684,52,4088,1703,1701,3404,632
2025-02-13,ED,Germany,6922,2861,567,33,4061,1728,1766,3494,534
2025-02-14,ED,Germany,7930,3535,574,28,4395,1932,1889,3821,546
2025-02-15,ED,Germany,7293,3611,386,6,3682,1663,1633,3296,380
2025-02-16,ED,Germany,7347,3395,433,14,3952,1770,1749,3519,419
2025-02-17,ED,Germany,7597,3322,697,44,4275,1767,1811,3578,653
2025-02-18,ED,Germany,6921,2838,753,50,4083,1674,1656,3330,703
2025-02-19,ED,Germany,7443,3068,773,55,4375,1810,1792,3602,718
2025-02-20,ED,Germany,7514,3131,736,64,4383,1827,1820,3647,672
2025-02-21,ED,Germany,7924,3423,692,40,4501,1912,1897,3809,652
2025-02-22,ED,Germany,7345,3657,447,16,3688,1626,1615,3241,431
2025-02-23,ED,Germany,7544,3518,480,16,4026,1779,1767,3546,464
2025-02-24,ED,Germany,7496,3405,632,55,4091,1694,1765,3459,577
2025-02-25,ED,Germany,6857,2784,694,55,4073,1695,1684,3379,639
2025-02-26,ED,Germany,7293,3025,689,59,4268,1798,1781,3579,630
2025-02-27,ED,Germany,6760,3050,500,46,3710,1607,1603,3210,454
2025-02-28,ED,Germany,7136,3357,477,22,3779,1656,1646,3302,455
2025-03-01,ED,Germany,7166,3486,325,4,3680,1698,1657,3355,321
2025-03-02,ED,Germany,7528,3455,444,5,4073,1819,1810,3629,439
2025-03-03,ED,Germany,7753,3426,600,37,4327,1844,1883,3727,563
2025-03-04,ED,Germany,7065,2816,681,54,4249,1776,1792,3568,627
2025-03-05,ED,Germany,7569,3154,719,44,4415,1860,1836,3696,675
2025-03-06,ED,Germany,7774,3158,727,59,4616,1955,1934,3889,668
2025-03-07,ED,Germany,8113,3482,660,36,4631,1978,1993,3971,624
2025-03-08,ED,Germany,7225,3370,435,7,3855,1712,1708,3420,428
2025-03-09,ED,Germany,7469,3458,451,6,4011,1786,1774,3560,445
2025-03-10,ED,Germany,5441,3486,358,40,1955,765,832,1597,318
2025-03-11,ED,Germany,7178,2841,663,56,4337,1847,1827,3674,607
2025-03-12,ED,Germany,7468,3043,711,48,4425,1866,1848,3714,663
2025-03-13,ED,Germany,7679,3118,713,59,4561,1915,1933,3848,654
2025-03-14,ED,Germany,8093,3487,639,29,4606,1986,1981,3967,610
2025-03-15,ED,Germany,7136,3324,410,7,3812,1707,1695,3402,403
2025-03-16,ED,Germany,7584,3468,471,9,4116,1816,1829,3645,462
2025-03-17,ED,Germany,7954,3464,684,46,4490,1893,1913,3806,638
2025-03-18,ED,Germany,7223,2853,770,45,4370,1797,1803,3600,725
2025-03-19,ED,Germany,7647,3030,812,56,4617,1916,1889,3805,756
2025-03-20,ED,Germany,7938,3197,760,59,4741,1994,1987,3981,701
2025-03-21,ED,Germany,7909,3225,722,31,4684,1981,1981,3962,691
2025-03-22,ED,Germany,7044,3208,426,6,3836,1723,1687,3410,420
2025-03-23,ED,Germany,7580,3438,414,7,4142,1849,1879,3728,407
2025-03-24,ED,Germany,7932,3417,664,49,4515,1905,1946,3851,615
2025-03-25,ED,Germany,7301,2899,760,59,4402,1818,1824,3642,701
2025-03-26,ED,Germany,7690,3134,771,66,4556,1900,1885,3785,705
2025-03-27,ED,Germany,7994,3254,812,57,4740,1974,1954,3928,755
2025-03-28,ED,Germany,8352,3570,729,35,4782,2042,2011,4053,694
2025-03-29,ED,Germany,7027,3161,436,13,3866,1720,1710,3430,423
2025-03-30,ED,Germany,8056,3614,455,7,4442,1981,2006,3987,448
2025-03-31,ED,Germany,8150,3327,647,46,4823,2056,2120,4176,601
2025-04-01,ED,Germany,8437,3537,736,53,4900,2089,2075,4164,683
2025-04-02,ED,Germany,8799,3658,776,47,5141,2184,2181,4365,729
2025-04-03,ED,Germany,8862,3649,819,52,5213,2207,2187,4394,767
2025-04-04,ED,Germany,9176,3859,788,31,5317,2263,2266,4529,757
2025-04-05,ED,Germany,8016,3615,498,11,4401,1962,1941,3903,487
2025-04-06,ED,Germany,8597,3829,513,19,4768,2116,2139,4255,494
2025-04-07,ED,Germany,8898,3718,739,47,5180,2185,2256,4441,692
2025-04-08,ED,Germany,8679,3562,827,53,5117,2119,2171,4290,774
2025-04-09,ED,Germany,8901,3551,822,65,5350,2262,2266,4528,757
2025-04-10,ED,Germany,9322,3772,916,55,5550,2314,2320,4634,861
2025-04-11,ED,Germany,9575,3867,830,31,5708,2447,2431,4878,799
2025-04-12,ED,Germany,8555,3761,498,16,4794,2202,2094,4296,482
2025-04-13,ED,Germany,8757,3820,492,4,4937,2228,2217,4445,488
2025-04-14,ED,Germany,8995,3768,708,49,5227,2258,2261,4519,659
2025-04-15,ED,Germany,8755,3672,707,39,5083,2194,2182,4376,668
2025-04-16,ED,Germany,9325,3913,768,44,5412,2339,2305,4644,724
2025-04-17,ED,Germany,9049,3768,700,52,5281,2295,2286,4581,648
2025-04-18,ED,Germany,8704,3810,426,3,4894,2244,2224,4468,423
2025-04-19,ED,Germany,8133,3663,407,8,4470,2034,2029,4063,399
2025-04-20,ED,Germany,8328,3813,324,4,4515,2083,2108,4191,320
2025-04-21,ED,Germany,8515,3825,449,3,4690,2096,2145,4241,446
2025-04-22,ED,Germany,8714,3622,697,45,5092,2200,2195,4395,652
2025-04-23,ED,Germany,8981,3724,670,39,5257,2304,2283,4587,631
2025-04-24,ED,Germany,9073,3764,692,43,5309,2294,2323,4617,649
2025-04-25,ED,Germany,9350,3880,666,37,5470,2398,2406,4804,629
2025-04-26,ED,Germany,8509,3761,492,10,4748,2142,2114,4256,482
2025-04-27,ED,Germany,9064,3944,540,4,5120,2280,2300,4580,536
2025-04-28,ED,Germany,9012,3780,740,48,5232,2227,2265,4492,692
2025-04-29,ED,Germany,8786,3521,814,49,5265,2223,2228,4451,765
2025-04-30,ED,Germany,9261,3704,778,35,5557,2407,2372,4779,743
2025-05-01,ED,Germany,8860,3939,476,5,4921,2243,2202,4445,471
2025-05-02,ED,Germany,9067,3889,555,15,5178,2315,2308,4623,540
2025-05-03,ED,Germany,8447,3834,397,14,4613,2116,2100,4216,383
2025-05-04,ED,Germany,9232,4094,497,4,5138,2282,2359,4641,493
2025-05-05,ED,Germany,9189,3910,665,29,5279,2294,2320,4614,636
2025-05-06,ED,Germany,9048,3793,734,48,5255,2269,2252,4521,686
2025-05-07,ED,Germany,9504,3905,836,29,5599,2385,2378,4763,807
2025-05-08,ED,Germany,9497,3950,817,34,5547,2366,2364,4730,783
2025-05-09,ED,Germany,9649,4064,752,26,5585,2425,2408,4833,726
2025-05-10,ED,Germany,8776,3939,523,17,4837,2163,2151,4314,506
2025-05-11,ED,Germany,9311,4186,501,7,5125,2303,2321,4624,494
2025-05-12,ED,Germany,9572,4020,820,39,5552,2338,2394,4732,781
2025-05-13,ED,Germany,9253,3907,799,42,5346,2280,2267,4547,757
2025-05-14,ED,Germany,9608,3945,895,70,5663,2393,2375,4768,825
2025-05-15,ED,Germany,9743,4019,876,67,5724,2425,2423,4848,809
2025-05-16,ED,Germany,9850,4066,808,54,5784,2495,2481,4976,754
2025-05-17,ED,Germany,8823,3947,494,13,4876,2207,2175,4382,481
2025-05-18,ED,Germany,9326,4127,534,8,5199,2321,2344,4665,526
2025-05-19,ED,Germany,9485,3979,768,60,5506,2358,2380,4738,708
2025-05-20,ED,Germany,9397,3946,789,61,5451,2331,2331,4662,728
2025-05-21,ED,Germany,9614,3973,811,48,5641,2410,2420,4830,763
2025-05-22,ED,Germany,9756,4069,793,44,5687,2475,2419,4894,749
2025-05-23,ED,Germany,9877,4136,739,36,5741,2508,2494,5002,703
2025-05-24,ED,Germany,8913,4063,474,13,4850,2206,2170,4376,461
2025-05-25,ED,Germany,9402,4233,470,10,5169,2336,2363,4699,460
2025-05-26,ED,Germany,9731,4143,754,48,5588,2389,2445,4834,706
2025-05-27,ED,Germany,9498,4030,757,54,5468,2357,2354,4711,703
2025-05-28,ED,Germany,9697,4063,660,45,5634,2513,2461,4974,615
2025-05-29,ED,Germany,9314,4015,529,10,5299,2423,2347,4770,519
2025-05-30,ED,Germany,9454,4002,546,20,5452,2435,2471,4906,526
2025-05-31,ED,Germany,9070,3969,461,8,5101,2273,2367,4640,453
2025-06-01,ED,Germany,9676,4150,502,5,5526,2526,2498,5024,497
2025-06-02,ED,Germany,9660,4145,675,42,5515,2403,2437,4840,633
2025-06-03,ED,Germany,9659,4053,791,69,5606,2404,2411,4815,722
2025-06-04,ED,Germany,9724,4112,740,41,5612,2440,2432,4872,699
2025-06-05,ED,Germany,10011,4172,848,56,5839,2539,2452,4991,792
2025-06-06,ED,Germany,10178,4193,764,46,5985,2628,2593,5221,718
2025-06-07,ED,Germany,9076,4105,451,11,4971,2293,2227,4520,440
2025-06-08,ED,Germany,9159,4147,364,4,5012,2312,2336,4648,360
2025-06-09,ED,Germany,9332,4052,511,6,5280,2350,2419,4769,505
2025-06-10,ED,Germany,9562,3907,755,56,5655,2441,2459,4900,699
2025-06-11,ED,Germany,9818,3980,807,61,5838,2520,2511,5031,746
2025-06-12,ED,Germany,10023,4173,801,66,5850,2537,2512,5049,735
2025-06-13,ED,Germany,10010,4213,693,42,5797,2545,2559,5104,651
2025-06-14,ED,Germany,9072,4061,494,11,5011,2274,2243,4517,483
2025-06-15,ED,Germany,9280,4085,421,3,5195,2374,2400,4774,418
2025-06-16,ED,Germany,9746,4085,725,40,5661,2448,2488,4936,685
2025-06-17,ED,Germany,9523,3955,760,56,5568,2409,2399,4808,704
2025-06-18,ED,Germany,9729,3920,744,44,5809,2534,2531,5065,700
2025-06-19,ED,Germany,9434,3947,598,19,5487,2484,2405,4889,579
2025-06-20,ED,Germany,9689,4070,612,26,5619,2501,2506,5007,586
2025-06-21,ED,Germany,9229,4208,464,21,5021,2270,2287,4557,443
2025-06-22,ED,Germany,9592,4123,532,8,5469,2422,2515,4937,524
2025-06-23,ED,Germany,9488,3958,727,40,5530,2387,2416,4803,687
2025-06-24,ED,Germany,9546,3940,866,83,5606,2358,2382,4740,783
2025-06-25,ED,Germany,9696,3889,889,74,5807,2473,2445,4918,815
2025-06-26,ED,Germany,9618,4110,705,42,5508,2402,2401,4803,663
2025-06-27,ED,Germany,10176,4338,783,31,5838,2550,2505,5055,752
2025-06-28,ED,Germany,9266,4253,512,10,5013,2264,2237,4501,502
2025-06-29,ED,Germany,9648,4331,548,5,5317,2377,2392,4769,543
2025-06-30,ED,Germany,9921,4317,756,36,5604,2412,2436,4848,720
2025-07-01,ED,Germany,9812,4191,803,40,5621,2409,2409,4818,763
2025-07-02,ED,Germany,9818,4265,688,42,5553,2445,2420,4865,646
2025-07-03,ED,Germany,9954,4359,728,39,5595,2440,2427,4867,689
2025-07-04,ED,Germany,10192,4580,731,29,5612,2451,2430,4881,702
2025-07-05,ED,Germany,9325,4290,480,6,5035,2293,2262,4555,474
2025-07-06,ED,Germany,9639,4364,488,7,5275,2383,2404,4787,481
2025-07-07,ED,Germany,9870,4402,629,46,5468,2394,2445,4839,583
2025-07-08,ED,Germany,9705,4130,779,59,5575,2402,2394,4796,720
2025-07-09,ED,Germany,10072,4313,800,52,5759,2482,2477,4959,748
2025-07-10,ED,Germany,10194,4317,866,57,5877,2523,2488,5011,809
2025-07-11,ED,Germany,10293,4446,748,41,5847,2550,2549,5099,707
2025-07-12,ED,Germany,9410,4342,471,11,5068,2322,2275,4597,460
2025-07-13,ED,Germany,9773,4469,476,4,5304,2417,2411,4828,472
2025-07-14,ED,Germany,9955,4372,709,38,5583,2406,2468,4874,671
2025-07-15,ED,Germany,9940,4344,778,55,5596,2413,2405,4818,723
2025-07-16,ED,Germany,9965,4337,691,54,5628,2470,2467,4937,637
2025-07-17,ED,Germany,10212,4364,852,64,5848,2495,2501,4996,788
2025-07-18,ED,Germany,10393,4471,738,38,5922,2605,2579,5184,700
2025-07-19,ED,Germany,9380,4365,471,12,5015,2280,2264,4544,459
2025-07-20,ED,Germany,9488,4335,402,5,5153,2369,2382,4751,397
2025-07-21,ED,Germany,9914,4343,638,56,5571,2449,2484,4933,582
2025-07-22,ED,Germany,9956,4419,676,43,5537,2430,2431,4861,633
2025-07-23,ED,Germany,10149,4420,749,49,5729,2501,2479,4980,700
2025-07-24,ED,Germany,9979,4340,686,46,5639,2469,2484,4953,640
2025-07-25,ED,Germany,10080,4374,661,34,5706,2522,2523,5045,627
2025-07-26,ED,Germany,9295,4285,445,9,5010,2312,2253,4565,436
2025-07-27,ED,Germany,9270,4231,370,2,5039,2323,2346,4669,368
2025-07-28,ED,Germany,9904,4413,571,32,5491,2442,2478,4920,539
2025-07-29,ED,Germany,9762,4253,692,42,5509,2414,2403,4817,650
2025-07-30,ED,Germany,9871,4233,692,46,5638,2476,2470,4946,646
2025-07-31,ED,Germany,9961,4333,619,42,5628,2505,2504,5009,577
2025-08-01,ED,Germany,9728,4194,552,29,5534,2491,2491,4982,523
2025-08-02,ED,Germany,9214,4218,413,4,4996,2318,2265,4583,409
2025-08-03,ED,Germany,9707,4409,460,7,5298,2412,2426,4838,453
2025-08-04,ED,Germany,9975,4382,661,26,5593,2449,2483,4932,635
2025-08-05,ED,Germany,9629,4247,656,37,5382,2369,2357,4726,619
2025-08-06,ED,Germany,10007,4317,704,40,5690,2483,2503,4986,664
2025-08-07,ED,Germany,9813,4231,670,31,5582,2462,2450,4912,639
2025-08-08,ED,Germany,10108,4288,647,25,5820,2578,2595,5173,622
2025-08-09,ED,Germany,9313,4266,428,8,5047,2326,2293,4619,420
2025-08-10,ED,Germany,9674,4369,443,8,5305,2424,2438,4862,435
2025-08-11,ED,Germany,9805,4227,644,52,5578,2442,2492,4934,592
2025-08-12,ED,Germany,9660,4162,680,34,5498,2409,2409,4818,646
2025-08-13,ED,Germany,9935,4310,661,36,5625,2481,2483,4964,625
2025-08-14,ED,Germany,9865,4257,701,38,5608,2458,2449,4907,663
2025-08-15,ED,Germany,9845,4262,574,27,5583,2508,2501,5009,547
2025-08-16,ED,Germany,9079,4091,406,6,4988,2320,2262,4582,400
2025-08-17,ED,Germany,9585,4287,473,12,5298,2382,2443,4825,461
2025-08-18,ED,Germany,9868,4288,638,40,5580,2445,2497,4942,598
2025-08-19,ED,Germany,9801,4265,704,43,5536,2427,2405,4832,661
2025-08-20,ED,Germany,9954,4266,725,61,5688,2485,2478,4963,664
2025-08-21,ED,Germany,9987,4293,726,49,5694,2488,2480,4968,677
2025-08-22,ED,Germany,10150,4311,685,37,5839,2609,2545,5154,648
2025-08-23,ED,Germany,9259,4227,422,4,5032,2313,2297,4610,418
2025-08-24,ED,Germany,9705,4351,469,5,5354,2424,2461,4885,464
2025-08-25,ED,Germany,10000,4309,694,50,5691,2476,2521,4997,644
2025-08-26,ED,Germany,9826,4219,720,55,5607,2441,2446,4887,665
2025-08-27,ED,Germany,10000,4289,701,56,5711,2520,2490,5010,645
2025-08-28,ED,Germany,10084,4502,627,54,5582,2477,2478,4955,573
2025-08-29,ED,Germany,10377,4500,666,40,5877,2597,2614,5211,626
2025-01-01,LG,Greece,1803,1229,175,5,574,202,197,399,170
2025-01-02,LG,Greece,2174,1376,264,11,798,269,265,534,253
2025-01-03,LG,Greece,2158,1304,321,14,854,266,267,533,307
2025-01-04,LG,Greece,2180,1496,250,6,684,219,215,434,244
2025-01-05,LG,Greece,2290,1518,264,6,772,251,257,508,258
2025-01-06,LG,Greece,2136,1306,318,3,830,256,256,512,315
2025-01-07,LG,Greece,1946,1223,278,12,723,221,224,445,266
2025-01-08,LG,Greece,1797,1161,246,24,636,199,191,390,222
2025-01-09,LG,Greece,1868,1199,260,18,669,207,202,409,242
2025-01-10,LG,Greece,1891,1154,278,13,737,226,233,459,265
2025-01-11,LG,Greece,1872,1272,223,9,600,185,192,377,214
2025-01-12,LG,Greece,2011,1312,249,5,699,228,222,450,244
2025-01-13,LG,Greece,1736,1066,237,11,670,220,213,433,226
2025-01-14,LG,Greece,1514,971,209,15,543,167,167,334,194
2025-01-15,LG,Greece,1595,1012,229,26,583,177,177,354,203
2025-01-16,LG,Greece,1718,1078,243,29,640,202,195,397,214
2025-01-17,LG,Greece,1732,1022,274,20,710,213,223,436,254
2025-01-18,LG,Greece,1790,1227,217,9,563,171,175,346,208
2025-01-19,LG,Greece,1947,1285,240,6,662,211,211,422,234
2025-01-20,LG,Greece,1783,1083,272,17,700,216,212,428,255
2025-01-21,LG,Greece,1578,1016,234,27,562,160,168,328,207
2025-01-22,LG,Greece,1585,1012,219,16,573,178,176,354,203
2025-01-23,LG,Greece,1819,1197,234,22,622,197,191,388,212
2025-01-24,LG,Greece,1832,1088,285,16,744,229,230,459,269
2025-01-25,LG,Greece,1836,1282,213,4,554,173,168,341,209
2025-01-26,LG,Greece,2027,1352,253,5,675,212,210,422,248
2025-01-27,LG,Greece,1820,1116,279,16,704,210,215,425,263
2025-01-28,LG,Greece,1594,1046,235,17,548,157,156,313,218
2025-01-29,LG,Greece,1655,1074,237,15,581,172,172,344,222
2025-01-30,LG,Greece,1775,1119,254,26,656,205,197,402,228
2025-01-31,LG,Greece,1849,1103,277,14,746,228,241,469,263
2025-02-01,LG,Greece,1886,1280,248,9,606,179,179,358,239
2025-02-02,LG,Greece,1982,1283,252,3,699,226,221,447,249
2025-02-03,LG,Greece,1786,1044,304,13,742,215,223,438,291
2025-02-04,LG,Greece,1671,1045,265,24,626,185,176,361,241
2025-02-05,LG,Greece,1704,1051,275,31,653,186,192,378,244
2025-02-06,LG,Greece,1881,1180,282,16,701,211,208,419,266
2025-02-07,LG,Greece,1968,1176,301,10,792,245,246,491,291
2025-02-08,LG,Greece,1903,1294,232,6,609,185,192,377,226
2025-02-09,LG,Greece,2009,1298,256,5,711,231,224,455,251
2025-02-10,LG,Greece,1868,1124,289,24,744,226,229,455,265
2025-02-11,LG,Greece,1739,1136,249,24,603,176,178,354,225
2025-02-12,LG,Greece,1764,1096,271,30,668,198,199,397,241
2025-02-13,LG,Greece,1866,1165,278,19,701,215,208,423,259
2025-02-14,LG,Greece,2008,1234,278,13,774,249,247,496,265
2025-02-15,LG,Greece,1974,1357,241,1,617,188,188,376,240
2025-02-16,LG,Greece,2146,1411,265,0,735,232,238,470,265
2025-02-17,LG,Greece,1961,1180,288,24,781,243,250,493,264
2025-02-18,LG,Greece,1802,1132,263,25,670,201,206,407,238
2025-02-19,LG,Greece,1873,1148,293,32,725,217,215,432,261
2025-02-20,LG,Greece,1975,1211,300,26,764,235,229,464,274
2025-02-21,LG,Greece,1950,1174,289,12,776,241,246,487,277
2025-02-22,LG,Greece,1969,1332,245,9,637,196,196,392,236
2025-02-23,LG,Greece,2169,1420,282,5,749,239,228,467,277
2025-02-24,LG,Greece,2081,1281,301,37,800,244,255,499,264
2025-02-25,LG,Greece,1857,1184,248,12,673,216,209,425,236
2025-02-26,LG,Greece,1905,1200,277,23,705,216,212,428,254
2025-02-27,LG,Greece,2067,1267,315,13,800,244,241,485,302
2025-02-28,LG,Greece,1364,1275,19,2,89,29,41,70,17
2025-03-01,LG,Greece,2171,1405,291,3,766,240,235,475,288
2025-03-02,LG,Greece,2105,1373,251,1,732,242,239,481,250
2025-03-03,LG,Greece,1948,1155,280,2,793,253,260,513,278
2025-03-04,LG,Greece,1889,1164,279,29,725,223,223,446,250
2025-03-05,LG,Greece,1929,1195,290,34,734,224,220,444,256
2025-03-06,LG,Greece,2062,1275,306,34,787,245,236,481,272
2025-03-07,LG,Greece,2127,1311,305,20,816,251,260,511,285
2025-03-08,LG,Greece,2096,1423,248,5,673,212,213,425,243
2025-03-09,LG,Greece,2173,1389,275,1,784,254,255,509,274
2025-03-10,LG,Greece,1874,1118,299,15,756,225,232,457,284
2025-03-11,LG,Greece,1892,1161,273,33,731,229,229,458,240
2025-03-12,LG,Greece,1924,1201,269,26,723,228,226,454,243
2025-03-13,LG,Greece,1978,1206,295,20,772,241,236,477,275
2025-03-14,LG,Greece,1989,1164,286,6,825,263,276,539,280
2025-03-15,LG,Greece,2000,1315,241,4,685,225,219,444,237
2025-03-16,LG,Greece,2206,1437,256,4,769,257,256,513,252
2025-03-17,LG,Greece,2003,1193,292,18,810,258,260,518,274
2025-03-18,LG,Greece,1783,1117,245,11,666,211,210,421,234
2025-03-19,LG,Greece,1830,1098,252,20,732,234,246,480,232
2025-03-20,LG,Greece,2022,1196,320,22,826,253,253,506,298
2025-03-21,LG,Greece,2073,1205,315,13,868,284,269,553,302
2025-03-22,LG,Greece,2072,1388,242,5,684,222,220,442,237
2025-03-23,LG,Greece,2114,1374,227,1,740,260,253,513,226
2025-03-24,LG,Greece,1901,1149,241,17,752,248,263,511,224
2025-03-25,LG,Greece,1873,1158,252,3,715,230,233,463,249
2025-03-26,LG,Greece,1931,1166,283,14,765,236,246,482,269
2025-03-27,LG,Greece,2000,1233,284,18,767,241,242,483,266
2025-03-28,LG,Greece,2064,1262,278,3,802,261,263,524,275
2025-03-29,LG,Greece,2062,1398,236,1,664,212,216,428,235
2025-03-30,LG,Greece,2593,1569,306,1,1024,357,361,718,305
2025-03-31,LG,Greece,2287,1338,320,21,949,319,310,629,299
2025-04-01,LG,Greece,2386,1430,317,33,956,315,324,639,284
2025-04-02,LG,Greece,2495,1506,339,23,989,327,323,650,316
2025-04-03,LG,Greece,2547,1457,351,17,1090,371,368,739,334
2025-04-04,LG,Greece,2679,1596,348,12,1083,365,370,735,336
2025-04-05,LG,Greece,2850,1748,276,6,1102,413,413,826,270
2025-04-06,LG,Greece,2817,1732,284,5,1085,403,398,801,279
2025-04-07,LG,Greece,2559,1501,330,23,1058,361,367,728,307
2025-04-08,LG,Greece,2514,1496,310,22,1018,361,347,708,288
2025-04-09,LG,Greece,1745,1548,74,15,197,50,73,123,59
2025-04-10,LG,Greece,3023,1636,396,22,1387,496,495,991,374
2025-04-11,LG,Greece,3004,1724,374,18,1280,455,451,906,356
2025-04-12,LG,Greece,3195,1852,329,7,1343,508,506,1014,322
2025-04-13,LG,Greece,2980,1732,332,2,1248,459,457,916,330
2025-04-14,LG,Greece,2925,1669,397,19,1256,434,425,859,378
2025-04-15,LG,Greece,2844,1630,385,19,1214,416,413,829,366
2025-04-16,LG,Greece,2914,1669,402,18,1245,426,417,843,384
2025-04-17,LG,Greece,2912,1537,409,8,1375,481,485,966,401
2025-04-18,LG,Greece,2978,1645,375,7,1333,471,487,958,368
2025-04-19,LG,Greece,3111,1740,314,5,1371,530,527,1057,309
2025-04-20,LG,Greece,2998,1781,247,4,1217,483,487,970,243
2025-04-21,LG,Greece,2959,1615,407,4,1344,477,460,937,403
2025-04-22,LG,Greece,2807,1498,412,14,1309,450,447,897,398
2025-04-23,LG,Greece,2749,1523,386,12,1226,418,422,840,374
2025-04-24,LG,Greece,2858,1556,383,4,1302,458,461,919,379
2025-04-25,LG,Greece,3026,1690,371,5,1336,479,486,965,366
2025-04-26,LG,Greece,3395,1869,337,1,1526,598,591,1189,336
2025-04-27,LG,Greece,3232,1727,357,4,1505,571,577,1148,353
2025-04-28,LG,Greece,2748,1442,385,13,1306,458,463,921,372
2025-04-29,LG,Greece,2679,1403,368,15,1276,454,454,908,353
2025-04-30,LG,Greece,2804,1488,366,7,1316,480,470,950,359
2025-05-01,LG,Greece,3101,1588,335,0,1513,586,592,1178,335
2025-05-02,LG,Greece,3169,1572,374,12,1597,603,620,1223,362
2025-05-03,LG,Greece,3428,1702,306,2,1726,715,705,1420,304
2025-05-04,LG,Greece,3567,1735,373,4,1832,729,730,1459,369
2025-05-05,LG,Greece,3062,1512,395,16,1550,578,577,1155,379
2025-05-06,LG,Greece,3013,1465,388,21,1548,581,579,1160,367
2025-05-07,LG,Greece,2997,1519,390,28,1478,545,543,1088,362
2025-05-08,LG,Greece,3199,1571,384,17,1628,625,619,1244,367
2025-05-09,LG,Greece,3161,1486,382,14,1675,643,650,1293,368
2025-05-10,LG,Greece,3484,1660,319,1,1824,748,757,1505,318
2025-05-11,LG,Greece,3474,1647,359,6,1827,738,730,1468,353
2025-05-12,LG,Greece,3128,1564,391,18,1564,580,593,1173,373
2025-05-13,LG,Greece,2986,1435,373,25,1551,594,584,1178,348
2025-05-14,LG,Greece,3027,1517,384,21,1510,567,559,1126,363
2025-05-15,LG,Greece,3162,1486,405,18,1676,626,645,1271,387
2025-05-16,LG,Greece,3320,1570,401,19,1750,663,686,1349,382
2025-05-17,LG,Greece,3694,1657,402,4,2037,826,809,1635,398
2025-05-18,LG,Greece,3591,1675,389,4,1916,770,757,1527,385
2025-05-19,LG,Greece,3148,1508,431,24,1640,604,605,1209,407
2025-05-20,LG,Greece,3150,1521,404,26,1629,614,611,1225,378
2025-05-21,LG,Greece,3110,1518,426,25,1592,583,583,1166,401
2025-05-22,LG,Greece,3396,1571,425,24,1825,700,700,1400,401
2025-05-23,LG,Greece,3505,1570,419,9,1935,748,768,1516,410
2025-05-24,LG,Greece,3862,1742,372,3,2120,872,876,1748,369
2025-05-25,LG,Greece,3681,1639,365,5,2042,843,834,1677,360
2025-05-26,LG,Greece,3438,1524,432,18,1914,740,742,1482,414
2025-05-27,LG,Greece,3371,1522,423,32,1849,712,714,1426,391
2025-05-28,LG,Greece,3342,1489,426,25,1853,717,710,1427,401
2025-05-29,LG,Greece,3570,1649,423,23,1921,741,757,1498,400
2025-05-30,LG,Greece,3654,1596,415,7,2058,823,820,1643,408
2025-05-31,LG,Greece,3834,1645,360,2,2189,918,911,1829,358
2025-06-01,LG,Greece,3996,1702,421,1,2294,936,937,1873,420
2025-06-02,LG,Greece,3647,1516,466,16,2131,835,830,1665,450
2025-06-03,LG,Greece,3728,1610,479,21,2118,818,821,1639,458
2025-06-04,LG,Greece,3748,1674,454,22,2074,811,809,1620,432
2025-06-05,LG,Greece,3773,1642,455,15,2131,833,843,1676,440
2025-06-06,LG,Greece,3804,1545,495,8,2259,876,888,1764,487
2025-06-07,LG,Greece,4124,1718,412,1,2406,998,996,1994,411
2025-06-08,LG,Greece,4187,1815,420,1,2372,978,974,1952,419
2025-06-09,LG,Greece,3908,1678,482,2,2230,876,872,1748,480
2025-06-10,LG,Greece,3842,1615,483,29,2227,868,876,1744,454
2025-06-11,LG,Greece,3932,1741,483,17,2191,854,854,1708,466
2025-06-12,LG,Greece,3982,1750,475,16,2232,880,877,1757,459
2025-06-13,LG,Greece,4208,1950,472,9,2258,883,903,1786,463
2025-06-14,LG,Greece,4676,2234,441,6,2442,1000,1001,2001,435
2025-06-15,LG,Greece,4548,2176,466,2,2372,959,947,1906,464
2025-06-16,LG,Greece,4253,2028,488,18,2225,864,873,1737,470
2025-06-17,LG,Greece,4323,2067,511,25,2256,868,877,1745,486
2025-06-18,LG,Greece,4365,2127,532,31,2238,853,853,1706,501
2025-06-19,LG,Greece,4326,2059,497,14,2267,883,887,1770,483
2025-06-20,LG,Greece,4604,2156,503,11,2448,976,969,1945,492
2025-06-21,LG,Greece,4904,2321,449,5,2583,1070,1064,2134,444
2025-06-22,LG,Greece,4776,2288,494,15,2488,998,996,1994,479
2025-06-23,LG,Greece,4426,2008,522,7,2418,943,953,1896,515
2025-06-24,LG,Greece,4324,1916,501,18,2408,957,950,1907,483
2025-06-25,LG,Greece,4420,2104,497,32,2316,905,914,1819,465
2025-06-26,LG,Greece,4261,1867,509,16,2394,945,940,1885,493
2025-06-27,LG,Greece,4350,1821,528,15,2529,1000,1001,2001,513
2025-06-28,LG,Greece,4622,1953,470,13,2669,1099,1100,2199,457
2025-06-29,LG,Greece,4575,1923,468,13,2652,1085,1099,2184,455
2025-06-30,LG,Greece,4317,1805,524,15,2512,1004,984,1988,509
2025-07-01,LG,Greece,4469,1899,537,16,2570,1020,1013,2033,521
2025-07-02,LG,Greece,4465,1950,525,24,2515,997,993,1990,501
2025-07-03,LG,Greece,4372,1879,506,16,2493,993,994,1987,490
2025-07-04,LG,Greece,4429,1856,543,6,2573,1007,1023,2030,537
2025-07-05,LG,Greece,4824,1968,501,6,2856,1178,1177,2355,495
2025-07-06,LG,Greece,4740,1978,492,5,2762,1141,1129,2270,487
2025-07-07,LG,Greece,4539,1898,525,10,2641,1063,1053,2116,515
2025-07-08,LG,Greece,4404,1843,505,16,2561,1023,1033,2056,489
2025-07-09,LG,Greece,4414,1893,496,18,2521,1017,1008,2025,478
2025-07-10,LG,Greece,4477,1887,518,13,2590,1033,1039,2072,505
2025-07-11,LG,Greece,4443,1819,523,4,2624,1044,1057,2101,519
2025-07-12,LG,Greece,4782,1934,472,0,2848,1192,1184,2376,472
2025-07-13,LG,Greece,4747,1964,483,0,2783,1155,1145,2300,483
2025-07-14,LG,Greece,4431,1847,515,17,2584,1039,1030,2069,498
2025-07-15,LG,Greece,4518,1862,523,12,2656,1061,1072,2133,511
2025-07-16,LG,Greece,4554,1918,512,17,2636,1065,1059,2124,495
2025-07-17,LG,Greece,4584,1983,511,19,2601,1039,1051,2090,492
2025-07-18,LG,Greece,4510,1814,522,7,2696,1086,1088,2174,515
2025-07-19,LG,Greece,4773,1925,475,2,2848,1197,1176,2373,473
2025-07-20,LG,Greece,4717,1919,479,4,2798,1159,1160,2319,475
2025-07-21,LG,Greece,4530,1879,496,7,2651,1081,1074,2155,489
2025-07-22,LG,Greece,4479,1862,502,19,2617,1055,1060,2115,483
2025-07-23,LG,Greece,4495,1922,491,9,2573,1040,1042,2082,482
2025-07-24,LG,Greece,4426,1810,479,10,2616,1071,1066,2137,469
2025-07-25,LG,Greece,4491,1816,524,6,2675,1063,1088,2151,518
2025-07-26,LG,Greece,4862,1963,483,6,2899,1214,1202,2416,477
2025-07-27,LG,Greece,4900,2083,498,6,2817,1160,1159,2319,492
2025-07-28,LG,Greece,4514,1867,501,8,2647,1074,1072,2146,493
2025-07-29,LG,Greece,4499,1897,504,11,2602,1053,1045,2098,493
2025-07-30,LG,Greece,4536,1887,523,37,2649,1062,1064,2126,486
2025-07-31,LG,Greece,4508,1889,497,12,2619,1062,1060,2122,485
2025-08-01,LG,Greece,4570,1809,531,15,2761,1103,1127,2230,516
2025-08-02,LG,Greece,4897,1997,481,1,2900,1219,1200,2419,480
2025-08-03,LG,Greece,4828,2021,486,1,2807,1154,1167,2321,485
2025-08-04,LG,Greece,4535,1926,492,15,2609,1060,1057,2117,477
2025-08-05,LG,Greece,4545,1878,522,22,2667,1077,1068,2145,500
2025-08-06,LG,Greece,4489,1914,484,15,2575,1048,1043,2091,469
2025-08-07,LG,Greece,4544,1896,502,24,2648,1067,1079,2146,478
2025-08-08,LG,Greece,4481,1818,492,6,2663,1082,1089,2171,486
2025-08-09,LG,Greece,4850,1923,476,3,2927,1229,1222,2451,473
2025-08-10,LG,Greece,4916,2046,500,2,2870,1188,1182,2370,498
2025-08-11,LG,Greece,4549,1927,509,18,2622,1055,1058,2113,491
2025-08-12,LG,Greece,4526,1896,501,25,2630,1064,1065,2129,476
2025-08-13,LG,Greece,4517,1896,520,28,2621,1052,1049,2101,492
2025-08-14,LG,Greece,4428,1864,471,10,2564,1045,1048,2093,461
2025-08-15,LG,Greece,4455,1851,483,0,2604,1054,1067,2121,483
2025-08-16,LG,Greece,4791,1933,476,1,2858,1196,1186,2382,475
2025-08-17,LG,Greece,4891,2099,481,3,2792,1156,1155,2311,478
2025-08-18,LG,Greece,4601,1985,522,21,2616,1053,1041,2094,501
2025-08-19,LG,Greece,4505,1935,494,13,2570,1033,1043,2076,481
2025-08-20,LG,Greece,4514,1933,500,9,2581,1044,1037,2081,491
2025-08-21,LG,Greece,4496,1910,495,15,2586,1051,1040,2091,480
2025-08-22,LG,Greece,4521,1912,508,9,2609,1039,1062,2101,499
2025-08-23,LG,Greece,4827,1982,463,1,2845,1204,1178,2382,462
2025-08-24,LG,Greece,4819,2055,475,1,2764,1139,1150,2289,474
2025-08-25,LG,Greece,4548,1942,513,13,2606,1047,1046,2093,500
2025-08-26,LG,Greece,4481,1895,480,14,2586,1050,1056,2106,466
2025-08-27,LG,Greece,4429,1919,475,8,2510,1022,1013,2035,467
2025-08-28,LG,Greece,4453,1900,476,14,2553,1043,1034,2077,462
2025-08-29,LG,Greece,4391,1784,509,8,2607,1035,1063,2098,501
2025-01-01,LH,Hungary,2132,1819,0,0,313,155,158,313,0
2025-01-02,LH,Hungary,2546,2164,0,0,382,188,194,382,0
2025-01-03,LH,Hungary,2695,2314,0,0,381,189,192,381,0
2025-01-04,LH,Hungary,2633,2293,4,0,340,168,168,336,4
2025-01-05,LH,Hungary,2586,2201,4,2,385,191,190,381,2
2025-01-06,LH,Hungary,2635,2256,2,0,379,189,188,377,2
2025-01-07,LH,Hungary,2429,2101,5,3,328,163,160,323,2
2025-01-08,LH,Hungary,2331,2045,4,1,286,141,141,282,3
2025-01-09,LH,Hungary,2405,2062,7,1,343,168,168,336,6
2025-01-10,LH,Hungary,2592,2229,5,1,363,179,179,358,4
2025-01-11,LH,Hungary,2497,2206,3,2,291,146,142,288,1
2025-01-12,LH,Hungary,2572,2204,2,0,368,180,186,366,2
2025-01-13,LH,Hungary,2418,2072,1,1,346,173,172,345,0
2025-01-14,LH,Hungary,2220,1950,6,1,270,134,130,264,5
2025-01-15,LH,Hungary,2290,2018,1,1,272,131,140,271,0
2025-01-16,LH,Hungary,2448,2102,3,2,346,171,172,343,1
2025-01-17,LH,Hungary,2556,2204,0,0,352,177,175,352,0
2025-01-18,LH,Hungary,2402,2111,0,0,291,148,143,291,0
2025-01-19,LH,Hungary,2531,2194,0,0,337,163,174,337,0
2025-01-20,LH,Hungary,2438,2093,2,2,345,170,173,343,0
2025-01-21,LH,Hungary,2203,1947,1,1,256,131,124,255,0
2025-01-22,LH,Hungary,2271,1989,1,1,282,142,139,281,0
2025-01-23,LH,Hungary,2381,2060,4,0,321,160,157,317,4
2025-01-24,LH,Hungary,2492,2118,3,1,374,183,188,371,2
2025-01-25,LH,Hungary,2354,2056,0,0,298,151,147,298,0
2025-01-26,LH,Hungary,2472,2116,7,3,356,171,178,349,4
2025-01-27,LH,Hungary,2365,2013,3,0,352,174,175,349,3
2025-01-28,LH,Hungary,2158,1876,8,4,282,141,133,274,4
2025-01-29,LH,Hungary,2218,1910,14,3,308,147,147,294,11
2025-01-30,LH,Hungary,2392,2047,8,4,345,166,171,337,4
2025-01-31,LH,Hungary,2515,2148,6,3,367,182,179,361,3
2025-02-01,LH,Hungary,2441,2131,3,1,310,158,149,307,2
2025-02-02,LH,Hungary,2529,2183,3,0,346,169,174,343,3
2025-02-03,LH,Hungary,2383,2017,7,2,366,179,180,359,5
2025-02-04,LH,Hungary,2196,1913,1,1,283,142,140,282,0
2025-02-05,LH,Hungary,2194,1887,5,5,307,151,151,302,0
2025-02-06,LH,Hungary,2333,1978,8,1,355,173,174,347,7
2025-02-07,LH,Hungary,2527,2159,8,3,368,176,184,360,5
2025-02-08,LH,Hungary,2466,2152,4,1,314,157,153,310,3
2025-02-09,LH,Hungary,2528,2161,5,1,367,178,184,362,4
2025-02-10,LH,Hungary,2387,2017,5,2,370,186,179,365,3
2025-02-11,LH,Hungary,2266,1968,5,2,298,146,147,293,3
2025-02-12,LH,Hungary,2317,2005,10,6,312,151,151,302,4
2025-02-13,LH,Hungary,2440,2094,2,0,346,171,173,344,2
2025-02-14,LH,Hungary,2646,2273,4,0,373,185,184,369,4
2025-02-15,LH,Hungary,2551,2235,3,2,316,159,154,313,1
2025-02-16,LH,Hungary,2568,2200,5,3,368,174,189,363,2
2025-02-17,LH,Hungary,2459,2092,6,0,367,183,178,361,6
2025-02-18,LH,Hungary,2291,1987,12,6,304,146,146,292,6
2025-02-19,LH,Hungary,2347,2014,8,2,333,161,164,325,6
2025-02-20,LH,Hungary,2479,2102,12,9,377,182,183,365,3
2025-02-21,LH,Hungary,2460,2076,4,4,384,193,187,380,0
2025-02-22,LH,Hungary,2381,2077,1,1,304,151,152,303,0
2025-02-23,LH,Hungary,2572,2187,4,3,385,185,196,381,1
2025-02-24,LH,Hungary,2430,2051,10,1,379,187,182,369,9
2025-02-25,LH,Hungary,2303,2004,6,1,299,147,146,293,5
2025-02-26,LH,Hungary,2379,2070,9,5,309,148,152,300,4
2025-02-27,LH,Hungary,2468,2112,2,2,356,178,176,354,0
2025-02-28,LH,Hungary,2511,2145,2,0,366,183,181,364,2
2025-03-01,LH,Hungary,2548,2221,1,0,327,165,161,326,1
2025-03-02,LH,Hungary,2671,2297,0,0,374,183,191,374,0
2025-03-03,LH,Hungary,2538,2170,1,1,368,187,180,367,0
2025-03-04,LH,Hungary,2316,2016,4,2,300,151,145,296,2
2025-03-05,LH,Hungary,2491,2150,4,3,341,168,169,337,1
2025-03-06,LH,Hungary,2489,2113,10,5,376,183,183,366,5
2025-03-07,LH,Hungary,2597,2212,1,1,385,184,200,384,0
2025-03-08,LH,Hungary,2539,2212,0,0,327,168,159,327,0
2025-03-09,LH,Hungary,2590,2215,1,0,375,187,187,374,1
2025-03-10,LH,Hungary,2203,1852,6,3,351,175,170,345,3
2025-03-11,LH,Hungary,2368,2051,8,2,317,152,157,309,6
2025-03-12,LH,Hungary,2450,2111,6,1,339,165,168,333,5
2025-03-13,LH,Hungary,2535,2165,3,0,370,185,182,367,3
2025-03-14,LH,Hungary,2710,2319,0,0,391,198,193,391,0
2025-03-15,LH,Hungary,2615,2290,4,0,325,163,158,321,4
2025-03-16,LH,Hungary,2665,2298,3,1,367,177,187,364,2
2025-03-17,LH,Hungary,2544,2146,3,0,398,200,195,395,3
2025-03-18,LH,Hungary,2400,2080,9,4,320,155,156,311,5
2025-03-19,LH,Hungary,2505,2172,9,6,333,160,164,324,3
2025-03-20,LH,Hungary,2556,2165,11,5,391,195,185,380,6
2025-03-21,LH,Hungary,2591,2174,4,0,417,203,210,413,4
2025-03-22,LH,Hungary,2544,2200,0,0,344,170,174,344,0
2025-03-23,LH,Hungary,2649,2272,1,1,377,185,191,376,0
2025-03-24,LH,Hungary,2533,2135,2,2,398,204,192,396,0
2025-03-25,LH,Hungary,2402,2065,10,3,337,166,161,327,7
2025-03-26,LH,Hungary,2537,2173,10,3,364,179,175,354,7
2025-03-27,LH,Hungary,2647,2256,7,5,391,192,192,384,2
2025-03-28,LH,Hungary,2799,2377,0,0,422,208,214,422,0
2025-03-29,LH,Hungary,2697,2358,4,2,339,170,165,335,2
2025-03-30,LH,Hungary,2840,2427,2,0,413,203,208,411,2
2025-03-31,LH,Hungary,2746,2352,0,0,394,200,194,394,0
2025-04-01,LH,Hungary,2907,2526,5,1,381,188,188,376,4
2025-04-02,LH,Hungary,2912,2498,5,1,414,202,207,409,4
2025-04-03,LH,Hungary,2920,2471,4,0,449,223,222,445,4
2025-04-04,LH,Hungary,3063,2639,7,4,424,211,206,417,3
2025-04-05,LH,Hungary,2980,2644,1,1,336,168,167,335,0
2025-04-06,LH,Hungary,3037,2615,2,2,422,204,216,420,0
2025-04-07,LH,Hungary,2952,2544,0,0,408,203,205,408,0
2025-04-08,LH,Hungary,3017,2645,7,2,372,184,181,365,5
2025-04-09,LH,Hungary,2967,2547,5,4,420,212,203,415,1
2025-04-10,LH,Hungary,3020,2570,3,2,450,222,225,447,1
2025-04-11,LH,Hungary,3133,2687,2,1,446,224,220,444,1
2025-04-12,LH,Hungary,3168,2830,1,1,338,168,169,337,0
2025-04-13,LH,Hungary,3114,2698,1,1,416,202,213,415,0
2025-04-14,LH,Hungary,3070,2661,1,0,409,203,205,408,1
2025-04-15,LH,Hungary,2999,2622,4,0,377,188,185,373,4
2025-04-16,LH,Hungary,3171,2747,8,4,424,208,208,416,4
2025-04-17,LH,Hungary,3238,2790,6,2,448,222,220,442,4
2025-04-18,LH,Hungary,3008,2610,0,0,398,198,200,398,0
2025-04-19,LH,Hungary,3283,2946,0,0,337,167,170,337,0
2025-04-20,LH,Hungary,3253,2844,0,0,409,208,201,409,0
2025-04-21,LH,Hungary,3074,2671,0,0,403,199,204,403,0
2025-04-22,LH,Hungary,3090,2698,8,1,392,191,193,384,7
2025-04-23,LH,Hungary,3111,2709,3,0,402,194,205,399,3
2025-04-24,LH,Hungary,3116,2681,5,1,435,218,212,430,4
2025-04-25,LH,Hungary,3316,2889,4,0,427,212,211,423,4
2025-04-26,LH,Hungary,3432,3079,1,0,353,177,175,352,1
2025-04-27,LH,Hungary,3470,3047,0,0,423,209,214,423,0
2025-04-28,LH,Hungary,3170,2766,4,3,404,204,196,400,1
2025-04-29,LH,Hungary,3074,2682,10,7,392,191,191,382,3
2025-04-30,LH,Hungary,3256,2815,6,2,441,216,219,435,4
2025-05-01,LH,Hungary,3179,2752,5,2,427,214,208,422,3
2025-05-02,LH,Hungary,3254,2859,1,1,395,198,196,394,0
2025-05-03,LH,Hungary,3430,3082,0,0,348,172,176,348,0
2025-05-04,LH,Hungary,3519,3075,1,0,444,220,223,443,1
2025-05-05,LH,Hungary,3181,2771,2,0,410,206,202,408,2
2025-05-06,LH,Hungary,3121,2747,1,0,374,185,188,373,1
2025-05-07,LH,Hungary,3134,2714,4,1,420,207,209,416,3
2025-05-08,LH,Hungary,3177,2736,7,3,441,219,215,434,4
2025-05-09,LH,Hungary,3293,2870,5,1,423,210,208,418,4
2025-05-10,LH,Hungary,3541,3201,2,2,340,165,173,338,0
2025-05-11,LH,Hungary,3515,3070,1,1,445,217,227,444,0
2025-05-12,LH,Hungary,3179,2736,9,6,443,221,213,434,3
2025-05-13,LH,Hungary,3119,2740,6,3,379,189,184,373,3
2025-05-14,LH,Hungary,3129,2718,10,3,411,202,199,401,7
2025-05-15,LH,Hungary,3319,2858,6,2,461,223,232,455,4
2025-05-16,LH,Hungary,3417,2964,9,5,453,223,221,444,4
2025-05-17,LH,Hungary,3600,3228,5,2,372,187,180,367,3
2025-05-18,LH,Hungary,3599,3164,1,0,435,212,222,434,1
2025-05-19,LH,Hungary,3190,2756,3,0,434,218,213,431,3
2025-05-20,LH,Hungary,3200,2813,7,4,387,187,193,380,3
2025-05-21,LH,Hungary,3291,2866,13,11,425,211,201,412,2
2025-05-22,LH,Hungary,3380,2933,5,2,447,221,221,442,3
2025-05-23,LH,Hungary,3559,3097,1,0,462,235,226,461,1
2025-05-24,LH,Hungary,3700,3338,5,0,362,176,181,357,5
2025-05-25,LH,Hungary,3680,3261,0,0,419,207,212,419,0
2025-05-26,LH,Hungary,3411,2977,8,6,434,214,212,426,2
2025-05-27,LH,Hungary,3370,2975,9,1,395,190,196,386,8
2025-05-28,LH,Hungary,3573,3136,10,7,437,214,213,427,3
2025-05-29,LH,Hungary,3438,2996,5,1,442,222,215,437,4
2025-05-30,LH,Hungary,3568,3126,3,0,442,221,218,439,3
2025-05-31,LH,Hungary,3800,3437,3,1,363,184,176,360,2
2025-06-01,LH,Hungary,3815,3399,0,0,416,202,214,416,0
2025-06-02,LH,Hungary,3583,3149,6,2,434,220,208,428,4
2025-06-03,LH,Hungary,3624,3213,5,2,411,199,207,406,3
2025-06-04,LH,Hungary,3678,3228,5,0,450,222,223,445,5
2025-06-05,LH,Hungary,3646,3197,6,4,449,221,222,443,2
2025-06-06,LH,Hungary,3805,3360,7,7,445,219,219,438,0
2025-06-07,LH,Hungary,3929,3555,4,0,374,187,183,370,4
2025-06-08,LH,Hungary,3928,3510,2,2,418,209,207,416,0
2025-06-09,LH,Hungary,3596,3174,1,0,422,207,214,421,1
2025-06-10,LH,Hungary,3738,3312,5,2,426,209,212,421,3
2025-06-11,LH,Hungary,3718,3295,0,0,423,209,214,423,0
2025-06-12,LH,Hungary,3681,3214,6,6,467,224,237,461,0
2025-06-13,LH,Hungary,3612,3162,5,5,450,230,215,445,0
2025-06-14,LH,Hungary,3692,3311,1,0,381,193,187,380,1
2025-06-15,LH,Hungary,3666,3244,0,0,422,208,214,422,0
2025-06-16,LH,Hungary,3617,3197,3,2,420,216,201,417,1
2025-06-17,LH,Hungary,3515,3100,14,4,415,200,201,401,10
2025-06-18,LH,Hungary,3505,3081,6,5,424,210,208,418,1
2025-06-19,LH,Hungary,3432,2990,8,7,442,217,217,434,1
2025-06-20,LH,Hungary,3701,3260,8,5,441,219,214,433,3
2025-06-21,LH,Hungary,3840,3476,2,0,364,180,182,362,2
2025-06-22,LH,Hungary,3676,3228,5,0,448,217,226,443,5
2025-06-23,LH,Hungary,3492,3040,7,5,452,225,220,445,2
2025-06-24,LH,Hungary,3567,3131,7,3,436,210,219,429,4
2025-06-25,LH,Hungary,3560,3127,12,7,433,216,205,421,5
2025-06-26,LH,Hungary,3808,3352,8,5,456,224,224,448,3
2025-06-27,LH,Hungary,3980,3535,6,0,445,223,216,439,6
2025-06-28,LH,Hungary,4072,3690,2,2,382,192,188,380,0
2025-06-29,LH,Hungary,4012,3580,4,1,432,212,216,428,3
2025-06-30,LH,Hungary,3886,3450,6,5,436,214,216,430,1
2025-07-01,LH,Hungary,3996,3573,8,2,423,209,206,415,6
2025-07-02,LH,Hungary,3943,3511,14,8,432,206,212,418,6
2025-07-03,LH,Hungary,4045,3606,6,2,439,217,216,433,4
2025-07-04,LH,Hungary,4220,3769,7,1,451,223,221,444,6
2025-07-05,LH,Hungary,4187,3809,2,0,378,190,186,376,2
2025-07-06,LH,Hungary,4193,3742,0,0,451,218,233,451,0
2025-07-07,LH,Hungary,3952,3530,3,1,422,213,206,419,2
2025-07-08,LH,Hungary,3980,3572,2,1,408,206,200,406,1
2025-07-09,LH,Hungary,4142,3712,0,0,430,216,214,430,0
2025-07-10,LH,Hungary,4036,3592,4,0,444,216,224,440,4
2025-07-11,LH,Hungary,4186,3748,2,2,438,218,218,436,0
2025-07-12,LH,Hungary,4186,3818,5,3,368,183,180,363,2
2025-07-13,LH,Hungary,4225,3783,2,0,442,214,226,440,2
2025-07-14,LH,Hungary,4092,3652,7,4,440,217,216,433,3
2025-07-15,LH,Hungary,4122,3698,3,3,424,211,210,421,0
2025-07-16,LH,Hungary,4168,3733,7,1,435,212,216,428,6
2025-07-17,LH,Hungary,4153,3695,5,0,458,230,223,453,5
2025-07-18,LH,Hungary,4251,3804,5,2,447,224,218,442,3
2025-07-19,LH,Hungary,4351,3967,5,3,384,186,193,379,2
2025-07-20,LH,Hungary,4171,3733,1,1,438,213,224,437,0
2025-07-21,LH,Hungary,4143,3680,5,4,463,233,225,458,1
2025-07-22,LH,Hungary,4199,3757,11,6,442,217,214,431,5
2025-07-23,LH,Hungary,4207,3759,9,6,448,217,222,439,3
2025-07-24,LH,Hungary,4200,3732,9,7,468,228,231,459,2
2025-07-25,LH,Hungary,4239,3785,9,8,454,222,223,445,1
2025-07-26,LH,Hungary,4468,4079,3,0,389,196,190,386,3
2025-07-27,LH,Hungary,4100,3666,2,0,434,212,220,432,2
2025-07-28,LH,Hungary,4284,3830,2,0,454,227,225,452,2
2025-07-29,LH,Hungary,4206,3778,8,2,428,214,206,420,6
2025-07-30,LH,Hungary,4148,3706,6,6,442,216,220,436,0
2025-07-31,LH,Hungary,4173,3682,8,5,491,237,246,483,3
2025-08-01,LH,Hungary,4284,3830,3,3,454,229,222,451,0
2025-08-02,LH,Hungary,4433,4038,0,0,395,187,208,395,0
2025-08-03,LH,Hungary,4440,3958,1,1,482,246,235,481,0
2025-08-04,LH,Hungary,4090,3634,1,1,456,231,224,455,0
2025-08-05,LH,Hungary,4244,3817,7,5,427,211,209,420,2
2025-08-06,LH,Hungary,4232,3787,6,4,445,220,219,439,2
2025-08-07,LH,Hungary,4080,3636,6,5,444,223,215,438,1
2025-08-08,LH,Hungary,4106,3686,4,2,420,205,211,416,2
2025-08-09,LH,Hungary,4304,3918,4,2,386,193,189,382,2
2025-08-10,LH,Hungary,4283,3869,2,2,414,203,209,412,0
2025-08-11,LH,Hungary,4114,3663,6,1,451,221,224,445,5
2025-08-12,LH,Hungary,4156,3736,4,4,420,211,205,416,0
2025-08-13,LH,Hungary,4147,3714,14,9,433,207,212,419,5
2025-08-14,LH,Hungary,4154,3703,8,7,451,221,222,443,1
2025-08-15,LH,Hungary,4232,3800,7,7,432,216,209,425,0
2025-08-16,LH,Hungary,4363,3987,4,3,376,185,187,372,1
2025-08-17,LH,Hungary,4273,3831,0,0,442,219,223,442,0
2025-08-18,LH,Hungary,4010,3563,7,3,447,225,215,440,4
2025-08-19,LH,Hungary,4120,3672,6,2,448,220,222,442,4
2025-08-20,LH,Hungary,4215,3788,6,4,427,211,210,421,2
2025-08-21,LH,Hungary,4179,3749,1,1,430,215,214,429,0
2025-08-22,LH,Hungary,4103,3654,3,1,449,222,224,446,2
2025-08-23,LH,Hungary,4332,3946,3,1,386,193,190,383,2
2025-08-24,LH,Hungary,4235,3789,1,0,446,220,225,445,1
2025-08-25,LH,Hungary,4094,3651,5,3,443,222,216,438,2
2025-08-26,LH,Hungary,4094,3675,4,4,419,207,208,415,0
2025-08-27,LH,Hungary,4035,3609,6,3,426,209,211,420,3
2025-08-28,LH,Hungary,4116,3661,9,5,455,223,223,446,4
2025-08-29,LH,Hungary,4343,3893,9,3,450,221,220,441,6
2025-01-01,EI,Ireland,1018,480,8,1,538,262,268,530,7
2025-01-02,EI,Ireland,1324,652,15,4,672,325,332,657,11
2025-01-03,EI,Ireland,1567,769,16,4,798,391,391,782,12
2025-01-04,EI,Ireland,1383,663,8,0,720,354,358,712,8
2025-01-05,EI,Ireland,1535,800,12,0,735,355,368,723,12
2025-01-06,EI,Ireland,1444,678,17,4,766,377,372,749,13
2025-01-07,EI,Ireland,1215,653,21,4,562,273,268,541,17
2025-01-08,EI,Ireland,1107,599,19,6,508,244,245,489,13
2025-01-09,EI,Ireland,1096,514,15,4,582,286,281,567,11
2025-01-10,EI,Ireland,1410,658,17,4,752,361,374,735,13
2025-01-11,EI,Ireland,1308,625,13,2,683,337,333,670,11
2025-01-12,EI,Ireland,1476,751,15,6,725,346,364,710,9
2025-01-13,EI,Ireland,1403,691,12,2,712,354,346,700,10
2025-01-14,EI,Ireland,1133,634,15,3,499,241,243,484,12
2025-01-15,EI,Ireland,1213,681,32,18,532,253,247,500,14
2025-01-16,EI,Ireland,1305,699,22,7,606,296,288,584,15
2025-01-17,EI,Ireland,1489,710,21,7,779,373,385,758,14
2025-01-18,EI,Ireland,1466,782,19,3,684,332,333,665,16
2025-01-19,EI,Ireland,1370,655,25,10,715,347,343,690,15
2025-01-20,EI,Ireland,1448,724,22,6,724,355,347,702,16
2025-01-21,EI,Ireland,1147,644,22,9,503,242,239,481,13
2025-01-22,EI,Ireland,1076,559,23,6,517,247,247,494,17
2025-01-23,EI,Ireland,1122,513,15,2,609,299,295,594,13
2025-01-24,EI,Ireland,852,395,5,0,457,220,232,452,5
2025-01-25,EI,Ireland,1269,555,12,3,714,351,351,702,9
2025-01-26,EI,Ireland,1348,640,10,3,708,350,348,698,7
2025-01-27,EI,Ireland,1275,568,19,6,707,343,345,688,13
2025-01-28,EI,Ireland,1022,507,14,2,515,253,248,501,12
2025-01-29,EI,Ireland,1066,547,14,0,519,247,258,505,14
2025-01-30,EI,Ireland,1224,599,17,2,625,307,301,608,15
2025-01-31,EI,Ireland,1481,688,17,2,793,384,392,776,15
2025-02-01,EI,Ireland,1403,687,9,1,716,352,355,707,8
2025-02-02,EI,Ireland,1302,562,8,0,740,371,361,732,8
2025-02-03,EI,Ireland,1359,648,8,0,711,351,352,703,8
2025-02-04,EI,Ireland,1099,579,24,6,520,248,248,496,18
2025-02-05,EI,Ireland,1131,600,25,9,531,253,253,506,16
2025-02-06,EI,Ireland,1332,708,28,7,624,297,299,596,21
2025-02-07,EI,Ireland,1486,653,29,7,833,400,404,804,22
2025-02-08,EI,Ireland,1474,748,12,2,726,357,357,714,10
2025-02-09,EI,Ireland,1428,673,13,3,755,374,368,742,10
2025-02-10,EI,Ireland,1428,632,27,9,796,383,386,769,18
2025-02-11,EI,Ireland,1144,606,22,6,538,260,256,516,16
2025-02-12,EI,Ireland,1252,680,26,8,572,272,274,546,18
2025-02-13,EI,Ireland,1216,586,21,7,630,304,305,609,14
2025-02-14,EI,Ireland,1555,742,22,7,813,400,391,791,15
2025-02-15,EI,Ireland,1495,779,14,2,716,350,352,702,12
2025-02-16,EI,Ireland,1558,800,17,6,758,365,376,741,11
2025-02-17,EI,Ireland,1442,690,17,5,752,374,361,735,12
2025-02-18,EI,Ireland,1302,740,27,14,562,266,269,535,13
2025-02-19,EI,Ireland,1177,598,20,5,579,279,280,559,15
2025-02-20,EI,Ireland,1138,488,12,1,650,317,321,638,11
2025-02-21,EI,Ireland,1410,614,15,2,796,391,390,781,13
2025-02-22,EI,Ireland,1320,587,14,3,733,359,360,719,11
2025-02-23,EI,Ireland,1385,608,10,1,777,382,385,767,9
2025-02-24,EI,Ireland,1526,753,15,3,773,380,378,758,12
2025-02-25,EI,Ireland,1232,678,21,6,554,264,269,533,15
2025-02-26,EI,Ireland,1216,625,17,5,591,284,290,574,12
2025-02-27,EI,Ireland,1339,690,20,2,649,315,314,629,18
2025-02-28,EI,Ireland,1474,650,23,5,824,401,400,801,18
2025-03-01,EI,Ireland,1419,692,19,2,727,357,351,708,17
2025-03-02,EI,Ireland,1465,694,19,3,771,375,377,752,16
2025-03-03,EI,Ireland,1534,743,18,6,791,391,382,773,12
2025-03-04,EI,Ireland,1099,515,23,7,584,278,283,561,16
2025-03-05,EI,Ireland,1277,667,17,4,610,296,297,593,13
2025-03-06,EI,Ireland,1440,761,20,7,679,327,332,659,13
2025-03-07,EI,Ireland,1619,725,23,2,894,426,445,871,21
2025-03-08,EI,Ireland,1601,858,12,1,743,367,364,731,11
2025-03-09,EI,Ireland,1619,760,17,1,859,427,415,842,16
2025-03-10,EI,Ireland,1459,660,25,7,799,390,384,774,18
2025-03-11,EI,Ireland,1372,745,14,2,627,306,307,613,12
2025-03-12,EI,Ireland,1435,796,20,7,639,310,309,619,13
2025-03-13,EI,Ireland,1445,738,9,1,707,346,352,698,8
2025-03-14,EI,Ireland,1715,778,15,3,937,457,465,922,12
2025-03-15,EI,Ireland,1547,804,11,3,743,367,365,732,8
2025-03-16,EI,Ireland,1588,749,14,2,839,416,409,825,12
2025-03-17,EI,Ireland,1637,809,10,2,828,408,410,818,8
2025-03-18,EI,Ireland,1405,787,26,12,618,293,299,592,14
2025-03-19,EI,Ireland,1386,744,25,10,642,311,306,617,15
2025-03-20,EI,Ireland,1565,873,24,6,692,336,332,668,18
2025-03-21,EI,Ireland,1492,663,20,5,829,402,407,809,15
2025-03-22,EI,Ireland,1535,807,9,0,728,363,356,719,9
2025-03-23,EI,Ireland,1536,763,11,3,773,379,383,762,8
2025-03-24,EI,Ireland,1583,797,17,4,786,388,381,769,13
2025-03-25,EI,Ireland,1406,814,19,6,592,282,291,573,13
2025-03-26,EI,Ireland,1451,837,24,3,614,298,292,590,21
2025-03-27,EI,Ireland,1400,730,15,1,670,324,331,655,14
2025-03-28,EI,Ireland,1394,555,15,2,839,415,409,824,13
2025-03-29,EI,Ireland,1334,621,17,1,713,346,350,696,16
2025-03-30,EI,Ireland,1793,900,22,2,893,433,438,871,20
2025-03-31,EI,Ireland,1740,860,27,11,880,433,420,853,16
2025-04-01,EI,Ireland,1658,776,18,5,882,429,435,864,13
2025-04-02,EI,Ireland,1615,738,25,8,877,424,428,852,17
2025-04-03,EI,Ireland,1766,854,19,4,912,446,447,893,15
2025-04-04,EI,Ireland,1729,793,31,9,936,452,453,905,22
2025-04-05,EI,Ireland,1726,892,12,0,834,413,409,822,12
2025-04-06,EI,Ireland,1763,854,17,6,909,445,447,892,11
2025-04-07,EI,Ireland,1869,975,19,0,894,440,435,875,19
2025-04-08,EI,Ireland,1794,898,30,9,896,429,437,866,21
2025-04-09,EI,Ireland,1786,875,31,9,911,446,434,880,22
2025-04-10,EI,Ireland,1887,971,21,3,916,448,447,895,18
2025-04-11,EI,Ireland,1956,1010,22,7,946,459,465,924,15
2025-04-12,EI,Ireland,1622,760,23,3,862,422,417,839,20
2025-04-13,EI,Ireland,1717,789,12,2,928,462,454,916,10
2025-04-14,EI,Ireland,1711,831,13,2,880,434,433,867,11
2025-04-15,EI,Ireland,1536,648,19,4,888,431,438,869,15
2025-04-16,EI,Ireland,1571,686,15,3,885,433,437,870,12
2025-04-17,EI,Ireland,1699,742,16,1,957,470,471,941,15
2025-04-18,EI,Ireland,1747,819,17,0,928,457,454,911,17
2025-04-19,EI,Ireland,1643,796,16,2,847,417,414,831,14
2025-04-20,EI,Ireland,1841,921,15,1,920,453,452,905,14
2025-04-21,EI,Ireland,1561,656,17,3,905,443,445,888,14
2025-04-22,EI,Ireland,1602,689,24,6,913,439,450,889,18
2025-04-23,EI,Ireland,1827,905,27,8,922,452,443,895,19
2025-04-24,EI,Ireland,1776,826,23,3,950,461,466,927,20
2025-04-25,EI,Ireland,1754,795,20,4,959,468,471,939,16
2025-04-26,EI,Ireland,1694,808,15,4,886,438,433,871,11
2025-04-27,EI,Ireland,1865,922,9,0,943,464,470,934,9
2025-04-28,EI,Ireland,1859,954,21,7,905,440,444,884,14
2025-04-29,EI,Ireland,1721,801,21,1,920,450,449,899,20
2025-04-30,EI,Ireland,1770,830,15,2,940,462,463,925,13
2025-05-01,EI,Ireland,1833,866,18,3,967,473,476,949,15
2025-05-02,EI,Ireland,1844,842,18,2,1002,495,489,984,16
2025-05-03,EI,Ireland,1760,863,13,2,897,443,441,884,11
2025-05-04,EI,Ireland,1830,853,11,1,977,482,484,966,10
2025-05-05,EI,Ireland,1795,867,13,0,928,458,457,915,13
2025-05-06,EI,Ireland,1824,882,20,3,942,460,462,922,17
2025-05-07,EI,Ireland,1874,920,20,2,954,466,468,934,18
2025-05-08,EI,Ireland,1863,878,27,7,985,481,477,958,20
2025-05-09,EI,Ireland,2005,1009,23,6,996,482,491,973,17
2025-05-10,EI,Ireland,1963,1069,10,2,894,445,439,884,8
2025-05-11,EI,Ireland,2033,1065,11,1,968,475,482,957,10
2025-05-12,EI,Ireland,1971,1029,20,2,942,463,459,922,18
2025-05-13,EI,Ireland,1960,1011,18,2,949,465,466,931,16
2025-05-14,EI,Ireland,1922,957,24,5,965,475,466,941,19
2025-05-15,EI,Ireland,1996,1006,19,4,990,484,487,971,15
2025-05-16,EI,Ireland,2041,1041,16,1,1000,494,490,984,15
2025-05-17,EI,Ireland,1978,1062,13,3,916,448,455,903,10
2025-05-18,EI,Ireland,1981,996,15,2,985,480,490,970,13
2025-05-19,EI,Ireland,1923,956,12,1,967,480,475,955,11
2025-05-20,EI,Ireland,1667,713,20,4,954,466,468,934,16
2025-05-21,EI,Ireland,1926,961,16,2,965,475,474,949,14
2025-05-22,EI,Ireland,1788,787,17,2,1001,491,493,984,15
2025-05-23,EI,Ireland,1952,926,20,3,1026,500,506,1006,17
2025-05-24,EI,Ireland,1852,940,9,1,912,457,446,903,8
2025-05-25,EI,Ireland,1764,758,13,4,1006,495,498,993,9
2025-05-26,EI,Ireland,1800,835,11,0,965,476,478,954,11
2025-05-27,EI,Ireland,1669,700,16,3,969,473,480,953,13
2025-05-28,EI,Ireland,1672,698,24,4,974,479,471,950,20
2025-05-29,EI,Ireland,1962,972,21,7,990,480,489,969,14
2025-05-30,EI,Ireland,1906,900,19,2,1006,495,492,987,17
2025-05-31,EI,Ireland,1849,926,10,0,923,457,456,913,10
2025-06-01,EI,Ireland,1915,908,13,1,1007,501,493,994,12
2025-06-02,EI,Ireland,1834,883,15,3,951,471,465,936,12
2025-06-03,EI,Ireland,2011,1046,14,2,965,471,480,951,12
2025-06-04,EI,Ireland,1950,966,15,2,984,488,481,969,13
2025-06-05,EI,Ireland,2158,1127,17,2,1031,504,510,1014,15
2025-06-06,EI,Ireland,2031,994,20,3,1037,510,507,1017,17
2025-06-07,EI,Ireland,1873,936,13,0,937,461,463,924,13
2025-06-08,EI,Ireland,1962,944,12,1,1018,502,504,1006,11
2025-06-09,EI,Ireland,2019,1031,23,7,988,485,480,965,16
2025-06-10,EI,Ireland,1913,923,25,9,990,480,485,965,16
2025-06-11,EI,Ireland,1906,936,20,6,970,473,477,950,14
2025-06-12,EI,Ireland,2037,1032,14,0,1005,497,494,991,14
2025-06-13,EI,Ireland,1974,947,16,1,1027,503,508,1011,15
2025-06-14,EI,Ireland,1823,885,15,2,938,463,460,923,13
2025-06-15,EI,Ireland,1968,956,13,0,1012,501,498,999,13
2025-06-16,EI,Ireland,2027,1046,23,1,981,480,478,958,22
2025-06-17,EI,Ireland,1797,793,18,1,1004,490,496,986,17
2025-06-18,EI,Ireland,1852,846,23,3,1006,485,498,983,20
2025-06-19,EI,Ireland,1991,946,25,2,1045,512,508,1020,23
2025-06-20,EI,Ireland,1960,912,26,6,1048,509,513,1022,20
2025-06-21,EI,Ireland,1865,906,17,3,959,477,465,942,14
2025-06-22,EI,Ireland,1886,846,12,3,1040,514,514,1028,9
2025-06-23,EI,Ireland,1901,922,18,4,979,483,478,961,14
2025-06-24,EI,Ireland,1958,951,21,4,1007,494,492,986,17
2025-06-25,EI,Ireland,1862,868,21,8,994,488,485,973,13
2025-06-26,EI,Ireland,1771,757,20,3,1014,494,500,994,17
2025-06-27,EI,Ireland,2217,1184,23,1,1033,503,507,1010,22
2025-06-28,EI,Ireland,1795,830,19,1,965,476,470,946,18
2025-06-29,EI,Ireland,2092,1058,12,2,1034,506,516,1022,10
2025-06-30,EI,Ireland,1938,947,18,2,991,492,481,973,16
2025-07-01,EI,Ireland,2029,1033,18,2,996,488,490,978,16
2025-07-02,EI,Ireland,2039,1043,18,5,996,487,491,978,13
2025-07-03,EI,Ireland,1998,997,15,0,1001,492,494,986,15
2025-07-04,EI,Ireland,1944,919,25,6,1025,500,500,1000,19
2025-07-05,EI,Ireland,1883,932,16,1,951,469,466,935,15
2025-07-06,EI,Ireland,1978,971,14,0,1007,498,495,993,14
2025-07-07,EI,Ireland,2089,1111,14,0,978,480,484,964,14
2025-07-08,EI,Ireland,1934,933,24,8,1001,490,487,977,16
2025-07-09,EI,Ireland,1980,992,20,6,988,482,486,968,14
2025-07-10,EI,Ireland,2068,1053,19,4,1015,496,500,996,15
2025-07-11,EI,Ireland,2027,1035,16,0,992,491,485,976,16
2025-07-12,EI,Ireland,1941,990,14,0,951,465,472,937,14
2025-07-13,EI,Ireland,2009,1008,17,4,1001,496,488,984,13
2025-07-14,EI,Ireland,2052,1074,17,2,978,484,477,961,15
2025-07-15,EI,Ireland,1915,930,19,6,985,480,486,966,13
2025-07-16,EI,Ireland,1757,748,23,9,1009,494,492,986,14
2025-07-17,EI,Ireland,1897,876,16,3,1021,502,503,1005,13
2025-07-18,EI,Ireland,1997,975,19,2,1022,499,504,1003,17
2025-07-19,EI,Ireland,1939,976,14,2,963,480,469,949,12
2025-07-20,EI,Ireland,1978,963,16,4,1015,498,501,999,12
2025-07-21,EI,Ireland,1822,843,13,3,979,485,481,966,10
2025-07-22,EI,Ireland,1867,875,17,5,992,487,488,975,12
2025-07-23,EI,Ireland,1930,937,19,1,993,484,490,974,18
2025-07-24,EI,Ireland,1984,983,16,2,1001,498,487,985,14
2025-07-25,EI,Ireland,1825,811,17,3,1014,499,498,997,14
2025-07-26,EI,Ireland,1811,862,15,1,949,463,471,934,14
2025-07-27,EI,Ireland,1965,967,11,1,998,488,499,987,10
2025-07-28,EI,Ireland,1913,927,25,9,986,483,478,961,16
2025-07-29,EI,Ireland,1945,945,25,8,1000,483,492,975,17
2025-07-30,EI,Ireland,1774,788,22,5,986,487,477,964,17
2025-07-31,EI,Ireland,1951,930,15,3,1021,500,506,1006,12
2025-08-01,EI,Ireland,1899,876,20,3,1023,503,500,1003,17
2025-08-02,EI,Ireland,2044,1083,18,5,961,475,468,943,13
2025-08-03,EI,Ireland,1907,911,13,1,996,492,491,983,12
2025-08-04,EI,Ireland,1788,832,7,2,956,477,472,949,5
2025-08-05,EI,Ireland,2067,1064,15,3,1003,494,494,988,12
2025-08-06,EI,Ireland,1863,856,26,5,1007,487,494,981,21
2025-08-07,EI,Ireland,2033,1042,15,1,991,489,487,976,14
2025-08-08,EI,Ireland,2053,1061,19,3,992,480,493,973,16
2025-08-09,EI,Ireland,1880,919,12,0,961,474,475,949,12
2025-08-10,EI,Ireland,1970,969,16,0,1001,491,494,985,16
2025-08-11,EI,Ireland,1991,1005,25,5,986,484,477,961,20
2025-08-12,EI,Ireland,1902,917,17,2,985,481,487,968,15
2025-08-13,EI,Ireland,2093,1106,20,5,987,485,482,967,15
2025-08-14,EI,Ireland,2102,1074,24,7,1028,503,501,1004,17
2025-08-15,EI,Ireland,2012,983,16,3,1029,503,510,1013,13
2025-08-16,EI,Ireland,1988,1017,21,1,971,479,471,950,20
2025-08-17,EI,Ireland,2118,1101,19,3,1017,496,502,998,16
2025-08-18,EI,Ireland,2113,1125,18,5,988,492,478,970,13
2025-08-19,EI,Ireland,1961,966,20,5,995,486,489,975,15
2025-08-20,EI,Ireland,2019,1034,25,8,985,481,479,960,17
2025-08-21,EI,Ireland,2171,1162,19,2,1009,496,494,990,17
2025-08-22,EI,Ireland,2199,1166,15,1,1033,504,514,1018,14
2025-08-23,EI,Ireland,2212,1270,16,3,942,465,461,926,13
2025-08-24,EI,Ireland,1711,696,16,5,1015,499,500,999,11
2025-08-25,EI,Ireland,1875,905,19,5,970,474,477,951,14
2025-08-26,EI,Ireland,1672,671,19,5,1001,493,489,982,14
2025-08-27,EI,Ireland,1714,713,28,4,1001,486,487,973,24
2025-08-28,EI,Ireland,1730,706,17,5,1024,510,497,1007,12
2025-08-29,EI,Ireland,1764,733,17,3,1031,503,511,1014,14
2025-01-01,LL,Israel,370,41,37,2,329,146,146,292,35
2025-01-02,LL,Israel,473,88,27,1,385,179,179,358,26
2025-01-03,LL,Israel,344,96,15,0,248,120,113,233,15
2025-01-04,LL,Israel,259,45,28,4,214,87,99,186,24
2025-01-05,LL,Israel,425,44,32,1,381,175,174,349,31
2025-01-06,LL,Israel,408,53,32,1,355,162,161,323,31
2025-01-07,LL,Israel,353,57,24,1,296,137,135,272,23
2025-01-08,LL,Israel,390,41,30,1,349,157,162,319,29
2025-01-09,LL,Israel,408,39,30,3,369,168,171,339,27
2025-01-10,LL,Israel,288,75,15,1,213,107,91,198,14
2025-01-11,LL,Israel,230,45,21,1,185,78,86,164,20
2025-01-12,LL,Israel,421,37,30,3,384,177,177,354,27
2025-01-13,LL,Israel,384,53,27,3,331,156,148,304,24
2025-01-14,LL,Israel,349,42,41,2,307,133,133,266,39
2025-01-15,LL,Israel,396,37,53,1,359,152,154,306,52
2025-01-16,LL,Israel,457,43,35,1,414,192,187,379,34
2025-01-17,LL,Israel,309,73,12,0,236,118,106,224,12
2025-01-18,LL,Israel,237,43,21,1,194,82,91,173,20
2025-01-19,LL,Israel,451,29,34,4,422,191,197,388,30
2025-01-20,LL,Israel,386,48,29,3,338,155,154,309,26
2025-01-21,LL,Israel,354,42,39,2,312,137,136,273,37
2025-01-22,LL,Israel,385,35,42,5,350,153,155,308,37
2025-01-23,LL,Israel,462,36,30,0,426,193,203,396,30
2025-01-24,LL,Israel,308,69,17,2,239,120,102,222,15
2025-01-25,LL,Israel,239,43,20,3,196,81,95,176,17
2025-01-26,LL,Israel,442,34,39,2,408,185,184,369,37
2025-01-27,LL,Israel,392,46,29,5,346,159,158,317,24
2025-01-28,LL,Israel,344,40,35,4,304,134,135,269,31
2025-01-29,LL,Israel,384,46,33,3,338,153,152,305,30
2025-01-30,LL,Israel,462,42,36,1,420,188,196,384,35
2025-01-31,LL,Israel,330,98,22,2,232,111,99,210,20
2025-02-01,LL,Israel,306,94,22,0,212,90,100,190,22
2025-02-02,LL,Israel,476,48,42,3,428,192,194,386,39
2025-02-03,LL,Israel,397,55,41,1,342,153,148,301,40
2025-02-04,LL,Israel,363,51,34,1,312,140,138,278,33
2025-02-05,LL,Israel,394,65,35,2,329,147,147,294,33
2025-02-06,LL,Israel,455,55,27,1,400,186,187,373,26
2025-02-07,LL,Israel,352,112,20,1,240,117,103,220,19
2025-02-08,LL,Israel,291,91,20,0,200,90,90,180,20
2025-02-09,LL,Israel,469,57,34,0,412,183,195,378,34
2025-02-10,LL,Israel,410,69,26,1,341,158,157,315,25
2025-02-11,LL,Israel,378,58,30,4,320,145,145,290,26
2025-02-12,LL,Israel,395,59,32,3,336,152,152,304,29
2025-02-13,LL,Israel,472,65,33,3,407,185,189,374,30
2025-02-14,LL,Israel,345,102,16,2,243,118,109,227,14
2025-02-15,LL,Israel,274,63,24,2,211,91,96,187,22
2025-02-16,LL,Israel,482,53,40,0,429,190,199,389,40
2025-02-17,LL,Israel,424,63,38,6,361,166,157,323,32
2025-02-18,LL,Israel,392,64,39,3,328,144,145,289,36
2025-02-19,LL,Israel,411,57,33,4,354,160,161,321,29
2025-02-20,LL,Israel,493,65,34,2,428,195,199,394,32
2025-02-21,LL,Israel,372,135,14,0,237,118,105,223,14
2025-02-22,LL,Israel,296,96,21,1,200,86,93,179,20
2025-02-23,LL,Israel,476,58,40,2,418,187,191,378,38
2025-02-24,LL,Israel,407,62,24,2,345,162,159,321,22
2025-02-25,LL,Israel,384,55,39,3,329,143,147,290,36
2025-02-26,LL,Israel,415,60,31,3,355,162,162,324,28
2025-02-27,LL,Israel,494,61,29,1,433,206,198,404,28
2025-02-28,LL,Israel,342,104,21,2,238,114,103,217,19
2025-03-01,LL,Israel,319,94,16,0,225,97,112,209,16
2025-03-02,LL,Israel,490,44,40,3,446,201,205,406,37
2025-03-03,LL,Israel,447,63,25,4,384,183,176,359,21
2025-03-04,LL,Israel,402,45,46,8,357,154,157,311,38
2025-03-05,LL,Israel,441,45,40,2,396,184,172,356,38
2025-03-06,LL,Israel,510,46,44,3,464,202,218,420,41
2025-03-07,LL,Israel,360,98,13,0,262,129,120,249,13
2025-03-08,LL,Israel,316,86,20,0,230,102,108,210,20
2025-03-09,LL,Israel,519,57,40,4,462,210,212,422,36
2025-03-10,LL,Israel,412,53,25,1,359,169,165,334,24
2025-03-11,LL,Israel,419,49,49,5,370,159,162,321,44
2025-03-12,LL,Israel,447,51,49,4,396,173,174,347,45
2025-03-13,LL,Israel,503,57,32,1,446,210,204,414,31
2025-03-14,LL,Israel,355,84,18,2,271,131,122,253,16
2025-03-15,LL,Israel,286,59,18,2,227,96,113,209,16
2025-03-16,LL,Israel,503,49,33,1,454,210,211,421,32
2025-03-17,LL,Israel,464,54,32,7,410,191,187,378,25
2025-03-18,LL,Israel,416,50,38,4,366,166,162,328,34
2025-03-19,LL,Israel,491,55,52,4,436,194,190,384,48
2025-03-20,LL,Israel,534,46,43,1,488,224,221,445,42
2025-03-21,LL,Israel,382,96,19,0,286,138,129,267,19
2025-03-22,LL,Israel,312,75,24,0,237,100,113,213,24
2025-03-23,LL,Israel,511,48,36,1,463,211,216,427,35
2025-03-24,LL,Israel,490,59,41,6,431,194,196,390,35
2025-03-25,LL,Israel,427,46,39,3,381,169,173,342,36
2025-03-26,LL,Israel,469,56,57,7,413,181,175,356,50
2025-03-27,LL,Israel,503,33,38,1,470,214,218,432,37
2025-03-28,LL,Israel,373,94,21,1,279,136,122,258,20
2025-03-29,LL,Israel,313,80,21,0,233,96,116,212,21
2025-03-30,LL,Israel,585,61,36,5,524,242,246,488,31
2025-03-31,LL,Israel,543,64,43,4,479,221,215,436,39
2025-04-01,LL,Israel,518,48,33,1,470,216,221,437,32
2025-04-02,LL,Israel,570,70,49,7,500,227,224,451,42
2025-04-03,LL,Israel,612,75,39,6,537,252,246,498,33
2025-04-04,LL,Israel,483,109,18,2,374,185,171,356,16
2025-04-05,LL,Israel,414,116,18,2,298,133,147,280,16
2025-04-06,LL,Israel,590,52,37,1,538,247,254,501,36
2025-04-07,LL,Israel,579,78,39,6,501,233,229,462,33
2025-04-08,LL,Israel,591,50,33,2,541,252,256,508,31
2025-04-09,LL,Israel,597,55,52,2,542,244,246,490,50
2025-04-10,LL,Israel,738,76,40,1,662,307,315,622,39
2025-04-11,LL,Israel,626,135,36,1,491,231,224,455,35
2025-04-12,LL,Israel,395,117,4,0,278,136,138,274,4
2025-04-13,LL,Israel,506,76,19,3,430,205,206,411,16
2025-04-14,LL,Israel,634,64,36,1,570,269,265,534,35
2025-04-15,LL,Israel,608,57,36,1,551,261,254,515,35
2025-04-16,LL,Israel,623,78,34,3,545,255,256,511,31
2025-04-17,LL,Israel,662,74,34,0,588,276,278,554,34
2025-04-18,LL,Israel,594,133,21,3,461,221,219,440,18
2025-04-19,LL,Israel,506,88,30,1,418,190,198,388,29
2025-04-20,LL,Israel,701,65,33,0,636,301,302,603,33
2025-04-21,LL,Israel,671,79,45,6,592,280,267,547,39
2025-04-22,LL,Israel,575,56,41,3,519,238,240,478,38
2025-04-23,LL,Israel,594,75,45,7,519,241,233,474,38
2025-04-24,LL,Israel,608,75,39,3,533,243,251,494,36
2025-04-25,LL,Israel,471,123,19,1,348,178,151,329,18
2025-04-26,LL,Israel,390,103,16,0,287,127,144,271,16
2025-04-27,LL,Israel,598,54,38,4,544,250,256,506,34
2025-04-28,LL,Israel,583,79,46,1,504,231,227,458,45
2025-04-29,LL,Israel,513,42,35,1,471,217,219,436,34
2025-04-30,LL,Israel,571,68,31,0,503,231,241,472,31
2025-05-01,LL,Israel,595,93,24,1,502,238,240,478,23
2025-05-02,LL,Israel,480,123,18,3,357,181,158,339,15
2025-05-03,LL,Israel,414,99,26,2,315,136,153,289,24
2025-05-04,LL,Israel,555,62,41,3,493,232,220,452,38
2025-05-05,LL,Israel,459,71,35,2,388,176,177,353,33
2025-05-06,LL,Israel,384,45,27,1,339,156,156,312,26
2025-05-07,LL,Israel,427,53,45,5,374,165,164,329,40
2025-05-08,LL,Israel,480,59,44,5,421,188,189,377,39
2025-05-09,LL,Israel,337,76,15,1,261,130,116,246,14
2025-05-10,LL,Israel,285,83,28,1,202,82,92,174,27
2025-05-11,LL,Israel,503,60,45,1,443,198,200,398,44
2025-05-12,LL,Israel,455,73,29,1,382,181,172,353,28
2025-05-13,LL,Israel,428,56,26,5,372,171,175,346,21
2025-05-14,LL,Israel,467,64,37,1,403,181,185,366,36
2025-05-15,LL,Israel,541,79,37,2,462,211,214,425,35
2025-05-16,LL,Israel,388,91,20,1,297,146,131,277,19
2025-05-17,LL,Israel,319,88,21,2,231,97,113,210,19
2025-05-18,LL,Israel,545,54,34,0,491,227,230,457,34
2025-05-19,LL,Israel,472,61,31,2,411,193,187,380,29
2025-05-20,LL,Israel,458,44,42,3,414,188,184,372,39
2025-05-21,LL,Israel,500,68,36,3,432,197,199,396,33
2025-05-22,LL,Israel,560,77,44,2,483,219,220,439,42
2025-05-23,LL,Israel,395,102,15,0,293,149,129,278,15
2025-05-24,LL,Israel,320,94,22,1,226,94,110,204,21
2025-05-25,LL,Israel,551,57,32,1,494,230,232,462,31
2025-05-26,LL,Israel,530,89,30,4,441,205,206,411,26
2025-05-27,LL,Israel,495,51,30,3,444,206,208,414,27
2025-05-28,LL,Israel,533,65,41,4,468,209,218,427,37
2025-05-29,LL,Israel,625,79,33,3,546,256,257,513,30
2025-05-30,LL,Israel,495,103,23,5,392,195,174,369,18
2025-05-31,LL,Israel,330,79,14,1,251,111,126,237,13
2025-06-01,LL,Israel,481,90,23,0,391,187,181,368,23
2025-06-02,LL,Israel,438,79,18,0,359,163,178,341,18
2025-06-03,LL,Israel,559,50,35,2,509,242,232,474,33
2025-06-04,LL,Israel,551,68,39,3,483,222,222,444,36
2025-06-05,LL,Israel,615,93,32,0,522,247,243,490,32
2025-06-06,LL,Israel,445,101,19,1,344,171,154,325,18
2025-06-07,LL,Israel,347,92,15,0,255,110,130,240,15
2025-06-08,LL,Israel,606,78,34,0,528,246,248,494,34
2025-06-09,LL,Israel,549,77,26,2,472,222,224,446,24
2025-06-10,LL,Israel,529,58,35,2,471,217,219,436,33
2025-06-11,LL,Israel,550,68,30,4,482,227,225,452,26
2025-06-12,LL,Israel,637,100,36,4,537,264,237,501,32
2025-06-13,LL,Israel,117,20,4,0,97,77,16,93,4
2025-06-14,LL,Israel,15,3,0,0,12,6,6,12,0
2025-06-15,LL,Israel,23,16,0,0,7,5,2,7,0
2025-06-16,LL,Israel,22,3,1,1,19,9,9,18,0
2025-06-17,LL,Israel,26,7,0,0,19,10,9,19,0
2025-06-18,LL,Israel,70,10,1,0,60,31,28,59,1
2025-06-19,LL,Israel,94,11,0,0,83,41,42,83,0
2025-06-20,LL,Israel,106,12,2,0,94,46,46,92,2
2025-06-21,LL,Israel,100,7,0,0,93,45,48,93,0
2025-06-22,LL,Israel,48,8,0,0,40,19,21,40,0
2025-06-23,LL,Israel,149,22,4,0,127,61,62,123,4
2025-06-24,LL,Israel,152,10,3,2,142,62,77,139,1
2025-06-25,LL,Israel,184,11,9,2,173,73,91,164,7
2025-06-26,LL,Israel,213,9,9,1,204,93,102,195,8
2025-06-27,LL,Israel,192,7,2,0,185,87,96,183,2
2025-06-28,LL,Israel,172,36,3,0,136,69,64,133,3
2025-06-29,LL,Israel,305,37,22,0,268,119,127,246,22
2025-06-30,LL,Israel,315,47,28,2,268,119,121,240,26
2025-07-01,LL,Israel,431,28,19,1,403,188,196,384,18
2025-07-02,LL,Israel,458,48,22,1,410,188,200,388,21
2025-07-03,LL,Israel,511,51,30,3,460,218,212,430,27
2025-07-04,LL,Israel,365,52,19,2,313,150,144,294,17
2025-07-05,LL,Israel,269,40,24,4,229,99,106,205,20
2025-07-06,LL,Israel,512,32,28,1,480,224,228,452,27
2025-07-07,LL,Israel,499,43,19,1,456,219,218,437,18
2025-07-08,LL,Israel,476,42,27,0,434,203,204,407,27
2025-07-09,LL,Israel,506,54,35,3,452,211,206,417,32
2025-07-10,LL,Israel,541,40,28,1,501,232,241,473,27
2025-07-11,LL,Israel,394,66,21,1,328,164,143,307,20
2025-07-12,LL,Israel,311,51,16,0,260,116,128,244,16
2025-07-13,LL,Israel,544,41,33,0,503,230,240,470,33
2025-07-14,LL,Israel,519,50,29,0,469,218,222,440,29
2025-07-15,LL,Israel,510,53,24,0,457,220,213,433,24
2025-07-16,LL,Israel,544,62,33,4,482,221,228,449,29
2025-07-17,LL,Israel,574,62,33,1,512,243,236,479,32
2025-07-18,LL,Israel,467,90,18,1,377,189,170,359,17
2025-07-19,LL,Israel,322,60,13,0,262,117,132,249,13
2025-07-20,LL,Israel,594,62,34,0,532,247,251,498,34
2025-07-21,LL,Israel,557,58,26,1,499,234,239,473,25
2025-07-22,LL,Israel,543,61,30,4,482,227,225,452,26
2025-07-23,LL,Israel,565,74,32,2,491,230,229,459,30
2025-07-24,LL,Israel,610,70,42,7,540,249,249,498,35
2025-07-25,LL,Israel,457,97,23,2,360,177,160,337,21
2025-07-26,LL,Israel,350,77,16,0,273,121,136,257,16
2025-07-27,LL,Israel,574,55,31,1,519,243,245,488,30
2025-07-28,LL,Israel,577,76,35,2,501,231,235,466,33
2025-07-29,LL,Israel,548,49,34,2,499,233,232,465,32
2025-07-30,LL,Israel,568,68,38,5,500,225,237,462,33
2025-07-31,LL,Israel,612,67,27,0,545,262,256,518,27
2025-08-01,LL,Israel,482,82,18,0,400,201,181,382,18
2025-08-02,LL,Israel,369,62,16,3,307,134,157,291,13
2025-08-03,LL,Israel,626,58,36,2,568,265,267,532,34
2025-08-04,LL,Israel,624,65,38,0,559,263,258,521,38
2025-08-05,LL,Israel,599,52,36,1,547,252,259,511,35
2025-08-06,LL,Israel,620,83,35,3,537,252,250,502,32
2025-08-07,LL,Israel,632,61,34,3,571,270,267,537,31
2025-08-08,LL,Israel,487,92,16,0,395,196,183,379,16
2025-08-09,LL,Israel,380,69,13,1,311,142,156,298,12
2025-08-10,LL,Israel,640,51,34,1,589,274,281,555,33
2025-08-11,LL,Israel,602,61,29,6,541,259,253,512,23
2025-08-12,LL,Israel,620,57,25,0,563,269,269,538,25
2025-08-13,LL,Israel,627,72,30,1,555,260,265,525,29
2025-08-14,LL,Israel,661,67,27,2,594,288,279,567,25
2025-08-15,LL,Israel,533,90,18,3,443,217,208,425,15
2025-08-16,LL,Israel,393,65,22,1,328,148,158,306,21
2025-08-17,LL,Israel,671,50,41,1,621,289,291,580,40
2025-08-18,LL,Israel,649,72,35,7,577,266,276,542,28
2025-08-19,LL,Israel,603,57,24,5,546,261,261,522,19
2025-08-20,LL,Israel,649,60,43,3,589,277,269,546,40
2025-08-21,LL,Israel,666,58,38,3,608,285,285,570,35
2025-08-22,LL,Israel,562,97,23,1,465,226,216,442,22
2025-08-23,LL,Israel,412,74,17,2,338,154,167,321,15
2025-08-24,LL,Israel,665,45,30,0,620,293,297,590,30
2025-08-25,LL,Israel,662,67,24,0,595,285,286,571,24
2025-08-26,LL,Israel,630,59,32,0,571,273,266,539,32
2025-08-27,LL,Israel,652,70,30,2,582,275,277,552,28
2025-08-28,LL,Israel,692,72,38,2,620,294,288,582,36
2025-08-29,LL,Israel,549,87,18,1,462,224,220,444,17
2025-01-01,LI,Italy,4448,1545,653,1,2903,1123,1127,2250,652
2025-01-02,LI,Italy,5093,1738,793,11,3355,1287,1275,2562,782
2025-01-03,LI,Italy,5264,1738,834,14,3526,1342,1350,2692,820
2025-01-04,LI,Italy,5052,1833,714,12,3219,1262,1243,2505,702
2025-01-05,LI,Italy,5341,1933,762,10,3408,1325,1321,2646,752
2025-01-06,LI,Italy,5073,1727,804,6,3346,1264,1278,2542,798
2025-01-07,LI,Italy,4320,1382,712,25,2938,1102,1124,2226,687
2025-01-08,LI,Italy,3831,1406,606,24,2425,905,914,1819,582
2025-01-09,LI,Italy,3931,1344,629,23,2587,979,979,1958,606
2025-01-10,LI,Italy,4720,1529,784,18,3191,1197,1210,2407,766
2025-01-11,LI,Italy,4224,1528,611,13,2696,1043,1042,2085,598
2025-01-12,LI,Italy,4733,1667,692,9,3066,1185,1189,2374,683
2025-01-13,LI,Italy,4609,1498,768,16,3111,1172,1171,2343,752
2025-01-14,LI,Italy,3420,1171,561,19,2249,843,845,1688,542
2025-01-15,LI,Italy,3556,1229,577,22,2327,881,869,1750,555
2025-01-16,LI,Italy,3887,1310,626,20,2577,979,972,1951,606
2025-01-17,LI,Italy,4700,1537,779,15,3163,1173,1211,2384,764
2025-01-18,LI,Italy,4162,1523,590,9,2639,1031,1018,2049,581
2025-01-19,LI,Italy,4541,1572,665,8,2969,1146,1158,2304,657
2025-01-20,LI,Italy,4537,1429,770,20,3108,1177,1161,2338,750
2025-01-21,LI,Italy,3476,1149,572,40,2327,870,885,1755,532
2025-01-22,LI,Italy,3671,1262,571,22,2409,918,920,1838,549
2025-01-23,LI,Italy,3959,1329,651,28,2630,993,986,1979,623
2025-01-24,LI,Italy,4806,1555,828,27,3251,1200,1223,2423,801
2025-01-25,LI,Italy,4214,1542,588,9,2672,1056,1028,2084,579
2025-01-26,LI,Italy,4634,1618,689,11,3016,1163,1164,2327,678
2025-01-27,LI,Italy,4583,1415,792,32,3168,1197,1179,2376,760
2025-01-28,LI,Italy,3450,1186,560,17,2264,845,859,1704,543
2025-01-29,LI,Italy,3644,1214,602,30,2430,912,916,1828,572
2025-01-30,LI,Italy,3926,1278,645,37,2648,994,1009,2003,608
2025-01-31,LI,Italy,4882,1596,787,19,3286,1252,1247,2499,768
2025-02-01,LI,Italy,4386,1534,629,10,2852,1118,1105,2223,619
2025-02-02,LI,Italy,4842,1652,721,11,3190,1228,1241,2469,710
2025-02-03,LI,Italy,4711,1416,837,28,3295,1236,1222,2458,809
2025-02-04,LI,Italy,3910,1322,648,37,2588,962,978,1940,611
2025-02-05,LI,Italy,3996,1365,642,34,2631,993,996,1989,608
2025-02-06,LI,Italy,4388,1438,735,35,2950,1103,1112,2215,700
2025-02-07,LI,Italy,5065,1616,836,16,3449,1309,1304,2613,820
2025-02-08,LI,Italy,4558,1640,655,7,2918,1139,1124,2263,648
2025-02-09,LI,Italy,4974,1695,735,8,3279,1267,1277,2544,727
2025-02-10,LI,Italy,4845,1527,815,29,3318,1262,1241,2503,786
2025-02-11,LI,Italy,4009,1335,648,40,2674,1009,1017,2026,608
2025-02-12,LI,Italy,4202,1408,646,41,2794,1072,1076,2148,605
2025-02-13,LI,Italy,4354,1422,706,20,2932,1121,1105,2226,686
2025-02-14,LI,Italy,5161,1676,806,18,3485,1326,1353,2679,788
2025-02-15,LI,Italy,4737,1680,664,19,3057,1202,1191,2393,645
2025-02-16,LI,Italy,5049,1763,707,6,3286,1278,1301,2579,701
2025-02-17,LI,Italy,4979,1611,812,13,3368,1284,1272,2556,799
2025-02-18,LI,Italy,4247,1413,682,43,2834,1066,1086,2152,639
2025-02-19,LI,Italy,4472,1529,663,33,2943,1146,1134,2280,630
2025-02-20,LI,Italy,4773,1569,775,43,3204,1205,1224,2429,732
2025-02-21,LI,Italy,5150,1689,794,21,3461,1336,1331,2667,773
2025-02-22,LI,Italy,4818,1708,659,7,3110,1226,1225,2451,652
2025-02-23,LI,Italy,5233,1804,728,9,3429,1345,1356,2701,719
2025-02-24,LI,Italy,5079,1659,817,27,3420,1321,1282,2603,790
2025-02-25,LI,Italy,4154,1407,647,31,2747,1040,1060,2100,616
2025-02-26,LI,Italy,4273,1441,635,18,2832,1098,1099,2197,617
2025-02-27,LI,Italy,4591,1519,726,28,3072,1171,1175,2346,698
2025-02-28,LI,Italy,5137,1612,839,21,3525,1327,1359,2686,818
2025-03-01,LI,Italy,4924,1756,686,12,3168,1254,1228,2482,674
2025-03-02,LI,Italy,5261,1803,718,9,3458,1374,1366,2740,709
2025-03-03,LI,Italy,5094,1666,825,15,3428,1311,1292,2603,810
2025-03-04,LI,Italy,4367,1452,664,24,2915,1116,1135,2251,640
2025-03-05,LI,Italy,4502,1512,673,20,2990,1165,1152,2317,653
2025-03-06,LI,Italy,4723,1580,753,14,3143,1187,1203,2390,739
2025-03-07,LI,Italy,5279,1699,834,13,3580,1365,1381,2746,821
2025-03-08,LI,Italy,4796,1693,668,16,3103,1225,1210,2435,652
2025-03-09,LI,Italy,5140,1743,714,9,3397,1346,1337,2683,705
2025-03-10,LI,Italy,4768,1477,819,31,3291,1239,1233,2472,788
2025-03-11,LI,Italy,4385,1459,682,32,2926,1115,1129,2244,650
2025-03-12,LI,Italy,4452,1427,706,37,3025,1148,1171,2319,669
2025-03-13,LI,Italy,4726,1455,781,34,3271,1248,1242,2490,747
2025-03-14,LI,Italy,5310,1682,811,20,3628,1405,1412,2817,791
2025-03-15,LI,Italy,4681,1610,666,8,3071,1209,1196,2405,658
2025-03-16,LI,Italy,5231,1761,719,10,3470,1380,1371,2751,709
2025-03-17,LI,Italy,5153,1632,837,24,3521,1346,1338,2684,813
2025-03-18,LI,Italy,4324,1408,660,22,2916,1123,1133,2256,638
2025-03-19,LI,Italy,4611,1532,732,29,3079,1170,1177,2347,703
2025-03-20,LI,Italy,4876,1602,787,35,3274,1247,1240,2487,752
2025-03-21,LI,Italy,5305,1712,829,21,3593,1366,1398,2764,808
2025-03-22,LI,Italy,4746,1683,643,9,3063,1225,1195,2420,634
2025-03-23,LI,Italy,5222,1794,707,10,3428,1366,1355,2721,697
2025-03-24,LI,Italy,4981,1622,812,22,3359,1276,1271,2547,790
2025-03-25,LI,Italy,4422,1441,689,28,2981,1142,1150,2292,661
2025-03-26,LI,Italy,4510,1481,695,23,3029,1171,1163,2334,672
2025-03-27,LI,Italy,4791,1563,735,13,3228,1237,1256,2493,722
2025-03-28,LI,Italy,5345,1746,801,6,3599,1389,1409,2798,795
2025-03-29,LI,Italy,4820,1763,693,9,3057,1194,1170,2364,684
2025-03-30,LI,Italy,6110,2063,807,10,4047,1607,1633,3240,797
2025-03-31,LI,Italy,5817,1849,883,16,3968,1553,1532,3085,867
2025-04-01,LI,Italy,5660,1792,837,24,3868,1520,1511,3031,813
2025-04-02,LI,Italy,5919,1970,861,21,3949,1536,1552,3088,840
2025-04-03,LI,Italy,6089,2010,875,24,4079,1600,1604,3204,851
2025-04-04,LI,Italy,6352,2162,897,14,4190,1624,1669,3293,883
2025-04-05,LI,Italy,6070,2254,763,12,3816,1529,1524,3053,751
2025-04-06,LI,Italy,6363,2217,800,9,4146,1672,1674,3346,791
2025-04-07,LI,Italy,6279,2083,887,12,4196,1655,1654,3309,875
2025-04-08,LI,Italy,5931,1921,871,25,4010,1572,1567,3139,846
2025-04-09,LI,Italy,5807,1838,854,10,3969,1561,1554,3115,844
2025-04-10,LI,Italy,6539,2263,915,31,4276,1669,1692,3361,884
2025-04-11,LI,Italy,6669,2320,910,18,4349,1721,1718,3439,892
2025-04-12,LI,Italy,6393,2495,769,12,3898,1567,1562,3129,757
2025-04-13,LI,Italy,6393,2223,799,6,4170,1696,1675,3371,793
2025-04-14,LI,Italy,6355,2143,887,24,4212,1648,1677,3325,863
2025-04-15,LI,Italy,6026,1990,886,29,4036,1581,1569,3150,857
2025-04-16,LI,Italy,6334,2147,896,20,4187,1631,1660,3291,876
2025-04-17,LI,Italy,6620,2308,893,21,4312,1716,1703,3419,872
2025-04-18,LI,Italy,6753,2369,938,18,4384,1706,1740,3446,920
2025-04-19,LI,Italy,6402,2448,767,9,3954,1607,1580,3187,758
2025-04-20,LI,Italy,6370,2345,741,5,4025,1650,1634,3284,736
2025-04-21,LI,Italy,6518,2394,814,3,4124,1660,1650,3310,811
2025-04-22,LI,Italy,6228,2213,884,40,4015,1568,1563,3131,844
2025-04-23,LI,Italy,6300,2196,877,21,4104,1613,1614,3227,856
2025-04-24,LI,Italy,6460,2242,898,32,4218,1665,1655,3320,866
2025-04-25,LI,Italy,6533,2316,838,8,4217,1655,1724,3379,830
2025-04-26,LI,Italy,6616,2615,777,9,4001,1639,1585,3224,768
2025-04-27,LI,Italy,6823,2564,830,7,4259,1718,1711,3429,823
2025-04-28,LI,Italy,6403,2226,911,22,4177,1637,1629,3266,889
2025-04-29,LI,Italy,6189,2167,862,21,4022,1580,1580,3160,841
2025-04-30,LI,Italy,6559,2342,878,11,4217,1654,1685,3339,867
2025-05-01,LI,Italy,6709,2529,814,11,4180,1681,1685,3366,803
2025-05-02,LI,Italy,6753,2507,866,9,4246,1681,1699,3380,857
2025-05-03,LI,Italy,6873,2811,775,13,4062,1640,1647,3287,762
2025-05-04,LI,Italy,7264,2809,860,4,4455,1807,1788,3595,856
2025-05-05,LI,Italy,6742,2439,895,30,4303,1713,1695,3408,865
2025-05-06,LI,Italy,6432,2258,886,44,4174,1632,1656,3288,842
2025-05-07,LI,Italy,6675,2323,954,45,4352,1702,1696,3398,909
2025-05-08,LI,Italy,6944,2479,965,63,4465,1735,1765,3500,902
2025-05-09,LI,Italy,6844,2437,922,22,4407,1728,1757,3485,900
2025-05-10,LI,Italy,6750,2674,812,17,4076,1644,1620,3264,795
2025-05-11,LI,Italy,7103,2712,826,6,4391,1798,1767,3565,820
2025-05-12,LI,Italy,6767,2457,896,13,4310,1713,1701,3414,883
2025-05-13,LI,Italy,6397,2246,900,37,4151,1629,1622,3251,863
2025-05-14,LI,Italy,6691,2423,923,35,4268,1660,1685,3345,888
2025-05-15,LI,Italy,6904,2478,925,29,4426,1751,1750,3501,896
2025-05-16,LI,Italy,7006,2496,940,18,4510,1764,1806,3570,922
2025-05-17,LI,Italy,6952,2751,831,6,4201,1664,1706,3370,825
2025-05-18,LI,Italy,7199,2700,848,7,4499,1833,1818,3651,841
2025-05-19,LI,Italy,6905,2434,914,24,4471,1801,1756,3557,890
2025-05-20,LI,Italy,6489,2290,871,26,4199,1656,1672,3328,845
2025-05-21,LI,Italy,6860,2511,924,30,4349,1724,1701,3425,894
2025-05-22,LI,Italy,7061,2586,908,11,4475,1761,1806,3567,897
2025-05-23,LI,Italy,7445,2811,946,13,4634,1819,1869,3688,933
2025-05-24,LI,Italy,7188,2914,811,9,4274,1722,1741,3463,802
2025-05-25,LI,Italy,7416,2839,856,5,4577,1878,1843,3721,851
2025-05-26,LI,Italy,7283,2704,932,10,4579,1846,1801,3647,922
2025-05-27,LI,Italy,6836,2524,886,18,4312,1708,1718,3426,868
2025-05-28,LI,Italy,7109,2629,924,25,4480,1769,1787,3556,899
2025-05-29,LI,Italy,7292,2771,959,28,4521,1771,1791,3562,931
2025-05-30,LI,Italy,7358,2723,1015,17,4635,1795,1825,3620,998
2025-05-31,LI,Italy,7372,2963,888,12,4409,1784,1737,3521,876
2025-06-01,LI,Italy,8023,3250,922,10,4773,1950,1901,3851,912
2025-06-02,LI,Italy,7275,2803,882,10,4472,1791,1799,3590,872
2025-06-03,LI,Italy,6993,2551,945,14,4442,1754,1743,3497,931
2025-06-04,LI,Italy,7253,2706,972,24,4547,1778,1797,3575,948
2025-06-05,LI,Italy,7502,2853,975,24,4649,1831,1843,3674,951
2025-06-06,LI,Italy,7721,2853,1006,15,4868,1908,1954,3862,991
2025-06-07,LI,Italy,7528,3018,946,13,4510,1766,1798,3564,933
2025-06-08,LI,Italy,7709,2971,948,10,4738,1903,1887,3790,938
2025-06-09,LI,Italy,7531,2863,946,20,4668,1881,1841,3722,926
2025-06-10,LI,Italy,7387,2882,937,26,4505,1779,1789,3568,911
2025-06-11,LI,Italy,7368,2787,953,23,4581,1821,1807,3628,930
2025-06-12,LI,Italy,7534,2839,1004,37,4695,1835,1856,3691,967
2025-06-13,LI,Italy,7666,2894,1009,19,4772,1865,1898,3763,990
2025-06-14,LI,Italy,7901,3281,992,10,4620,1818,1810,3628,982
2025-06-15,LI,Italy,8114,3304,952,3,4810,1943,1915,3858,949
2025-06-16,LI,Italy,7536,2859,967,21,4677,1856,1854,3710,946
2025-06-17,LI,Italy,7383,2893,945,22,4490,1773,1772,3545,923
2025-06-18,LI,Italy,7708,3039,982,16,4669,1827,1860,3687,966
2025-06-19,LI,Italy,7749,3025,994,18,4724,1846,1884,3730,976
2025-06-20,LI,Italy,7869,3104,998,17,4765,1867,1900,3767,981
2025-06-21,LI,Italy,8022,3303,996,10,4719,1863,1860,3723,986
2025-06-22,LI,Italy,8320,3308,1010,9,5012,2029,1973,4002,1001
2025-06-23,LI,Italy,7898,3073,1002,18,4825,1917,1906,3823,984
2025-06-24,LI,Italy,7534,2924,955,15,4610,1824,1831,3655,940
2025-06-25,LI,Italy,7697,3033,1020,26,4664,1809,1835,3644,994
2025-06-26,LI,Italy,7954,3095,1037,25,4859,1912,1910,3822,1012
2025-06-27,LI,Italy,8192,3123,1085,15,5069,1986,1998,3984,1070
2025-06-28,LI,Italy,8055,3312,1001,13,4743,1866,1876,3742,988
2025-06-29,LI,Italy,8352,3249,1061,11,5103,2034,2008,4042,1050
2025-06-30,LI,Italy,7795,2860,1007,13,4935,1968,1960,3928,994
2025-07-01,LI,Italy,7740,2998,1031,18,4742,1869,1842,3711,1013
2025-07-02,LI,Italy,7804,2992,1058,19,4812,1857,1897,3754,1039
2025-07-03,LI,Italy,7543,2804,1013,15,4739,1868,1858,3726,998
2025-07-04,LI,Italy,7732,2868,1056,18,4864,1898,1910,3808,1038
2025-07-05,LI,Italy,8349,3529,984,12,4820,1920,1916,3836,972
2025-07-06,LI,Italy,8361,3344,1003,8,5017,2030,1984,4014,995
2025-07-07,LI,Italy,8149,3253,1000,13,4896,1957,1939,3896,987
2025-07-08,LI,Italy,7772,3135,966,19,4637,1831,1840,3671,947
2025-07-09,LI,Italy,7972,3146,1005,16,4826,1904,1917,3821,989
2025-07-10,LI,Italy,7913,3166,995,15,4747,1863,1889,3752,980
2025-07-11,LI,Italy,8310,3226,1056,6,5084,2001,2027,4028,1050
2025-07-12,LI,Italy,8333,3520,996,6,4813,1910,1907,3817,990
2025-07-13,LI,Italy,8374,3382,1031,4,4992,1984,1977,3961,1027
2025-07-14,LI,Italy,8079,3150,993,16,4929,1970,1966,3936,977
2025-07-15,LI,Italy,7752,3059,1002,24,4693,1847,1844,3691,978
2025-07-16,LI,Italy,7838,3052,1004,19,4786,1890,1892,3782,985
2025-07-17,LI,Italy,8078,3186,1044,15,4892,1931,1917,3848,1029
2025-07-18,LI,Italy,8231,3139,1047,9,5092,1998,2047,4045,1038
2025-07-19,LI,Italy,8294,3508,974,7,4786,1898,1914,3812,967
2025-07-20,LI,Italy,8556,3486,1020,10,5070,2043,2007,4050,1010
2025-07-21,LI,Italy,8061,3177,977,8,4884,1965,1942,3907,969
2025-07-22,LI,Italy,7720,3019,978,11,4701,1858,1865,3723,967
2025-07-23,LI,Italy,7831,3067,1011,12,4764,1877,1876,3753,999
2025-07-24,LI,Italy,8025,3200,1022,14,4825,1900,1903,3803,1008
2025-07-25,LI,Italy,8440,3393,1053,11,5047,1992,2002,3994,1042
2025-07-26,LI,Italy,8527,3684,954,3,4843,1939,1950,3889,951
2025-07-27,LI,Italy,8869,3699,1067,12,5170,2038,2065,4103,1055
2025-07-28,LI,Italy,8077,3155,990,13,4922,1981,1951,3932,977
2025-07-29,LI,Italy,7802,3117,989,14,4685,1854,1842,3696,975
2025-07-30,LI,Italy,8042,3218,1009,21,4824,1916,1899,3815,988
2025-07-31,LI,Italy,8070,3200,988,15,4870,1963,1919,3882,973
2025-08-01,LI,Italy,8454,3454,1067,10,5000,1944,1989,3933,1057
2025-08-02,LI,Italy,8559,3644,963,7,4915,1972,1980,3952,956
2025-08-03,LI,Italy,8532,3541,971,3,4991,2025,1995,4020,968
2025-08-04,LI,Italy,8060,3213,925,12,4847,1968,1954,3922,913
2025-08-05,LI,Italy,7703,3070,933,9,4633,1857,1843,3700,924
2025-08-06,LI,Italy,7741,3082,950,14,4659,1845,1864,3709,936
2025-08-07,LI,Italy,7840,3141,937,10,4699,1885,1877,3762,927
2025-08-08,LI,Italy,8183,3238,974,13,4945,1966,2005,3971,961
2025-08-09,LI,Italy,8471,3562,965,7,4909,1967,1977,3944,958
2025-08-10,LI,Italy,8494,3480,974,5,5014,2050,1990,4040,969
2025-08-11,LI,Italy,7791,3046,897,21,4745,1932,1916,3848,876
2025-08-12,LI,Italy,7474,2944,934,26,4530,1791,1805,3596,908
2025-08-13,LI,Italy,7574,2975,952,17,4599,1809,1838,3647,935
2025-08-14,LI,Italy,7777,3082,927,7,4695,1889,1879,3768,920
2025-08-15,LI,Italy,7794,3107,900,3,4687,1888,1899,3787,897
2025-08-16,LI,Italy,8293,3535,963,3,4758,1902,1893,3795,960
2025-08-17,LI,Italy,8425,3483,952,5,4942,2002,1988,3990,947
2025-08-18,LI,Italy,7819,3100,929,22,4719,1899,1891,3790,907
2025-08-19,LI,Italy,7457,2896,955,22,4561,1810,1796,3606,933
2025-08-20,LI,Italy,7636,2991,980,22,4645,1825,1840,3665,958
2025-08-21,LI,Italy,7748,3113,946,15,4635,1844,1845,3689,931
2025-08-22,LI,Italy,8069,3215,954,17,4854,1932,1968,3900,937
2025-08-23,LI,Italy,8172,3379,979,11,4793,1908,1906,3814,968
2025-08-24,LI,Italy,8299,3339,957,10,4960,2003,2000,4003,947
2025-08-25,LI,Italy,7813,3050,933,21,4763,1917,1913,3830,912
2025-08-26,LI,Italy,7663,3076,977,26,4587,1808,1802,3610,951
2025-08-27,LI,Italy,7694,3092,947,21,4602,1820,1835,3655,926
2025-08-28,LI,Italy,7614,2940,961,18,4674,1851,1862,3713,943
2025-08-29,LI,Italy,8005,3099,979,9,4906,1946,1981,3927,970
2025-01-01,EV,Latvia,452,331,0,0,121,62,59,121,0
2025-01-02,EV,Latvia,592,409,0,0,183,91,92,183,0
2025-01-03,EV,Latvia,579,396,1,1,183,93,89,182,0
2025-01-04,EV,Latvia,570,412,0,0,158,80,78,158,0
2025-01-05,EV,Latvia,601,422,0,0,179,87,92,179,0
2025-01-06,EV,Latvia,592,389,1,1,203,100,102,202,0
2025-01-07,EV,Latvia,494,369,2,2,125,62,61,123,0
2025-01-08,EV,Latvia,469,347,0,0,122,61,61,122,0
2025-01-09,EV,Latvia,513,369,0,0,144,72,72,144,0
2025-01-10,EV,Latvia,538,358,0,0,180,91,89,180,0
2025-01-11,EV,Latvia,527,384,0,0,143,71,72,143,0
2025-01-12,EV,Latvia,530,375,1,1,155,75,79,154,0
2025-01-13,EV,Latvia,569,394,0,0,175,88,87,175,0
2025-01-14,EV,Latvia,414,327,0,0,87,44,43,87,0
2025-01-15,EV,Latvia,467,339,7,7,128,61,60,121,0
2025-01-16,EV,Latvia,496,360,1,1,136,68,67,135,0
2025-01-17,EV,Latvia,536,369,1,1,167,85,81,166,0
2025-01-18,EV,Latvia,517,382,0,0,135,66,69,135,0
2025-01-19,EV,Latvia,544,390,0,0,154,77,77,154,0
2025-01-20,EV,Latvia,535,362,0,0,173,87,86,173,0
2025-01-21,EV,Latvia,386,304,1,1,82,39,42,81,0
2025-01-22,EV,Latvia,428,318,0,0,110,54,56,110,0
2025-01-23,EV,Latvia,507,355,2,2,152,73,77,150,0
2025-01-24,EV,Latvia,562,382,1,1,180,93,86,179,0
2025-01-25,EV,Latvia,526,394,0,0,132,68,64,132,0
2025-01-26,EV,Latvia,541,388,1,1,153,73,79,152,0
2025-01-27,EV,Latvia,534,359,1,1,175,87,87,174,0
2025-01-28,EV,Latvia,402,315,5,5,87,41,41,82,0
2025-01-29,EV,Latvia,433,331,1,1,102,51,50,101,0
2025-01-30,EV,Latvia,479,345,3,3,134,66,65,131,0
2025-01-31,EV,Latvia,528,360,0,0,168,86,82,168,0
2025-02-01,EV,Latvia,510,368,0,0,142,69,73,142,0
2025-02-02,EV,Latvia,532,376,0,0,156,78,78,156,0
2025-02-03,EV,Latvia,531,353,2,2,178,87,89,176,0
2025-02-04,EV,Latvia,441,349,0,0,92,48,44,92,0
2025-02-05,EV,Latvia,444,334,1,1,110,52,57,109,0
2025-02-06,EV,Latvia,513,361,1,1,152,76,75,151,0
2025-02-07,EV,Latvia,547,361,1,1,186,94,91,185,0
2025-02-08,EV,Latvia,517,373,2,2,144,70,72,142,0
2025-02-09,EV,Latvia,561,400,2,2,161,79,80,159,0
2025-02-10,EV,Latvia,538,360,0,0,178,90,88,178,0
2025-02-11,EV,Latvia,410,319,3,3,91,45,43,88,0
2025-02-12,EV,Latvia,463,338,4,2,125,60,61,121,2
2025-02-13,EV,Latvia,505,361,2,2,144,72,70,142,0
2025-02-14,EV,Latvia,547,367,3,3,180,91,86,177,0
2025-02-15,EV,Latvia,528,383,1,1,145,72,72,144,0
2025-02-16,EV,Latvia,535,380,0,0,155,76,79,155,0
2025-02-17,EV,Latvia,542,365,0,0,177,88,89,177,0
2025-02-18,EV,Latvia,434,336,1,1,98,49,48,97,0
2025-02-19,EV,Latvia,462,338,2,2,124,61,61,122,0
2025-02-20,EV,Latvia,538,386,2,2,152,74,76,150,0
2025-02-21,EV,Latvia,565,386,0,0,179,90,89,179,0
2025-02-22,EV,Latvia,556,407,2,2,149,73,74,147,0
2025-02-23,EV,Latvia,563,405,0,0,158,77,81,158,0
2025-02-24,EV,Latvia,558,373,2,2,185,91,92,183,0
2025-02-25,EV,Latvia,435,335,4,4,100,48,48,96,0
2025-02-26,EV,Latvia,459,341,2,2,118,59,57,116,0
2025-02-27,EV,Latvia,497,351,1,1,146,72,73,145,0
2025-02-28,EV,Latvia,570,383,4,4,187,92,91,183,0
2025-03-01,EV,Latvia,568,414,1,1,154,76,77,153,0
2025-03-02,EV,Latvia,582,417,0,0,165,82,83,165,0
2025-03-03,EV,Latvia,600,394,2,2,206,102,102,204,0
2025-03-04,EV,Latvia,472,343,1,1,129,66,62,128,0
2025-03-05,EV,Latvia,496,362,0,0,134,64,70,134,0
2025-03-06,EV,Latvia,556,381,2,2,175,88,85,173,0
2025-03-07,EV,Latvia,576,380,4,4,196,95,97,192,0
2025-03-08,EV,Latvia,560,405,1,1,155,79,75,154,0
2025-03-09,EV,Latvia,568,406,0,0,162,80,82,162,0
2025-03-10,EV,Latvia,540,347,1,1,193,95,97,192,0
2025-03-11,EV,Latvia,481,344,1,1,137,68,68,136,0
2025-03-12,EV,Latvia,499,356,1,1,143,72,70,142,0
2025-03-13,EV,Latvia,550,372,1,1,178,88,89,177,0
2025-03-14,EV,Latvia,601,410,2,2,191,93,96,189,0
2025-03-15,EV,Latvia,564,402,1,1,162,79,82,161,0
2025-03-16,EV,Latvia,593,409,0,0,184,92,92,184,0
2025-03-17,EV,Latvia,598,387,4,4,211,105,102,207,0
2025-03-18,EV,Latvia,498,366,5,3,132,65,62,127,2
2025-03-19,EV,Latvia,527,375,6,6,152,74,72,146,0
2025-03-20,EV,Latvia,595,396,5,5,199,96,98,194,0
2025-03-21,EV,Latvia,571,382,3,3,189,93,93,186,0
2025-03-22,EV,Latvia,577,419,0,0,158,80,78,158,0
2025-03-23,EV,Latvia,579,405,0,0,174,84,90,174,0
2025-03-24,EV,Latvia,610,398,2,2,212,106,104,210,0
2025-03-25,EV,Latvia,520,388,4,4,132,68,60,128,0
2025-03-26,EV,Latvia,520,373,0,0,147,72,75,147,0
2025-03-27,EV,Latvia,583,397,4,3,186,89,93,182,1
2025-03-28,EV,Latvia,607,420,3,3,187,95,89,184,0
2025-03-29,EV,Latvia,555,391,0,0,164,79,85,164,0
2025-03-30,EV,Latvia,592,420,1,1,172,90,81,171,0
2025-03-31,EV,Latvia,565,380,5,5,185,90,90,180,0
2025-04-01,EV,Latvia,558,383,3,3,175,85,87,172,0
2025-04-02,EV,Latvia,578,415,3,3,163,80,80,160,0
2025-04-03,EV,Latvia,610,414,2,2,196,98,96,194,0
2025-04-04,EV,Latvia,611,436,1,1,175,86,88,174,0
2025-04-05,EV,Latvia,589,433,0,0,156,79,77,156,0
2025-04-06,EV,Latvia,587,421,0,0,166,83,83,166,0
2025-04-07,EV,Latvia,600,422,1,1,178,89,88,177,0
2025-04-08,EV,Latvia,558,389,4,4,169,83,82,165,0
2025-04-09,EV,Latvia,595,427,1,1,168,84,83,167,0
2025-04-10,EV,Latvia,637,440,2,2,197,99,96,195,0
2025-04-11,EV,Latvia,619,444,3,2,175,86,86,172,1
2025-04-12,EV,Latvia,612,456,0,0,156,77,79,156,0
2025-04-13,EV,Latvia,631,459,1,1,172,87,84,171,0
2025-04-14,EV,Latvia,630,450,1,1,180,89,90,179,0
2025-04-15,EV,Latvia,606,437,3,2,169,81,85,166,1
2025-04-16,EV,Latvia,614,431,3,3,183,90,90,180,0
2025-04-17,EV,Latvia,645,452,2,2,193,98,93,191,0
2025-04-18,EV,Latvia,620,443,5,5,177,84,88,172,0
2025-04-19,EV,Latvia,596,440,2,1,156,78,76,154,1
2025-04-20,EV,Latvia,619,436,1,1,183,89,93,182,0
2025-04-21,EV,Latvia,611,432,0,0,179,92,87,179,0
2025-04-22,EV,Latvia,610,441,7,6,169,79,83,162,1
2025-04-23,EV,Latvia,607,436,3,3,171,84,84,168,0
2025-04-24,EV,Latvia,649,452,6,6,197,94,97,191,0
2025-04-25,EV,Latvia,667,479,1,1,188,96,91,187,0
2025-04-26,EV,Latvia,689,536,0,0,153,76,77,153,0
2025-04-27,EV,Latvia,703,534,0,0,169,85,84,169,0
2025-04-28,EV,Latvia,680,499,3,3,181,88,90,178,0
2025-04-29,EV,Latvia,654,476,4,4,178,85,89,174,0
2025-04-30,EV,Latvia,670,491,2,2,179,87,90,177,0
2025-05-01,EV,Latvia,703,514,2,2,189,94,93,187,0
2025-05-02,EV,Latvia,643,469,0,0,174,88,86,174,0
2025-05-03,EV,Latvia,681,514,1,1,167,82,84,166,0
2025-05-04,EV,Latvia,734,554,1,1,180,90,89,179,0
2025-05-05,EV,Latvia,674,486,3,3,188,91,94,185,0
2025-05-06,EV,Latvia,657,473,4,4,184,89,91,180,0
2025-05-07,EV,Latvia,666,486,2,2,180,88,90,178,0
2025-05-08,EV,Latvia,709,516,2,1,193,95,96,191,1
2025-05-09,EV,Latvia,721,528,5,4,193,98,90,188,1
2025-05-10,EV,Latvia,713,548,4,3,165,79,82,161,1
2025-05-11,EV,Latvia,738,559,0,0,179,90,89,179,0
2025-05-12,EV,Latvia,751,552,2,2,199,100,97,197,0
2025-05-13,EV,Latvia,696,505,0,0,191,90,101,191,0
2025-05-14,EV,Latvia,693,510,3,3,183,89,91,180,0
2025-05-15,EV,Latvia,723,528,6,4,195,97,92,189,2
2025-05-16,EV,Latvia,705,517,7,7,188,91,90,181,0
2025-05-17,EV,Latvia,709,545,2,2,164,79,83,162,0
2025-05-18,EV,Latvia,716,527,1,1,189,99,89,188,0
2025-05-19,EV,Latvia,703,505,0,0,198,100,98,198,0
2025-05-20,EV,Latvia,684,502,1,1,182,90,91,181,0
2025-05-21,EV,Latvia,671,500,1,1,171,86,84,170,0
2025-05-22,EV,Latvia,741,540,6,6,201,93,102,195,0
2025-05-23,EV,Latvia,735,547,0,0,188,98,90,188,0
2025-05-24,EV,Latvia,723,554,3,3,169,82,84,166,0
2025-05-25,EV,Latvia,730,548,3,3,182,91,88,179,0
2025-05-26,EV,Latvia,768,581,1,1,187,92,94,186,0
2025-05-27,EV,Latvia,714,529,2,2,185,91,92,183,0
2025-05-28,EV,Latvia,712,525,6,6,187,93,88,181,0
2025-05-29,EV,Latvia,742,543,5,5,199,95,99,194,0
2025-05-30,EV,Latvia,727,535,5,5,192,95,92,187,0
2025-05-31,EV,Latvia,750,570,4,4,180,89,87,176,0
2025-06-01,EV,Latvia,785,594,5,2,191,92,94,186,3
2025-06-02,EV,Latvia,736,548,2,2,188,92,94,186,0
2025-06-03,EV,Latvia,701,513,5,4,188,90,93,183,1
2025-06-04,EV,Latvia,696,518,3,3,178,88,87,175,0
2025-06-05,EV,Latvia,749,544,1,1,205,101,103,204,0
2025-06-06,EV,Latvia,764,562,5,4,202,101,96,197,1
2025-06-07,EV,Latvia,749,571,1,1,178,87,90,177,0
2025-06-08,EV,Latvia,751,565,0,0,186,94,92,186,0
2025-06-09,EV,Latvia,735,539,4,4,196,97,95,192,0
2025-06-10,EV,Latvia,730,526,7,5,204,96,101,197,2
2025-06-11,EV,Latvia,752,562,5,5,190,93,92,185,0
2025-06-12,EV,Latvia,744,536,5,5,208,102,101,203,0
2025-06-13,EV,Latvia,780,585,3,2,195,98,94,192,1
2025-06-14,EV,Latvia,755,585,0,0,170,82,88,170,0
2025-06-15,EV,Latvia,776,585,1,1,191,95,95,190,0
2025-06-16,EV,Latvia,768,569,4,3,199,97,98,195,1
2025-06-17,EV,Latvia,687,497,4,2,190,92,94,186,2
2025-06-18,EV,Latvia,746,568,1,1,178,91,86,177,0
2025-06-19,EV,Latvia,715,515,1,1,200,99,100,199,0
2025-06-20,EV,Latvia,769,575,1,1,194,100,93,193,0
2025-06-21,EV,Latvia,747,575,1,1,172,82,89,171,0
2025-06-22,EV,Latvia,753,570,1,1,183,95,87,182,0
2025-06-23,EV,Latvia,727,540,0,0,187,94,93,187,0
2025-06-24,EV,Latvia,709,534,0,0,175,88,87,175,0
2025-06-25,EV,Latvia,709,541,1,1,168,82,85,167,0
2025-06-26,EV,Latvia,753,555,1,1,198,97,100,197,0
2025-06-27,EV,Latvia,746,559,2,2,187,94,91,185,0
2025-06-28,EV,Latvia,778,599,3,3,179,88,88,176,0
2025-06-29,EV,Latvia,769,581,3,3,188,91,94,185,0
2025-06-30,EV,Latvia,752,546,3,3,206,103,100,203,0
2025-07-01,EV,Latvia,764,565,6,4,199,94,99,193,2
2025-07-02,EV,Latvia,753,569,2,2,184,95,87,182,0
2025-07-03,EV,Latvia,768,562,2,2,206,100,104,204,0
2025-07-04,EV,Latvia,723,540,3,3,183,92,88,180,0
2025-07-05,EV,Latvia,734,552,2,2,182,88,92,180,0
2025-07-06,EV,Latvia,729,547,2,1,182,93,87,180,1
2025-07-07,EV,Latvia,743,544,0,0,199,97,102,199,0
2025-07-08,EV,Latvia,757,545,8,8,212,100,104,204,0
2025-07-09,EV,Latvia,710,521,3,3,189,92,94,186,0
2025-07-10,EV,Latvia,744,541,1,1,203,101,101,202,0
2025-07-11,EV,Latvia,753,558,6,6,195,97,92,189,0
2025-07-12,EV,Latvia,736,557,1,1,179,90,88,178,0
2025-07-13,EV,Latvia,738,556,0,0,182,91,91,182,0
2025-07-14,EV,Latvia,748,549,2,2,199,99,98,197,0
2025-07-15,EV,Latvia,731,535,1,1,196,97,98,195,0
2025-07-16,EV,Latvia,720,541,1,1,179,89,89,178,0
2025-07-17,EV,Latvia,759,545,3,3,214,106,105,211,0
2025-07-18,EV,Latvia,762,563,2,2,199,98,99,197,0
2025-07-19,EV,Latvia,745,569,0,0,176,90,86,176,0
2025-07-20,EV,Latvia,719,540,0,0,179,89,90,179,0
2025-07-21,EV,Latvia,760,555,4,4,205,98,103,201,0
2025-07-22,EV,Latvia,744,553,2,2,191,96,93,189,0
2025-07-23,EV,Latvia,752,569,6,5,183,87,90,177,1
2025-07-24,EV,Latvia,731,528,1,1,203,102,100,202,0
2025-07-25,EV,Latvia,774,578,6,5,196,92,98,190,1
2025-07-26,EV,Latvia,763,586,3,2,177,89,85,174,1
2025-07-27,EV,Latvia,750,564,6,5,186,88,92,180,1
2025-07-28,EV,Latvia,755,556,2,2,199,102,95,197,0
2025-07-29,EV,Latvia,732,541,3,3,191,93,95,188,0
2025-07-30,EV,Latvia,738,557,4,4,181,90,87,177,0
2025-07-31,EV,Latvia,765,562,3,3,203,101,99,200,0
2025-08-01,EV,Latvia,750,564,1,1,186,90,95,185,0
2025-08-02,EV,Latvia,754,570,3,3,184,90,91,181,0
2025-08-03,EV,Latvia,741,553,1,0,188,96,91,187,1
2025-08-04,EV,Latvia,808,608,3,2,200,98,99,197,1
2025-08-05,EV,Latvia,776,578,3,2,198,98,97,195,1
2025-08-06,EV,Latvia,751,567,2,1,184,90,92,182,1
2025-08-07,EV,Latvia,797,598,1,1,199,97,101,198,0
2025-08-08,EV,Latvia,762,577,1,1,185,90,94,184,0
2025-08-09,EV,Latvia,751,578,2,2,173,87,84,171,0
2025-08-10,EV,Latvia,764,578,1,1,186,94,91,185,0
2025-08-11,EV,Latvia,785,593,0,0,192,98,94,192,0
2025-08-12,EV,Latvia,770,577,3,3,193,94,96,190,0
2025-08-13,EV,Latvia,744,571,1,1,173,87,85,172,0
2025-08-14,EV,Latvia,785,575,4,4,210,101,105,206,0
2025-08-15,EV,Latvia,792,595,2,2,197,100,95,195,0
2025-08-16,EV,Latvia,777,599,2,2,178,87,89,176,0
2025-08-17,EV,Latvia,756,578,2,2,178,88,88,176,0
2025-08-18,EV,Latvia,794,593,3,3,201,99,99,198,0
2025-08-19,EV,Latvia,776,579,3,3,197,97,97,194,0
2025-08-20,EV,Latvia,746,572,1,0,174,85,88,173,1
2025-08-21,EV,Latvia,772,569,3,3,203,100,100,200,0
2025-08-22,EV,Latvia,769,574,1,1,195,100,94,194,0
2025-08-23,EV,Latvia,719,552,2,2,167,83,82,165,0
2025-08-24,EV,Latvia,754,568,4,4,186,90,92,182,0
2025-08-25,EV,Latvia,797,597,1,1,200,98,101,199,0
2025-08-26,EV,Latvia,759,558,0,0,201,98,103,201,0
2025-08-27,EV,Latvia,763,582,2,2,181,92,87,179,0
2025-08-28,EV,Latvia,806,596,5,5,210,103,102,205,0
2025-08-29,EV,Latvia,786,585,4,2,201,100,97,197,2
2025-01-01,EY,Lithuania,425,323,0,0,102,50,52,102,0
2025-01-02,EY,Lithuania,553,409,4,4,144,71,69,140,0
2025-01-03,EY,Lithuania,543,382,6,5,161,76,79,155,1
2025-01-04,EY,Lithuania,534,393,3,3,141,67,71,138,0
2025-01-05,EY,Lithuania,529,388,0,0,141,67,74,141,0
2025-01-06,EY,Lithuania,547,397,3,3,150,75,72,147,0
2025-01-07,EY,Lithuania,501,343,8,8,158,75,75,150,0
2025-01-08,EY,Lithuania,429,309,4,3,120,59,57,116,1
2025-01-09,EY,Lithuania,462,332,7,7,130,58,65,123,0
2025-01-10,EY,Lithuania,510,361,5,4,149,74,70,144,1
2025-01-11,EY,Lithuania,488,367,3,3,121,59,59,118,0
2025-01-12,EY,Lithuania,478,340,4,2,138,65,69,134,2
2025-01-13,EY,Lithuania,514,353,10,7,161,76,75,151,3
2025-01-14,EY,Lithuania,385,272,4,3,113,53,56,109,1
2025-01-15,EY,Lithuania,399,280,6,4,119,57,56,113,2
2025-01-16,EY,Lithuania,442,309,7,5,133,63,63,126,2
2025-01-17,EY,Lithuania,480,328,6,5,152,72,74,146,1
2025-01-18,EY,Lithuania,454,333,5,4,121,61,55,116,1
2025-01-19,EY,Lithuania,484,343,5,4,141,67,69,136,1
2025-01-20,EY,Lithuania,494,345,3,0,149,73,73,146,3
2025-01-21,EY,Lithuania,355,246,7,6,109,51,51,102,1
2025-01-22,EY,Lithuania,382,252,9,6,130,61,60,121,3
2025-01-23,EY,Lithuania,442,304,8,8,138,64,66,130,0
2025-01-24,EY,Lithuania,482,326,6,4,156,76,74,150,2
2025-01-25,EY,Lithuania,481,355,2,2,126,62,62,124,0
2025-01-26,EY,Lithuania,478,334,2,2,144,70,72,142,0
2025-01-27,EY,Lithuania,481,326,9,9,155,71,75,146,0
2025-01-28,EY,Lithuania,373,256,6,5,117,54,57,111,1
2025-01-29,EY,Lithuania,379,248,7,7,131,65,59,124,0
2025-01-30,EY,Lithuania,427,293,5,4,134,64,65,129,1
2025-01-31,EY,Lithuania,475,327,8,5,148,71,69,140,3
2025-02-01,EY,Lithuania,470,345,3,3,125,61,61,122,0
2025-02-02,EY,Lithuania,463,319,2,2,144,72,70,142,0
2025-02-03,EY,Lithuania,466,317,5,5,149,73,71,144,0
2025-02-04,EY,Lithuania,387,267,7,6,120,56,57,113,1
2025-02-05,EY,Lithuania,391,269,6,6,122,60,56,116,0
2025-02-06,EY,Lithuania,457,317,5,4,140,64,71,135,1
2025-02-07,EY,Lithuania,479,314,7,5,165,82,76,158,2
2025-02-08,EY,Lithuania,447,322,3,3,125,61,61,122,0
2025-02-09,EY,Lithuania,485,332,5,4,153,72,76,148,1
2025-02-10,EY,Lithuania,475,324,9,7,151,68,74,142,2
2025-02-11,EY,Lithuania,370,249,7,6,121,60,54,114,1
2025-02-12,EY,Lithuania,408,276,8,8,132,63,61,124,0
2025-02-13,EY,Lithuania,449,304,6,5,145,68,71,139,1
2025-02-14,EY,Lithuania,488,334,6,4,154,75,73,148,2
2025-02-15,EY,Lithuania,467,334,3,2,133,66,64,130,1
2025-02-16,EY,Lithuania,475,326,5,4,149,72,72,144,1
2025-02-17,EY,Lithuania,488,335,8,5,153,73,72,145,3
2025-02-18,EY,Lithuania,403,262,4,4,141,68,69,137,0
2025-02-19,EY,Lithuania,417,265,8,7,152,76,68,144,1
2025-02-20,EY,Lithuania,465,305,7,6,160,73,80,153,1
2025-02-21,EY,Lithuania,469,316,7,5,153,75,71,146,2
2025-02-22,EY,Lithuania,463,335,2,2,128,62,64,126,0
2025-02-23,EY,Lithuania,493,345,6,2,148,71,71,142,4
2025-02-24,EY,Lithuania,495,340,7,7,155,73,75,148,0
2025-02-25,EY,Lithuania,398,267,5,5,131,61,65,126,0
2025-02-26,EY,Lithuania,418,290,5,4,128,63,60,123,1
2025-02-27,EY,Lithuania,441,298,10,10,143,66,67,133,0
2025-02-28,EY,Lithuania,509,347,1,1,162,81,80,161,0
2025-03-01,EY,Lithuania,477,346,1,1,131,67,63,130,0
2025-03-02,EY,Lithuania,496,350,3,2,146,71,72,143,1
2025-03-03,EY,Lithuania,521,367,5,5,154,72,77,149,0
2025-03-04,EY,Lithuania,429,292,4,4,137,66,67,133,0
2025-03-05,EY,Lithuania,446,298,5,4,148,72,71,143,1
2025-03-06,EY,Lithuania,498,346,4,4,152,72,76,148,0
2025-03-07,EY,Lithuania,516,348,13,9,168,80,75,155,4
2025-03-08,EY,Lithuania,492,361,2,2,131,65,64,129,0
2025-03-09,EY,Lithuania,508,354,4,4,154,73,77,150,0
2025-03-10,EY,Lithuania,486,341,7,5,145,68,70,138,2
2025-03-11,EY,Lithuania,429,292,7,6,137,63,67,130,1
2025-03-12,EY,Lithuania,454,300,6,5,154,75,73,148,1
2025-03-13,EY,Lithuania,503,344,8,6,159,75,76,151,2
2025-03-14,EY,Lithuania,551,386,8,7,165,76,81,157,1
2025-03-15,EY,Lithuania,502,358,8,6,144,71,65,136,2
2025-03-16,EY,Lithuania,518,376,2,2,142,71,69,140,0
2025-03-17,EY,Lithuania,540,379,6,4,161,79,76,155,2
2025-03-18,EY,Lithuania,451,307,8,7,144,65,71,136,1
2025-03-19,EY,Lithuania,498,340,6,5,158,79,73,152,1
2025-03-20,EY,Lithuania,541,376,10,7,165,79,76,155,3
2025-03-21,EY,Lithuania,513,350,12,10,163,75,76,151,2
2025-03-22,EY,Lithuania,509,369,4,4,140,68,68,136,0
2025-03-23,EY,Lithuania,519,375,6,3,144,70,68,138,3
2025-03-24,EY,Lithuania,542,384,6,4,158,76,76,152,2
2025-03-25,EY,Lithuania,457,312,5,4,145,69,71,140,1
2025-03-26,EY,Lithuania,468,321,6,5,147,72,69,141,1
2025-03-27,EY,Lithuania,510,344,10,9,166,74,82,156,1
2025-03-28,EY,Lithuania,529,364,10,7,165,77,78,155,3
2025-03-29,EY,Lithuania,500,363,6,4,137,68,63,131,2
2025-03-30,EY,Lithuania,540,380,5,3,160,78,77,155,2
2025-03-31,EY,Lithuania,530,349,6,5,181,88,87,175,1
2025-04-01,EY,Lithuania,518,351,9,9,167,83,75,158,0
2025-04-02,EY,Lithuania,540,355,9,7,185,89,87,176,2
2025-04-03,EY,Lithuania,548,374,7,7,174,82,85,167,0
2025-04-04,EY,Lithuania,548,377,9,8,171,80,82,162,1
2025-04-05,EY,Lithuania,544,397,1,1,147,71,75,146,0
2025-04-06,EY,Lithuania,555,389,1,1,166,84,81,165,0
2025-04-07,EY,Lithuania,553,375,8,8,178,84,86,170,0
2025-04-08,EY,Lithuania,517,353,7,7,164,80,77,157,0
2025-04-09,EY,Lithuania,543,371,5,5,172,80,87,167,0
2025-04-10,EY,Lithuania,572,391,9,8,181,85,87,172,1
2025-04-11,EY,Lithuania,556,375,5,4,181,88,88,176,1
2025-04-12,EY,Lithuania,556,403,5,4,153,75,73,148,1
2025-04-13,EY,Lithuania,587,418,2,2,169,83,84,167,0
2025-04-14,EY,Lithuania,600,408,11,11,192,93,88,181,0
2025-04-15,EY,Lithuania,549,382,9,7,167,79,79,158,2
2025-04-16,EY,Lithuania,564,384,6,3,180,89,85,174,3
2025-04-17,EY,Lithuania,601,418,12,10,183,82,89,171,2
2025-04-18,EY,Lithuania,562,390,5,4,172,86,81,167,1
2025-04-19,EY,Lithuania,556,412,2,2,144,69,73,142,0
2025-04-20,EY,Lithuania,566,412,1,1,154,78,75,153,0
2025-04-21,EY,Lithuania,580,409,3,2,171,78,90,168,1
2025-04-22,EY,Lithuania,565,387,10,8,178,87,81,168,2
2025-04-23,EY,Lithuania,577,391,8,8,186,87,91,178,0
2025-04-24,EY,Lithuania,601,415,10,8,186,89,87,176,2
2025-04-25,EY,Lithuania,608,418,7,5,190,91,92,183,2
2025-04-26,EY,Lithuania,621,469,4,4,152,74,74,148,0
2025-04-27,EY,Lithuania,651,480,2,0,171,81,88,169,2
2025-04-28,EY,Lithuania,665,465,15,15,200,94,91,185,0
2025-04-29,EY,Lithuania,628,451,8,8,177,84,85,169,0
2025-04-30,EY,Lithuania,662,469,9,9,193,97,87,184,0
2025-05-01,EY,Lithuania,668,498,5,5,170,80,85,165,0
2025-05-02,EY,Lithuania,641,460,8,5,181,89,84,173,3
2025-05-03,EY,Lithuania,666,519,3,3,147,71,73,144,0
2025-05-04,EY,Lithuania,698,532,3,2,166,79,84,163,1
2025-05-05,EY,Lithuania,668,471,16,13,197,88,93,181,3
2025-05-06,EY,Lithuania,611,442,10,6,169,81,78,159,4
2025-05-07,EY,Lithuania,616,436,10,10,180,85,85,170,0
2025-05-08,EY,Lithuania,658,474,11,8,184,87,86,173,3
2025-05-09,EY,Lithuania,652,458,11,9,194,91,92,183,2
2025-05-10,EY,Lithuania,681,527,5,4,154,75,74,149,1
2025-05-11,EY,Lithuania,683,526,3,2,157,75,79,154,1
2025-05-12,EY,Lithuania,721,528,9,6,193,92,92,184,3
2025-05-13,EY,Lithuania,660,489,7,7,171,82,82,164,0
2025-05-14,EY,Lithuania,662,474,6,5,188,93,89,182,1
2025-05-15,EY,Lithuania,701,513,10,6,188,89,89,178,4
2025-05-16,EY,Lithuania,720,505,8,7,215,103,104,207,1
2025-05-17,EY,Lithuania,675,520,3,2,155,79,73,152,1
2025-05-18,EY,Lithuania,689,520,3,1,169,80,86,166,2
2025-05-19,EY,Lithuania,680,493,7,7,187,89,91,180,0
2025-05-20,EY,Lithuania,658,479,13,10,179,85,81,166,3
2025-05-21,EY,Lithuania,653,457,11,9,196,90,95,185,2
2025-05-22,EY,Lithuania,682,470,7,5,212,106,99,205,2
2025-05-23,EY,Lithuania,703,510,14,10,193,89,90,179,4
2025-05-24,EY,Lithuania,696,540,3,3,156,78,75,153,0
2025-05-25,EY,Lithuania,679,508,4,2,171,84,83,167,2
2025-05-26,EY,Lithuania,739,535,9,9,204,96,99,195,0
2025-05-27,EY,Lithuania,666,487,9,7,179,85,85,170,2
2025-05-28,EY,Lithuania,650,464,8,7,186,86,92,178,1
2025-05-29,EY,Lithuania,698,511,12,10,187,91,84,175,2
2025-05-30,EY,Lithuania,689,498,10,6,191,90,91,181,4
2025-05-31,EY,Lithuania,717,558,8,8,159,75,76,151,0
2025-06-01,EY,Lithuania,715,546,3,2,169,84,82,166,1
2025-06-02,EY,Lithuania,727,515,8,8,212,102,102,204,0
2025-06-03,EY,Lithuania,683,496,17,12,187,85,85,170,5
2025-06-04,EY,Lithuania,675,484,12,12,191,90,89,179,0
2025-06-05,EY,Lithuania,702,505,8,7,197,93,96,189,1
2025-06-06,EY,Lithuania,723,529,10,9,194,92,92,184,1
2025-06-07,EY,Lithuania,720,559,5,5,161,78,78,156,0
2025-06-08,EY,Lithuania,723,553,5,2,170,81,84,165,3
2025-06-09,EY,Lithuania,692,499,3,3,193,96,94,190,0
2025-06-10,EY,Lithuania,707,513,12,11,194,92,90,182,1
2025-06-11,EY,Lithuania,705,508,13,9,197,93,91,184,4
2025-06-12,EY,Lithuania,710,524,9,8,186,86,91,177,1
2025-06-13,EY,Lithuania,720,526,8,4,194,96,90,186,4
2025-06-14,EY,Lithuania,721,567,5,3,154,74,75,149,2
2025-06-15,EY,Lithuania,717,544,3,1,173,84,86,170,2
2025-06-16,EY,Lithuania,738,536,9,9,202,93,100,193,0
2025-06-17,EY,Lithuania,677,501,10,10,176,85,81,166,0
2025-06-18,EY,Lithuania,696,499,9,9,197,97,91,188,0
2025-06-19,EY,Lithuania,695,511,9,8,184,87,88,175,1
2025-06-20,EY,Lithuania,733,545,9,8,188,93,86,179,1
2025-06-21,EY,Lithuania,738,588,6,6,150,71,73,144,0
2025-06-22,EY,Lithuania,716,545,2,1,171,83,86,169,1
2025-06-23,EY,Lithuania,702,512,11,11,190,92,87,179,0
2025-06-24,EY,Lithuania,665,509,3,1,156,74,79,153,2
2025-06-25,EY,Lithuania,676,490,15,14,186,87,84,171,1
2025-06-26,EY,Lithuania,722,541,12,10,181,83,86,169,2
2025-06-27,EY,Lithuania,705,529,7,5,176,88,81,169,2
2025-06-28,EY,Lithuania,725,577,3,3,148,71,74,145,0
2025-06-29,EY,Lithuania,705,551,2,1,154,76,76,152,1
2025-06-30,EY,Lithuania,716,531,11,10,185,87,87,174,1
2025-07-01,EY,Lithuania,723,555,14,14,168,75,79,154,0
2025-07-02,EY,Lithuania,708,523,13,11,185,86,86,172,2
2025-07-03,EY,Lithuania,725,544,10,10,181,84,87,171,0
2025-07-04,EY,Lithuania,686,505,14,10,181,86,81,167,4
2025-07-05,EY,Lithuania,683,547,1,1,136,65,70,135,0
2025-07-06,EY,Lithuania,685,519,6,1,166,79,81,160,5
2025-07-07,EY,Lithuania,698,515,10,7,183,90,83,173,3
2025-07-08,EY,Lithuania,719,554,14,11,165,75,76,151,3
2025-07-09,EY,Lithuania,694,515,8,6,179,87,84,171,2
2025-07-10,EY,Lithuania,684,512,6,5,172,80,86,166,1
2025-07-11,EY,Lithuania,714,527,3,3,187,92,92,184,0
2025-07-12,EY,Lithuania,724,573,3,2,151,75,73,148,1
2025-07-13,EY,Lithuania,692,532,1,1,160,80,79,159,0
2025-07-14,EY,Lithuania,689,514,3,2,175,86,86,172,1
2025-07-15,EY,Lithuania,680,516,6,5,164,77,81,158,1
2025-07-16,EY,Lithuania,690,507,9,8,183,87,87,174,1
2025-07-17,EY,Lithuania,695,512,13,12,183,84,86,170,1
2025-07-18,EY,Lithuania,705,536,6,6,169,82,81,163,0
2025-07-19,EY,Lithuania,700,559,3,3,141,70,68,138,0
2025-07-20,EY,Lithuania,667,514,1,1,153,74,78,152,0
2025-07-21,EY,Lithuania,737,547,12,9,190,90,88,178,3
2025-07-22,EY,Lithuania,718,560,12,10,158,71,75,146,2
2025-07-23,EY,Lithuania,709,525,11,8,184,88,85,173,3
2025-07-24,EY,Lithuania,699,517,11,8,182,86,85,171,3
2025-07-25,EY,Lithuania,722,539,5,4,183,90,88,178,1
2025-07-26,EY,Lithuania,730,576,3,3,154,76,75,151,0
2025-07-27,EY,Lithuania,694,530,3,3,164,81,80,161,0
2025-07-28,EY,Lithuania,718,529,5,4,189,91,93,184,1
2025-07-29,EY,Lithuania,739,556,14,11,183,80,89,169,3
2025-07-30,EY,Lithuania,701,512,7,2,189,92,90,182,5
2025-07-31,EY,Lithuania,746,546,15,13,200,92,93,185,2
2025-08-01,EY,Lithuania,738,535,17,12,203,96,90,186,5
2025-08-02,EY,Lithuania,729,581,2,1,148,72,74,146,1
2025-08-03,EY,Lithuania,680,512,3,3,168,82,83,165,0
2025-08-04,EY,Lithuania,766,572,13,11,194,90,91,181,2
2025-08-05,EY,Lithuania,765,593,14,14,172,79,79,158,0
2025-08-06,EY,Lithuania,714,532,7,6,182,91,84,175,1
2025-08-07,EY,Lithuania,747,564,12,12,183,84,87,171,0
2025-08-08,EY,Lithuania,736,558,10,9,178,84,84,168,1
2025-08-09,EY,Lithuania,724,569,5,2,155,73,77,150,3
2025-08-10,EY,Lithuania,738,572,3,3,166,84,79,163,0
2025-08-11,EY,Lithuania,738,554,10,10,184,88,86,174,0
2025-08-12,EY,Lithuania,747,580,10,9,167,79,78,157,1
2025-08-13,EY,Lithuania,689,514,10,9,175,84,81,165,1
2025-08-14,EY,Lithuania,742,550,11,10,192,89,92,181,1
2025-08-15,EY,Lithuania,740,565,9,8,175,85,81,166,1
2025-08-16,EY,Lithuania,743,600,4,4,143,69,70,139,0
2025-08-17,EY,Lithuania,701,538,2,1,163,79,82,161,1
2025-08-18,EY,Lithuania,745,544,8,7,201,96,97,193,1
2025-08-19,EY,Lithuania,722,552,8,8,170,79,83,162,0
2025-08-20,EY,Lithuania,703,514,10,10,189,92,87,179,0
2025-08-21,EY,Lithuania,746,548,9,7,198,91,98,189,2
2025-08-22,EY,Lithuania,748,547,12,12,201,97,92,189,0
2025-08-23,EY,Lithuania,696,535,3,0,161,77,81,158,3
2025-08-24,EY,Lithuania,703,537,2,0,166,81,83,164,2
2025-08-25,EY,Lithuania,768,576,3,2,192,94,95,189,1
2025-08-26,EY,Lithuania,736,564,7,7,172,84,81,165,0
2025-08-27,EY,Lithuania,714,517,16,14,197,89,92,181,2
2025-08-28,EY,Lithuania,758,558,13,11,200,94,93,187,2
2025-08-29,EY,Lithuania,738,548,9,8,190,90,91,181,1
2025-01-01,LM,Malta,324,183,2,2,141,69,70,139,0
2025-01-02,LM,Malta,383,200,0,0,183,90,93,183,0
2025-01-03,LM,Malta,382,206,0,0,176,88,88,176,0
2025-01-04,LM,Malta,434,252,0,0,182,91,91,182,0
2025-01-05,LM,Malta,394,224,0,0,170,83,87,170,0
2025-01-06,LM,Malta,439,265,1,1,174,87,86,173,0
2025-01-07,LM,Malta,374,234,1,1,140,69,70,139,0
2025-01-08,LM,Malta,328,222,2,2,106,51,53,104,0
2025-01-09,LM,Malta,345,218,2,2,127,63,62,125,0
2025-01-10,LM,Malta,355,196,2,2,159,79,78,157,0
2025-01-11,LM,Malta,388,223,2,2,165,82,81,163,0
2025-01-12,LM,Malta,363,220,2,2,143,70,71,141,0
2025-01-13,LM,Malta,390,227,1,1,163,81,81,162,0
2025-01-14,LM,Malta,292,202,0,0,90,47,43,90,0
2025-01-15,LM,Malta,339,226,2,2,113,53,58,111,0
2025-01-16,LM,Malta,356,221,4,4,135,68,63,131,0
2025-01-17,LM,Malta,383,216,1,1,167,83,83,166,0
2025-01-18,LM,Malta,411,251,2,2,160,79,79,158,0
2025-01-19,LM,Malta,399,235,5,5,164,80,79,159,0
2025-01-20,LM,Malta,405,241,4,4,164,78,82,160,0
2025-01-21,LM,Malta,330,236,3,3,94,47,44,91,0
2025-01-22,LM,Malta,340,222,2,2,118,57,59,116,0
2025-01-23,LM,Malta,353,227,1,1,126,63,62,125,0
2025-01-24,LM,Malta,380,212,2,2,168,84,82,166,0
2025-01-25,LM,Malta,391,238,0,0,153,76,77,153,0
2025-01-26,LM,Malta,383,229,3,3,154,74,77,151,0
2025-01-27,LM,Malta,395,235,1,1,160,80,79,159,0
2025-01-28,LM,Malta,318,228,3,3,90,43,44,87,0
2025-01-29,LM,Malta,338,227,1,1,111,54,56,110,0
2025-01-30,LM,Malta,333,210,1,1,123,64,58,122,0
2025-01-31,LM,Malta,345,187,3,3,158,77,78,155,0
2025-02-01,LM,Malta,384,215,0,0,169,83,86,169,0
2025-02-02,LM,Malta,365,200,0,0,165,81,84,165,0
2025-02-03,LM,Malta,412,240,1,1,172,85,86,171,0
2025-02-04,LM,Malta,331,223,2,2,108,51,55,106,0
2025-02-05,LM,Malta,330,206,3,3,124,62,59,121,0
2025-02-06,LM,Malta,379,222,3,3,157,79,75,154,0
2025-02-07,LM,Malta,391,212,3,3,179,88,88,176,0
2025-02-08,LM,Malta,403,229,0,0,174,87,87,174,0
2025-02-09,LM,Malta,381,218,2,2,163,80,81,161,0
2025-02-10,LM,Malta,409,231,1,1,178,85,92,177,0
2025-02-11,LM,Malta,351,237,0,0,114,58,56,114,0
2025-02-12,LM,Malta,347,227,0,0,120,59,61,120,0
2025-02-13,LM,Malta,382,224,2,2,158,77,79,156,0
2025-02-14,LM,Malta,423,241,3,3,182,93,86,179,0
2025-02-15,LM,Malta,420,247,0,0,173,84,89,173,0
2025-02-16,LM,Malta,394,228,0,0,166,82,84,166,0
2025-02-17,LM,Malta,417,239,0,0,178,90,88,178,0
2025-02-18,LM,Malta,362,224,0,0,138,67,71,138,0
2025-02-19,LM,Malta,383,232,2,2,151,75,74,149,0
2025-02-20,LM,Malta,436,256,3,3,180,89,88,177,0
2025-02-21,LM,Malta,396,214,2,2,182,89,91,180,0
2025-02-22,LM,Malta,400,223,0,0,177,90,87,177,0
2025-02-23,LM,Malta,417,251,1,1,166,81,84,165,0
2025-02-24,LM,Malta,454,271,1,1,183,91,91,182,0
2025-02-25,LM,Malta,366,252,2,2,114,56,56,112,0
2025-02-26,LM,Malta,349,224,2,2,125,60,63,123,0
2025-02-27,LM,Malta,413,249,2,2,164,80,82,162,0
2025-02-28,LM,Malta,444,269,1,1,175,87,87,174,0
2025-03-01,LM,Malta,408,220,1,1,188,93,94,187,0
2025-03-02,LM,Malta,387,221,0,0,166,82,84,166,0
2025-03-03,LM,Malta,431,243,0,0,188,95,93,188,0
2025-03-04,LM,Malta,358,220,0,0,138,69,69,138,0
2025-03-05,LM,Malta,382,225,0,0,157,79,78,157,0
2025-03-06,LM,Malta,422,245,0,0,177,89,88,177,0
2025-03-07,LM,Malta,374,195,2,2,179,92,85,177,0
2025-03-08,LM,Malta,425,242,0,0,183,89,94,183,0
2025-03-09,LM,Malta,386,217,2,2,169,81,86,167,0
2025-03-10,LM,Malta,407,242,2,2,165,80,83,163,0
2025-03-11,LM,Malta,370,229,2,2,141,70,69,139,0
2025-03-12,LM,Malta,373,227,1,1,146,72,73,145,0
2025-03-13,LM,Malta,407,231,4,4,176,85,87,172,0
2025-03-14,LM,Malta,412,224,3,3,188,93,92,185,0
2025-03-15,LM,Malta,444,245,2,2,199,97,100,197,0
2025-03-16,LM,Malta,437,261,3,3,176,87,86,173,0
2025-03-17,LM,Malta,418,238,3,3,180,89,88,177,0
2025-03-18,LM,Malta,359,215,3,3,144,69,72,141,0
2025-03-19,LM,Malta,342,187,3,3,155,76,76,152,0
2025-03-20,LM,Malta,381,203,3,3,178,89,86,175,0
2025-03-21,LM,Malta,369,193,1,1,176,87,88,175,0
2025-03-22,LM,Malta,412,226,5,5,186,91,90,181,0
2025-03-23,LM,Malta,388,204,0,0,184,89,95,184,0
2025-03-24,LM,Malta,382,194,1,1,188,96,91,187,0
2025-03-25,LM,Malta,328,180,3,3,148,71,74,145,0
2025-03-26,LM,Malta,319,177,2,2,142,71,69,140,0
2025-03-27,LM,Malta,401,198,3,3,203,100,100,200,0
2025-03-28,LM,Malta,417,231,2,2,186,94,90,184,0
2025-03-29,LM,Malta,419,222,4,4,197,99,94,193,0
2025-03-30,LM,Malta,393,212,2,2,181,89,90,179,0
2025-03-31,LM,Malta,458,242,0,0,216,107,109,216,0
2025-04-01,LM,Malta,486,280,0,0,206,103,103,206,0
2025-04-02,LM,Malta,466,257,2,2,209,102,105,207,0
2025-04-03,LM,Malta,474,243,2,2,231,116,113,229,0
2025-04-04,LM,Malta,477,253,4,4,224,110,110,220,0
2025-04-05,LM,Malta,462,261,4,4,201,99,98,197,0
2025-04-06,LM,Malta,439,242,3,3,197,97,97,194,0
2025-04-07,LM,Malta,477,261,2,2,216,106,108,214,0
2025-04-08,LM,Malta,453,254,0,0,199,99,100,199,0
2025-04-09,LM,Malta,458,245,1,1,213,105,107,212,0
2025-04-10,LM,Malta,494,249,5,5,245,121,119,240,0
2025-04-11,LM,Malta,480,258,4,4,222,109,109,218,0
2025-04-12,LM,Malta,480,270,5,5,210,103,102,205,0
2025-04-13,LM,Malta,433,238,5,5,195,96,94,190,0
2025-04-14,LM,Malta,471,238,1,1,233,113,119,232,0
2025-04-15,LM,Malta,448,230,3,3,218,109,106,215,0
2025-04-16,LM,Malta,436,221,3,3,215,108,104,212,0
2025-04-17,LM,Malta,511,267,1,1,244,120,123,243,0
2025-04-18,LM,Malta,470,255,1,1,215,107,107,214,0
2025-04-19,LM,Malta,472,270,1,1,202,102,99,201,0
2025-04-20,LM,Malta,464,279,1,1,185,90,94,184,0
2025-04-21,LM,Malta,493,269,2,2,224,110,112,222,0
2025-04-22,LM,Malta,455,236,0,0,219,110,109,219,0
2025-04-23,LM,Malta,461,242,2,2,219,110,107,217,0
2025-04-24,LM,Malta,483,248,1,1,235,114,120,234,0
2025-04-25,LM,Malta,472,249,1,1,223,112,110,222,0
2025-04-26,LM,Malta,450,244,0,0,206,104,102,206,0
2025-04-27,LM,Malta,442,244,2,2,198,97,99,196,0
2025-04-28,LM,Malta,435,206,3,3,229,116,110,226,0
2025-04-29,LM,Malta,408,199,3,3,209,104,102,206,0
2025-04-30,LM,Malta,429,199,2,2,230,112,116,228,0
2025-05-01,LM,Malta,432,205,1,1,227,113,113,226,0
2025-05-02,LM,Malta,440,221,2,2,219,108,109,217,0
2025-05-03,LM,Malta,440,231,3,3,209,103,103,206,0
2025-05-04,LM,Malta,441,229,2,2,212,103,107,210,0
2025-05-05,LM,Malta,471,239,3,3,232,117,112,229,0
2025-05-06,LM,Malta,406,200,1,1,206,103,102,205,0
2025-05-07,LM,Malta,394,180,4,4,214,104,106,210,0
2025-05-08,LM,Malta,462,220,5,5,242,118,119,237,0
2025-05-09,LM,Malta,436,210,2,2,226,113,111,224,0
2025-05-10,LM,Malta,428,217,3,3,211,104,104,208,0
2025-05-11,LM,Malta,425,226,3,3,199,100,96,196,0
2025-05-12,LM,Malta,465,232,1,1,233,116,116,232,0
2025-05-13,LM,Malta,426,223,0,0,203,99,104,203,0
2025-05-14,LM,Malta,396,184,2,2,212,106,104,210,0
2025-05-15,LM,Malta,455,228,0,0,227,110,117,227,0
2025-05-16,LM,Malta,526,292,0,0,234,117,117,234,0
2025-05-17,LM,Malta,474,258,2,2,216,112,102,214,0
2025-05-18,LM,Malta,448,249,2,2,199,95,102,197,0
2025-05-19,LM,Malta,493,260,1,1,233,117,115,232,0
2025-05-20,LM,Malta,453,239,2,2,214,106,106,212,0
2025-05-21,LM,Malta,440,223,2,2,217,109,106,215,0
2025-05-22,LM,Malta,512,262,2,2,250,118,130,248,0
2025-05-23,LM,Malta,489,254,4,4,235,119,112,231,0
2025-05-24,LM,Malta,458,259,0,0,199,99,100,199,0
2025-05-25,LM,Malta,469,271,0,0,198,100,98,198,0
2025-05-26,LM,Malta,465,238,0,0,227,113,114,227,0
2025-05-27,LM,Malta,443,228,3,3,215,106,106,212,0
2025-05-28,LM,Malta,429,208,1,1,221,109,111,220,0
2025-05-29,LM,Malta,527,274,0,0,253,124,129,253,0
2025-05-30,LM,Malta,480,258,3,3,222,111,108,219,0
2025-05-31,LM,Malta,463,260,1,1,203,100,102,202,0
2025-06-01,LM,Malta,454,244,1,1,210,107,102,209,0
2025-06-02,LM,Malta,466,227,1,1,239,118,120,238,0
2025-06-03,LM,Malta,441,228,3,3,213,107,103,210,0
2025-06-04,LM,Malta,417,200,2,2,217,106,109,215,0
2025-06-05,LM,Malta,497,250,1,1,247,124,122,246,0
2025-06-06,LM,Malta,444,223,2,2,221,109,110,219,0
2025-06-07,LM,Malta,438,225,2,2,213,106,105,211,0
2025-06-08,LM,Malta,416,216,1,1,200,98,101,199,0
2025-06-09,LM,Malta,455,214,3,3,241,120,118,238,0
2025-06-10,LM,Malta,434,227,3,3,207,104,100,204,0
2025-06-11,LM,Malta,446,241,1,1,205,102,102,204,0
2025-06-12,LM,Malta,524,286,1,1,238,118,119,237,0
2025-06-13,LM,Malta,528,304,4,4,224,114,106,220,0
2025-06-14,LM,Malta,631,421,4,4,210,102,104,206,0
2025-06-15,LM,Malta,606,403,3,3,203,100,100,200,0
2025-06-16,LM,Malta,589,359,2,2,230,111,117,228,0
2025-06-17,LM,Malta,618,399,2,2,219,109,108,217,0
2025-06-18,LM,Malta,582,353,1,1,229,115,113,228,0
2025-06-19,LM,Malta,616,370,2,2,246,123,121,244,0
2025-06-20,LM,Malta,617,395,2,2,222,110,110,220,0
2025-06-21,LM,Malta,648,438,2,2,210,107,101,208,0
2025-06-22,LM,Malta,617,406,2,2,211,104,105,209,0
2025-06-23,LM,Malta,568,338,0,0,230,115,115,230,0
2025-06-24,LM,Malta,562,346,0,0,216,109,107,216,0
2025-06-25,LM,Malta,564,353,2,2,211,107,102,209,0
2025-06-26,LM,Malta,554,310,3,3,244,117,124,241,0
2025-06-27,LM,Malta,513,288,1,1,225,111,113,224,0
2025-06-28,LM,Malta,520,290,4,4,230,114,112,226,0
2025-06-29,LM,Malta,454,246,0,0,208,103,105,208,0
2025-06-30,LM,Malta,508,254,1,1,254,123,130,253,0
2025-07-01,LM,Malta,541,297,2,2,244,125,117,242,0
2025-07-02,LM,Malta,506,291,3,3,215,107,105,212,0
2025-07-03,LM,Malta,555,322,5,5,233,114,114,228,0
2025-07-04,LM,Malta,563,334,3,3,229,114,112,226,0
2025-07-05,LM,Malta,507,291,0,0,216,108,108,216,0
2025-07-06,LM,Malta,491,280,1,1,211,104,106,210,0
2025-07-07,LM,Malta,527,288,2,2,239,118,119,237,0
2025-07-08,LM,Malta,498,280,2,2,218,106,110,216,0
2025-07-09,LM,Malta,470,252,0,0,218,108,110,218,0
2025-07-10,LM,Malta,546,300,0,0,246,124,122,246,0
2025-07-11,LM,Malta,510,285,1,1,225,109,115,224,0
2025-07-12,LM,Malta,503,274,1,1,229,115,113,228,0
2025-07-13,LM,Malta,486,279,2,2,207,104,101,205,0
2025-07-14,LM,Malta,510,266,2,2,244,124,118,242,0
2025-07-15,LM,Malta,463,261,1,1,202,101,100,201,0
2025-07-16,LM,Malta,469,244,1,1,225,113,111,224,0
2025-07-17,LM,Malta,541,298,2,2,243,119,122,241,0
2025-07-18,LM,Malta,520,278,3,3,242,120,119,239,0
2025-07-19,LM,Malta,507,283,2,2,224,108,114,222,0
2025-07-20,LM,Malta,488,267,4,4,221,112,105,217,0
2025-07-21,LM,Malta,550,297,2,2,253,122,129,251,0
2025-07-22,LM,Malta,480,263,2,2,217,108,107,215,0
2025-07-23,LM,Malta,502,266,2,2,236,118,116,234,0
2025-07-24,LM,Malta,552,300,0,0,252,127,125,252,0
2025-07-25,LM,Malta,512,282,2,2,230,114,114,228,0
2025-07-26,LM,Malta,542,320,2,2,222,110,110,220,0
2025-07-27,LM,Malta,528,302,2,2,226,113,111,224,0
2025-07-28,LM,Malta,548,307,3,3,241,118,120,238,0
2025-07-29,LM,Malta,492,274,2,2,218,107,109,216,0
2025-07-30,LM,Malta,495,260,1,1,235,115,119,234,0
2025-07-31,LM,Malta,559,307,1,1,252,125,126,251,0
2025-08-01,LM,Malta,543,302,2,2,241,120,119,239,0
2025-08-02,LM,Malta,553,335,2,2,218,109,107,216,0
2025-08-03,LM,Malta,506,302,2,2,204,100,102,202,0
2025-08-04,LM,Malta,549,311,2,2,238,122,114,236,0
2025-08-05,LM,Malta,534,312,1,1,222,113,108,221,0
2025-08-06,LM,Malta,530,297,2,2,233,112,119,231,0
2025-08-07,LM,Malta,559,312,2,2,247,121,124,245,0
2025-08-08,LM,Malta,523,290,2,2,233,120,111,231,0
2025-08-09,LM,Malta,566,337,2,2,229,111,116,227,0
2025-08-10,LM,Malta,528,322,1,1,206,104,101,205,0
2025-08-11,LM,Malta,518,282,1,1,236,116,119,235,0
2025-08-12,LM,Malta,515,303,2,2,212,107,103,210,0
2025-08-13,LM,Malta,493,274,3,3,219,109,107,216,0
2025-08-14,LM,Malta,547,307,1,1,240,119,120,239,0
2025-08-15,LM,Malta,540,315,1,1,225,111,113,224,0
2025-08-16,LM,Malta,548,333,0,0,215,109,106,215,0
2025-08-17,LM,Malta,514,304,2,2,210,101,107,208,0
2025-08-18,LM,Malta,538,304,1,1,234,115,118,233,0
2025-08-19,LM,Malta,491,278,4,4,213,107,102,209,0
2025-08-20,LM,Malta,492,264,2,2,228,113,113,226,0
2025-08-21,LM,Malta,545,302,1,1,243,121,121,242,0
2025-08-22,LM,Malta,534,296,4,4,238,118,116,234,0
2025-08-23,LM,Malta,555,336,4,4,219,108,107,215,0
2025-08-24,LM,Malta,552,341,1,1,211,105,105,210,0
2025-08-25,LM,Malta,585,338,3,3,247,122,122,244,0
2025-08-26,LM,Malta,553,329,1,1,224,112,111,223,0
2025-08-27,LM,Malta,492,265,2,2,227,112,113,225,0
2025-08-28,LM,Malta,532,287,2,2,245,122,121,243,0
2025-08-29,LM,Malta,525,304,0,0,221,113,108,221,0
2025-01-01,LU,Moldova,55,-1,0,0,56,29,27,56,0
2025-01-02,LU,Moldova,86,-1,0,0,87,43,44,87,0
2025-01-03,LU,Moldova,87,0,0,0,87,43,44,87,0
2025-01-04,LU,Moldova,80,0,0,0,80,42,38,80,0
2025-01-05,LU,Moldova,98,1,0,0,97,48,49,97,0
2025-01-06,LU,Moldova,89,3,0,0,86,43,43,86,0
2025-01-07,LU,Moldova,75,-3,0,0,78,38,40,78,0
2025-01-08,LU,Moldova,100,2,0,0,98,50,48,98,0
2025-01-09,LU,Moldova,90,-4,0,0,94,45,49,94,0
2025-01-10,LU,Moldova,94,3,0,0,91,47,44,91,0
2025-01-11,LU,Moldova,76,2,0,0,74,37,37,74,0
2025-01-12,LU,Moldova,102,-2,0,0,104,51,53,104,0
2025-01-13,LU,Moldova,87,5,0,0,82,42,40,82,0
2025-01-14,LU,Moldova,79,-4,0,0,83,41,42,83,0
2025-01-15,LU,Moldova,87,2,0,0,85,42,43,85,0
2025-01-16,LU,Moldova,87,-1,0,0,88,43,45,88,0
2025-01-17,LU,Moldova,84,0,0,0,84,42,42,84,0
2025-01-18,LU,Moldova,76,-1,1,1,77,37,39,76,0
2025-01-19,LU,Moldova,95,-2,0,0,97,49,48,97,0
2025-01-20,LU,Moldova,89,6,0,0,83,43,40,83,0
2025-01-21,LU,Moldova,74,-3,0,0,77,37,40,77,0
2025-01-22,LU,Moldova,87,2,0,0,85,44,41,85,0
2025-01-23,LU,Moldova,73,0,0,0,73,35,38,73,0
2025-01-24,LU,Moldova,85,0,0,0,85,44,41,85,0
2025-01-25,LU,Moldova,64,-1,0,0,65,33,32,65,0
2025-01-26,LU,Moldova,92,-2,0,0,94,47,47,94,0
2025-01-27,LU,Moldova,86,5,0,0,81,39,42,81,0
2025-01-28,LU,Moldova,77,-2,0,0,79,38,41,79,0
2025-01-29,LU,Moldova,83,2,0,0,81,43,38,81,0
2025-01-30,LU,Moldova,77,0,0,0,77,37,40,77,0
2025-01-31,LU,Moldova,88,-2,0,0,90,46,44,90,0
2025-02-01,LU,Moldova,70,0,0,0,70,36,34,70,0
2025-02-02,LU,Moldova,87,-2,0,0,89,44,45,89,0
2025-02-03,LU,Moldova,83,5,0,0,78,38,40,78,0
2025-02-04,LU,Moldova,73,-2,0,0,75,36,39,75,0
2025-02-05,LU,Moldova,87,0,0,0,87,45,42,87,0
2025-02-06,LU,Moldova,80,0,0,0,80,38,42,80,0
2025-02-07,LU,Moldova,85,0,0,0,85,43,42,85,0
2025-02-08,LU,Moldova,67,-2,0,0,69,35,34,69,0
2025-02-09,LU,Moldova,90,-1,0,0,91,46,45,91,0
2025-02-10,LU,Moldova,80,5,0,0,75,36,39,75,0
2025-02-11,LU,Moldova,68,-2,0,0,70,35,35,70,0
2025-02-12,LU,Moldova,80,2,0,0,78,40,38,78,0
2025-02-13,LU,Moldova,76,-3,0,0,79,38,41,79,0
2025-02-14,LU,Moldova,91,-1,0,0,92,48,44,92,0
2025-02-15,LU,Moldova,66,-1,0,0,67,35,32,67,0
2025-02-16,LU,Moldova,89,0,0,0,89,44,45,89,0
2025-02-17,LU,Moldova,77,5,1,1,72,36,35,71,0
2025-02-18,LU,Moldova,75,-2,0,0,77,38,39,77,0
2025-02-19,LU,Moldova,85,1,0,0,84,43,41,84,0
2025-02-20,LU,Moldova,75,-1,0,0,76,36,40,76,0
2025-02-21,LU,Moldova,82,-1,0,0,83,42,41,83,0
2025-02-22,LU,Moldova,65,1,0,0,64,34,30,64,0
2025-02-23,LU,Moldova,88,-2,0,0,90,44,46,90,0
2025-02-24,LU,Moldova,84,5,0,0,79,40,39,79,0
2025-02-25,LU,Moldova,76,-3,0,0,79,39,40,79,0
2025-02-26,LU,Moldova,82,3,0,0,79,40,39,79,0
2025-02-27,LU,Moldova,87,-1,0,0,88,42,46,88,0
2025-02-28,LU,Moldova,83,-1,0,0,84,43,41,84,0
2025-03-01,LU,Moldova,84,-1,0,0,85,42,43,85,0
2025-03-02,LU,Moldova,99,0,0,0,99,49,50,99,0
2025-03-03,LU,Moldova,86,5,0,0,81,41,40,81,0
2025-03-04,LU,Moldova,76,-2,0,0,78,38,40,78,0
2025-03-05,LU,Moldova,82,2,0,0,80,41,39,80,0
2025-03-06,LU,Moldova,89,-1,0,0,90,43,47,90,0
2025-03-07,LU,Moldova,89,-1,0,0,90,46,44,90,0
2025-03-08,LU,Moldova,75,-1,0,0,76,38,38,76,0
2025-03-09,LU,Moldova,102,-1,0,0,103,51,52,103,0
2025-03-10,LU,Moldova,86,4,0,0,82,41,41,82,0
2025-03-11,LU,Moldova,87,-2,0,0,89,45,44,89,0
2025-03-12,LU,Moldova,88,1,0,0,87,43,44,87,0
2025-03-13,LU,Moldova,93,0,0,0,93,46,47,93,0
2025-03-14,LU,Moldova,92,1,0,0,91,47,44,91,0
2025-03-15,LU,Moldova,82,1,0,0,81,41,40,81,0
2025-03-16,LU,Moldova,91,-2,0,0,93,46,47,93,0
2025-03-17,LU,Moldova,86,4,0,0,82,40,42,82,0
2025-03-18,LU,Moldova,82,-3,1,1,85,41,43,84,0
2025-03-19,LU,Moldova,89,1,0,0,88,45,43,88,0
2025-03-20,LU,Moldova,90,-1,0,0,91,45,46,91,0
2025-03-21,LU,Moldova,92,0,0,0,92,47,45,92,0
2025-03-22,LU,Moldova,84,1,0,0,83,43,40,83,0
2025-03-23,LU,Moldova,99,-2,0,0,101,50,51,101,0
2025-03-24,LU,Moldova,89,5,0,0,84,42,42,84,0
2025-03-25,LU,Moldova,82,-2,0,0,84,42,42,84,0
2025-03-26,LU,Moldova,86,1,1,1,85,42,42,84,0
2025-03-27,LU,Moldova,83,-2,0,0,85,41,44,85,0
2025-03-28,LU,Moldova,89,-3,0,0,92,46,46,92,0
2025-03-29,LU,Moldova,88,4,0,0,84,42,42,84,0
2025-03-30,LU,Moldova,94,0,0,0,94,46,48,94,0
2025-03-31,LU,Moldova,88,0,0,0,88,43,45,88,0
2025-04-01,LU,Moldova,103,-2,0,0,105,53,52,105,0
2025-04-02,LU,Moldova,89,1,0,0,88,44,44,88,0
2025-04-03,LU,Moldova,92,1,0,0,91,46,45,91,0
2025-04-04,LU,Moldova,93,1,1,1,92,45,46,91,0
2025-04-05,LU,Moldova,91,-4,0,0,95,45,50,95,0
2025-04-06,LU,Moldova,107,4,0,0,103,55,48,103,0
2025-04-07,LU,Moldova,91,0,0,0,91,44,47,91,0
2025-04-08,LU,Moldova,102,-2,0,0,104,53,51,104,0
2025-04-09,LU,Moldova,90,1,0,0,89,44,45,89,0
2025-04-10,LU,Moldova,92,2,0,0,90,45,45,90,0
2025-04-11,LU,Moldova,102,0,0,0,102,51,51,102,0
2025-04-12,LU,Moldova,97,-3,0,0,100,47,53,100,0
2025-04-13,LU,Moldova,102,2,0,0,100,51,49,100,0
2025-04-14,LU,Moldova,102,2,0,0,100,49,51,100,0
2025-04-15,LU,Moldova,108,-3,0,0,111,56,55,111,0
2025-04-16,LU,Moldova,96,-1,0,0,97,48,49,97,0
2025-04-17,LU,Moldova,107,4,0,0,103,52,51,103,0
2025-04-18,LU,Moldova,114,-1,0,0,115,59,56,115,0
2025-04-19,LU,Moldova,103,-3,0,0,106,52,54,106,0
2025-04-20,LU,Moldova,102,3,0,0,99,50,49,99,0
2025-04-21,LU,Moldova,100,1,0,0,99,50,49,99,0
2025-04-22,LU,Moldova,114,-4,0,0,118,59,59,118,0
2025-04-23,LU,Moldova,95,0,0,0,95,48,47,95,0
2025-04-24,LU,Moldova,111,3,0,0,108,54,54,108,0
2025-04-25,LU,Moldova,103,0,0,0,103,53,50,103,0
2025-04-26,LU,Moldova,105,-4,0,0,109,52,57,109,0
2025-04-27,LU,Moldova,110,2,1,1,108,54,53,107,0
2025-04-28,LU,Moldova,102,2,0,0,100,50,50,100,0
2025-04-29,LU,Moldova,121,-1,0,0,122,62,60,122,0
2025-04-30,LU,Moldova,103,-3,0,0,106,52,54,106,0
2025-05-01,LU,Moldova,116,6,0,0,110,55,55,110,0
2025-05-02,LU,Moldova,116,1,0,0,115,57,58,115,0
2025-05-03,LU,Moldova,108,-2,0,0,110,55,55,110,0
2025-05-04,LU,Moldova,126,1,2,1,125,63,60,123,1
2025-05-05,LU,Moldova,106,0,0,0,106,51,55,106,0
2025-05-06,LU,Moldova,110,-2,0,0,112,57,55,112,0
2025-05-07,LU,Moldova,114,0,0,0,114,54,60,114,0
2025-05-08,LU,Moldova,117,2,1,1,115,58,56,114,0
2025-05-09,LU,Moldova,109,1,0,0,108,56,52,108,0
2025-05-10,LU,Moldova,113,-3,0,0,116,57,59,116,0
2025-05-11,LU,Moldova,118,2,0,0,116,59,57,116,0
2025-05-12,LU,Moldova,100,-1,0,0,101,48,53,101,0
2025-05-13,LU,Moldova,124,0,0,0,124,63,61,124,0
2025-05-14,LU,Moldova,121,0,0,0,121,60,61,121,0
2025-05-15,LU,Moldova,122,3,0,0,119,60,59,119,0
2025-05-16,LU,Moldova,116,-2,0,0,118,58,60,118,0
2025-05-17,LU,Moldova,125,-1,0,0,126,62,64,126,0
2025-05-18,LU,Moldova,124,1,0,0,123,65,58,123,0
2025-05-19,LU,Moldova,112,2,0,0,110,54,56,110,0
2025-05-20,LU,Moldova,121,-3,1,0,124,61,62,123,1
2025-05-21,LU,Moldova,126,1,0,0,125,63,62,125,0
2025-05-22,LU,Moldova,124,-1,0,0,125,61,64,125,0
2025-05-23,LU,Moldova,131,1,0,0,130,66,64,130,0
2025-05-24,LU,Moldova,156,-2,0,0,158,77,81,158,0
2025-05-25,LU,Moldova,137,5,0,0,132,71,61,132,0
2025-05-26,LU,Moldova,124,-1,0,0,125,58,67,125,0
2025-05-27,LU,Moldova,138,-1,0,0,139,70,69,139,0
2025-05-28,LU,Moldova,143,1,0,0,142,71,71,142,0
2025-05-29,LU,Moldova,132,1,0,0,131,65,66,131,0
2025-05-30,LU,Moldova,152,1,0,0,151,77,74,151,0
2025-05-31,LU,Moldova,142,-5,0,0,147,71,76,147,0
2025-06-01,LU,Moldova,146,4,0,0,142,74,68,142,0
2025-06-02,LU,Moldova,135,0,0,0,135,65,70,135,0
2025-06-03,LU,Moldova,140,0,0,0,140,69,71,140,0
2025-06-04,LU,Moldova,147,-1,0,0,148,75,73,148,0
2025-06-05,LU,Moldova,139,1,0,0,138,71,67,138,0
2025-06-06,LU,Moldova,142,0,0,0,142,72,70,142,0
2025-06-07,LU,Moldova,159,1,0,0,158,77,81,158,0
2025-06-08,LU,Moldova,153,2,0,0,151,77,74,151,0
2025-06-09,LU,Moldova,143,0,0,0,143,70,73,143,0
2025-06-10,LU,Moldova,147,-3,0,0,150,74,76,150,0
2025-06-11,LU,Moldova,158,1,0,0,157,81,76,157,0
2025-06-12,LU,Moldova,134,3,0,0,131,67,64,131,0
2025-06-13,LU,Moldova,152,-2,0,0,154,75,79,154,0
2025-06-14,LU,Moldova,148,-1,0,0,149,74,75,149,0
2025-06-15,LU,Moldova,151,1,0,0,150,76,74,150,0
2025-06-16,LU,Moldova,132,3,0,0,129,64,65,129,0
2025-06-17,LU,Moldova,146,-2,0,0,148,73,75,148,0
2025-06-18,LU,Moldova,150,-1,0,0,151,74,77,151,0
2025-06-19,LU,Moldova,137,1,0,0,136,71,65,136,0
2025-06-20,LU,Moldova,155,0,0,0,155,76,79,155,0
2025-06-21,LU,Moldova,152,-2,0,0,154,78,76,154,0
2025-06-22,LU,Moldova,157,2,0,0,155,78,77,155,0
2025-06-23,LU,Moldova,132,1,0,0,131,65,66,131,0
2025-06-24,LU,Moldova,152,-1,0,0,153,78,75,153,0
2025-06-25,LU,Moldova,152,0,0,0,152,75,77,152,0
2025-06-26,LU,Moldova,143,3,0,0,140,71,69,140,0
2025-06-27,LU,Moldova,148,-1,0,0,149,72,77,149,0
2025-06-28,LU,Moldova,162,-1,0,0,163,82,81,163,0
2025-06-29,LU,Moldova,158,2,0,0,156,81,75,156,0
2025-06-30,LU,Moldova,142,-2,0,0,144,69,75,144,0
2025-07-01,LU,Moldova,156,2,0,0,154,77,77,154,0
2025-07-02,LU,Moldova,147,-1,0,0,148,74,74,148,0
2025-07-03,LU,Moldova,146,1,0,0,145,73,72,145,0
2025-07-04,LU,Moldova,145,0,0,0,145,72,73,145,0
2025-07-05,LU,Moldova,169,-1,0,0,170,85,85,170,0
2025-07-06,LU,Moldova,159,0,0,0,159,81,78,159,0
2025-07-07,LU,Moldova,140,2,0,0,138,70,68,138,0
2025-07-08,LU,Moldova,161,-3,1,1,164,78,85,163,0
2025-07-09,LU,Moldova,156,0,0,0,156,79,77,156,0
2025-07-10,LU,Moldova,148,3,0,0,145,74,71,145,0
2025-07-11,LU,Moldova,153,0,0,0,153,75,78,153,0
2025-07-12,LU,Moldova,159,-1,0,0,160,81,79,160,0
2025-07-13,LU,Moldova,156,2,0,0,154,78,76,154,0
2025-07-14,LU,Moldova,145,-2,0,0,147,72,75,147,0
2025-07-15,LU,Moldova,163,1,0,0,162,79,83,162,0
2025-07-16,LU,Moldova,156,-2,0,0,158,79,79,158,0
2025-07-17,LU,Moldova,153,3,0,0,150,77,73,150,0
2025-07-18,LU,Moldova,164,0,0,0,164,79,85,164,0
2025-07-19,LU,Moldova,165,-2,0,0,167,84,83,167,0
2025-07-20,LU,Moldova,150,1,0,0,149,77,72,149,0
2025-07-21,LU,Moldova,154,-3,1,0,157,74,82,156,1
2025-07-22,LU,Moldova,169,1,0,0,168,84,84,168,0
2025-07-23,LU,Moldova,160,1,0,0,159,81,78,159,0
2025-07-24,LU,Moldova,143,1,0,0,142,73,69,142,0
2025-07-25,LU,Moldova,175,1,0,0,174,88,86,174,0
2025-07-26,LU,Moldova,164,3,0,0,161,83,78,161,0
2025-07-27,LU,Moldova,156,0,0,0,156,78,78,156,0
2025-07-28,LU,Moldova,161,0,0,0,161,81,80,161,0
2025-07-29,LU,Moldova,166,-2,0,0,168,82,86,168,0
2025-07-30,LU,Moldova,165,-1,0,0,166,82,84,166,0
2025-07-31,LU,Moldova,154,3,0,0,151,75,76,151,0
2025-08-01,LU,Moldova,152,-2,0,0,154,78,76,154,0
2025-08-02,LU,Moldova,165,2,0,0,163,83,80,163,0
2025-08-03,LU,Moldova,169,-1,0,0,170,83,87,170,0
2025-08-04,LU,Moldova,155,1,0,0,154,78,76,154,0
2025-08-05,LU,Moldova,174,-1,0,0,175,87,88,175,0
2025-08-06,LU,Moldova,162,0,0,0,162,80,82,162,0
2025-08-07,LU,Moldova,155,1,0,0,154,76,78,154,0
2025-08-08,LU,Moldova,163,-1,0,0,164,81,83,164,0
2025-08-09,LU,Moldova,168,2,0,0,166,85,81,166,0
2025-08-10,LU,Moldova,173,-3,0,0,176,86,90,176,0
2025-08-11,LU,Moldova,162,-2,0,0,164,82,82,164,0
2025-08-12,LU,Moldova,167,5,0,0,162,82,80,162,0
2025-08-13,LU,Moldova,166,-2,0,0,168,81,87,168,0
2025-08-14,LU,Moldova,152,1,0,0,151,76,75,151,0
2025-08-15,LU,Moldova,164,-4,0,0,168,83,85,168,0
2025-08-16,LU,Moldova,169,2,0,0,167,84,83,167,0
2025-08-17,LU,Moldova,164,1,0,0,163,84,79,163,0
2025-08-18,LU,Moldova,156,-1,0,0,157,78,79,157,0
2025-08-19,LU,Moldova,174,2,0,0,172,86,86,172,0
2025-08-20,LU,Moldova,163,0,0,0,163,82,81,163,0
2025-08-21,LU,Moldova,165,0,0,0,165,83,82,165,0
2025-08-22,LU,Moldova,160,-3,0,0,163,80,83,163,0
2025-08-23,LU,Moldova,171,3,0,0,168,85,83,168,0
2025-08-24,LU,Moldova,167,0,0,0,167,83,84,167,0
2025-08-25,LU,Moldova,161,0,1,1,161,80,80,160,0
2025-08-26,LU,Moldova,158,3,0,0,155,77,78,155,0
2025-08-27,LU,Moldova,174,-2,0,0,176,89,87,176,0
2025-08-28,LU,Moldova,156,1,0,0,155,75,80,155,0
2025-08-29,LU,Moldova,168,0,0,0,168,84,84,168,0
2025-01-01,GM,Morocco,1566,877,71,1,689,311,307,618,70
2025-01-02,GM,Morocco,1760,1013,77,3,747,343,327,670,74
2025-01-03,GM,Morocco,1781,994,103,2,787,347,337,684,101
2025-01-04,GM,Morocco,2068,1266,64,0,802,370,368,738,64
2025-01-05,GM,Morocco,1852,1091,76,1,761,345,340,685,75
2025-01-06,GM,Morocco,1641,920,77,0,721,320,324,644,77
2025-01-07,GM,Morocco,1618,931,87,4,687,301,299,600,83
2025-01-08,GM,Morocco,1408,830,68,0,578,256,254,510,68
2025-01-09,GM,Morocco,1424,863,67,2,561,244,250,494,65
2025-01-10,GM,Morocco,1602,874,105,2,728,318,305,623,103
2025-01-11,GM,Morocco,1855,1154,54,0,701,322,325,647,54
2025-01-12,GM,Morocco,1670,977,79,0,693,312,302,614,79
2025-01-13,GM,Morocco,1394,750,85,0,644,279,280,559,85
2025-01-14,GM,Morocco,1269,774,57,2,495,220,218,438,55
2025-01-15,GM,Morocco,1262,731,74,4,531,230,227,457,70
2025-01-16,GM,Morocco,1334,792,70,5,542,237,235,472,65
2025-01-17,GM,Morocco,1563,852,105,0,711,305,301,606,105
2025-01-18,GM,Morocco,1868,1175,67,0,693,312,314,626,67
2025-01-19,GM,Morocco,1662,992,69,0,670,302,299,601,69
2025-01-20,GM,Morocco,1428,770,94,5,658,277,287,564,89
2025-01-21,GM,Morocco,1281,760,73,8,521,224,224,448,65
2025-01-22,GM,Morocco,1230,700,78,1,530,226,226,452,77
2025-01-23,GM,Morocco,1325,784,61,2,541,238,242,480,59
2025-01-24,GM,Morocco,1510,830,92,1,680,299,289,588,91
2025-01-25,GM,Morocco,1856,1154,59,0,702,322,321,643,59
2025-01-26,GM,Morocco,1611,945,77,0,666,297,292,589,77
2025-01-27,GM,Morocco,1416,766,88,3,650,279,283,562,85
2025-01-28,GM,Morocco,1262,757,62,3,505,221,222,443,59
2025-01-29,GM,Morocco,1281,749,68,6,532,237,227,464,62
2025-01-30,GM,Morocco,1358,809,64,1,549,242,243,485,63
2025-01-31,GM,Morocco,1565,852,108,5,713,302,303,605,103
2025-02-01,GM,Morocco,1879,1153,63,1,726,330,333,663,62
2025-02-02,GM,Morocco,1679,1001,75,2,678,305,298,603,73
2025-02-03,GM,Morocco,1460,783,89,1,677,292,296,588,88
2025-02-04,GM,Morocco,1372,816,78,1,556,238,240,478,77
2025-02-05,GM,Morocco,1357,772,78,2,585,257,250,507,76
2025-02-06,GM,Morocco,1460,877,66,2,583,259,258,517,64
2025-02-07,GM,Morocco,1593,852,106,2,741,321,314,635,104
2025-02-08,GM,Morocco,1922,1201,52,1,721,333,336,669,51
2025-02-09,GM,Morocco,1705,1030,74,0,675,300,301,601,74
2025-02-10,GM,Morocco,1466,794,84,1,672,291,297,588,83
2025-02-11,GM,Morocco,1421,811,74,2,610,269,267,536,72
2025-02-12,GM,Morocco,1418,814,86,1,604,263,255,518,85
2025-02-13,GM,Morocco,1464,884,61,4,580,259,260,519,57
2025-02-14,GM,Morocco,1666,907,101,4,759,327,331,658,97
2025-02-15,GM,Morocco,1966,1206,64,2,760,345,351,696,62
2025-02-16,GM,Morocco,1779,1070,75,0,709,316,318,634,75
2025-02-17,GM,Morocco,1598,871,107,4,727,306,314,620,103
2025-02-18,GM,Morocco,1562,914,76,1,648,289,283,572,75
2025-02-19,GM,Morocco,1544,883,76,4,661,294,291,585,72
2025-02-20,GM,Morocco,1644,969,79,2,675,297,299,596,77
2025-02-21,GM,Morocco,1667,914,106,2,753,322,325,647,104
2025-02-22,GM,Morocco,2007,1241,72,0,766,346,348,694,72
2025-02-23,GM,Morocco,1767,1033,78,1,734,333,323,656,77
2025-02-24,GM,Morocco,1532,817,93,7,715,308,314,622,86
2025-02-25,GM,Morocco,1527,876,84,4,651,285,282,567,80
2025-02-26,GM,Morocco,1503,863,83,3,640,279,278,557,80
2025-02-27,GM,Morocco,1519,870,72,1,649,290,287,577,71
2025-02-28,GM,Morocco,1600,854,98,0,746,324,324,648,98
2025-03-01,GM,Morocco,2017,1237,61,1,780,356,363,719,60
2025-03-02,GM,Morocco,1725,1029,71,0,696,315,310,625,71
2025-03-03,GM,Morocco,1506,807,77,2,699,312,310,622,75
2025-03-04,GM,Morocco,1503,862,76,2,641,284,281,565,74
2025-03-05,GM,Morocco,1455,830,68,2,625,278,279,557,66
2025-03-06,GM,Morocco,1551,966,49,3,585,269,267,536,46
2025-03-07,GM,Morocco,1589,887,101,2,702,305,296,601,99
2025-03-08,GM,Morocco,1917,1182,55,1,735,336,344,680,54
2025-03-09,GM,Morocco,1723,1049,73,0,674,305,296,601,73
2025-03-10,GM,Morocco,1432,813,77,2,619,271,271,542,75
2025-03-11,GM,Morocco,1481,929,45,1,552,255,252,507,44
2025-03-12,GM,Morocco,1459,886,59,0,573,258,256,514,59
2025-03-13,GM,Morocco,1473,924,58,1,549,243,248,491,57
2025-03-14,GM,Morocco,1543,876,84,1,667,291,292,583,83
2025-03-15,GM,Morocco,1889,1194,50,1,695,325,320,645,49
2025-03-16,GM,Morocco,1715,1047,72,0,668,298,298,596,72
2025-03-17,GM,Morocco,1431,797,80,2,634,270,284,554,78
2025-03-18,GM,Morocco,1444,909,61,2,535,239,235,474,59
2025-03-19,GM,Morocco,1422,872,78,5,550,239,233,472,73
2025-03-20,GM,Morocco,1462,888,57,3,574,258,259,517,54
2025-03-21,GM,Morocco,1579,886,98,3,693,293,302,595,95
2025-03-22,GM,Morocco,1897,1171,47,0,726,344,335,679,47
2025-03-23,GM,Morocco,1715,1051,64,0,664,305,295,600,64
2025-03-24,GM,Morocco,1477,829,81,5,648,279,288,567,76
2025-03-25,GM,Morocco,1503,924,67,3,579,259,253,512,64
2025-03-26,GM,Morocco,1487,861,83,2,626,276,267,543,81
2025-03-27,GM,Morocco,1520,909,63,2,611,276,272,548,61
2025-03-28,GM,Morocco,1538,830,105,4,708,302,301,603,101
2025-03-29,GM,Morocco,1948,1192,69,1,756,339,348,687,68
2025-03-30,GM,Morocco,1567,900,73,0,667,297,297,594,73
2025-03-31,GM,Morocco,1406,774,78,0,632,271,283,554,78
2025-04-01,GM,Morocco,1538,873,67,0,665,301,297,598,67
2025-04-02,GM,Morocco,1460,758,91,6,702,305,306,611,85
2025-04-03,GM,Morocco,1496,796,84,9,700,308,308,616,75
2025-04-04,GM,Morocco,1598,825,101,6,773,339,333,672,95
2025-04-05,GM,Morocco,1810,1076,72,2,734,325,337,662,70
2025-04-06,GM,Morocco,1701,927,79,0,774,348,347,695,79
2025-04-07,GM,Morocco,1489,776,73,1,713,322,318,640,72
2025-04-08,GM,Morocco,1562,865,84,2,697,308,305,613,82
2025-04-09,GM,Morocco,1523,813,86,2,710,315,309,624,84
2025-04-10,GM,Morocco,1536,812,68,1,724,320,336,656,67
2025-04-11,GM,Morocco,1527,767,104,1,760,332,324,656,103
2025-04-12,GM,Morocco,1835,1067,78,1,768,344,346,690,77
2025-04-13,GM,Morocco,1699,954,80,1,745,335,330,665,79
2025-04-14,GM,Morocco,1514,792,88,0,722,316,318,634,88
2025-04-15,GM,Morocco,1615,906,82,1,709,314,313,627,81
2025-04-16,GM,Morocco,1567,827,95,4,740,322,323,645,91
2025-04-17,GM,Morocco,1592,846,77,2,746,328,341,669,75
2025-04-18,GM,Morocco,1571,814,106,1,757,329,322,651,105
2025-04-19,GM,Morocco,1802,1055,74,1,747,327,346,673,73
2025-04-20,GM,Morocco,1619,889,75,0,730,333,322,655,75
2025-04-21,GM,Morocco,1532,783,95,7,749,334,320,654,88
2025-04-22,GM,Morocco,1594,871,106,9,723,309,308,617,97
2025-04-23,GM,Morocco,1551,821,103,12,730,314,313,627,91
2025-04-24,GM,Morocco,1560,826,96,11,734,315,323,638,85
2025-04-25,GM,Morocco,1596,844,103,1,752,330,319,649,102
2025-04-26,GM,Morocco,1762,1002,81,1,760,336,343,679,80
2025-04-27,GM,Morocco,1606,866,76,0,740,345,319,664,76
2025-04-28,GM,Morocco,1313,688,89,2,625,262,274,536,87
2025-04-29,GM,Morocco,1536,830,106,10,706,304,296,600,96
2025-04-30,GM,Morocco,1392,676,87,8,716,315,314,629,79
2025-05-01,GM,Morocco,1395,700,72,1,695,307,316,623,71
2025-05-02,GM,Morocco,1437,699,113,4,738,314,311,625,109
2025-05-03,GM,Morocco,1601,874,72,1,727,329,326,655,71
2025-05-04,GM,Morocco,1484,762,77,0,722,328,317,645,77
2025-05-05,GM,Morocco,1435,738,82,6,697,310,305,615,76
2025-05-06,GM,Morocco,1440,765,88,4,675,292,295,587,84
2025-05-07,GM,Morocco,1398,715,90,5,683,296,297,593,85
2025-05-08,GM,Morocco,1447,746,76,9,701,309,316,625,67
2025-05-09,GM,Morocco,1398,693,107,7,705,298,300,598,100
2025-05-10,GM,Morocco,1583,857,75,3,726,323,328,651,72
2025-05-11,GM,Morocco,1460,730,87,0,730,327,316,643,87
2025-05-12,GM,Morocco,1384,684,90,9,700,305,305,610,81
2025-05-13,GM,Morocco,1424,750,87,5,674,294,293,587,82
2025-05-14,GM,Morocco,1416,721,82,2,695,308,305,613,80
2025-05-15,GM,Morocco,1470,749,93,11,721,314,314,628,82
2025-05-16,GM,Morocco,1453,733,117,13,720,304,299,603,104
2025-05-17,GM,Morocco,1575,871,75,0,704,314,315,629,75
2025-05-18,GM,Morocco,1437,732,83,0,705,314,308,622,83
2025-05-19,GM,Morocco,1419,715,102,6,704,300,302,602,96
2025-05-20,GM,Morocco,1406,751,88,8,655,284,283,567,80
2025-05-21,GM,Morocco,1380,730,89,8,650,284,277,561,81
2025-05-22,GM,Morocco,1458,747,84,11,711,309,318,627,73
2025-05-23,GM,Morocco,1444,713,109,11,731,314,308,622,98
2025-05-24,GM,Morocco,1576,869,70,1,707,313,324,637,69
2025-05-25,GM,Morocco,1484,768,88,0,716,319,309,628,88
2025-05-26,GM,Morocco,1421,720,94,4,701,306,301,607,90
2025-05-27,GM,Morocco,1414,764,94,3,650,277,279,556,91
2025-05-28,GM,Morocco,1411,733,84,1,678,297,297,594,83
2025-05-29,GM,Morocco,1452,757,72,3,695,307,316,623,69
2025-05-30,GM,Morocco,1436,731,100,0,705,310,295,605,100
2025-05-31,GM,Morocco,1574,879,72,1,695,308,315,623,71
2025-06-01,GM,Morocco,1469,771,74,0,698,317,307,624,74
2025-06-02,GM,Morocco,1433,745,85,4,688,300,303,603,81
2025-06-03,GM,Morocco,1418,757,76,3,661,293,292,585,73
2025-06-04,GM,Morocco,1403,729,89,2,674,293,292,585,87
2025-06-05,GM,Morocco,1468,785,73,5,683,306,304,610,68
2025-06-06,GM,Morocco,1457,736,110,3,721,308,303,611,107
2025-06-07,GM,Morocco,1568,883,81,1,685,303,301,604,80
2025-06-08,GM,Morocco,1463,789,69,0,674,305,300,605,69
2025-06-09,GM,Morocco,1390,737,72,3,653,288,293,581,69
2025-06-10,GM,Morocco,1421,758,85,4,663,287,291,578,81
2025-06-11,GM,Morocco,1436,736,94,5,700,303,303,606,89
2025-06-12,GM,Morocco,1444,756,63,5,688,307,318,625,58
2025-06-13,GM,Morocco,1448,722,92,1,726,317,317,634,91
2025-06-14,GM,Morocco,1613,891,77,0,722,319,326,645,77
2025-06-15,GM,Morocco,1510,778,85,0,732,330,317,647,85
2025-06-16,GM,Morocco,1477,750,92,3,727,316,319,635,89
2025-06-17,GM,Morocco,1489,796,99,7,693,298,296,594,92
2025-06-18,GM,Morocco,1462,752,87,2,710,311,312,623,85
2025-06-19,GM,Morocco,1508,806,78,3,702,309,315,624,75
2025-06-20,GM,Morocco,1525,762,120,3,763,322,321,643,117
2025-06-21,GM,Morocco,1646,924,74,2,722,318,330,648,72
2025-06-22,GM,Morocco,1470,745,85,1,725,324,316,640,84
2025-06-23,GM,Morocco,1460,733,93,6,727,316,318,634,87
2025-06-24,GM,Morocco,1483,779,89,7,704,307,308,615,82
2025-06-25,GM,Morocco,1471,749,105,5,722,308,309,617,100
2025-06-26,GM,Morocco,1556,817,90,6,739,326,323,649,84
2025-06-27,GM,Morocco,1516,751,106,3,765,329,330,659,103
2025-06-28,GM,Morocco,1603,886,67,0,717,326,324,650,67
2025-06-29,GM,Morocco,1522,806,87,2,716,318,311,629,85
2025-06-30,GM,Morocco,1543,803,100,2,740,321,319,640,98
2025-07-01,GM,Morocco,1573,829,107,8,744,319,318,637,99
2025-07-02,GM,Morocco,1525,800,104,9,725,308,313,621,95
2025-07-03,GM,Morocco,1449,802,84,7,647,279,284,563,77
2025-07-04,GM,Morocco,1492,802,115,6,690,297,278,575,109
2025-07-05,GM,Morocco,1643,901,76,2,742,328,338,666,74
2025-07-06,GM,Morocco,1547,807,85,2,740,333,322,655,83
2025-07-07,GM,Morocco,1576,818,104,8,758,326,328,654,96
2025-07-08,GM,Morocco,1573,834,98,4,739,321,320,641,94
2025-07-09,GM,Morocco,1555,809,98,5,746,325,323,648,93
2025-07-10,GM,Morocco,1548,830,70,1,718,320,328,648,69
2025-07-11,GM,Morocco,1560,777,109,0,783,335,339,674,109
2025-07-12,GM,Morocco,1633,893,71,4,740,331,338,669,67
2025-07-13,GM,Morocco,1557,813,83,3,744,339,322,661,80
2025-07-14,GM,Morocco,1578,833,93,8,745,322,330,652,85
2025-07-15,GM,Morocco,1571,840,87,5,731,323,321,644,82
2025-07-16,GM,Morocco,1565,810,102,3,755,329,324,653,99
2025-07-17,GM,Morocco,1609,859,87,5,750,329,334,663,82
2025-07-18,GM,Morocco,1588,801,109,2,787,345,333,678,107
2025-07-19,GM,Morocco,1660,936,66,1,724,329,329,658,65
2025-07-20,GM,Morocco,1558,821,85,0,737,327,325,652,85
2025-07-21,GM,Morocco,1578,823,93,2,755,329,333,662,91
2025-07-22,GM,Morocco,1582,851,89,4,731,318,324,642,85
2025-07-23,GM,Morocco,1527,784,85,1,743,333,325,658,84
2025-07-24,GM,Morocco,1616,867,83,1,749,325,341,666,82
2025-07-25,GM,Morocco,1595,771,121,2,824,357,346,703,119
2025-07-26,GM,Morocco,1646,900,78,2,746,329,339,668,76
2025-07-27,GM,Morocco,1566,825,82,0,741,330,329,659,82
2025-07-28,GM,Morocco,1582,809,94,4,773,341,338,679,90
2025-07-29,GM,Morocco,1548,824,80,3,724,321,323,644,77
2025-07-30,GM,Morocco,1570,812,105,1,758,331,322,653,104
2025-07-31,GM,Morocco,1605,864,90,4,741,321,330,651,86
2025-08-01,GM,Morocco,1597,780,127,1,817,352,338,690,126
2025-08-02,GM,Morocco,1647,912,71,2,735,329,335,664,69
2025-08-03,GM,Morocco,1530,794,82,0,736,326,328,654,82
2025-08-04,GM,Morocco,1564,813,80,2,751,336,335,671,78
2025-08-05,GM,Morocco,1611,855,84,3,756,336,336,672,81
2025-08-06,GM,Morocco,1590,840,97,3,750,326,327,653,94
2025-08-07,GM,Morocco,1632,881,85,3,751,335,331,666,82
2025-08-08,GM,Morocco,1577,785,122,3,792,340,330,670,119
2025-08-09,GM,Morocco,1643,905,73,1,738,330,335,665,72
2025-08-10,GM,Morocco,1525,800,81,1,725,321,323,644,80
2025-08-11,GM,Morocco,1582,807,105,1,775,335,335,670,104
2025-08-12,GM,Morocco,1611,846,103,4,765,328,334,662,99
2025-08-13,GM,Morocco,1574,835,87,0,739,327,325,652,87
2025-08-14,GM,Morocco,1582,859,70,2,723,323,330,653,68
2025-08-15,GM,Morocco,1588,799,110,1,789,349,330,679,109
2025-08-16,GM,Morocco,1639,908,77,2,731,322,332,654,75
2025-08-17,GM,Morocco,1532,803,77,1,729,325,327,652,76
2025-08-18,GM,Morocco,1570,815,83,2,755,338,334,672,81
2025-08-19,GM,Morocco,1584,837,82,5,747,329,336,665,77
2025-08-20,GM,Morocco,1556,822,85,1,734,326,323,649,84
2025-08-21,GM,Morocco,1626,878,76,2,748,332,340,672,74
2025-08-22,GM,Morocco,1576,781,111,3,795,346,338,684,108
2025-08-23,GM,Morocco,1684,931,78,0,753,331,344,675,78
2025-08-24,GM,Morocco,1539,818,74,0,721,327,320,647,74
2025-08-25,GM,Morocco,1562,798,96,1,764,332,336,668,95
2025-08-26,GM,Morocco,1588,820,92,4,768,339,337,676,88
2025-08-27,GM,Morocco,1556,814,90,2,742,326,326,652,88
2025-08-28,GM,Morocco,1605,857,76,5,748,333,339,672,71
2025-08-29,GM,Morocco,1601,782,121,4,819,357,341,698,117
2025-01-01,EH,Netherlands,2697,1376,2,2,1321,659,660,1319,0
2025-01-02,EH,Netherlands,3091,1622,33,7,1469,718,718,1436,26
2025-01-03,EH,Netherlands,3254,1728,42,9,1526,740,744,1484,33
2025-01-04,EH,Netherlands,3043,1635,16,2,1408,697,695,1392,14
2025-01-05,EH,Netherlands,2954,1627,2,1,1327,662,663,1325,1
2025-01-06,EH,Netherlands,3121,1668,34,10,1453,713,706,1419,24
2025-01-07,EH,Netherlands,2745,1396,59,19,1349,643,647,1290,40
2025-01-08,EH,Netherlands,2687,1285,66,18,1402,669,667,1336,48
2025-01-09,EH,Netherlands,2759,1355,36,8,1404,687,681,1368,28
2025-01-10,EH,Netherlands,3031,1602,35,6,1429,693,701,1394,29
2025-01-11,EH,Netherlands,2808,1565,19,3,1243,610,614,1224,16
2025-01-12,EH,Netherlands,2947,1558,8,4,1389,690,691,1381,4
2025-01-13,EH,Netherlands,2983,1513,45,12,1470,714,711,1425,33
2025-01-14,EH,Netherlands,2523,1185,48,11,1338,643,647,1290,37
2025-01-15,EH,Netherlands,2369,1273,5,1,1096,550,541,1091,4
2025-01-16,EH,Netherlands,2716,1371,42,5,1345,650,653,1303,37
2025-01-17,EH,Netherlands,2895,1596,12,1,1299,645,642,1287,11
2025-01-18,EH,Netherlands,2717,1516,6,0,1201,593,602,1195,6
2025-01-19,EH,Netherlands,2936,1571,7,5,1365,684,674,1358,2
2025-01-20,EH,Netherlands,2949,1511,33,7,1438,705,700,1405,26
2025-01-21,EH,Netherlands,2459,1220,12,3,1239,610,617,1227,9
2025-01-22,EH,Netherlands,2719,1310,66,8,1409,675,668,1343,58
2025-01-23,EH,Netherlands,2861,1385,68,13,1476,705,703,1408,55
2025-01-24,EH,Netherlands,2932,1502,41,13,1430,693,696,1389,28
2025-01-25,EH,Netherlands,2756,1480,18,2,1276,625,633,1258,16
2025-01-26,EH,Netherlands,2992,1562,29,7,1430,698,703,1401,22
2025-01-27,EH,Netherlands,2957,1489,44,7,1468,717,707,1424,37
2025-01-28,EH,Netherlands,2552,1186,67,12,1366,646,653,1299,55
2025-01-29,EH,Netherlands,2686,1269,44,10,1417,682,691,1373,34
2025-01-30,EH,Netherlands,2848,1371,66,18,1477,709,702,1411,48
2025-01-31,EH,Netherlands,3146,1602,51,13,1544,746,747,1493,38
2025-02-01,EH,Netherlands,2827,1591,14,7,1236,610,612,1222,7
2025-02-02,EH,Netherlands,3043,1618,20,2,1425,700,705,1405,18
2025-02-03,EH,Netherlands,3129,1619,51,18,1510,734,725,1459,33
2025-02-04,EH,Netherlands,2684,1250,65,22,1434,675,694,1369,43
2025-02-05,EH,Netherlands,2780,1339,59,19,1441,699,683,1382,40
2025-02-06,EH,Netherlands,2945,1448,58,10,1497,720,719,1439,48
2025-02-07,EH,Netherlands,3239,1680,60,17,1559,755,744,1499,43
2025-02-08,EH,Netherlands,2945,1621,28,8,1324,642,654,1296,20
2025-02-09,EH,Netherlands,3118,1688,16,4,1430,714,700,1414,12
2025-02-10,EH,Netherlands,3098,1586,38,4,1512,737,737,1474,34
2025-02-11,EH,Netherlands,2643,1289,10,4,1354,668,676,1344,6
2025-02-12,EH,Netherlands,2819,1405,16,6,1414,692,706,1398,10
2025-02-13,EH,Netherlands,3010,1423,51,11,1587,775,761,1536,40
2025-02-14,EH,Netherlands,3405,1793,48,6,1612,779,785,1564,42
2025-02-15,EH,Netherlands,3164,1744,19,2,1420,705,696,1401,17
2025-02-16,EH,Netherlands,3183,1695,13,4,1488,742,733,1475,9
2025-02-17,EH,Netherlands,3292,1706,47,6,1586,766,773,1539,41
2025-02-18,EH,Netherlands,2930,1442,50,5,1488,719,719,1438,45
2025-02-19,EH,Netherlands,3097,1570,53,7,1527,741,733,1474,46
2025-02-20,EH,Netherlands,3105,1539,42,3,1566,757,767,1524,39
2025-02-21,EH,Netherlands,3383,1754,46,6,1629,792,791,1583,40
2025-02-22,EH,Netherlands,3160,1719,18,6,1441,707,716,1423,12
2025-02-23,EH,Netherlands,3264,1715,11,5,1549,769,769,1538,6
2025-02-24,EH,Netherlands,3265,1710,42,9,1555,756,757,1513,33
2025-02-25,EH,Netherlands,2857,1377,51,11,1480,714,715,1429,40
2025-02-26,EH,Netherlands,3060,1533,45,8,1527,742,740,1482,37
2025-02-27,EH,Netherlands,3037,1506,47,7,1531,743,741,1484,40
2025-02-28,EH,Netherlands,3268,1699,44,5,1569,762,763,1525,39
2025-03-01,EH,Netherlands,3073,1631,11,1,1442,711,720,1431,10
2025-03-02,EH,Netherlands,3162,1666,12,4,1496,745,739,1484,8
2025-03-03,EH,Netherlands,3274,1732,36,6,1542,751,755,1506,30
2025-03-04,EH,Netherlands,2821,1374,58,13,1447,687,702,1389,45
2025-03-05,EH,Netherlands,3151,1590,69,14,1561,742,750,1492,55
2025-03-06,EH,Netherlands,3169,1545,75,19,1624,776,773,1549,56
2025-03-07,EH,Netherlands,3405,1747,67,22,1658,800,791,1591,45
2025-03-08,EH,Netherlands,3049,1604,24,7,1445,714,707,1421,17
2025-03-09,EH,Netherlands,3234,1701,16,8,1533,748,769,1517,8
2025-03-10,EH,Netherlands,3002,1457,56,21,1545,746,743,1489,35
2025-03-11,EH,Netherlands,2944,1415,73,22,1529,725,731,1456,51
2025-03-12,EH,Netherlands,3111,1549,59,22,1562,752,751,1503,37
2025-03-13,EH,Netherlands,3298,1597,79,25,1701,808,814,1622,54
2025-03-14,EH,Netherlands,3433,1768,74,24,1665,797,794,1591,50
2025-03-15,EH,Netherlands,3165,1700,32,5,1465,717,716,1433,27
2025-03-16,EH,Netherlands,3290,1744,15,3,1546,770,761,1531,12
2025-03-17,EH,Netherlands,3399,1766,56,21,1633,790,787,1577,35
2025-03-18,EH,Netherlands,2950,1421,88,26,1529,719,722,1441,62
2025-03-19,EH,Netherlands,3101,1531,73,24,1570,746,751,1497,49
2025-03-20,EH,Netherlands,3260,1604,73,25,1656,799,784,1583,48
2025-03-21,EH,Netherlands,3152,1545,64,21,1607,766,777,1543,43
2025-03-22,EH,Netherlands,3008,1616,12,2,1392,698,682,1380,10
2025-03-23,EH,Netherlands,3249,1713,12,4,1536,755,769,1524,8
2025-03-24,EH,Netherlands,3357,1739,65,22,1618,776,777,1553,43
2025-03-25,EH,Netherlands,2960,1449,74,18,1511,721,716,1437,56
2025-03-26,EH,Netherlands,3161,1646,62,14,1515,725,728,1453,48
2025-03-27,EH,Netherlands,3278,1639,75,28,1639,776,788,1564,47
2025-03-28,EH,Netherlands,3422,1803,57,19,1619,781,781,1562,38
2025-03-29,EH,Netherlands,2998,1612,27,3,1386,680,679,1359,24
2025-03-30,EH,Netherlands,3268,1751,12,1,1517,744,761,1505,11
2025-03-31,EH,Netherlands,3442,1743,50,22,1699,829,820,1649,28
2025-04-01,EH,Netherlands,3336,1694,72,18,1642,783,787,1570,54
2025-04-02,EH,Netherlands,3455,1794,55,18,1661,809,797,1606,37
2025-04-03,EH,Netherlands,3520,1802,73,19,1718,819,826,1645,54
2025-04-04,EH,Netherlands,3633,1933,40,12,1700,834,826,1660,28
2025-04-05,EH,Netherlands,3290,1769,18,4,1521,749,754,1503,14
2025-04-06,EH,Netherlands,3456,1860,18,3,1596,791,787,1578,15
2025-04-07,EH,Netherlands,3610,1925,51,16,1685,817,817,1634,35
2025-04-08,EH,Netherlands,3363,1723,57,12,1640,789,794,1583,45
2025-04-09,EH,Netherlands,3468,1806,63,19,1662,801,798,1599,44
2025-04-10,EH,Netherlands,3528,1827,53,12,1701,827,821,1648,41
2025-04-11,EH,Netherlands,3655,1895,67,19,1760,851,842,1693,48
2025-04-12,EH,Netherlands,3311,1796,19,7,1515,750,746,1496,12
2025-04-13,EH,Netherlands,3317,1731,19,2,1586,780,787,1567,17
2025-04-14,EH,Netherlands,3480,1806,48,11,1674,812,814,1626,37
2025-04-15,EH,Netherlands,3319,1704,49,7,1615,775,791,1566,42
2025-04-16,EH,Netherlands,3507,1815,63,16,1692,821,808,1629,47
2025-04-17,EH,Netherlands,3536,1776,82,19,1760,842,836,1678,63
2025-04-18,EH,Netherlands,3487,1774,26,6,1713,847,840,1687,20
2025-04-19,EH,Netherlands,3277,1707,11,2,1570,774,785,1559,9
2025-04-20,EH,Netherlands,3414,1794,13,2,1620,807,800,1607,11
2025-04-21,EH,Netherlands,3599,1888,18,1,1711,843,850,1693,17
2025-04-22,EH,Netherlands,3417,1701,61,9,1716,825,830,1655,52
2025-04-23,EH,Netherlands,3559,1851,36,10,1708,837,835,1672,26
2025-04-24,EH,Netherlands,3592,1836,43,8,1756,854,859,1713,35
2025-04-25,EH,Netherlands,3683,1894,46,12,1789,873,870,1743,34
2025-04-26,EH,Netherlands,3269,1698,6,3,1571,782,783,1565,3
2025-04-27,EH,Netherlands,3442,1771,16,4,1671,828,827,1655,12
2025-04-28,EH,Netherlands,3527,1794,33,9,1733,854,846,1700,24
2025-04-29,EH,Netherlands,3497,1737,61,8,1760,843,856,1699,53
2025-04-30,EH,Netherlands,3528,1795,56,13,1733,842,835,1677,43
2025-05-01,EH,Netherlands,3580,1765,67,13,1815,869,879,1748,54
2025-05-02,EH,Netherlands,3590,1802,55,18,1788,869,864,1733,37
2025-05-03,EH,Netherlands,3408,1803,28,6,1605,786,791,1577,22
2025-05-04,EH,Netherlands,3441,1784,15,3,1657,820,822,1642,12
2025-05-05,EH,Netherlands,3541,1820,23,2,1721,846,852,1698,21
2025-05-06,EH,Netherlands,3538,1794,55,11,1744,849,840,1689,44
2025-05-07,EH,Netherlands,3619,1882,59,18,1737,837,841,1678,41
2025-05-08,EH,Netherlands,3606,1848,50,15,1758,852,856,1708,35
2025-05-09,EH,Netherlands,3657,1944,50,10,1713,833,830,1663,40
2025-05-10,EH,Netherlands,3386,1783,19,5,1603,798,786,1584,14
2025-05-11,EH,Netherlands,3526,1859,22,7,1667,820,825,1645,15
2025-05-12,EH,Netherlands,3713,1922,60,24,1791,869,862,1731,36
2025-05-13,EH,Netherlands,3573,1848,57,13,1725,829,839,1668,44
2025-05-14,EH,Netherlands,3677,1893,69,20,1784,861,854,1715,49
2025-05-15,EH,Netherlands,3781,1962,73,20,1819,873,873,1746,53
2025-05-16,EH,Netherlands,3708,1918,45,12,1790,873,872,1745,33
2025-05-17,EH,Netherlands,3389,1779,9,1,1610,802,799,1601,8
2025-05-18,EH,Netherlands,3503,1833,5,1,1670,830,835,1665,4
2025-05-19,EH,Netherlands,3614,1828,46,20,1786,865,875,1740,26
2025-05-20,EH,Netherlands,3564,1817,58,15,1747,840,849,1689,43
2025-05-21,EH,Netherlands,3720,1933,60,18,1787,874,853,1727,42
2025-05-22,EH,Netherlands,3777,1978,54,21,1799,871,874,1745,33
2025-05-23,EH,Netherlands,3756,1988,45,16,1768,862,861,1723,29
2025-05-24,EH,Netherlands,3435,1837,12,3,1598,796,790,1586,9
2025-05-25,EH,Netherlands,3503,1822,12,2,1681,831,838,1669,10
2025-05-26,EH,Netherlands,3718,1933,53,19,1785,857,875,1732,34
2025-05-27,EH,Netherlands,3695,1916,61,19,1779,863,855,1718,42
2025-05-28,EH,Netherlands,3753,1961,50,12,1792,881,861,1742,38
2025-05-29,EH,Netherlands,3696,1936,47,6,1760,865,848,1713,41
2025-05-30,EH,Netherlands,3646,1906,29,6,1740,852,859,1711,23
2025-05-31,EH,Netherlands,3525,1886,23,3,1639,807,809,1616,20
2025-06-01,EH,Netherlands,3739,2005,17,1,1734,841,876,1717,16
2025-06-02,EH,Netherlands,3732,1930,60,16,1802,874,868,1742,44
2025-06-03,EH,Netherlands,3626,1887,57,12,1739,845,837,1682,45
2025-06-04,EH,Netherlands,3779,1978,71,24,1801,865,865,1730,47
2025-06-05,EH,Netherlands,3794,1978,44,11,1816,885,887,1772,33
2025-06-06,EH,Netherlands,3687,1899,46,12,1788,876,866,1742,34
2025-06-07,EH,Netherlands,3339,1731,20,5,1608,797,791,1588,15
2025-06-08,EH,Netherlands,3556,1865,12,1,1691,832,847,1679,11
2025-06-09,EH,Netherlands,3675,1900,46,6,1775,857,872,1729,40
2025-06-10,EH,Netherlands,3678,1912,68,16,1766,851,847,1698,52
2025-06-11,EH,Netherlands,3680,1865,58,13,1815,877,880,1757,45
2025-06-12,EH,Netherlands,3797,1958,63,13,1839,892,884,1776,50
2025-06-13,EH,Netherlands,3816,2041,47,12,1775,869,859,1728,35
2025-06-14,EH,Netherlands,3479,1867,20,4,1612,804,788,1592,16
2025-06-15,EH,Netherlands,3574,1891,9,4,1683,831,843,1674,5
2025-06-16,EH,Netherlands,3725,1935,61,18,1790,868,861,1729,43
2025-06-17,EH,Netherlands,3585,1879,70,12,1706,813,823,1636,58
2025-06-18,EH,Netherlands,3707,1939,50,15,1768,859,859,1718,35
2025-06-19,EH,Netherlands,3716,1910,78,21,1806,866,862,1728,57
2025-06-20,EH,Netherlands,3766,1956,57,19,1810,885,868,1753,38
2025-06-21,EH,Netherlands,3524,1891,25,8,1633,808,800,1608,17
2025-06-22,EH,Netherlands,3540,1985,6,0,1555,768,781,1549,6
2025-06-23,EH,Netherlands,3384,1881,37,19,1503,739,727,1466,18
2025-06-24,EH,Netherlands,3374,1850,38,13,1524,727,759,1486,25
2025-06-25,EH,Netherlands,3519,1897,39,16,1622,810,773,1583,23
2025-06-26,EH,Netherlands,3616,1976,70,17,1640,782,788,1570,53
2025-06-27,EH,Netherlands,3656,1940,47,14,1716,833,836,1669,33
2025-06-28,EH,Netherlands,3504,1919,15,2,1585,779,791,1570,13
2025-06-29,EH,Netherlands,3692,1992,16,3,1700,843,841,1684,13
2025-06-30,EH,Netherlands,3756,1977,60,22,1779,866,853,1719,38
2025-07-01,EH,Netherlands,3665,1959,54,14,1706,823,829,1652,40
2025-07-02,EH,Netherlands,3763,2041,48,13,1722,830,844,1674,35
2025-07-03,EH,Netherlands,3852,2112,56,12,1740,845,839,1684,44
2025-07-04,EH,Netherlands,3995,2211,53,14,1784,869,862,1731,39
2025-07-05,EH,Netherlands,3485,1848,17,3,1637,808,812,1620,14
2025-07-06,EH,Netherlands,3683,1960,11,5,1723,860,852,1712,6
2025-07-07,EH,Netherlands,3783,1993,44,5,1790,875,871,1746,39
2025-07-08,EH,Netherlands,3637,1901,57,9,1736,834,845,1679,48
2025-07-09,EH,Netherlands,3789,2031,62,15,1758,844,852,1696,47
2025-07-10,EH,Netherlands,3822,1986,65,12,1836,888,883,1771,53
2025-07-11,EH,Netherlands,3833,1972,66,12,1861,902,893,1795,54
2025-07-12,EH,Netherlands,3510,1865,22,4,1645,813,810,1623,18
2025-07-13,EH,Netherlands,3741,1996,24,7,1745,864,857,1721,17
2025-07-14,EH,Netherlands,3784,1977,52,13,1807,869,886,1755,39
2025-07-15,EH,Netherlands,3677,1921,70,17,1756,850,836,1686,53
2025-07-16,EH,Netherlands,3725,1970,48,16,1755,850,857,1707,32
2025-07-17,EH,Netherlands,3824,2018,58,17,1806,875,873,1748,41
2025-07-18,EH,Netherlands,3877,2061,45,14,1816,887,884,1771,31
2025-07-19,EH,Netherlands,3622,1986,20,2,1636,806,810,1616,18
2025-07-20,EH,Netherlands,3719,2025,12,2,1694,844,838,1682,10
2025-07-21,EH,Netherlands,3771,2024,34,6,1747,854,859,1713,28
2025-07-22,EH,Netherlands,3676,1919,59,7,1757,849,849,1698,52
2025-07-23,EH,Netherlands,3834,2063,57,17,1771,857,857,1714,40
2025-07-24,EH,Netherlands,3809,2030,60,16,1779,860,859,1719,44
2025-07-25,EH,Netherlands,3813,2024,41,16,1789,876,872,1748,25
2025-07-26,EH,Netherlands,3533,1905,20,10,1628,805,803,1608,10
2025-07-27,EH,Netherlands,3645,1949,10,2,1696,842,844,1686,8
2025-07-28,EH,Netherlands,3809,2021,47,17,1788,873,868,1741,30
2025-07-29,EH,Netherlands,3741,2005,54,10,1736,840,842,1682,44
2025-07-30,EH,Netherlands,3730,2016,58,19,1714,827,829,1656,39
2025-07-31,EH,Netherlands,3821,2038,54,23,1783,863,866,1729,31
2025-08-01,EH,Netherlands,3724,1975,45,19,1749,852,852,1704,26
2025-08-02,EH,Netherlands,3429,1840,11,2,1589,788,790,1578,9
2025-08-03,EH,Netherlands,3711,2008,12,2,1703,853,838,1691,10
2025-08-04,EH,Netherlands,3763,2010,40,14,1753,855,858,1713,26
2025-08-05,EH,Netherlands,3635,1900,74,22,1735,824,837,1661,52
2025-08-06,EH,Netherlands,3722,1981,63,15,1741,841,837,1678,48
2025-08-07,EH,Netherlands,3690,1898,58,9,1792,867,867,1734,49
2025-08-08,EH,Netherlands,3769,1963,62,16,1806,875,869,1744,46
2025-08-09,EH,Netherlands,3449,1823,30,5,1626,793,803,1596,25
2025-08-10,EH,Netherlands,3705,1985,14,5,1720,847,859,1706,9
2025-08-11,EH,Netherlands,3793,1986,60,13,1807,879,868,1747,47
2025-08-12,EH,Netherlands,3670,1938,53,13,1732,840,839,1679,40
2025-08-13,EH,Netherlands,3789,2037,48,21,1752,851,853,1704,27
2025-08-14,EH,Netherlands,3770,1994,48,16,1776,863,865,1728,32
2025-08-15,EH,Netherlands,3812,2026,43,15,1786,871,872,1743,28
2025-08-16,EH,Netherlands,3537,1896,15,6,1641,809,817,1626,9
2025-08-17,EH,Netherlands,3620,1899,16,6,1721,852,853,1705,10
2025-08-18,EH,Netherlands,3776,1991,39,16,1785,872,874,1746,23
2025-08-19,EH,Netherlands,3734,1971,49,11,1763,861,853,1714,38
2025-08-20,EH,Netherlands,3737,1988,52,14,1749,849,848,1697,38
2025-08-21,EH,Netherlands,3854,2049,53,19,1805,868,884,1752,34
2025-08-22,EH,Netherlands,3844,2060,42,8,1784,874,868,1742,34
2025-08-23,EH,Netherlands,3546,1925,14,4,1621,803,804,1607,10
2025-08-24,EH,Netherlands,3680,1956,5,1,1724,856,863,1719,4
2025-08-25,EH,Netherlands,3793,2000,39,11,1793,881,873,1754,28
2025-08-26,EH,Netherlands,3666,1895,60,9,1771,853,858,1711,51
2025-08-27,EH,Netherlands,3757,1980,51,9,1777,863,863,1726,42
2025-08-28,EH,Netherlands,3876,2035,52,9,1841,890,899,1789,43
2025-08-29,EH,Netherlands,3812,1993,52,7,1819,878,889,1767,45
2025-01-01,LW,North Macedonia,548,489,1,0,59,29,29,58,1
2025-01-02,LW,North Macedonia,622,570,0,0,52,28,24,52,0
2025-01-03,LW,North Macedonia,557,485,0,0,72,35,37,72,0
2025-01-04,LW,North Macedonia,535,472,0,0,63,33,30,63,0
2025-01-05,LW,North Macedonia,565,493,0,0,72,36,36,72,0
2025-01-06,LW,North Macedonia,526,456,0,0,70,35,35,70,0
2025-01-07,LW,North Macedonia,421,378,0,0,43,23,20,43,0
2025-01-08,LW,North Macedonia,459,396,0,0,63,30,33,63,0
2025-01-09,LW,North Macedonia,470,412,0,0,58,29,29,58,0
2025-01-10,LW,North Macedonia,483,410,0,0,73,35,38,73,0
2025-01-11,LW,North Macedonia,489,430,0,0,59,31,28,59,0
2025-01-12,LW,North Macedonia,491,432,0,0,59,29,30,59,0
2025-01-13,LW,North Macedonia,458,388,0,0,70,37,33,70,0
2025-01-14,LW,North Macedonia,367,319,0,0,48,24,24,48,0
2025-01-15,LW,North Macedonia,396,347,0,0,49,25,24,49,0
2025-01-16,LW,North Macedonia,432,380,0,0,52,25,27,52,0
2025-01-17,LW,North Macedonia,436,372,0,0,64,31,33,64,0
2025-01-18,LW,North Macedonia,448,386,0,0,62,32,30,62,0
2025-01-19,LW,North Macedonia,469,410,0,0,59,29,30,59,0
2025-01-20,LW,North Macedonia,437,378,0,0,59,30,29,59,0
2025-01-21,LW,North Macedonia,340,292,0,0,48,24,24,48,0
2025-01-22,LW,North Macedonia,434,385,0,0,49,24,25,49,0
2025-01-23,LW,North Macedonia,513,460,0,0,53,26,27,53,0
2025-01-24,LW,North Macedonia,515,452,0,0,63,32,31,63,0
2025-01-25,LW,North Macedonia,445,407,0,0,38,23,15,38,0
2025-01-26,LW,North Macedonia,510,442,0,0,68,30,38,68,0
2025-01-27,LW,North Macedonia,514,447,0,0,67,34,33,67,0
2025-01-28,LW,North Macedonia,387,332,0,0,55,28,27,55,0
2025-01-29,LW,North Macedonia,399,344,0,0,55,26,29,55,0
2025-01-30,LW,North Macedonia,449,394,0,0,55,28,27,55,0
2025-01-31,LW,North Macedonia,518,456,0,0,62,31,31,62,0
2025-02-01,LW,North Macedonia,499,448,0,0,51,25,26,51,0
2025-02-02,LW,North Macedonia,501,442,0,0,59,29,30,59,0
2025-02-03,LW,North Macedonia,499,440,0,0,59,31,28,59,0
2025-02-04,LW,North Macedonia,404,360,0,0,44,22,22,44,0
2025-02-05,LW,North Macedonia,465,415,0,0,50,25,25,50,0
2025-02-06,LW,North Macedonia,451,409,0,0,42,21,21,42,0
2025-02-07,LW,North Macedonia,534,474,0,0,60,29,31,60,0
2025-02-08,LW,North Macedonia,516,466,0,0,50,26,24,50,0
2025-02-09,LW,North Macedonia,542,486,0,0,56,27,29,56,0
2025-02-10,LW,North Macedonia,547,492,0,0,55,29,26,55,0
2025-02-11,LW,North Macedonia,402,357,0,0,45,22,23,45,0
2025-02-12,LW,North Macedonia,486,440,0,0,46,23,23,46,0
2025-02-13,LW,North Macedonia,444,399,0,0,45,23,22,45,0
2025-02-14,LW,North Macedonia,514,453,0,0,61,29,32,61,0
2025-02-15,LW,North Macedonia,523,472,0,0,51,26,25,51,0
2025-02-16,LW,North Macedonia,539,484,0,0,55,26,29,55,0
2025-02-17,LW,North Macedonia,504,444,0,0,60,31,29,60,0
2025-02-18,LW,North Macedonia,402,353,0,0,49,25,24,49,0
2025-02-19,LW,North Macedonia,467,419,0,0,48,24,24,48,0
2025-02-20,LW,North Macedonia,454,403,0,0,51,26,25,51,0
2025-02-21,LW,North Macedonia,519,470,0,0,49,23,26,49,0
2025-02-22,LW,North Macedonia,534,490,0,0,44,22,22,44,0
2025-02-23,LW,North Macedonia,562,504,0,0,58,29,29,58,0
2025-02-24,LW,North Macedonia,544,484,0,0,60,32,28,60,0
2025-02-25,LW,North Macedonia,508,455,0,0,53,26,27,53,0
2025-02-26,LW,North Macedonia,475,428,0,0,47,23,24,47,0
2025-02-27,LW,North Macedonia,493,440,0,0,53,27,26,53,0
2025-02-28,LW,North Macedonia,450,391,0,0,59,28,31,59,0
2025-03-01,LW,North Macedonia,545,495,0,0,50,25,25,50,0
2025-03-02,LW,North Macedonia,551,490,0,0,61,30,31,61,0
2025-03-03,LW,North Macedonia,524,457,0,0,67,36,31,67,0
2025-03-04,LW,North Macedonia,473,424,0,0,49,24,25,49,0
2025-03-05,LW,North Macedonia,507,453,0,0,54,25,29,54,0
2025-03-06,LW,North Macedonia,520,460,0,0,60,31,29,60,0
2025-03-07,LW,North Macedonia,585,521,0,0,64,31,33,64,0
2025-03-08,LW,North Macedonia,568,513,0,0,55,29,26,55,0
2025-03-09,LW,North Macedonia,588,528,0,0,60,30,30,60,0
2025-03-10,LW,North Macedonia,484,417,0,0,67,34,33,67,0
2025-03-11,LW,North Macedonia,453,402,0,0,51,25,26,51,0
2025-03-12,LW,North Macedonia,512,456,1,0,56,27,28,55,1
2025-03-13,LW,North Macedonia,482,427,0,0,55,28,27,55,0
2025-03-14,LW,North Macedonia,512,454,0,0,58,28,30,58,0
2025-03-15,LW,North Macedonia,491,437,0,0,54,28,26,54,0
2025-03-16,LW,North Macedonia,575,505,0,0,70,33,37,70,0
2025-03-17,LW,North Macedonia,521,442,0,0,79,41,38,79,0
2025-03-18,LW,North Macedonia,442,381,0,0,61,32,29,61,0
2025-03-19,LW,North Macedonia,526,469,0,0,57,27,30,57,0
2025-03-20,LW,North Macedonia,535,475,0,0,60,31,29,60,0
2025-03-21,LW,North Macedonia,580,513,0,0,67,32,35,67,0
2025-03-22,LW,North Macedonia,584,527,0,0,57,29,28,57,0
2025-03-23,LW,North Macedonia,547,485,0,0,62,30,32,62,0
2025-03-24,LW,North Macedonia,508,442,0,0,66,34,32,66,0
2025-03-25,LW,North Macedonia,439,387,0,0,52,27,25,52,0
2025-03-26,LW,North Macedonia,489,440,0,0,49,24,25,49,0
2025-03-27,LW,North Macedonia,523,459,0,0,64,31,33,64,0
2025-03-28,LW,North Macedonia,516,452,0,0,64,32,32,64,0
2025-03-29,LW,North Macedonia,585,527,0,0,58,29,29,58,0
2025-03-30,LW,North Macedonia,807,738,0,0,69,34,35,69,0
2025-03-31,LW,North Macedonia,641,567,0,0,74,38,36,74,0
2025-04-01,LW,North Macedonia,671,616,0,0,55,26,29,55,0
2025-04-02,LW,North Macedonia,724,651,0,0,73,37,36,73,0
2025-04-03,LW,North Macedonia,701,635,0,0,66,33,33,66,0
2025-04-04,LW,North Macedonia,745,667,0,0,78,38,40,78,0
2025-04-05,LW,North Macedonia,872,811,0,0,61,32,29,61,0
2025-04-06,LW,North Macedonia,772,702,0,0,70,34,36,70,0
2025-04-07,LW,North Macedonia,739,654,0,0,85,44,41,85,0
2025-04-08,LW,North Macedonia,717,653,0,0,64,31,33,64,0
2025-04-09,LW,North Macedonia,591,520,0,0,71,35,36,71,0
2025-04-10,LW,North Macedonia,859,789,1,1,70,34,35,69,0
2025-04-11,LW,North Macedonia,864,790,0,0,74,36,38,74,0
2025-04-12,LW,North Macedonia,854,792,0,0,62,32,30,62,0
2025-04-13,LW,North Macedonia,850,777,0,0,73,36,37,73,0
2025-04-14,LW,North Macedonia,796,722,0,0,74,39,35,74,0
2025-04-15,LW,North Macedonia,748,684,0,0,64,30,34,64,0
2025-04-16,LW,North Macedonia,813,737,0,0,76,38,38,76,0
2025-04-17,LW,North Macedonia,645,576,0,0,69,35,34,69,0
2025-04-18,LW,North Macedonia,763,688,0,0,75,36,39,75,0
2025-04-19,LW,North Macedonia,831,773,0,0,58,30,28,58,0
2025-04-20,LW,North Macedonia,809,737,0,0,72,34,38,72,0
2025-04-21,LW,North Macedonia,792,714,0,0,78,42,36,78,0
2025-04-22,LW,North Macedonia,735,676,0,0,59,29,30,59,0
2025-04-23,LW,North Macedonia,780,704,0,0,76,38,38,76,0
2025-04-24,LW,North Macedonia,766,687,0,0,79,39,40,79,0
2025-04-25,LW,North Macedonia,823,741,0,0,82,41,41,82,0
2025-04-26,LW,North Macedonia,938,871,0,0,67,34,33,67,0
2025-04-27,LW,North Macedonia,967,890,0,0,77,37,40,77,0
2025-04-28,LW,North Macedonia,897,824,0,0,73,38,35,73,0
2025-04-29,LW,North Macedonia,835,774,0,0,61,29,32,61,0
2025-04-30,LW,North Macedonia,929,854,0,0,75,38,37,75,0
2025-05-01,LW,North Macedonia,928,859,2,0,69,34,33,67,2
2025-05-02,LW,North Macedonia,923,845,0,0,78,39,39,78,0
2025-05-03,LW,North Macedonia,996,932,0,0,64,31,33,64,0
2025-05-04,LW,North Macedonia,1024,947,0,0,77,39,38,77,0
2025-05-05,LW,North Macedonia,903,826,0,0,77,40,37,77,0
2025-05-06,LW,North Macedonia,855,792,0,0,63,31,32,63,0
2025-05-07,LW,North Macedonia,897,820,0,0,77,37,40,77,0
2025-05-08,LW,North Macedonia,900,830,0,0,70,35,35,70,0
2025-05-09,LW,North Macedonia,899,820,0,0,79,40,39,79,0
2025-05-10,LW,North Macedonia,1006,938,0,0,68,34,34,68,0
2025-05-11,LW,North Macedonia,1040,962,0,0,78,39,39,78,0
2025-05-12,LW,North Macedonia,951,872,0,0,79,40,39,79,0
2025-05-13,LW,North Macedonia,873,813,0,0,60,29,31,60,0
2025-05-14,LW,North Macedonia,919,847,0,0,72,37,35,72,0
2025-05-15,LW,North Macedonia,844,770,0,0,74,36,38,74,0
2025-05-16,LW,North Macedonia,900,818,0,0,82,40,42,82,0
2025-05-17,LW,North Macedonia,987,920,0,0,67,35,32,67,0
2025-05-18,LW,North Macedonia,1005,930,0,0,75,37,38,75,0
2025-05-19,LW,North Macedonia,888,810,0,0,78,40,38,78,0
2025-05-20,LW,North Macedonia,883,823,0,0,60,29,31,60,0
2025-05-21,LW,North Macedonia,923,845,1,0,78,40,37,77,1
2025-05-22,LW,North Macedonia,1034,960,0,0,74,35,39,74,0
2025-05-23,LW,North Macedonia,957,872,0,0,85,41,44,85,0
2025-05-24,LW,North Macedonia,1042,969,0,0,73,41,32,73,0
2025-05-25,LW,North Macedonia,1013,931,0,0,82,39,43,82,0
2025-05-26,LW,North Macedonia,1015,929,0,0,86,44,42,86,0
2025-05-27,LW,North Macedonia,1050,985,0,0,65,31,34,65,0
2025-05-28,LW,North Macedonia,1040,949,0,0,91,46,45,91,0
2025-05-29,LW,North Macedonia,1068,994,0,0,74,37,37,74,0
2025-05-30,LW,North Macedonia,1086,1005,0,0,81,40,41,81,0
2025-05-31,LW,North Macedonia,1144,1075,0,0,69,34,35,69,0
2025-06-01,LW,North Macedonia,1079,986,0,0,93,46,47,93,0
2025-06-02,LW,North Macedonia,1046,954,0,0,92,49,43,92,0
2025-06-03,LW,North Macedonia,1020,955,0,0,65,30,35,65,0
2025-06-04,LW,North Macedonia,1097,1005,0,0,92,46,46,92,0
2025-06-05,LW,North Macedonia,1035,958,0,0,77,39,38,77,0
2025-06-06,LW,North Macedonia,1091,1011,0,0,80,39,41,80,0
2025-06-07,LW,North Macedonia,1122,1044,0,0,78,38,40,78,0
2025-06-08,LW,North Macedonia,1076,992,0,0,84,42,42,84,0
2025-06-09,LW,North Macedonia,1100,1016,0,0,84,44,40,84,0
2025-06-10,LW,North Macedonia,1144,1079,0,0,65,30,35,65,0
2025-06-11,LW,North Macedonia,1160,1055,0,0,105,54,51,105,0
2025-06-12,LW,North Macedonia,1085,1014,0,0,71,36,35,71,0
2025-06-13,LW,North Macedonia,1175,1086,0,0,89,43,46,89,0
2025-06-14,LW,North Macedonia,1256,1176,0,0,80,41,39,80,0
2025-06-15,LW,North Macedonia,1175,1085,2,0,90,42,46,88,2
2025-06-16,LW,North Macedonia,1163,1078,0,0,85,46,39,85,0
2025-06-17,LW,North Macedonia,1188,1120,0,0,68,31,37,68,0
2025-06-18,LW,North Macedonia,1238,1144,0,0,94,46,48,94,0
2025-06-19,LW,North Macedonia,1194,1119,0,0,75,39,36,75,0
2025-06-20,LW,North Macedonia,1252,1171,0,0,81,40,41,81,0
2025-06-21,LW,North Macedonia,1256,1181,0,0,75,38,37,75,0
2025-06-22,LW,North Macedonia,1203,1114,0,0,89,43,46,89,0
2025-06-23,LW,North Macedonia,1147,1056,0,0,91,49,42,91,0
2025-06-24,LW,North Macedonia,1171,1109,0,0,62,29,33,62,0
2025-06-25,LW,North Macedonia,1205,1112,0,0,93,45,48,93,0
2025-06-26,LW,North Macedonia,1141,1061,0,0,80,41,39,80,0
2025-06-27,LW,North Macedonia,1167,1076,0,0,91,46,45,91,0
2025-06-28,LW,North Macedonia,1233,1153,1,0,80,38,41,79,1
2025-06-29,LW,North Macedonia,1162,1071,0,0,91,47,44,91,0
2025-06-30,LW,North Macedonia,1146,1057,0,0,89,46,43,89,0
2025-07-01,LW,North Macedonia,1180,1109,0,0,71,33,38,71,0
2025-07-02,LW,North Macedonia,1226,1130,0,0,96,49,47,96,0
2025-07-03,LW,North Macedonia,1098,1017,0,0,81,40,41,81,0
2025-07-04,LW,North Macedonia,1146,1057,0,0,89,45,44,89,0
2025-07-05,LW,North Macedonia,1205,1128,0,0,77,39,38,77,0
2025-07-06,LW,North Macedonia,1175,1084,0,0,91,44,47,91,0
2025-07-07,LW,North Macedonia,1138,1042,0,0,96,51,45,96,0
2025-07-08,LW,North Macedonia,1146,1077,0,0,69,32,37,69,0
2025-07-09,LW,North Macedonia,1138,1038,0,0,100,51,49,100,0
2025-07-10,LW,North Macedonia,1110,1030,0,0,80,38,42,80,0
2025-07-11,LW,North Macedonia,1112,1018,0,0,94,48,46,94,0
2025-07-12,LW,North Macedonia,1167,1089,0,0,78,38,40,78,0
2025-07-13,LW,North Macedonia,1175,1085,0,0,90,46,44,90,0
2025-07-14,LW,North Macedonia,1112,1021,0,0,91,48,43,91,0
2025-07-15,LW,North Macedonia,1166,1094,0,0,72,34,38,72,0
2025-07-16,LW,North Macedonia,1152,1055,0,0,97,50,47,97,0
2025-07-17,LW,North Macedonia,1162,1084,0,0,78,38,40,78,0
2025-07-18,LW,North Macedonia,1148,1056,0,0,92,45,47,92,0
2025-07-19,LW,North Macedonia,1193,1091,0,0,102,52,50,102,0
2025-07-20,LW,North Macedonia,1194,1104,0,0,90,45,45,90,0
2025-07-21,LW,North Macedonia,1121,1027,0,0,94,50,44,94,0
2025-07-22,LW,North Macedonia,1136,1064,0,0,72,33,39,72,0
2025-07-23,LW,North Macedonia,1188,1087,0,0,101,52,49,101,0
2025-07-24,LW,North Macedonia,1109,1026,0,0,83,40,43,83,0
2025-07-25,LW,North Macedonia,1115,1021,0,0,94,46,48,94,0
2025-07-26,LW,North Macedonia,1177,1092,0,0,85,43,42,85,0
2025-07-27,LW,North Macedonia,1188,1078,0,0,110,55,55,110,0
2025-07-28,LW,North Macedonia,1109,1017,0,0,92,50,42,92,0
2025-07-29,LW,North Macedonia,1122,1052,0,0,70,31,39,70,0
2025-07-30,LW,North Macedonia,1116,1018,0,0,98,51,47,98,0
2025-07-31,LW,North Macedonia,1140,1054,0,0,86,42,44,86,0
2025-08-01,LW,North Macedonia,1139,1046,0,0,93,46,47,93,0
2025-08-02,LW,North Macedonia,1188,1110,0,0,78,39,39,78,0
2025-08-03,LW,North Macedonia,1215,1112,0,0,103,51,52,103,0
2025-08-04,LW,North Macedonia,1045,950,0,0,95,50,45,95,0
2025-08-05,LW,North Macedonia,1148,1068,0,0,80,36,44,80,0
2025-08-06,LW,North Macedonia,1201,1103,1,1,98,51,46,97,0
2025-08-07,LW,North Macedonia,1196,1107,0,0,89,42,47,89,0
2025-08-08,LW,North Macedonia,1167,1075,0,0,92,47,45,92,0
2025-08-09,LW,North Macedonia,1205,1121,0,0,84,42,42,84,0
2025-08-10,LW,North Macedonia,1133,1039,0,0,94,46,48,94,0
2025-08-11,LW,North Macedonia,1125,1033,0,0,92,50,42,92,0
2025-08-12,LW,North Macedonia,1152,1078,0,0,74,34,40,74,0
2025-08-13,LW,North Macedonia,1235,1141,0,0,94,48,46,94,0
2025-08-14,LW,North Macedonia,1125,1047,0,0,78,37,41,78,0
2025-08-15,LW,North Macedonia,1126,1032,0,0,94,48,46,94,0
2025-08-16,LW,North Macedonia,1211,1134,0,0,77,39,38,77,0
2025-08-17,LW,North Macedonia,1252,1155,0,0,97,48,49,97,0
2025-08-18,LW,North Macedonia,1104,1018,0,0,86,46,40,86,0
2025-08-19,LW,North Macedonia,1204,1128,0,0,76,35,41,76,0
2025-08-20,LW,North Macedonia,1203,1108,0,0,95,50,45,95,0
2025-08-21,LW,North Macedonia,1119,1032,1,0,87,41,45,86,1
2025-08-22,LW,North Macedonia,1129,1039,0,0,90,46,44,90,0
2025-08-23,LW,North Macedonia,1212,1129,0,0,83,43,40,83,0
2025-08-24,LW,North Macedonia,1199,1113,0,0,86,41,45,86,0
2025-08-25,LW,North Macedonia,1181,1097,0,0,84,45,39,84,0
2025-08-26,LW,North Macedonia,1210,1141,0,0,69,32,37,69,0
2025-08-27,LW,North Macedonia,1218,1127,0,0,91,46,45,91,0
2025-08-28,LW,North Macedonia,1095,1014,0,0,81,39,42,81,0
2025-08-29,LW,North Macedonia,1094,1006,0,0,88,44,44,88,0
2025-01-01,EN,Norway,1041,173,519,3,868,175,174,349,516
2025-01-02,EN,Norway,1336,220,625,8,1116,245,246,491,617
2025-01-03,EN,Norway,1336,236,610,12,1100,243,247,490,598
2025-01-04,EN,Norway,1000,250,281,7,750,238,231,469,274
2025-01-05,EN,Norway,1382,242,580,4,1140,275,285,560,576
2025-01-06,EN,Norway,1411,215,756,5,1196,222,218,440,751
2025-01-07,EN,Norway,1365,217,757,3,1148,198,193,391,754
2025-01-08,EN,Norway,1433,213,800,7,1220,211,209,420,793
2025-01-09,EN,Norway,1500,213,822,9,1287,231,234,465,813
2025-01-10,EN,Norway,1479,210,772,6,1269,249,248,497,766
2025-01-11,EN,Norway,866,210,261,4,656,201,194,395,257
2025-01-12,EN,Norway,1250,254,521,4,996,230,245,475,517
2025-01-13,EN,Norway,1329,190,706,8,1139,219,214,433,698
2025-01-14,EN,Norway,1428,180,844,5,1248,203,201,404,839
2025-01-15,EN,Norway,1288,178,750,10,1110,176,184,360,740
2025-01-16,EN,Norway,1480,192,815,14,1288,237,236,473,801
2025-01-17,EN,Norway,1408,191,708,11,1217,256,253,509,697
2025-01-18,EN,Norway,841,201,256,1,640,194,190,384,255
2025-01-19,EN,Norway,1221,213,551,1,1008,226,231,457,550
2025-01-20,EN,Norway,1426,168,806,7,1258,228,224,452,799
2025-01-21,EN,Norway,1409,182,838,3,1227,192,197,389,835
2025-01-22,EN,Norway,1469,217,824,7,1252,212,216,428,817
2025-01-23,EN,Norway,1515,229,814,5,1286,235,237,472,809
2025-01-24,EN,Norway,1457,233,732,5,1224,249,243,492,727
2025-01-25,EN,Norway,864,250,238,4,614,190,186,376,234
2025-01-26,EN,Norway,1305,238,604,8,1067,227,236,463,596
2025-01-27,EN,Norway,1491,203,819,1,1288,237,232,469,818
2025-01-28,EN,Norway,1459,196,851,4,1263,210,202,412,847
2025-01-29,EN,Norway,1447,212,825,2,1235,204,206,410,823
2025-01-30,EN,Norway,1540,206,839,10,1334,246,249,495,829
2025-01-31,EN,Norway,1497,183,791,8,1314,261,262,523,783
2025-02-01,EN,Norway,834,208,249,6,626,192,185,377,243
2025-02-02,EN,Norway,1298,235,566,3,1063,243,254,497,563
2025-02-03,EN,Norway,1506,198,812,1,1308,250,246,496,811
2025-02-04,EN,Norway,1331,199,721,5,1132,207,204,411,716
2025-02-05,EN,Norway,1419,168,808,13,1251,220,223,443,795
2025-02-06,EN,Norway,1456,178,785,18,1278,244,249,493,767
2025-02-07,EN,Norway,1471,208,746,11,1263,256,261,517,735
2025-02-08,EN,Norway,912,231,279,0,681,205,197,402,279
2025-02-09,EN,Norway,1311,211,586,5,1100,251,263,514,581
2025-02-10,EN,Norway,1456,159,832,14,1297,236,229,465,818
2025-02-11,EN,Norway,1467,204,822,11,1263,217,224,441,811
2025-02-12,EN,Norway,1470,170,839,3,1300,234,227,461,836
2025-02-13,EN,Norway,1585,191,859,6,1394,270,265,535,853
2025-02-14,EN,Norway,1525,168,778,9,1357,287,292,579,769
2025-02-15,EN,Norway,939,191,291,3,748,230,227,457,288
2025-02-16,EN,Norway,1351,193,605,9,1158,275,278,553,596
2025-02-17,EN,Norway,1484,155,818,17,1329,257,254,511,801
2025-02-18,EN,Norway,1469,152,837,16,1317,241,239,480,821
2025-02-19,EN,Norway,1497,161,835,10,1336,251,250,501,825
2025-02-20,EN,Norway,1542,197,806,10,1345,266,273,539,796
2025-02-21,EN,Norway,1544,205,767,11,1339,284,288,572,756
2025-02-22,EN,Norway,1015,237,322,2,778,230,226,456,320
2025-02-23,EN,Norway,1431,256,597,3,1175,285,293,578,594
2025-02-24,EN,Norway,1574,190,848,0,1384,267,269,536,848
2025-02-25,EN,Norway,1553,187,873,8,1366,245,248,493,865
2025-02-26,EN,Norway,1576,199,875,8,1377,251,251,502,867
2025-02-27,EN,Norway,1651,215,886,11,1436,274,276,550,875
2025-02-28,EN,Norway,1599,197,816,10,1402,291,295,586,806
2025-03-01,EN,Norway,961,249,278,6,712,220,214,434,272
2025-03-02,EN,Norway,1422,246,619,2,1176,276,281,557,617
2025-03-03,EN,Norway,1576,194,861,10,1382,263,258,521,851
2025-03-04,EN,Norway,1564,200,867,13,1364,249,248,497,854
2025-03-05,EN,Norway,1574,178,871,4,1396,261,264,525,867
2025-03-06,EN,Norway,1672,198,908,20,1474,281,285,566,888
2025-03-07,EN,Norway,1592,187,845,8,1405,279,281,560,837
2025-03-08,EN,Norway,928,187,305,7,741,222,214,436,298
2025-03-09,EN,Norway,1348,200,606,5,1148,268,274,542,601
2025-03-10,EN,Norway,1528,166,866,11,1362,246,250,496,855
2025-03-11,EN,Norway,1590,179,911,8,1411,254,246,500,903
2025-03-12,EN,Norway,1585,158,922,6,1427,249,256,505,916
2025-03-13,EN,Norway,1634,198,884,25,1436,279,273,552,859
2025-03-14,EN,Norway,1605,207,833,17,1398,280,285,565,816
2025-03-15,EN,Norway,942,224,281,3,718,221,216,437,278
2025-03-16,EN,Norway,1403,215,625,8,1188,280,283,563,617
2025-03-17,EN,Norway,1582,172,873,11,1410,268,269,537,862
2025-03-18,EN,Norway,1499,178,830,20,1321,245,246,491,810
2025-03-19,EN,Norway,1594,179,905,23,1415,255,255,510,882
2025-03-20,EN,Norway,1664,179,919,18,1485,281,285,566,901
2025-03-21,EN,Norway,1622,205,853,12,1417,281,283,564,841
2025-03-22,EN,Norway,912,179,283,6,733,228,222,450,277
2025-03-23,EN,Norway,1375,225,615,2,1150,264,271,535,613
2025-03-24,EN,Norway,1625,191,902,15,1434,269,263,532,887
2025-03-25,EN,Norway,1529,205,853,24,1324,233,238,471,829
2025-03-26,EN,Norway,1638,183,923,25,1455,261,271,532,898
2025-03-27,EN,Norway,1657,173,919,12,1484,286,279,565,907
2025-03-28,EN,Norway,1637,226,848,1,1411,278,285,563,847
2025-03-29,EN,Norway,968,234,286,8,734,226,222,448,278
2025-03-30,EN,Norway,1384,179,629,7,1205,287,289,576,622
2025-03-31,EN,Norway,1733,190,936,20,1543,306,301,607,916
2025-04-01,EN,Norway,1690,203,904,15,1487,291,292,583,889
2025-04-02,EN,Norway,1719,182,940,19,1537,299,298,597,921
2025-04-03,EN,Norway,1670,217,829,10,1453,310,314,624,819
2025-04-04,EN,Norway,1672,194,844,18,1478,316,318,634,826
2025-04-05,EN,Norway,974,166,302,10,808,253,253,506,292
2025-04-06,EN,Norway,1442,239,613,8,1203,293,297,590,605
2025-04-07,EN,Norway,1734,231,895,8,1503,300,308,608,887
2025-04-08,EN,Norway,1691,214,905,10,1477,289,283,572,895
2025-04-09,EN,Norway,1660,160,907,13,1500,294,299,593,894
2025-04-10,EN,Norway,1801,215,931,16,1586,330,325,655,915
2025-04-11,EN,Norway,1628,211,780,15,1417,320,317,637,765
2025-04-12,EN,Norway,1074,183,339,5,891,278,274,552,334
2025-04-13,EN,Norway,1470,267,586,3,1203,305,312,617,583
2025-04-14,EN,Norway,1641,242,780,9,1399,312,307,619,771
2025-04-15,EN,Norway,1558,219,781,7,1339,278,280,558,774
2025-04-16,EN,Norway,1572,227,764,12,1345,290,291,581,752
2025-04-17,EN,Norway,1346,253,479,2,1093,308,306,614,477
2025-04-18,EN,Norway,1090,237,265,4,853,290,298,588,261
2025-04-19,EN,Norway,956,236,216,4,720,252,252,504,212
2025-04-20,EN,Norway,1312,223,529,6,1089,279,281,560,523
2025-04-21,EN,Norway,1545,183,743,5,1362,308,311,619,738
2025-04-22,EN,Norway,1747,235,943,7,1512,284,285,569,936
2025-04-23,EN,Norway,1723,182,928,23,1541,308,305,613,905
2025-04-24,EN,Norway,1829,214,975,14,1615,319,321,640,961
2025-04-25,EN,Norway,1729,183,893,17,1546,324,329,653,876
2025-04-26,EN,Norway,1028,185,322,17,843,263,258,521,305
2025-04-27,EN,Norway,1454,222,651,8,1232,292,289,581,643
2025-04-28,EN,Norway,1754,211,912,9,1543,317,314,631,903
2025-04-29,EN,Norway,1730,193,935,17,1537,296,306,602,918
2025-04-30,EN,Norway,1759,174,954,17,1585,318,313,631,937
2025-05-01,EN,Norway,1501,241,633,9,1260,314,313,627,624
2025-05-02,EN,Norway,1571,195,710,10,1376,331,335,666,700
2025-05-03,EN,Norway,999,184,286,5,815,268,261,529,281
2025-05-04,EN,Norway,1422,225,607,3,1197,292,298,590,604
2025-05-05,EN,Norway,1723,202,900,9,1521,311,310,621,891
2025-05-06,EN,Norway,1707,193,915,11,1514,299,300,599,904
2025-05-07,EN,Norway,1729,202,915,10,1527,306,306,612,905
2025-05-08,EN,Norway,1790,263,872,16,1527,323,332,655,856
2025-05-09,EN,Norway,1818,220,909,21,1598,348,341,689,888
2025-05-10,EN,Norway,1049,165,337,8,884,277,270,547,329
2025-05-11,EN,Norway,1429,219,618,5,1210,296,296,592,613
2025-05-12,EN,Norway,1767,216,902,19,1551,322,327,649,883
2025-05-13,EN,Norway,1735,196,922,12,1539,307,310,617,910
2025-05-14,EN,Norway,1701,179,934,16,1522,292,296,588,918
2025-05-15,EN,Norway,1846,262,934,20,1584,328,322,650,914
2025-05-16,EN,Norway,1725,204,850,9,1521,329,342,671,841
2025-05-17,EN,Norway,890,176,171,4,714,275,268,543,167
2025-05-18,EN,Norway,1402,251,564,5,1151,292,295,587,559
2025-05-19,EN,Norway,1760,231,890,17,1529,318,321,639,873
2025-05-20,EN,Norway,1748,215,920,20,1533,305,308,613,900
2025-05-21,EN,Norway,1748,207,909,21,1541,315,317,632,888
2025-05-22,EN,Norway,1853,274,925,18,1579,332,322,654,907
2025-05-23,EN,Norway,1839,274,882,16,1565,343,340,683,866
2025-05-24,EN,Norway,1146,233,322,4,913,297,294,591,318
2025-05-25,EN,Norway,1497,285,590,6,1212,307,315,622,584
2025-05-26,EN,Norway,1832,283,897,15,1549,328,324,652,882
2025-05-27,EN,Norway,1817,269,917,3,1548,311,320,631,914
2025-05-28,EN,Norway,1871,290,922,13,1581,335,324,659,909
2025-05-29,EN,Norway,1548,264,653,8,1284,317,314,631,645
2025-05-30,EN,Norway,1532,223,681,6,1309,315,313,628,675
2025-05-31,EN,Norway,1106,211,301,5,895,297,297,594,296
2025-06-01,EN,Norway,1540,299,608,2,1241,311,322,633,606
2025-06-02,EN,Norway,1823,247,903,7,1576,333,340,673,896
2025-06-03,EN,Norway,1881,309,928,12,1572,322,322,644,916
2025-06-04,EN,Norway,1812,256,921,12,1556,319,316,635,909
2025-06-05,EN,Norway,1846,258,892,5,1588,348,348,696,887
2025-06-06,EN,Norway,1861,249,891,12,1612,358,363,721,879
2025-06-07,EN,Norway,1162,258,303,10,904,304,297,601,293
2025-06-08,EN,Norway,1470,310,575,4,1160,291,294,585,571
2025-06-09,EN,Norway,1695,276,772,10,1419,322,325,647,762
2025-06-10,EN,Norway,1871,241,965,9,1630,327,338,665,956
2025-06-11,EN,Norway,1849,257,928,5,1592,332,332,664,923
2025-06-12,EN,Norway,1942,258,961,14,1684,358,365,723,947
2025-06-13,EN,Norway,1837,231,891,10,1606,366,349,715,881
2025-06-14,EN,Norway,1124,197,300,7,927,314,313,627,293
2025-06-15,EN,Norway,1611,301,645,4,1310,332,333,665,641
2025-06-16,EN,Norway,1824,241,916,23,1583,332,335,667,893
2025-06-17,EN,Norway,1796,233,914,15,1563,326,323,649,899
2025-06-18,EN,Norway,1750,198,896,10,1552,331,325,656,886
2025-06-19,EN,Norway,1848,226,918,15,1622,348,356,704,903
2025-06-20,EN,Norway,1833,227,866,7,1606,368,372,740,859
2025-06-21,EN,Norway,1161,190,310,4,971,338,323,661,306
2025-06-22,EN,Norway,1531,266,609,3,1265,324,332,656,606
2025-06-23,EN,Norway,1766,254,799,7,1512,355,358,713,792
2025-06-24,EN,Norway,1755,233,795,10,1522,361,366,727,785
2025-06-25,EN,Norway,1685,194,812,10,1491,342,337,679,802
2025-06-26,EN,Norway,1803,308,771,13,1495,361,363,724,758
2025-06-27,EN,Norway,1755,278,705,4,1477,387,385,772,701
2025-06-28,EN,Norway,1240,224,330,3,1016,345,341,686,327
2025-06-29,EN,Norway,1474,234,532,6,1240,351,357,708,526
2025-06-30,EN,Norway,1732,243,744,15,1489,374,371,745,729
2025-07-01,EN,Norway,1728,250,750,9,1478,363,365,728,741
2025-07-02,EN,Norway,1668,245,724,16,1423,349,350,699,708
2025-07-03,EN,Norway,1774,289,754,12,1485,369,362,731,742
2025-07-04,EN,Norway,1737,253,729,2,1484,375,380,755,727
2025-07-05,EN,Norway,1229,214,341,6,1015,341,333,674,335
2025-07-06,EN,Norway,1504,272,516,2,1232,359,357,716,514
2025-07-07,EN,Norway,1712,245,734,9,1467,362,371,733,725
2025-07-08,EN,Norway,1736,253,767,16,1483,359,357,716,751
2025-07-09,EN,Norway,1700,240,747,6,1460,358,355,713,741
2025-07-10,EN,Norway,1743,287,729,18,1456,361,366,727,711
2025-07-11,EN,Norway,1719,269,697,11,1450,371,382,753,686
2025-07-12,EN,Norway,1240,207,342,10,1033,353,338,691,332
2025-07-13,EN,Norway,1518,279,528,5,1239,354,357,711,523
2025-07-14,EN,Norway,1716,262,713,10,1454,367,374,741,703
2025-07-15,EN,Norway,1767,307,744,10,1460,361,355,716,734
2025-07-16,EN,Norway,1753,289,747,10,1464,354,363,717,737
2025-07-17,EN,Norway,1756,317,710,10,1439,365,364,729,700
2025-07-18,EN,Norway,1704,271,689,19,1433,371,373,744,670
2025-07-19,EN,Norway,1289,228,354,11,1061,358,349,707,343
2025-07-20,EN,Norway,1548,289,571,12,1259,342,346,688,559
2025-07-21,EN,Norway,1757,305,724,10,1452,363,365,728,714
2025-07-22,EN,Norway,1772,309,734,8,1463,362,367,729,726
2025-07-23,EN,Norway,1668,278,709,7,1390,341,340,681,702
2025-07-24,EN,Norway,1745,282,729,11,1463,366,368,734,718
2025-07-25,EN,Norway,1725,247,720,7,1478,383,375,758,713
2025-07-26,EN,Norway,1259,249,330,4,1010,340,340,680,326
2025-07-27,EN,Norway,1578,330,550,3,1248,349,349,698,547
2025-07-28,EN,Norway,1783,313,745,13,1470,361,364,725,732
2025-07-29,EN,Norway,1762,281,756,8,1481,361,364,725,748
2025-07-30,EN,Norway,1771,302,730,24,1469,372,367,739,706
2025-07-31,EN,Norway,1835,354,746,16,1481,361,374,735,730
2025-08-01,EN,Norway,1744,286,725,15,1458,368,365,733,710
2025-08-02,EN,Norway,1272,268,326,4,1004,339,339,678,322
2025-08-03,EN,Norway,1554,324,527,5,1230,352,351,703,522
2025-08-04,EN,Norway,1725,259,729,4,1466,364,373,737,725
2025-08-05,EN,Norway,1758,321,733,6,1437,351,353,704,727
2025-08-06,EN,Norway,1771,279,759,20,1492,366,367,733,739
2025-08-07,EN,Norway,1835,320,766,11,1515,376,373,749,755
2025-08-08,EN,Norway,1744,266,733,10,1478,374,371,745,723
2025-08-09,EN,Norway,1220,241,299,4,979,340,340,680,295
2025-08-10,EN,Norway,1493,263,531,7,1230,347,352,699,524
2025-08-11,EN,Norway,1799,245,804,13,1554,373,377,750,791
2025-08-12,EN,Norway,1730,243,806,19,1487,339,342,681,787
2025-08-13,EN,Norway,1782,280,818,11,1502,342,342,684,807
2025-08-14,EN,Norway,1813,293,802,18,1520,362,356,718,784
2025-08-15,EN,Norway,1772,260,783,13,1512,365,364,729,770
2025-08-16,EN,Norway,1190,219,332,7,971,323,316,639,325
2025-08-17,EN,Norway,1496,272,567,6,1224,326,331,657,561
2025-08-18,EN,Norway,1791,222,877,15,1569,343,349,692,862
2025-08-19,EN,Norway,1809,226,911,12,1583,336,336,672,899
2025-08-20,EN,Norway,1808,242,910,10,1566,328,328,656,900
2025-08-21,EN,Norway,1876,249,914,12,1627,356,357,713,902
2025-08-22,EN,Norway,1794,230,832,9,1564,371,361,732,823
2025-08-23,EN,Norway,1150,227,301,3,923,314,308,622,298
2025-08-24,EN,Norway,1577,290,632,5,1287,320,335,655,627
2025-08-25,EN,Norway,1857,224,944,16,1633,348,341,689,928
2025-08-26,EN,Norway,1920,268,985,11,1652,333,334,667,974
2025-08-27,EN,Norway,1944,313,952,11,1631,332,347,679,941
2025-08-28,EN,Norway,1951,319,931,18,1632,353,348,701,913
2025-08-29,EN,Norway,1940,324,907,11,1616,359,350,709,896
2025-01-01,EP,Poland,1465,576,76,7,889,404,409,813,69
2025-01-02,EP,Poland,1822,719,88,6,1103,514,501,1015,82
2025-01-03,EP,Poland,1888,710,90,8,1178,536,552,1088,82
2025-01-04,EP,Poland,1795,730,70,8,1065,496,499,995,62
2025-01-05,EP,Poland,1757,710,81,13,1047,487,479,966,68
2025-01-06,EP,Poland,1853,710,94,7,1143,516,533,1049,87
2025-01-07,EP,Poland,1668,628,105,10,1040,462,473,935,95
2025-01-08,EP,Poland,1513,611,113,18,902,396,393,789,95
2025-01-09,EP,Poland,1584,620,121,29,964,431,412,843,92
2025-01-10,EP,Poland,1836,687,103,7,1149,518,528,1046,96
2025-01-11,EP,Poland,1664,701,55,2,963,455,453,908,53
2025-01-12,EP,Poland,1694,688,80,6,1006,462,464,926,74
2025-01-13,EP,Poland,1765,621,115,14,1144,506,523,1029,101
2025-01-14,EP,Poland,1419,555,104,14,864,384,376,760,90
2025-01-15,EP,Poland,1425,563,89,7,862,386,387,773,82
2025-01-16,EP,Poland,1588,613,94,9,975,441,440,881,85
2025-01-17,EP,Poland,1802,625,121,14,1177,524,532,1056,107
2025-01-18,EP,Poland,1631,673,72,16,958,449,437,886,56
2025-01-19,EP,Poland,1650,651,77,2,999,463,459,922,75
2025-01-20,EP,Poland,1692,588,115,12,1104,485,504,989,103
2025-01-21,EP,Poland,1436,496,128,16,940,403,409,812,112
2025-01-22,EP,Poland,1442,566,102,25,876,394,380,774,77
2025-01-23,EP,Poland,1621,636,124,12,985,432,429,861,112
2025-01-24,EP,Poland,1894,696,124,21,1198,529,545,1074,103
2025-01-25,EP,Poland,1706,692,88,14,1014,469,457,926,74
2025-01-26,EP,Poland,1713,650,94,10,1063,481,488,969,84
2025-01-27,EP,Poland,1894,625,144,21,1269,559,566,1125,123
2025-01-28,EP,Poland,1404,503,108,14,901,398,395,793,94
2025-01-29,EP,Poland,1475,561,111,24,914,400,403,803,87
2025-01-30,EP,Poland,1596,604,125,19,992,438,429,867,106
2025-01-31,EP,Poland,1834,659,117,13,1175,528,530,1058,104
2025-02-01,EP,Poland,1684,685,65,11,999,470,464,934,54
2025-02-02,EP,Poland,1712,655,79,2,1057,492,486,978,77
2025-02-03,EP,Poland,1791,614,121,22,1177,517,539,1056,99
2025-02-04,EP,Poland,1473,522,126,26,951,410,415,825,100
2025-02-05,EP,Poland,1500,536,123,21,964,423,418,841,102
2025-02-06,EP,Poland,1631,592,101,11,1039,478,460,938,90
2025-02-07,EP,Poland,1897,652,138,28,1245,548,559,1107,110
2025-02-08,EP,Poland,1678,656,82,20,1022,473,467,940,62
2025-02-09,EP,Poland,1715,663,95,15,1052,485,472,957,80
2025-02-10,EP,Poland,1762,594,122,26,1168,518,528,1046,96
2025-02-11,EP,Poland,1452,518,117,23,934,407,410,817,94
2025-02-12,EP,Poland,1501,544,114,23,957,421,422,843,91
2025-02-13,EP,Poland,1652,614,97,8,1038,477,464,941,89
2025-02-14,EP,Poland,1847,632,110,4,1215,549,556,1105,106
2025-02-15,EP,Poland,1682,659,72,7,1023,477,474,951,65
2025-02-16,EP,Poland,1721,635,86,7,1086,497,503,1000,79
2025-02-17,EP,Poland,1830,609,122,19,1221,548,551,1099,103
2025-02-18,EP,Poland,1565,513,123,19,1052,466,463,929,104
2025-02-19,EP,Poland,1603,544,107,11,1059,475,477,952,96
2025-02-20,EP,Poland,1753,623,121,30,1130,508,501,1009,91
2025-02-21,EP,Poland,1815,603,125,26,1212,542,545,1087,99
2025-02-22,EP,Poland,1704,677,82,24,1027,477,468,945,58
2025-02-23,EP,Poland,1769,693,89,14,1076,494,493,987,75
2025-02-24,EP,Poland,1813,641,113,5,1172,519,540,1059,108
2025-02-25,EP,Poland,1559,535,134,18,1024,450,440,890,116
2025-02-26,EP,Poland,1573,561,136,29,1012,433,443,876,107
2025-02-27,EP,Poland,1646,599,110,17,1047,478,459,937,93
2025-02-28,EP,Poland,1823,665,104,11,1158,526,528,1054,93
2025-03-01,EP,Poland,1766,728,72,14,1038,481,485,966,58
2025-03-02,EP,Poland,1786,715,76,5,1071,499,496,995,71
2025-03-03,EP,Poland,1912,725,127,25,1187,523,537,1060,102
2025-03-04,EP,Poland,1603,576,140,31,1027,448,439,887,109
2025-03-05,EP,Poland,1671,630,137,25,1041,457,447,904,112
2025-03-06,EP,Poland,1759,654,124,26,1105,493,488,981,98
2025-03-07,EP,Poland,1916,670,140,28,1246,549,557,1106,112
2025-03-08,EP,Poland,1740,667,84,18,1073,493,496,989,66
2025-03-09,EP,Poland,1740,660,96,19,1080,490,494,984,77
2025-03-10,EP,Poland,1647,537,128,26,1110,487,495,982,102
2025-03-11,EP,Poland,1598,550,140,25,1048,452,456,908,115
2025-03-12,EP,Poland,1613,590,127,28,1023,451,445,896,99
2025-03-13,EP,Poland,1736,639,96,15,1097,503,498,1001,81
2025-03-14,EP,Poland,1932,698,133,24,1234,549,552,1101,109
2025-03-15,EP,Poland,1744,721,77,16,1023,473,473,946,61
2025-03-16,EP,Poland,1788,711,90,15,1077,500,487,987,75
2025-03-17,EP,Poland,1909,668,157,31,1241,532,552,1084,126
2025-03-18,EP,Poland,1618,569,141,29,1049,456,452,908,112
2025-03-19,EP,Poland,1678,644,131,29,1034,449,454,903,102
2025-03-20,EP,Poland,1838,666,137,32,1172,517,518,1035,105
2025-03-21,EP,Poland,1928,689,130,21,1239,556,553,1109,109
2025-03-22,EP,Poland,1719,697,83,19,1022,469,470,939,64
2025-03-23,EP,Poland,1797,708,86,10,1089,505,498,1003,76
2025-03-24,EP,Poland,1917,684,139,19,1233,534,560,1094,120
2025-03-25,EP,Poland,1646,588,131,20,1058,465,462,927,111
2025-03-26,EP,Poland,1693,635,131,28,1058,462,465,927,103
2025-03-27,EP,Poland,1780,659,114,15,1121,508,499,1007,99
2025-03-28,EP,Poland,1872,660,117,16,1212,543,552,1095,101
2025-03-29,EP,Poland,1735,699,77,11,1036,481,478,959,66
2025-03-30,EP,Poland,1969,740,99,11,1229,567,563,1130,88
2025-03-31,EP,Poland,2033,725,131,21,1308,582,595,1177,110
2025-04-01,EP,Poland,2017,728,128,20,1289,582,579,1161,108
2025-04-02,EP,Poland,1989,711,125,21,1278,574,579,1153,104
2025-04-03,EP,Poland,2044,693,144,20,1351,609,598,1207,124
2025-04-04,EP,Poland,2062,717,145,21,1345,603,597,1200,124
2025-04-05,EP,Poland,1907,741,79,12,1166,545,542,1087,67
2025-04-06,EP,Poland,2042,786,99,3,1256,580,577,1157,96
2025-04-07,EP,Poland,2060,756,135,17,1304,577,592,1169,118
2025-04-08,EP,Poland,2013,726,145,24,1287,574,568,1142,121
2025-04-09,EP,Poland,1969,715,131,24,1254,566,557,1123,107
2025-04-10,EP,Poland,2079,740,135,27,1339,605,599,1204,108
2025-04-11,EP,Poland,2119,772,112,8,1347,614,621,1235,104
2025-04-12,EP,Poland,2022,807,101,26,1215,553,561,1114,75
2025-04-13,EP,Poland,2078,811,111,22,1267,573,583,1156,89
2025-04-14,EP,Poland,2140,817,143,27,1323,591,589,1180,116
2025-04-15,EP,Poland,2013,746,142,30,1267,562,563,1125,112
2025-04-16,EP,Poland,2114,793,144,27,1321,595,582,1177,117
2025-04-17,EP,Poland,2147,771,142,33,1376,612,622,1234,109
2025-04-18,EP,Poland,2116,781,110,11,1335,614,611,1225,99
2025-04-19,EP,Poland,2056,878,63,2,1178,559,556,1115,61
2025-04-20,EP,Poland,2039,824,68,0,1215,579,568,1147,68
2025-04-21,EP,Poland,2032,788,94,6,1244,568,582,1150,88
2025-04-22,EP,Poland,2092,769,135,22,1323,590,598,1188,113
2025-04-23,EP,Poland,2130,773,147,31,1357,606,604,1210,116
2025-04-24,EP,Poland,2202,767,154,29,1435,644,637,1281,125
2025-04-25,EP,Poland,2310,810,148,18,1500,675,677,1352,130
2025-04-26,EP,Poland,2203,885,101,15,1318,604,613,1217,86
2025-04-27,EP,Poland,2306,886,103,20,1420,658,659,1317,83
2025-04-28,EP,Poland,2273,881,153,31,1392,615,624,1239,122
2025-04-29,EP,Poland,2151,817,138,27,1334,607,589,1196,111
2025-04-30,EP,Poland,2242,875,133,27,1367,623,611,1234,106
2025-05-01,EP,Poland,2163,815,102,8,1348,633,613,1246,94
2025-05-02,EP,Poland,2241,827,103,10,1414,654,657,1311,93
2025-05-03,EP,Poland,2288,995,80,7,1293,603,610,1213,73
2025-05-04,EP,Poland,2401,946,92,2,1455,670,693,1363,90
2025-05-05,EP,Poland,2203,854,134,24,1349,599,616,1215,110
2025-05-06,EP,Poland,2133,822,129,14,1311,597,585,1182,115
2025-05-07,EP,Poland,2208,816,132,32,1392,626,634,1260,100
2025-05-08,EP,Poland,2291,841,150,27,1450,651,649,1300,123
2025-05-09,EP,Poland,2365,857,130,16,1508,694,684,1378,114
2025-05-10,EP,Poland,2267,994,92,10,1273,588,593,1181,82
2025-05-11,EP,Poland,2309,936,94,9,1373,643,636,1279,85
2025-05-12,EP,Poland,2313,930,128,28,1383,622,633,1255,100
2025-05-13,EP,Poland,2201,847,145,26,1354,604,605,1209,119
2025-05-14,EP,Poland,2185,825,132,20,1360,615,613,1228,112
2025-05-15,EP,Poland,2297,860,137,17,1437,656,644,1300,120
2025-05-16,EP,Poland,2422,942,132,20,1480,679,669,1348,112
2025-05-17,EP,Poland,2328,1042,82,12,1286,598,606,1204,70
2025-05-18,EP,Poland,2422,1039,89,4,1383,648,646,1294,85
2025-05-19,EP,Poland,2273,896,133,17,1377,617,627,1244,116
2025-05-20,EP,Poland,2238,883,148,32,1355,603,604,1207,116
2025-05-21,EP,Poland,2288,881,143,22,1407,629,635,1264,121
2025-05-22,EP,Poland,2379,909,158,28,1470,661,651,1312,130
2025-05-23,EP,Poland,2470,985,144,21,1485,672,669,1341,123
2025-05-24,EP,Poland,2435,1083,116,26,1352,615,621,1236,90
2025-05-25,EP,Poland,2490,1025,123,18,1465,670,672,1342,105
2025-05-26,EP,Poland,2497,1026,124,19,1471,670,677,1347,105
2025-05-27,EP,Poland,2365,907,148,31,1458,660,650,1310,117
2025-05-28,EP,Poland,2494,932,153,37,1562,690,719,1409,116
2025-05-29,EP,Poland,2462,908,153,22,1554,718,683,1401,131
2025-05-30,EP,Poland,2443,918,133,21,1525,696,696,1392,112
2025-05-31,EP,Poland,2511,1134,108,18,1377,637,632,1269,90
2025-06-01,EP,Poland,2609,1084,94,7,1525,709,722,1431,87
2025-06-02,EP,Poland,2458,969,130,22,1489,676,683,1359,108
2025-06-03,EP,Poland,2416,912,145,25,1504,678,681,1359,120
2025-06-04,EP,Poland,2450,894,140,29,1556,707,709,1416,111
2025-06-05,EP,Poland,2481,934,134,22,1547,712,701,1413,112
2025-06-06,EP,Poland,2608,978,147,23,1630,742,741,1483,124
2025-06-07,EP,Poland,2538,1124,94,14,1414,661,659,1320,80
2025-06-08,EP,Poland,2585,1046,99,11,1539,721,719,1440,88
2025-06-09,EP,Poland,2507,968,147,27,1539,689,703,1392,120
2025-06-10,EP,Poland,2491,940,162,38,1551,699,690,1389,124
2025-06-11,EP,Poland,2519,936,131,24,1583,720,732,1452,107
2025-06-12,EP,Poland,2554,925,155,28,1629,740,734,1474,127
2025-06-13,EP,Poland,2603,965,136,18,1638,760,742,1502,118
2025-06-14,EP,Poland,2565,1097,110,20,1468,681,677,1358,90
2025-06-15,EP,Poland,2613,1037,118,16,1576,722,736,1458,102
2025-06-16,EP,Poland,2545,973,130,14,1572,721,721,1442,116
2025-06-17,EP,Poland,2470,889,164,34,1581,704,713,1417,130
2025-06-18,EP,Poland,2612,982,156,40,1630,745,729,1474,116
2025-06-19,EP,Poland,2486,891,93,3,1595,753,749,1502,90
2025-06-20,EP,Poland,2669,1032,113,19,1637,766,758,1524,94
2025-06-21,EP,Poland,2563,1106,104,19,1457,670,683,1353,85
2025-06-22,EP,Poland,2594,1032,88,4,1562,735,739,1474,84
2025-06-23,EP,Poland,2571,1006,124,16,1565,720,721,1441,108
2025-06-24,EP,Poland,2576,948,167,34,1628,727,734,1461,133
2025-06-25,EP,Poland,2572,966,146,26,1606,732,728,1460,120
2025-06-26,EP,Poland,2707,1047,148,31,1660,760,752,1512,117
2025-06-27,EP,Poland,2749,1060,138,25,1689,777,774,1551,113
2025-06-28,EP,Poland,2643,1177,108,20,1466,680,678,1358,88
2025-06-29,EP,Poland,2659,1095,103,13,1564,729,732,1461,90
2025-06-30,EP,Poland,2658,1043,147,33,1615,733,735,1468,114
2025-07-01,EP,Poland,2598,1025,157,31,1573,701,715,1416,126
2025-07-02,EP,Poland,2603,991,149,22,1612,730,733,1463,127
2025-07-03,EP,Poland,2665,1040,145,29,1625,747,733,1480,116
2025-07-04,EP,Poland,2655,1002,142,25,1653,759,752,1511,117
2025-07-05,EP,Poland,2570,1109,99,25,1461,681,681,1362,74
2025-07-06,EP,Poland,2647,1082,101,8,1565,732,732,1464,93
2025-07-07,EP,Poland,2616,1022,129,24,1594,733,732,1465,105
2025-07-08,EP,Poland,2557,1019,131,19,1538,708,699,1407,112
2025-07-09,EP,Poland,2632,1056,117,11,1576,724,735,1459,106
2025-07-10,EP,Poland,2660,1049,128,29,1611,749,734,1483,99
2025-07-11,EP,Poland,2770,1106,138,23,1664,761,765,1526,115
2025-07-12,EP,Poland,2594,1142,88,15,1452,682,682,1364,73
2025-07-13,EP,Poland,2651,1099,95,13,1552,723,734,1457,82
2025-07-14,EP,Poland,2674,1062,152,40,1612,732,728,1460,112
2025-07-15,EP,Poland,2646,1073,144,31,1573,712,717,1429,113
2025-07-16,EP,Poland,2689,1103,134,28,1586,722,730,1452,106
2025-07-17,EP,Poland,2703,1046,144,35,1657,769,744,1513,109
2025-07-18,EP,Poland,2757,1091,133,29,1666,768,765,1533,104
2025-07-19,EP,Poland,2569,1116,90,11,1453,676,687,1363,79
2025-07-20,EP,Poland,2675,1111,100,16,1564,729,735,1464,84
2025-07-21,EP,Poland,2758,1119,149,38,1639,745,745,1490,111
2025-07-22,EP,Poland,2668,1087,144,31,1581,719,718,1437,113
2025-07-23,EP,Poland,2677,1069,138,28,1608,733,737,1470,110
2025-07-24,EP,Poland,2706,1077,150,35,1629,742,737,1479,115
2025-07-25,EP,Poland,2802,1125,149,23,1677,766,762,1528,126
2025-07-26,EP,Poland,2683,1224,108,23,1459,674,677,1351,85
2025-07-27,EP,Poland,2710,1119,89,7,1591,749,753,1502,82
2025-07-28,EP,Poland,2702,1081,131,13,1621,746,744,1490,118
2025-07-29,EP,Poland,2659,1064,142,24,1595,728,725,1453,118
2025-07-30,EP,Poland,2738,1089,160,37,1649,742,747,1489,123
2025-07-31,EP,Poland,2744,1080,144,29,1664,768,752,1520,115
2025-08-01,EP,Poland,2757,1122,133,18,1635,749,753,1502,115
2025-08-02,EP,Poland,2680,1203,108,26,1477,683,686,1369,82
2025-08-03,EP,Poland,2760,1147,107,12,1613,750,756,1506,95
2025-08-04,EP,Poland,2664,1051,119,17,1613,746,748,1494,102
2025-08-05,EP,Poland,2659,1085,141,28,1574,713,720,1433,113
2025-08-06,EP,Poland,2639,1059,122,33,1580,722,736,1458,89
2025-08-07,EP,Poland,2753,1090,148,39,1663,770,745,1515,109
2025-08-08,EP,Poland,2765,1078,152,35,1687,771,764,1535,117
2025-08-09,EP,Poland,2644,1174,101,21,1470,682,687,1369,80
2025-08-10,EP,Poland,2707,1103,91,8,1604,755,758,1513,83
2025-08-11,EP,Poland,2653,1032,133,36,1621,749,739,1488,97
2025-08-12,EP,Poland,2606,1025,138,37,1581,719,724,1443,101
2025-08-13,EP,Poland,2619,1002,139,28,1617,728,750,1478,111
2025-08-14,EP,Poland,2676,1029,130,29,1647,768,749,1517,101
2025-08-15,EP,Poland,2681,1074,115,14,1607,748,744,1492,101
2025-08-16,EP,Poland,2644,1185,84,12,1459,684,691,1375,72
2025-08-17,EP,Poland,2665,1053,95,8,1612,761,756,1517,87
2025-08-18,EP,Poland,2589,968,139,20,1621,742,740,1482,119
2025-08-19,EP,Poland,2564,949,146,32,1615,733,736,1469,114
2025-08-20,EP,Poland,2548,933,137,32,1615,733,745,1478,105
2025-08-21,EP,Poland,2652,973,147,38,1679,773,759,1532,109
2025-08-22,EP,Poland,2657,990,123,22,1667,770,774,1544,101
2025-08-23,EP,Poland,2594,1107,92,10,1487,696,699,1395,82
2025-08-24,EP,Poland,2676,1072,101,11,1604,747,756,1503,90
2025-08-25,EP,Poland,2652,1012,146,38,1640,748,746,1494,108
2025-08-26,EP,Poland,2594,968,144,26,1626,740,742,1482,118
2025-08-27,EP,Poland,2627,985,144,33,1642,748,750,1498,111
2025-08-28,EP,Poland,2668,971,144,32,1697,770,783,1553,112
2025-08-29,EP,Poland,2754,1047,137,19,1707,789,781,1570,118
2025-01-01,LP,Portugal,2004,1055,146,0,949,414,389,803,146
2025-01-02,LP,Portugal,2328,1183,169,0,1145,488,488,976,169
2025-01-03,LP,Portugal,2407,1234,174,1,1173,505,494,999,173
2025-01-04,LP,Portugal,2564,1421,143,0,1143,503,497,1000,143
2025-01-05,LP,Portugal,2419,1251,181,3,1168,491,496,987,178
2025-01-06,LP,Portugal,2300,1200,132,1,1100,479,489,968,131
2025-01-07,LP,Portugal,1963,1054,140,1,909,384,385,769,139
2025-01-08,LP,Portugal,1836,1010,126,2,826,359,341,700,124
2025-01-09,LP,Portugal,1929,1065,132,0,864,362,370,732,132
2025-01-10,LP,Portugal,2022,1027,138,0,995,429,428,857,138
2025-01-11,LP,Portugal,2304,1366,118,4,938,409,411,820,114
2025-01-12,LP,Portugal,2191,1181,139,0,1010,439,432,871,139
2025-01-13,LP,Portugal,1864,917,145,3,947,395,407,802,142
2025-01-14,LP,Portugal,1730,958,135,2,772,322,315,637,133
2025-01-15,LP,Portugal,1699,931,123,0,768,325,320,645,123
2025-01-16,LP,Portugal,1886,1035,142,0,851,345,364,709,142
2025-01-17,LP,Portugal,2095,1106,140,3,989,425,424,849,137
2025-01-18,LP,Portugal,2323,1372,127,0,951,418,406,824,127
2025-01-19,LP,Portugal,2195,1222,125,1,973,420,428,848,124
2025-01-20,LP,Portugal,1916,969,130,3,947,408,409,817,127
2025-01-21,LP,Portugal,1742,975,139,2,767,314,314,628,137
2025-01-22,LP,Portugal,1733,939,128,1,794,338,328,666,127
2025-01-23,LP,Portugal,1842,1006,140,4,836,341,355,696,136
2025-01-24,LP,Portugal,1942,974,143,0,968,414,411,825,143
2025-01-25,LP,Portugal,2245,1326,115,1,919,403,401,804,114
2025-01-26,LP,Portugal,2109,1112,134,2,997,433,430,863,132
2025-01-27,LP,Portugal,1945,996,154,5,949,392,403,795,149
2025-01-28,LP,Portugal,1777,1023,131,1,754,310,313,623,130
2025-01-29,LP,Portugal,1708,939,128,3,769,327,314,641,125
2025-01-30,LP,Portugal,1871,1015,150,3,856,351,355,706,147
2025-01-31,LP,Portugal,2088,1092,143,2,996,431,422,853,141
2025-02-01,LP,Portugal,2286,1322,126,0,964,423,415,838,126
2025-02-02,LP,Portugal,2219,1175,140,0,1044,448,456,904,140
2025-02-03,LP,Portugal,2012,1008,142,1,1004,421,441,862,141
2025-02-04,LP,Portugal,1813,980,135,0,833,351,347,698,135
2025-02-05,LP,Portugal,1766,962,122,1,804,345,337,682,121
2025-02-06,LP,Portugal,2003,1078,143,0,925,392,390,782,143
2025-02-07,LP,Portugal,2179,1125,147,3,1054,457,450,907,144
2025-02-08,LP,Portugal,2367,1321,124,1,1046,462,460,922,123
2025-02-09,LP,Portugal,2265,1187,150,0,1078,463,465,928,150
2025-02-10,LP,Portugal,2099,1043,152,1,1056,447,457,904,151
2025-02-11,LP,Portugal,2047,1144,141,0,903,380,382,762,141
2025-02-12,LP,Portugal,1984,1074,133,2,910,391,386,777,131
2025-02-13,LP,Portugal,2031,1064,143,2,967,416,408,824,141
2025-02-14,LP,Portugal,2187,1131,141,0,1056,453,462,915,141
2025-02-15,LP,Portugal,2442,1335,140,3,1107,489,478,967,137
2025-02-16,LP,Portugal,2413,1288,158,0,1125,483,484,967,158
2025-02-17,LP,Portugal,2109,1018,147,9,1091,466,478,944,138
2025-02-18,LP,Portugal,2104,1138,146,4,966,417,403,820,142
2025-02-19,LP,Portugal,2119,1156,134,5,963,418,411,829,129
2025-02-20,LP,Portugal,2150,1133,128,4,1017,441,448,889,124
2025-02-21,LP,Portugal,2250,1123,165,2,1127,482,480,962,163
2025-02-22,LP,Portugal,2666,1578,133,1,1088,476,479,955,132
2025-02-23,LP,Portugal,2471,1328,152,1,1143,496,495,991,151
2025-02-24,LP,Portugal,2137,1004,162,5,1133,478,493,971,157
2025-02-25,LP,Portugal,2067,1113,144,5,954,404,406,810,139
2025-02-26,LP,Portugal,1976,1040,134,3,936,407,395,802,131
2025-02-27,LP,Portugal,2257,1205,150,0,1052,451,451,902,150
2025-02-28,LP,Portugal,2257,1132,167,1,1125,483,475,958,166
2025-03-01,LP,Portugal,2655,1501,161,6,1154,495,498,993,155
2025-03-02,LP,Portugal,2442,1283,143,1,1159,510,506,1016,142
2025-03-03,LP,Portugal,2167,1063,143,0,1104,479,482,961,143
2025-03-04,LP,Portugal,2144,1144,144,0,1000,422,434,856,144
2025-03-05,LP,Portugal,2037,1057,136,1,980,424,420,844,135
2025-03-06,LP,Portugal,2266,1170,142,1,1096,475,479,954,141
2025-03-07,LP,Portugal,2224,1123,135,3,1101,487,479,966,132
2025-03-08,LP,Portugal,2547,1400,155,2,1147,497,495,992,153
2025-03-09,LP,Portugal,2494,1359,153,0,1135,491,491,982,153
2025-03-10,LP,Portugal,2205,1106,151,1,1099,469,479,948,150
2025-03-11,LP,Portugal,2128,1148,127,5,980,427,426,853,122
2025-03-12,LP,Portugal,2088,1106,142,1,982,424,416,840,141
2025-03-13,LP,Portugal,2248,1188,140,0,1060,457,463,920,140
2025-03-14,LP,Portugal,2267,1151,155,1,1116,484,477,961,154
2025-03-15,LP,Portugal,2545,1429,132,1,1116,494,490,984,131
2025-03-16,LP,Portugal,2471,1303,158,3,1168,507,503,1010,155
2025-03-17,LP,Portugal,2219,1098,159,4,1121,475,487,962,155
2025-03-18,LP,Portugal,2171,1151,151,8,1020,434,435,869,143
2025-03-19,LP,Portugal,2010,1061,125,6,949,418,406,824,119
2025-03-20,LP,Portugal,2221,1120,158,2,1101,466,477,943,156
2025-03-21,LP,Portugal,2213,1103,156,1,1110,486,468,954,155
2025-03-22,LP,Portugal,2536,1422,136,2,1114,483,495,978,134
2025-03-23,LP,Portugal,2457,1291,146,3,1166,510,510,1020,143
2025-03-24,LP,Portugal,2118,1003,155,1,1115,473,487,960,154
2025-03-25,LP,Portugal,2162,1159,147,0,1003,435,421,856,147
2025-03-26,LP,Portugal,2019,1064,137,0,955,409,409,818,137
2025-03-27,LP,Portugal,2297,1193,147,0,1104,477,480,957,147
2025-03-28,LP,Portugal,2269,1121,158,2,1148,499,491,990,156
2025-03-29,LP,Portugal,2559,1429,149,2,1130,485,496,981,147
2025-03-30,LP,Portugal,2458,1148,193,3,1310,562,555,1117,190
2025-03-31,LP,Portugal,2281,1030,182,3,1251,533,536,1069,179
2025-04-01,LP,Portugal,2343,1078,173,2,1265,544,548,1092,171
2025-04-02,LP,Portugal,2284,1044,166,1,1240,541,533,1074,165
2025-04-03,LP,Portugal,2378,1087,174,4,1291,562,555,1117,170
2025-04-04,LP,Portugal,2414,1102,189,0,1312,559,564,1123,189
2025-04-05,LP,Portugal,2584,1217,174,2,1367,591,602,1193,172
2025-04-06,LP,Portugal,2468,1125,172,1,1343,593,578,1171,171
2025-04-07,LP,Portugal,2323,980,187,1,1343,575,581,1156,186
2025-04-08,LP,Portugal,2313,1035,190,2,1278,545,543,1088,188
2025-04-09,LP,Portugal,2199,930,175,2,1269,548,546,1094,173
2025-04-10,LP,Portugal,2433,1078,190,1,1355,577,588,1165,189
2025-04-11,LP,Portugal,2404,1060,201,2,1344,575,568,1143,199
2025-04-12,LP,Portugal,2644,1269,178,3,1375,594,603,1197,175
2025-04-13,LP,Portugal,2522,1127,197,2,1395,601,597,1198,195
2025-04-14,LP,Portugal,2351,981,190,1,1370,585,595,1180,189
2025-04-15,LP,Portugal,2406,1111,178,1,1295,560,557,1117,177
2025-04-16,LP,Portugal,2440,1093,181,3,1347,578,588,1166,178
2025-04-17,LP,Portugal,2453,1056,194,1,1397,601,602,1203,193
2025-04-18,LP,Portugal,2400,1067,188,2,1333,573,572,1145,186
2025-04-19,LP,Portugal,2713,1309,184,0,1404,610,610,1220,184
2025-04-20,LP,Portugal,2545,1162,183,0,1383,600,600,1200,183
2025-04-21,LP,Portugal,2425,1032,191,0,1393,601,601,1202,191
2025-04-22,LP,Portugal,2378,1051,193,3,1327,571,563,1134,190
2025-04-23,LP,Portugal,2315,996,176,0,1319,572,571,1143,176
2025-04-24,LP,Portugal,2400,1021,200,7,1379,590,589,1179,193
2025-04-25,LP,Portugal,2335,994,189,2,1341,578,574,1152,187
2025-04-26,LP,Portugal,2625,1208,177,1,1417,616,624,1240,176
2025-04-27,LP,Portugal,2482,1075,183,0,1407,615,609,1224,183
2025-04-28,LP,Portugal,1910,929,152,1,981,413,416,829,151
2025-04-29,LP,Portugal,2295,997,198,1,1298,555,545,1100,197
2025-04-30,LP,Portugal,2365,1017,176,5,1348,587,585,1172,171
2025-05-01,LP,Portugal,2317,942,184,2,1375,592,599,1191,182
2025-05-02,LP,Portugal,2281,930,188,0,1351,584,579,1163,188
2025-05-03,LP,Portugal,2517,1108,173,2,1409,613,623,1236,171
2025-05-04,LP,Portugal,2486,1070,187,1,1416,620,609,1229,186
2025-05-05,LP,Portugal,2477,1088,191,1,1389,592,606,1198,190
2025-05-06,LP,Portugal,2310,979,187,3,1331,576,568,1144,184
2025-05-07,LP,Portugal,2298,1008,172,2,1290,562,556,1118,170
2025-05-08,LP,Portugal,2446,1074,184,1,1372,593,595,1188,183
2025-05-09,LP,Portugal,2310,956,180,1,1354,590,584,1174,179
2025-05-10,LP,Portugal,2512,1106,185,0,1406,608,613,1221,185
2025-05-11,LP,Portugal,2452,1041,182,0,1411,615,614,1229,182
2025-05-12,LP,Portugal,2343,964,188,1,1379,589,602,1191,187
2025-05-13,LP,Portugal,2328,1024,189,3,1304,555,560,1115,186
2025-05-14,LP,Portugal,2321,1018,174,2,1303,572,557,1129,172
2025-05-15,LP,Portugal,2411,992,201,5,1419,613,605,1218,196
2025-05-16,LP,Portugal,2241,877,198,5,1364,582,584,1166,193
2025-05-17,LP,Portugal,2411,1007,185,4,1404,608,611,1219,181
2025-05-18,LP,Portugal,2343,959,179,2,1384,605,600,1205,177
2025-05-19,LP,Portugal,2281,910,183,2,1371,588,600,1188,181
2025-05-20,LP,Portugal,2203,920,170,3,1283,560,553,1113,167
2025-05-21,LP,Portugal,2215,907,174,1,1308,563,571,1134,173
2025-05-22,LP,Portugal,2334,921,197,2,1413,609,607,1216,195
2025-05-23,LP,Portugal,2339,917,208,1,1422,604,610,1214,207
2025-05-24,LP,Portugal,2496,1030,186,1,1466,640,640,1280,185
2025-05-25,LP,Portugal,2346,928,191,2,1418,618,609,1227,189
2025-05-26,LP,Portugal,2304,898,191,3,1406,605,610,1215,188
2025-05-27,LP,Portugal,2293,945,197,1,1348,580,571,1151,196
2025-05-28,LP,Portugal,2325,966,189,1,1359,583,587,1170,188
2025-05-29,LP,Portugal,2330,924,184,1,1406,604,618,1222,183
2025-05-30,LP,Portugal,2277,934,181,2,1343,592,570,1162,179
2025-05-31,LP,Portugal,2508,1009,197,5,1499,644,658,1302,192
2025-06-01,LP,Portugal,2397,958,212,1,1439,618,609,1227,211
2025-06-02,LP,Portugal,2389,927,219,2,1462,618,625,1243,217
2025-06-03,LP,Portugal,2352,963,211,1,1389,590,588,1178,210
2025-06-04,LP,Portugal,2327,930,214,3,1397,594,589,1183,211
2025-06-05,LP,Portugal,2406,977,208,2,1429,608,613,1221,206
2025-06-06,LP,Portugal,2456,1010,208,1,1446,623,615,1238,207
2025-06-07,LP,Portugal,2631,1107,207,1,1524,660,657,1317,206
2025-06-08,LP,Portugal,2503,1034,213,1,1469,635,621,1256,212
2025-06-09,LP,Portugal,2485,995,226,2,1490,624,640,1264,224
2025-06-10,LP,Portugal,2330,937,225,2,1393,582,586,1168,223
2025-06-11,LP,Portugal,2375,962,212,2,1413,602,599,1201,210
2025-06-12,LP,Portugal,2452,983,214,2,1469,634,621,1255,212
2025-06-13,LP,Portugal,2306,887,197,4,1419,611,611,1222,193
2025-06-14,LP,Portugal,2543,1016,214,1,1527,653,660,1313,213
2025-06-15,LP,Portugal,2496,1021,216,2,1475,629,630,1259,214
2025-06-16,LP,Portugal,2463,972,228,2,1491,631,632,1263,226
2025-06-17,LP,Portugal,2355,975,211,0,1380,586,583,1169,211
2025-06-18,LP,Portugal,2375,953,217,1,1422,603,602,1205,216
2025-06-19,LP,Portugal,2484,1010,212,3,1474,631,631,1262,209
2025-06-20,LP,Portugal,2474,1009,216,0,1465,618,631,1249,216
2025-06-21,LP,Portugal,2653,1109,234,11,1544,652,658,1310,223
2025-06-22,LP,Portugal,2528,1032,230,4,1496,636,630,1266,226
2025-06-23,LP,Portugal,2469,999,215,0,1470,624,631,1255,215
2025-06-24,LP,Portugal,2565,1146,226,0,1419,603,590,1193,226
2025-06-25,LP,Portugal,2475,1086,229,0,1389,584,576,1160,229
2025-06-26,LP,Portugal,2494,1026,221,1,1468,620,627,1247,220
2025-06-27,LP,Portugal,2462,958,219,0,1504,637,648,1285,219
2025-06-28,LP,Portugal,2667,1104,209,0,1563,681,673,1354,209
2025-06-29,LP,Portugal,2538,1031,226,2,1507,639,642,1281,224
2025-06-30,LP,Portugal,2608,1069,234,6,1539,647,658,1305,228
2025-07-01,LP,Portugal,2467,1018,211,7,1449,612,626,1238,204
2025-07-02,LP,Portugal,2602,1112,239,3,1490,635,616,1251,236
2025-07-03,LP,Portugal,2554,1141,225,2,1413,588,600,1188,223
2025-07-04,LP,Portugal,2581,1163,224,3,1418,602,592,1194,221
2025-07-05,LP,Portugal,2777,1176,220,1,1601,692,689,1381,219
2025-07-06,LP,Portugal,2595,1076,230,11,1519,648,641,1289,219
2025-07-07,LP,Portugal,2615,1054,238,3,1561,665,658,1323,235
2025-07-08,LP,Portugal,2515,1040,229,4,1475,615,631,1246,225
2025-07-09,LP,Portugal,2545,1065,220,3,1480,634,626,1260,217
2025-07-10,LP,Portugal,2605,1054,224,0,1551,662,665,1327,224
2025-07-11,LP,Portugal,2470,966,221,0,1504,645,638,1283,221
2025-07-12,LP,Portugal,2713,1132,219,1,1581,672,690,1362,218
2025-07-13,LP,Portugal,2552,1030,225,0,1522,652,645,1297,225
2025-07-14,LP,Portugal,2536,968,233,0,1568,666,669,1335,233
2025-07-15,LP,Portugal,2468,969,226,1,1499,639,634,1273,225
2025-07-16,LP,Portugal,2451,956,238,2,1495,631,626,1257,236
2025-07-17,LP,Portugal,2530,993,229,0,1537,657,651,1308,229
2025-07-18,LP,Portugal,2507,1000,231,3,1507,637,639,1276,228
2025-07-19,LP,Portugal,2690,1101,207,1,1589,690,692,1382,206
2025-07-20,LP,Portugal,2631,1087,230,0,1544,659,655,1314,230
2025-07-21,LP,Portugal,2550,972,238,2,1578,664,676,1340,236
2025-07-22,LP,Portugal,2516,1028,222,0,1488,634,632,1266,222
2025-07-23,LP,Portugal,2510,1055,215,0,1455,623,617,1240,215
2025-07-24,LP,Portugal,2646,1126,228,3,1520,644,648,1292,225
2025-07-25,LP,Portugal,2542,1061,217,6,1481,636,628,1264,211
2025-07-26,LP,Portugal,2728,1150,224,1,1578,669,685,1354,223
2025-07-27,LP,Portugal,2545,1025,217,0,1520,657,646,1303,217
2025-07-28,LP,Portugal,2588,1020,227,2,1568,668,673,1341,225
2025-07-29,LP,Portugal,2501,1018,226,2,1483,632,625,1257,224
2025-07-30,LP,Portugal,2562,1092,224,2,1470,626,620,1246,222
2025-07-31,LP,Portugal,2673,1142,228,1,1531,653,650,1303,227
2025-08-01,LP,Portugal,2664,1169,219,9,1495,635,641,1276,210
2025-08-02,LP,Portugal,2723,1165,212,0,1558,671,675,1346,212
2025-08-03,LP,Portugal,2671,1150,238,0,1521,645,638,1283,238
2025-08-04,LP,Portugal,2654,1092,232,0,1562,658,672,1330,232
2025-08-05,LP,Portugal,2569,1079,235,0,1490,627,628,1255,235
2025-08-06,LP,Portugal,2497,1031,221,2,1466,625,620,1245,219
2025-08-07,LP,Portugal,2566,1048,225,1,1518,647,646,1293,224
2025-08-08,LP,Portugal,2566,1061,235,0,1505,639,631,1270,235
2025-08-09,LP,Portugal,2714,1143,221,0,1571,672,678,1350,221
2025-08-10,LP,Portugal,2497,989,231,0,1508,642,635,1277,231
2025-08-11,LP,Portugal,2539,998,229,1,1541,650,662,1312,228
2025-08-12,LP,Portugal,2494,1033,228,1,1461,618,615,1233,227
2025-08-13,LP,Portugal,2459,1012,216,2,1447,616,615,1231,214
2025-08-14,LP,Portugal,2518,1011,238,1,1507,634,635,1269,237
2025-08-15,LP,Portugal,2385,932,200,1,1453,632,621,1253,199
2025-08-16,LP,Portugal,2599,1012,232,1,1587,675,680,1355,231
2025-08-17,LP,Portugal,2504,990,235,2,1514,642,637,1279,233
2025-08-18,LP,Portugal,2508,956,247,1,1552,648,657,1305,246
2025-08-19,LP,Portugal,2493,1018,229,2,1475,626,620,1246,227
2025-08-20,LP,Portugal,2452,1008,227,2,1444,609,608,1217,225
2025-08-21,LP,Portugal,2559,1051,225,0,1508,643,640,1283,225
2025-08-22,LP,Portugal,2457,968,230,0,1489,629,630,1259,230
2025-08-23,LP,Portugal,2653,1075,216,0,1578,676,686,1362,216
2025-08-24,LP,Portugal,2518,1023,218,0,1495,639,638,1277,218
2025-08-25,LP,Portugal,2525,974,228,1,1551,656,667,1323,227
2025-08-26,LP,Portugal,2514,1031,233,0,1483,632,618,1250,233
2025-08-27,LP,Portugal,2445,997,215,0,1448,616,617,1233,215
2025-08-28,LP,Portugal,2531,1042,220,3,1489,639,630,1269,217
2025-08-29,LP,Portugal,2424,941,224,1,1483,621,638,1259,223
2025-01-01,LR,Romania,1639,1293,10,2,346,165,171,336,8
2025-01-02,LR,Romania,1954,1460,35,5,494,228,231,459,30
2025-01-03,LR,Romania,2097,1564,35,2,533,248,250,498,33
2025-01-04,LR,Romania,2086,1603,23,5,483,232,228,460,18
2025-01-05,LR,Romania,1985,1495,24,3,490,231,235,466,21
2025-01-06,LR,Romania,2031,1508,46,8,523,236,241,477,38
2025-01-07,LR,Romania,1932,1454,40,3,478,219,219,438,37
2025-01-08,LR,Romania,1997,1500,54,8,497,218,225,443,46
2025-01-09,LR,Romania,1971,1508,55,7,463,208,200,408,48
2025-01-10,LR,Romania,2046,1527,52,5,519,231,236,467,47
2025-01-11,LR,Romania,2030,1588,30,5,442,208,204,412,25
2025-01-12,LR,Romania,2033,1559,38,6,474,209,227,436,32
2025-01-13,LR,Romania,1914,1404,56,9,510,226,228,454,47
2025-01-14,LR,Romania,1901,1445,64,8,456,199,193,392,56
2025-01-15,LR,Romania,1902,1472,72,5,430,179,179,358,67
2025-01-16,LR,Romania,1948,1496,70,4,452,194,188,382,66
2025-01-17,LR,Romania,2087,1580,67,5,507,219,221,440,62
2025-01-18,LR,Romania,1969,1537,49,12,432,194,189,383,37
2025-01-19,LR,Romania,2005,1558,38,4,447,201,208,409,34
2025-01-20,LR,Romania,1989,1491,63,3,498,219,216,435,60
2025-01-21,LR,Romania,1877,1437,62,5,440,192,186,378,57
2025-01-22,LR,Romania,2001,1572,73,4,429,176,180,356,69
2025-01-23,LR,Romania,1973,1508,78,8,465,195,192,387,70
2025-01-24,LR,Romania,1975,1481,55,4,494,221,218,439,51
2025-01-25,LR,Romania,1914,1517,25,5,397,189,183,372,20
2025-01-26,LR,Romania,1910,1454,33,1,456,203,220,423,32
2025-01-27,LR,Romania,1870,1380,58,5,490,219,213,432,53
2025-01-28,LR,Romania,1830,1401,59,8,429,185,185,370,51
2025-01-29,LR,Romania,1841,1415,64,5,426,175,187,362,59
2025-01-30,LR,Romania,1892,1436,74,11,456,195,187,382,63
2025-01-31,LR,Romania,2000,1491,74,5,509,220,215,435,69
2025-02-01,LR,Romania,1912,1485,36,7,427,199,192,391,29
2025-02-02,LR,Romania,1943,1491,40,2,452,201,211,412,38
2025-02-03,LR,Romania,1880,1377,66,6,503,216,221,437,60
2025-02-04,LR,Romania,1865,1414,67,9,451,191,193,384,58
2025-02-05,LR,Romania,1839,1384,72,3,455,192,191,383,69
2025-02-06,LR,Romania,1866,1391,80,11,475,199,196,395,69
2025-02-07,LR,Romania,1977,1462,59,6,515,228,228,456,53
2025-02-08,LR,Romania,1931,1519,33,6,412,191,188,379,27
2025-02-09,LR,Romania,1947,1500,47,8,447,198,202,400,39
2025-02-10,LR,Romania,1837,1343,62,5,494,215,217,432,57
2025-02-11,LR,Romania,1853,1397,63,6,456,193,200,393,57
2025-02-12,LR,Romania,1870,1426,68,8,444,191,185,376,60
2025-02-13,LR,Romania,1912,1449,76,8,463,193,194,387,68
2025-02-14,LR,Romania,2082,1539,71,7,543,236,236,472,64
2025-02-15,LR,Romania,1992,1557,30,5,435,208,197,405,25
2025-02-16,LR,Romania,1964,1522,29,1,442,203,210,413,28
2025-02-17,LR,Romania,1898,1418,52,4,480,213,215,428,48
2025-02-18,LR,Romania,1825,1415,42,3,410,185,183,368,39
2025-02-19,LR,Romania,1899,1435,72,6,464,190,202,392,66
2025-02-20,LR,Romania,1925,1446,69,9,479,209,201,410,60
2025-02-21,LR,Romania,1897,1366,76,8,531,228,227,455,68
2025-02-22,LR,Romania,1864,1416,37,4,448,205,206,411,33
2025-02-23,LR,Romania,1974,1502,39,5,472,215,218,433,34
2025-02-24,LR,Romania,1886,1374,64,7,512,225,223,448,57
2025-02-25,LR,Romania,1915,1440,78,17,475,204,193,397,61
2025-02-26,LR,Romania,1923,1477,67,8,446,186,193,379,59
2025-02-27,LR,Romania,1925,1482,63,4,443,186,194,380,59
2025-02-28,LR,Romania,1985,1472,72,8,513,221,220,441,64
2025-03-01,LR,Romania,1988,1546,29,1,442,208,205,413,28
2025-03-02,LR,Romania,2080,1583,45,6,497,226,226,452,39
2025-03-03,LR,Romania,2010,1483,75,13,527,223,229,452,62
2025-03-04,LR,Romania,1904,1419,76,12,485,203,206,409,64
2025-03-05,LR,Romania,1991,1501,88,12,490,200,202,402,76
2025-03-06,LR,Romania,1964,1463,82,8,501,214,205,419,74
2025-03-07,LR,Romania,1979,1429,79,12,550,238,233,471,67
2025-03-08,LR,Romania,1935,1498,44,9,437,199,194,393,35
2025-03-09,LR,Romania,1939,1470,42,6,469,208,219,427,36
2025-03-10,LR,Romania,1818,1307,78,4,511,214,219,433,74
2025-03-11,LR,Romania,1910,1440,66,6,470,205,199,404,60
2025-03-12,LR,Romania,1974,1483,88,8,491,203,200,403,80
2025-03-13,LR,Romania,1977,1496,76,8,481,203,202,405,68
2025-03-14,LR,Romania,2157,1591,91,11,566,238,237,475,80
2025-03-15,LR,Romania,2039,1585,40,5,454,205,209,414,35
2025-03-16,LR,Romania,2090,1613,40,5,477,220,217,437,35
2025-03-17,LR,Romania,1978,1463,61,1,515,225,229,454,60
2025-03-18,LR,Romania,1934,1475,59,7,459,201,199,400,52
2025-03-19,LR,Romania,2017,1526,77,15,491,203,211,414,62
2025-03-20,LR,Romania,1999,1526,73,7,473,202,198,400,66
2025-03-21,LR,Romania,2019,1462,80,10,557,236,241,477,70
2025-03-22,LR,Romania,1968,1533,34,3,435,204,197,401,31
2025-03-23,LR,Romania,2083,1618,36,3,465,213,216,429,33
2025-03-24,LR,Romania,2018,1497,75,6,521,220,226,446,69
2025-03-25,LR,Romania,1954,1471,65,7,483,208,210,418,58
2025-03-26,LR,Romania,2024,1522,78,3,502,210,214,424,75
2025-03-27,LR,Romania,2031,1539,76,6,492,211,205,416,70
2025-03-28,LR,Romania,2110,1572,71,0,538,234,233,467,71
2025-03-29,LR,Romania,2101,1650,32,5,451,213,206,419,27
2025-03-30,LR,Romania,2098,1585,41,3,513,230,242,472,38
2025-03-31,LR,Romania,2082,1524,75,7,558,244,239,483,68
2025-04-01,LR,Romania,2200,1640,84,13,560,239,237,476,71
2025-04-02,LR,Romania,2182,1609,80,8,573,251,242,493,72
2025-04-03,LR,Romania,2265,1701,91,12,564,235,238,473,79
2025-04-04,LR,Romania,2239,1637,88,8,602,258,256,514,80
2025-04-05,LR,Romania,2179,1697,35,3,482,226,221,447,32
2025-04-06,LR,Romania,2239,1699,47,5,540,246,247,493,42
2025-04-07,LR,Romania,2251,1652,89,9,599,251,259,510,80
2025-04-08,LR,Romania,2243,1697,75,14,546,237,234,471,61
2025-04-09,LR,Romania,2288,1687,91,10,601,257,253,510,81
2025-04-10,LR,Romania,2203,1643,72,6,560,239,249,488,66
2025-04-11,LR,Romania,2298,1691,80,3,607,266,261,527,77
2025-04-12,LR,Romania,2297,1775,46,10,522,240,236,476,36
2025-04-13,LR,Romania,2235,1687,44,5,548,249,255,504,39
2025-04-14,LR,Romania,2223,1619,84,5,604,260,260,520,79
2025-04-15,LR,Romania,2221,1662,69,6,559,247,243,490,63
2025-04-16,LR,Romania,2322,1683,104,11,639,269,266,535,93
2025-04-17,LR,Romania,2454,1859,75,11,595,261,259,520,64
2025-04-18,LR,Romania,2258,1688,55,3,570,256,259,515,52
2025-04-19,LR,Romania,2409,1879,38,8,530,248,244,492,30
2025-04-20,LR,Romania,2297,1792,26,6,505,239,240,479,20
2025-04-21,LR,Romania,2277,1710,54,8,567,259,254,513,46
2025-04-22,LR,Romania,2420,1878,52,5,542,242,248,490,47
2025-04-23,LR,Romania,2397,1775,94,13,622,262,266,528,81
2025-04-24,LR,Romania,2410,1812,90,8,598,257,251,508,82
2025-04-25,LR,Romania,2464,1853,90,13,611,261,260,521,77
2025-04-26,LR,Romania,2603,2067,47,6,536,245,244,489,41
2025-04-27,LR,Romania,2548,1987,50,4,561,253,258,511,46
2025-04-28,LR,Romania,2423,1812,80,16,611,265,266,531,64
2025-04-29,LR,Romania,2393,1841,77,12,552,237,238,475,65
2025-04-30,LR,Romania,2433,1834,81,12,599,259,259,518,69
2025-05-01,LR,Romania,2356,1800,65,12,556,246,245,491,53
2025-05-02,LR,Romania,2364,1805,58,8,559,252,249,501,50
2025-05-03,LR,Romania,2465,1920,38,7,545,254,253,507,31
2025-05-04,LR,Romania,2451,1894,46,4,557,249,262,511,42
2025-05-05,LR,Romania,2349,1780,67,6,569,252,250,502,61
2025-05-06,LR,Romania,2337,1793,65,7,544,239,240,479,58
2025-05-07,LR,Romania,2418,1844,74,9,574,249,251,500,65
2025-05-08,LR,Romania,2341,1769,79,4,572,250,243,493,75
2025-05-09,LR,Romania,2451,1870,82,10,581,247,252,499,72
2025-05-10,LR,Romania,2489,1993,42,9,496,230,224,454,33
2025-05-11,LR,Romania,2476,1922,55,6,554,246,253,499,49
2025-05-12,LR,Romania,2236,1665,82,14,571,247,242,489,68
2025-05-13,LR,Romania,2261,1717,86,16,544,229,229,458,70
2025-05-14,LR,Romania,2350,1771,87,16,579,243,249,492,71
2025-05-15,LR,Romania,2487,1905,84,12,582,256,242,498,72
2025-05-16,LR,Romania,2452,1878,80,5,574,245,249,494,75
2025-05-17,LR,Romania,2545,2047,33,2,498,233,232,465,31
2025-05-18,LR,Romania,2586,2038,52,12,548,247,249,496,40
2025-05-19,LR,Romania,2353,1771,79,6,582,248,255,503,73
2025-05-20,LR,Romania,2295,1727,88,19,568,238,242,480,69
2025-05-21,LR,Romania,2538,1931,95,9,607,254,258,512,86
2025-05-22,LR,Romania,2501,1909,92,10,592,254,246,500,82
2025-05-23,LR,Romania,2687,2048,104,13,639,267,268,535,91
2025-05-24,LR,Romania,2660,2125,54,11,535,241,240,481,43
2025-05-25,LR,Romania,2606,2055,45,1,551,252,254,506,44
2025-05-26,LR,Romania,2494,1898,71,5,596,262,263,525,66
2025-05-27,LR,Romania,2455,1874,89,12,581,244,248,492,77
2025-05-28,LR,Romania,2614,2023,95,9,591,245,251,496,86
2025-05-29,LR,Romania,2492,1911,80,12,581,256,245,501,68
2025-05-30,LR,Romania,2587,1983,75,9,604,265,264,529,66
2025-05-31,LR,Romania,2743,2195,51,7,548,247,250,497,44
2025-06-01,LR,Romania,2702,2119,45,3,583,266,272,538,42
2025-06-02,LR,Romania,2617,1996,71,10,621,274,276,550,61
2025-06-03,LR,Romania,2586,1973,85,12,613,267,261,528,73
2025-06-04,LR,Romania,2659,2016,104,11,643,265,274,539,93
2025-06-05,LR,Romania,2721,2075,90,13,646,285,271,556,77
2025-06-06,LR,Romania,2777,2119,79,10,658,289,290,579,69
2025-06-07,LR,Romania,2756,2195,39,5,561,263,259,522,34
2025-06-08,LR,Romania,2735,2134,43,5,601,279,279,558,38
2025-06-09,LR,Romania,2614,1996,57,8,618,272,289,561,49
2025-06-10,LR,Romania,2758,2104,69,10,654,296,289,585,59
2025-06-11,LR,Romania,2678,2037,72,7,641,280,289,569,65
2025-06-12,LR,Romania,2610,1953,80,13,657,293,284,577,67
2025-06-13,LR,Romania,2450,1752,87,11,698,300,311,611,76
2025-06-14,LR,Romania,2396,1814,52,10,582,268,262,530,42
2025-06-15,LR,Romania,2349,1750,51,8,599,274,274,548,43
2025-06-16,LR,Romania,2371,1711,82,7,660,285,293,578,75
2025-06-17,LR,Romania,2419,1767,71,5,652,292,289,581,66
2025-06-18,LR,Romania,2355,1709,76,11,646,284,286,570,65
2025-06-19,LR,Romania,2431,1749,84,11,682,299,299,598,73
2025-06-20,LR,Romania,2510,1817,81,7,693,305,307,612,74
2025-06-21,LR,Romania,2508,1899,47,6,609,286,276,562,41
2025-06-22,LR,Romania,2364,1727,48,4,637,292,297,589,44
2025-06-23,LR,Romania,2371,1684,93,16,687,297,297,594,77
2025-06-24,LR,Romania,2456,1776,77,10,680,301,302,603,67
2025-06-25,LR,Romania,2390,1742,81,10,648,284,283,567,71
2025-06-26,LR,Romania,2581,1912,73,8,669,300,296,596,65
2025-06-27,LR,Romania,2947,2235,86,8,712,316,310,626,78
2025-06-28,LR,Romania,2809,2216,46,7,593,275,272,547,39
2025-06-29,LR,Romania,2712,2094,41,4,618,286,291,577,37
2025-06-30,LR,Romania,2739,2059,75,12,680,307,298,605,63
2025-07-01,LR,Romania,2859,2184,80,19,675,294,301,595,61
2025-07-02,LR,Romania,2700,2048,84,12,652,284,284,568,72
2025-07-03,LR,Romania,2874,2182,89,13,692,307,296,603,76
2025-07-04,LR,Romania,2907,2197,82,9,710,312,316,628,73
2025-07-05,LR,Romania,2886,2313,33,4,573,273,267,540,29
2025-07-06,LR,Romania,2901,2268,45,3,633,290,298,588,42
2025-07-07,LR,Romania,2857,2158,72,8,699,313,314,627,64
2025-07-08,LR,Romania,2872,2194,55,3,678,311,312,623,52
2025-07-09,LR,Romania,2885,2197,72,5,688,303,313,616,67
2025-07-10,LR,Romania,2840,2167,62,6,673,311,300,611,56
2025-07-11,LR,Romania,3010,2330,71,3,680,302,307,609,68
2025-07-12,LR,Romania,2918,2314,36,5,604,280,288,568,31
2025-07-13,LR,Romania,2945,2312,41,2,633,295,297,592,39
2025-07-14,LR,Romania,2887,2193,83,9,694,306,305,611,74
2025-07-15,LR,Romania,3053,2361,76,8,692,303,313,616,68
2025-07-16,LR,Romania,2984,2321,68,4,663,299,296,595,64
2025-07-17,LR,Romania,3012,2341,74,8,671,301,296,597,66
2025-07-18,LR,Romania,3081,2384,82,6,697,308,307,615,76
2025-07-19,LR,Romania,3037,2462,32,5,575,272,271,543,27
2025-07-20,LR,Romania,3032,2398,41,6,634,292,301,593,35
2025-07-21,LR,Romania,2878,2191,75,9,687,308,304,612,66
2025-07-22,LR,Romania,3077,2406,70,10,671,299,302,601,60
2025-07-23,LR,Romania,2969,2287,78,9,682,299,305,604,69
2025-07-24,LR,Romania,2980,2286,78,9,694,312,304,616,69
2025-07-25,LR,Romania,3086,2381,86,9,705,307,312,619,77
2025-07-26,LR,Romania,3186,2588,41,5,598,282,275,557,36
2025-07-27,LR,Romania,2981,2366,48,6,615,285,282,567,42
2025-07-28,LR,Romania,3064,2371,71,7,693,310,312,622,64
2025-07-29,LR,Romania,3109,2406,71,6,703,315,317,632,65
2025-07-30,LR,Romania,2939,2256,69,5,683,301,313,614,64
2025-07-31,LR,Romania,2975,2271,67,7,704,321,316,637,60
2025-08-01,LR,Romania,3062,2332,78,6,730,329,323,652,72
2025-08-02,LR,Romania,3066,2447,38,2,619,291,290,581,36
2025-08-03,LR,Romania,3179,2532,42,3,647,302,303,605,39
2025-08-04,LR,Romania,3108,2388,80,4,720,321,319,640,76
2025-08-05,LR,Romania,3124,2412,69,7,712,323,320,643,62
2025-08-06,LR,Romania,3103,2429,66,3,674,304,304,608,63
2025-08-07,LR,Romania,2931,2212,85,9,719,316,318,634,76
2025-08-08,LR,Romania,3021,2324,73,6,697,309,315,624,67
2025-08-09,LR,Romania,2986,2359,37,5,627,296,294,590,32
2025-08-10,LR,Romania,2970,2306,45,5,664,310,309,619,40
2025-08-11,LR,Romania,2920,2190,87,8,730,323,320,643,79
2025-08-12,LR,Romania,2998,2294,66,6,704,318,320,638,60
2025-08-13,LR,Romania,2939,2240,85,9,699,307,307,614,76
2025-08-14,LR,Romania,2927,2240,65,9,687,312,310,622,56
2025-08-15,LR,Romania,2997,2318,53,5,679,313,313,626,48
2025-08-16,LR,Romania,3145,2538,30,3,607,291,286,577,27
2025-08-17,LR,Romania,3036,2383,46,3,653,299,308,607,43
2025-08-18,LR,Romania,2941,2245,72,8,696,312,312,624,64
2025-08-19,LR,Romania,2944,2267,62,8,677,306,309,615,54
2025-08-20,LR,Romania,3084,2397,77,8,687,304,306,610,69
2025-08-21,LR,Romania,3081,2373,73,13,708,317,318,635,60
2025-08-22,LR,Romania,3102,2392,77,7,710,320,313,633,70
2025-08-23,LR,Romania,3153,2548,37,7,605,282,286,568,30
2025-08-24,LR,Romania,3092,2438,44,5,654,306,304,610,39
2025-08-25,LR,Romania,3036,2325,80,13,711,315,316,631,67
2025-08-26,LR,Romania,3060,2382,64,6,678,304,310,614,58
2025-08-27,LR,Romania,3089,2391,68,6,698,310,320,630,62
2025-08-28,LR,Romania,3044,2343,67,9,701,311,323,634,58
2025-08-29,LR,Romania,3236,2521,68,9,715,328,319,647,59
2025-01-01,LY,Serbia & Montenegro,1893,1714,13,1,179,83,83,166,12
2025-01-02,LY,Serbia & Montenegro,2240,1962,27,0,278,127,124,251,27
2025-01-03,LY,Serbia & Montenegro,2231,1957,18,0,274,124,132,256,18
2025-01-04,LY,Serbia & Montenegro,2241,2025,20,0,216,99,97,196,20
2025-01-05,LY,Serbia & Montenegro,2406,2146,18,1,260,124,118,242,17
2025-01-06,LY,Serbia & Montenegro,2117,1850,17,0,267,125,125,250,17
2025-01-07,LY,Serbia & Montenegro,1818,1620,21,0,198,85,92,177,21
2025-01-08,LY,Serbia & Montenegro,1823,1603,23,1,220,100,97,197,22
2025-01-09,LY,Serbia & Montenegro,1811,1563,19,2,248,114,115,229,17
2025-01-10,LY,Serbia & Montenegro,2034,1753,17,0,281,134,130,264,17
2025-01-11,LY,Serbia & Montenegro,1995,1775,21,2,220,101,98,199,19
2025-01-12,LY,Serbia & Montenegro,2134,1890,18,0,244,113,113,226,18
2025-01-13,LY,Serbia & Montenegro,1873,1603,15,0,270,126,129,255,15
2025-01-14,LY,Serbia & Montenegro,1570,1368,18,0,202,91,93,184,18
2025-01-15,LY,Serbia & Montenegro,1653,1457,19,0,196,91,86,177,19
2025-01-16,LY,Serbia & Montenegro,1801,1562,19,3,239,111,109,220,16
2025-01-17,LY,Serbia & Montenegro,1904,1620,17,0,284,135,132,267,17
2025-01-18,LY,Serbia & Montenegro,1904,1696,19,0,208,92,97,189,19
2025-01-19,LY,Serbia & Montenegro,1991,1753,18,0,238,112,108,220,18
2025-01-20,LY,Serbia & Montenegro,1762,1495,19,0,267,122,126,248,19
2025-01-21,LY,Serbia & Montenegro,1508,1316,17,0,192,84,91,175,17
2025-01-22,LY,Serbia & Montenegro,1567,1346,20,0,221,102,99,201,20
2025-01-23,LY,Serbia & Montenegro,1743,1505,22,5,238,108,108,216,17
2025-01-24,LY,Serbia & Montenegro,1900,1651,14,0,249,119,116,235,14
2025-01-25,LY,Serbia & Montenegro,1875,1666,20,0,209,93,96,189,20
2025-01-26,LY,Serbia & Montenegro,2099,1862,18,1,237,111,108,219,17
2025-01-27,LY,Serbia & Montenegro,1843,1566,25,4,277,125,127,252,21
2025-01-28,LY,Serbia & Montenegro,1503,1304,23,4,199,86,90,176,19
2025-01-29,LY,Serbia & Montenegro,1683,1468,31,7,215,94,90,184,24
2025-01-30,LY,Serbia & Montenegro,1773,1530,22,4,243,108,113,221,18
2025-01-31,LY,Serbia & Montenegro,1995,1699,24,6,296,137,135,272,18
2025-02-01,LY,Serbia & Montenegro,1932,1722,19,0,210,95,96,191,19
2025-02-02,LY,Serbia & Montenegro,2093,1853,20,0,240,111,109,220,20
2025-02-03,LY,Serbia & Montenegro,1835,1570,22,5,265,122,121,243,17
2025-02-04,LY,Serbia & Montenegro,1572,1370,23,6,202,86,93,179,17
2025-02-05,LY,Serbia & Montenegro,1735,1533,27,6,202,91,84,175,21
2025-02-06,LY,Serbia & Montenegro,1748,1526,23,6,222,97,102,199,17
2025-02-07,LY,Serbia & Montenegro,1957,1689,18,0,268,128,122,250,18
2025-02-08,LY,Serbia & Montenegro,1959,1757,21,2,202,87,94,181,19
2025-02-09,LY,Serbia & Montenegro,2071,1834,20,0,237,111,106,217,20
2025-02-10,LY,Serbia & Montenegro,1884,1619,24,7,265,116,125,241,17
2025-02-11,LY,Serbia & Montenegro,1601,1415,23,4,186,79,84,163,19
2025-02-12,LY,Serbia & Montenegro,1778,1574,21,1,204,93,90,183,20
2025-02-13,LY,Serbia & Montenegro,1784,1566,16,0,218,106,96,202,16
2025-02-14,LY,Serbia & Montenegro,2103,1828,22,3,275,123,130,253,19
2025-02-15,LY,Serbia & Montenegro,2044,1813,20,0,231,105,106,211,20
2025-02-16,LY,Serbia & Montenegro,2169,1936,19,0,233,113,101,214,19
2025-02-17,LY,Serbia & Montenegro,1924,1657,17,0,267,123,127,250,17
2025-02-18,LY,Serbia & Montenegro,1715,1534,18,0,181,80,83,163,18
2025-02-19,LY,Serbia & Montenegro,1857,1650,22,0,207,92,93,185,22
2025-02-20,LY,Serbia & Montenegro,1842,1617,16,0,225,105,104,209,16
2025-02-21,LY,Serbia & Montenegro,2003,1740,17,1,263,125,121,246,16
2025-02-22,LY,Serbia & Montenegro,2012,1799,20,0,213,95,98,193,20
2025-02-23,LY,Serbia & Montenegro,2182,1949,18,0,233,109,106,215,18
2025-02-24,LY,Serbia & Montenegro,2023,1756,17,0,267,122,128,250,17
2025-02-25,LY,Serbia & Montenegro,1728,1529,18,0,199,90,91,181,18
2025-02-26,LY,Serbia & Montenegro,1878,1678,21,1,200,91,88,179,20
2025-02-27,LY,Serbia & Montenegro,1853,1630,16,0,223,104,103,207,16
2025-02-28,LY,Serbia & Montenegro,1862,1610,19,0,252,116,117,233,19
2025-03-01,LY,Serbia & Montenegro,2118,1901,19,0,217,100,98,198,19
2025-03-02,LY,Serbia & Montenegro,2263,2031,18,0,232,109,105,214,18
2025-03-03,LY,Serbia & Montenegro,1960,1703,17,0,257,117,123,240,17
2025-03-04,LY,Serbia & Montenegro,1810,1619,18,1,191,86,87,173,17
2025-03-05,LY,Serbia & Montenegro,1828,1625,25,5,203,91,87,178,20
2025-03-06,LY,Serbia & Montenegro,1925,1688,20,4,237,106,111,217,16
2025-03-07,LY,Serbia & Montenegro,2168,1895,25,6,273,127,121,248,19
2025-03-08,LY,Serbia & Montenegro,2109,1896,22,0,213,94,97,191,22
2025-03-09,LY,Serbia & Montenegro,2279,2046,20,0,233,108,105,213,20
2025-03-10,LY,Serbia & Montenegro,1650,1388,26,9,262,114,122,236,17
2025-03-11,LY,Serbia & Montenegro,1859,1644,19,0,215,98,98,196,19
2025-03-12,LY,Serbia & Montenegro,1846,1634,32,7,212,94,86,180,25
2025-03-13,LY,Serbia & Montenegro,1912,1683,19,3,229,103,107,210,16
2025-03-14,LY,Serbia & Montenegro,2108,1840,19,1,268,125,124,249,18
2025-03-15,LY,Serbia & Montenegro,2057,1844,24,4,213,91,98,189,20
2025-03-16,LY,Serbia & Montenegro,2215,1978,18,0,237,114,105,219,18
2025-03-17,LY,Serbia & Montenegro,1979,1718,17,0,261,118,126,244,17
2025-03-18,LY,Serbia & Montenegro,1744,1553,17,2,191,84,90,174,15
2025-03-19,LY,Serbia & Montenegro,1952,1725,33,10,227,100,94,194,23
2025-03-20,LY,Serbia & Montenegro,1906,1672,29,7,234,100,105,205,22
2025-03-21,LY,Serbia & Montenegro,2134,1825,32,11,309,142,135,277,21
2025-03-22,LY,Serbia & Montenegro,2143,1932,22,1,211,92,97,189,21
2025-03-23,LY,Serbia & Montenegro,2205,1954,19,0,251,122,110,232,19
2025-03-24,LY,Serbia & Montenegro,1983,1721,21,2,262,116,125,241,19
2025-03-25,LY,Serbia & Montenegro,1872,1661,21,2,211,93,97,190,19
2025-03-26,LY,Serbia & Montenegro,1901,1690,22,1,211,98,91,189,21
2025-03-27,LY,Serbia & Montenegro,1998,1768,18,1,230,104,108,212,17
2025-03-28,LY,Serbia & Montenegro,2169,1891,18,0,278,132,128,260,18
2025-03-29,LY,Serbia & Montenegro,2125,1916,21,1,209,90,98,188,20
2025-03-30,LY,Serbia & Montenegro,2636,2353,22,1,283,131,130,261,21
2025-03-31,LY,Serbia & Montenegro,2338,2035,26,5,303,137,140,277,21
2025-04-01,LY,Serbia & Montenegro,2244,1979,21,0,265,123,121,244,21
2025-04-02,LY,Serbia & Montenegro,2526,2248,24,3,278,127,127,254,21
2025-04-03,LY,Serbia & Montenegro,2346,2040,21,5,306,144,141,285,16
2025-04-04,LY,Serbia & Montenegro,2630,2296,33,8,334,154,147,301,25
2025-04-05,LY,Serbia & Montenegro,2798,2546,21,2,252,112,119,231,19
2025-04-06,LY,Serbia & Montenegro,2806,2530,24,0,276,129,123,252,24
2025-04-07,LY,Serbia & Montenegro,2528,2203,25,6,325,147,153,300,19
2025-04-08,LY,Serbia & Montenegro,2417,2163,31,7,254,112,111,223,24
2025-04-09,LY,Serbia & Montenegro,2255,1973,27,5,282,131,124,255,22
2025-04-10,LY,Serbia & Montenegro,2706,2402,21,2,304,143,140,283,19
2025-04-11,LY,Serbia & Montenegro,2854,2533,31,6,321,146,144,290,25
2025-04-12,LY,Serbia & Montenegro,2959,2696,23,0,263,116,124,240,23
2025-04-13,LY,Serbia & Montenegro,2920,2631,26,0,289,132,131,263,26
2025-04-14,LY,Serbia & Montenegro,2682,2371,23,1,311,141,147,288,22
2025-04-15,LY,Serbia & Montenegro,2589,2325,25,1,264,119,120,239,24
2025-04-16,LY,Serbia & Montenegro,2722,2453,20,0,269,126,123,249,20
2025-04-17,LY,Serbia & Montenegro,2592,2296,21,1,296,139,136,275,20
2025-04-18,LY,Serbia & Montenegro,3057,2733,23,0,324,151,150,301,23
2025-04-19,LY,Serbia & Montenegro,2945,2699,21,0,246,111,114,225,21
2025-04-20,LY,Serbia & Montenegro,2989,2696,22,0,293,137,134,271,22
2025-04-21,LY,Serbia & Montenegro,2829,2499,21,1,330,152,157,309,20
2025-04-22,LY,Serbia & Montenegro,2570,2290,29,8,280,120,131,251,21
2025-04-23,LY,Serbia & Montenegro,2729,2453,31,9,276,127,118,245,22
2025-04-24,LY,Serbia & Montenegro,2796,2485,18,0,311,149,144,293,18
2025-04-25,LY,Serbia & Montenegro,2940,2613,31,5,327,146,150,296,26
2025-04-26,LY,Serbia & Montenegro,3135,2834,24,0,301,138,139,277,24
2025-04-27,LY,Serbia & Montenegro,3137,2809,22,0,328,154,152,306,22
2025-04-28,LY,Serbia & Montenegro,2757,2405,24,2,352,161,167,328,22
2025-04-29,LY,Serbia & Montenegro,2522,2238,32,8,284,122,130,252,24
2025-04-30,LY,Serbia & Montenegro,2848,2555,36,8,293,136,121,257,28
2025-05-01,LY,Serbia & Montenegro,3000,2694,24,0,306,139,143,282,24
2025-05-02,LY,Serbia & Montenegro,3057,2732,21,0,325,148,156,304,21
2025-05-03,LY,Serbia & Montenegro,3252,2953,25,0,299,137,137,274,25
2025-05-04,LY,Serbia & Montenegro,3384,3038,28,0,346,160,158,318,28
2025-05-05,LY,Serbia & Montenegro,2844,2482,25,4,362,165,172,337,21
2025-05-06,LY,Serbia & Montenegro,2767,2486,25,2,281,127,129,256,23
2025-05-07,LY,Serbia & Montenegro,2742,2458,25,1,284,133,126,259,24
2025-05-08,LY,Serbia & Montenegro,2926,2605,24,0,321,150,147,297,24
2025-05-09,LY,Serbia & Montenegro,3012,2663,28,6,349,159,162,321,22
2025-05-10,LY,Serbia & Montenegro,3260,2964,21,0,296,136,139,275,21
2025-05-11,LY,Serbia & Montenegro,3335,2992,24,0,343,162,157,319,24
2025-05-12,LY,Serbia & Montenegro,3079,2711,26,6,368,170,172,342,20
2025-05-13,LY,Serbia & Montenegro,2797,2494,33,8,303,132,138,270,25
2025-05-14,LY,Serbia & Montenegro,2945,2638,27,6,307,143,137,280,21
2025-05-15,LY,Serbia & Montenegro,2948,2614,28,5,334,153,153,306,23
2025-05-16,LY,Serbia & Montenegro,3162,2795,26,0,367,173,168,341,26
2025-05-17,LY,Serbia & Montenegro,3399,3097,23,0,302,138,141,279,23
2025-05-18,LY,Serbia & Montenegro,3384,3035,23,0,349,163,163,326,23
2025-05-19,LY,Serbia & Montenegro,2989,2619,20,2,370,174,176,350,18
2025-05-20,LY,Serbia & Montenegro,2913,2604,30,7,309,137,142,279,23
2025-05-21,LY,Serbia & Montenegro,2878,2586,24,2,292,139,129,268,22
2025-05-22,LY,Serbia & Montenegro,2995,2650,24,3,345,164,157,321,21
2025-05-23,LY,Serbia & Montenegro,3149,2790,23,3,359,166,170,336,20
2025-05-24,LY,Serbia & Montenegro,3492,3181,26,2,311,139,146,285,24
2025-05-25,LY,Serbia & Montenegro,3436,3085,25,0,351,166,160,326,25
2025-05-26,LY,Serbia & Montenegro,3296,2921,28,5,375,173,174,347,23
2025-05-27,LY,Serbia & Montenegro,3088,2783,25,4,305,139,141,280,21
2025-05-28,LY,Serbia & Montenegro,3226,2892,28,6,334,157,149,306,22
2025-05-29,LY,Serbia & Montenegro,3280,2942,28,4,338,153,157,310,24
2025-05-30,LY,Serbia & Montenegro,3334,2947,29,4,387,179,179,358,25
2025-05-31,LY,Serbia & Montenegro,3516,3190,24,3,326,150,152,302,21
2025-06-01,LY,Serbia & Montenegro,3486,3118,25,0,368,173,170,343,25
2025-06-02,LY,Serbia & Montenegro,3265,2879,28,4,386,178,180,358,24
2025-06-03,LY,Serbia & Montenegro,3306,2961,32,4,345,151,162,313,28
2025-06-04,LY,Serbia & Montenegro,3372,3023,30,4,349,163,156,319,26
2025-06-05,LY,Serbia & Montenegro,3377,3001,26,4,376,176,174,350,22
2025-06-06,LY,Serbia & Montenegro,3720,3305,27,3,415,193,195,388,24
2025-06-07,LY,Serbia & Montenegro,3835,3472,24,1,363,166,173,339,23
2025-06-08,LY,Serbia & Montenegro,3743,3369,25,0,374,178,171,349,25
2025-06-09,LY,Serbia & Montenegro,3569,3166,23,0,403,188,192,380,23
2025-06-10,LY,Serbia & Montenegro,3433,3053,34,2,380,172,174,346,32
2025-06-11,LY,Serbia & Montenegro,3634,3252,30,5,382,181,171,352,25
2025-06-12,LY,Serbia & Montenegro,3603,3199,34,3,404,185,185,370,31
2025-06-13,LY,Serbia & Montenegro,3828,3401,36,5,427,197,194,391,31
2025-06-14,LY,Serbia & Montenegro,4040,3671,29,1,369,167,173,340,28
2025-06-15,LY,Serbia & Montenegro,3871,3471,31,0,400,188,181,369,31
2025-06-16,LY,Serbia & Montenegro,3587,3184,25,2,403,186,192,378,23
2025-06-17,LY,Serbia & Montenegro,3497,3150,33,2,347,155,159,314,31
2025-06-18,LY,Serbia & Montenegro,3615,3215,37,2,400,187,176,363,35
2025-06-19,LY,Serbia & Montenegro,3546,3141,26,3,405,190,189,379,23
2025-06-20,LY,Serbia & Montenegro,3810,3404,27,2,406,188,191,379,25
2025-06-21,LY,Serbia & Montenegro,4139,3752,28,1,387,179,180,359,27
2025-06-22,LY,Serbia & Montenegro,4031,3606,36,1,425,194,195,389,35
2025-06-23,LY,Serbia & Montenegro,3638,3207,42,5,431,192,197,389,37
2025-06-24,LY,Serbia & Montenegro,3561,3206,34,3,355,161,160,321,31
2025-06-25,LY,Serbia & Montenegro,3716,3320,39,2,396,180,177,357,37
2025-06-26,LY,Serbia & Montenegro,3604,3199,30,3,405,191,184,375,27
2025-06-27,LY,Serbia & Montenegro,3825,3385,30,0,440,203,207,410,30
2025-06-28,LY,Serbia & Montenegro,4002,3602,35,1,400,182,183,365,34
2025-06-29,LY,Serbia & Montenegro,3980,3574,36,0,406,187,183,370,36
2025-06-30,LY,Serbia & Montenegro,3715,3283,38,2,432,194,200,394,36
2025-07-01,LY,Serbia & Montenegro,3703,3301,41,0,402,178,183,361,41
2025-07-02,LY,Serbia & Montenegro,3835,3443,41,1,392,179,172,351,40
2025-07-03,LY,Serbia & Montenegro,3624,3216,30,0,408,192,186,378,30
2025-07-04,LY,Serbia & Montenegro,3847,3405,31,2,442,208,203,411,29
2025-07-05,LY,Serbia & Montenegro,4048,3645,36,1,403,181,186,367,35
2025-07-06,LY,Serbia & Montenegro,3869,3451,32,0,418,192,194,386,32
2025-07-07,LY,Serbia & Montenegro,3665,3208,36,1,457,207,214,421,35
2025-07-08,LY,Serbia & Montenegro,3624,3227,34,1,397,183,180,363,33
2025-07-09,LY,Serbia & Montenegro,3788,3369,37,0,419,192,190,382,37
2025-07-10,LY,Serbia & Montenegro,3774,3345,31,2,429,196,202,398,29
2025-07-11,LY,Serbia & Montenegro,3899,3443,35,1,456,215,206,421,34
2025-07-12,LY,Serbia & Montenegro,4161,3743,34,0,418,186,198,384,34
2025-07-13,LY,Serbia & Montenegro,3986,3558,37,0,428,200,191,391,37
2025-07-14,LY,Serbia & Montenegro,3869,3401,35,3,468,213,220,433,32
2025-07-15,LY,Serbia & Montenegro,3791,3401,33,1,390,177,180,357,32
2025-07-16,LY,Serbia & Montenegro,3869,3444,35,0,425,198,192,390,35
2025-07-17,LY,Serbia & Montenegro,3657,3229,30,2,428,195,203,398,28
2025-07-18,LY,Serbia & Montenegro,3915,3461,33,4,454,215,206,421,29
2025-07-19,LY,Serbia & Montenegro,4019,3608,34,1,411,186,191,377,33
2025-07-20,LY,Serbia & Montenegro,3818,3387,35,0,431,200,196,396,35
2025-07-21,LY,Serbia & Montenegro,3881,3437,37,3,444,200,207,407,34
2025-07-22,LY,Serbia & Montenegro,3749,3374,34,4,375,169,172,341,30
2025-07-23,LY,Serbia & Montenegro,3952,3516,44,3,436,201,191,392,41
2025-07-24,LY,Serbia & Montenegro,3706,3288,32,1,418,194,192,386,31
2025-07-25,LY,Serbia & Montenegro,3867,3405,32,2,462,217,213,430,30
2025-07-26,LY,Serbia & Montenegro,3840,3410,38,0,430,190,202,392,38
2025-07-27,LY,Serbia & Montenegro,3910,3488,41,0,422,192,189,381,41
2025-07-28,LY,Serbia & Montenegro,3557,3101,35,4,456,211,210,421,31
2025-07-29,LY,Serbia & Montenegro,3671,3290,31,0,381,171,179,350,31
2025-07-30,LY,Serbia & Montenegro,3911,3498,39,2,413,192,182,374,37
2025-07-31,LY,Serbia & Montenegro,3856,3425,31,1,431,200,200,400,30
2025-08-01,LY,Serbia & Montenegro,3931,3471,31,1,460,213,216,429,30
2025-08-02,LY,Serbia & Montenegro,4027,3607,36,0,420,190,194,384,36
2025-08-03,LY,Serbia & Montenegro,3928,3473,45,0,455,206,204,410,45
2025-08-04,LY,Serbia & Montenegro,3748,3290,31,0,458,210,217,427,31
2025-08-05,LY,Serbia & Montenegro,3711,3310,36,2,401,186,179,365,34
2025-08-06,LY,Serbia & Montenegro,3804,3381,43,2,423,192,188,380,41
2025-08-07,LY,Serbia & Montenegro,3924,3500,35,2,424,197,192,389,33
2025-08-08,LY,Serbia & Montenegro,3939,3486,34,4,453,209,210,419,30
2025-08-09,LY,Serbia & Montenegro,4175,3754,41,2,421,186,194,380,39
2025-08-10,LY,Serbia & Montenegro,4055,3616,37,1,439,201,201,402,36
2025-08-11,LY,Serbia & Montenegro,3919,3454,34,2,465,214,217,431,32
2025-08-12,LY,Serbia & Montenegro,3844,3444,33,3,400,185,182,367,30
2025-08-13,LY,Serbia & Montenegro,3922,3507,42,1,415,190,183,373,41
2025-08-14,LY,Serbia & Montenegro,3816,3392,30,1,424,196,198,394,29
2025-08-15,LY,Serbia & Montenegro,3976,3533,36,0,443,206,201,407,36
2025-08-16,LY,Serbia & Montenegro,4030,3620,35,0,410,184,191,375,35
2025-08-17,LY,Serbia & Montenegro,3996,3553,40,0,443,204,199,403,40
2025-08-18,LY,Serbia & Montenegro,3768,3322,35,4,446,202,209,411,31
2025-08-19,LY,Serbia & Montenegro,3854,3459,40,6,395,173,182,355,34
2025-08-20,LY,Serbia & Montenegro,3660,3252,42,3,408,187,179,366,39
2025-08-21,LY,Serbia & Montenegro,3561,3135,28,1,426,199,199,398,27
2025-08-22,LY,Serbia & Montenegro,3751,3294,30,1,457,216,211,427,29
2025-08-23,LY,Serbia & Montenegro,3941,3546,36,0,395,175,184,359,36
2025-08-24,LY,Serbia & Montenegro,3921,3486,42,1,435,202,191,393,41
2025-08-25,LY,Serbia & Montenegro,3661,3214,29,0,447,204,214,418,29
2025-08-26,LY,Serbia & Montenegro,3653,3279,35,3,374,168,171,339,32
2025-08-27,LY,Serbia & Montenegro,3615,3203,43,3,412,186,183,369,40
2025-08-28,LY,Serbia & Montenegro,3558,3131,26,0,427,204,197,401,26
2025-08-29,LY,Serbia & Montenegro,3552,3117,31,1,435,201,203,404,30
2025-01-01,LZ,Slovakia,1073,1039,0,0,34,17,17,34,0
2025-01-02,LZ,Slovakia,1268,1201,5,0,67,31,31,62,5
2025-01-03,LZ,Slovakia,1306,1238,5,1,68,32,31,63,4
2025-01-04,LZ,Slovakia,1259,1208,4,0,51,24,23,47,4
2025-01-05,LZ,Slovakia,1273,1228,0,0,45,21,24,45,0
2025-01-06,LZ,Slovakia,1228,1168,2,0,60,28,30,58,2
2025-01-07,LZ,Slovakia,1138,1084,0,0,54,27,27,54,0
2025-01-08,LZ,Slovakia,1155,1112,1,0,43,21,21,42,1
2025-01-09,LZ,Slovakia,1169,1108,4,0,61,28,29,57,4
2025-01-10,LZ,Slovakia,1290,1228,2,0,62,31,29,60,2
2025-01-11,LZ,Slovakia,1241,1207,3,1,34,17,14,31,2
2025-01-12,LZ,Slovakia,1254,1201,4,0,53,25,24,49,4
2025-01-13,LZ,Slovakia,1126,1069,4,2,57,27,26,53,2
2025-01-14,LZ,Slovakia,1076,1019,9,2,57,25,23,48,7
2025-01-15,LZ,Slovakia,1078,1025,2,0,53,23,28,51,2
2025-01-16,LZ,Slovakia,1221,1157,7,1,64,30,27,57,6
2025-01-17,LZ,Slovakia,1194,1136,3,1,58,24,31,55,2
2025-01-18,LZ,Slovakia,1168,1134,1,0,34,16,17,33,1
2025-01-19,LZ,Slovakia,1252,1200,3,0,52,26,23,49,3
2025-01-20,LZ,Slovakia,1072,1001,1,1,71,35,35,70,0
2025-01-21,LZ,Slovakia,1019,975,1,0,44,24,19,43,1
2025-01-22,LZ,Slovakia,1113,1065,0,0,48,25,23,48,0
2025-01-23,LZ,Slovakia,1103,1044,2,0,59,27,30,57,2
2025-01-24,LZ,Slovakia,1177,1112,5,3,65,31,29,60,2
2025-01-25,LZ,Slovakia,1176,1135,1,1,41,20,20,40,0
2025-01-26,LZ,Slovakia,1126,1070,5,1,56,24,27,51,4
2025-01-27,LZ,Slovakia,1101,1021,5,2,80,36,39,75,3
2025-01-28,LZ,Slovakia,997,945,6,2,52,24,22,46,4
2025-01-29,LZ,Slovakia,1027,952,11,4,75,33,31,64,7
2025-01-30,LZ,Slovakia,1151,1067,11,3,84,33,40,73,8
2025-01-31,LZ,Slovakia,1157,1077,9,0,80,37,34,71,9
2025-02-01,LZ,Slovakia,1134,1091,7,1,43,19,17,36,6
2025-02-02,LZ,Slovakia,1182,1125,0,0,57,29,28,57,0
2025-02-03,LZ,Slovakia,1083,1004,4,1,79,35,40,75,3
2025-02-04,LZ,Slovakia,1074,1013,7,2,61,28,26,54,5
2025-02-05,LZ,Slovakia,1026,970,10,4,56,23,23,46,6
2025-02-06,LZ,Slovakia,1072,1004,7,1,68,30,31,61,6
2025-02-07,LZ,Slovakia,1168,1100,6,1,68,32,30,62,5
2025-02-08,LZ,Slovakia,1142,1098,2,1,44,23,19,42,1
2025-02-09,LZ,Slovakia,1132,1074,6,1,58,24,28,52,5
2025-02-10,LZ,Slovakia,1044,958,11,1,86,38,37,75,10
2025-02-11,LZ,Slovakia,985,920,12,5,65,27,26,53,7
2025-02-12,LZ,Slovakia,1024,957,9,1,67,27,31,58,8
2025-02-13,LZ,Slovakia,1129,1047,7,1,82,37,38,75,6
2025-02-14,LZ,Slovakia,1157,1084,5,2,73,36,32,68,3
2025-02-15,LZ,Slovakia,1186,1138,8,1,48,21,19,40,7
2025-02-16,LZ,Slovakia,1152,1089,3,0,63,28,32,60,3
2025-02-17,LZ,Slovakia,1047,972,6,2,75,36,33,69,4
2025-02-18,LZ,Slovakia,996,931,8,1,65,27,30,57,7
2025-02-19,LZ,Slovakia,1060,1001,7,2,59,24,28,52,5
2025-02-20,LZ,Slovakia,1213,1127,12,5,86,38,36,74,7
2025-02-21,LZ,Slovakia,1094,1018,3,0,76,38,35,73,3
2025-02-22,LZ,Slovakia,1113,1071,3,1,42,21,18,39,2
2025-02-23,LZ,Slovakia,1194,1125,3,1,69,33,33,66,2
2025-02-24,LZ,Slovakia,1066,1013,3,2,53,24,26,50,1
2025-02-25,LZ,Slovakia,1031,979,6,1,52,25,21,46,5
2025-02-26,LZ,Slovakia,1043,996,4,1,47,19,24,43,3
2025-02-27,LZ,Slovakia,1126,1075,2,1,51,24,25,49,1
2025-02-28,LZ,Slovakia,1160,1080,6,1,80,39,35,74,5
2025-03-01,LZ,Slovakia,1196,1152,6,2,44,19,19,38,4
2025-03-02,LZ,Slovakia,1227,1160,7,5,67,29,31,60,2
2025-03-03,LZ,Slovakia,1193,1129,4,2,64,31,29,60,2
2025-03-04,LZ,Slovakia,1085,1034,3,0,51,23,25,48,3
2025-03-05,LZ,Slovakia,1111,1041,10,1,70,30,30,60,9
2025-03-06,LZ,Slovakia,1187,1107,6,0,80,35,39,74,6
2025-03-07,LZ,Slovakia,1156,1076,4,2,80,38,38,76,2
2025-03-08,LZ,Slovakia,1160,1111,3,3,49,24,22,46,0
2025-03-09,LZ,Slovakia,1164,1096,4,1,68,30,34,64,3
2025-03-10,LZ,Slovakia,1038,965,11,3,73,32,30,62,8
2025-03-11,LZ,Slovakia,1086,1029,11,3,57,23,23,46,8
2025-03-12,LZ,Slovakia,1113,1046,9,2,67,28,30,58,7
2025-03-13,LZ,Slovakia,1140,1079,2,0,61,29,30,59,2
2025-03-14,LZ,Slovakia,1235,1162,2,1,73,36,35,71,1
2025-03-15,LZ,Slovakia,1226,1187,0,0,39,20,19,39,0
2025-03-16,LZ,Slovakia,1208,1145,4,1,63,29,30,59,3
2025-03-17,LZ,Slovakia,1118,1050,3,1,68,34,31,65,2
2025-03-18,LZ,Slovakia,1064,1010,18,9,54,19,17,36,9
2025-03-19,LZ,Slovakia,1111,1056,12,3,55,19,24,43,9
2025-03-20,LZ,Slovakia,1198,1123,10,5,75,33,32,65,5
2025-03-21,LZ,Slovakia,1259,1175,12,1,84,36,36,72,11
2025-03-22,LZ,Slovakia,1186,1144,6,1,42,20,16,36,5
2025-03-23,LZ,Slovakia,1263,1206,4,0,57,23,30,53,4
2025-03-24,LZ,Slovakia,1175,1106,3,2,69,32,34,66,1
2025-03-25,LZ,Slovakia,1107,1048,10,2,59,26,23,49,8
2025-03-26,LZ,Slovakia,1144,1078,6,2,66,29,31,60,4
2025-03-27,LZ,Slovakia,1229,1146,7,2,83,37,39,76,5
2025-03-28,LZ,Slovakia,1249,1170,8,4,79,36,35,71,4
2025-03-29,LZ,Slovakia,1223,1186,0,0,37,21,16,37,0
2025-03-30,LZ,Slovakia,1311,1236,2,1,75,33,40,73,1
2025-03-31,LZ,Slovakia,1317,1259,8,0,58,27,23,50,8
2025-04-01,LZ,Slovakia,1324,1230,10,5,94,39,45,84,5
2025-04-02,LZ,Slovakia,1366,1286,7,3,80,38,35,73,4
2025-04-03,LZ,Slovakia,1354,1257,9,3,97,47,41,88,6
2025-04-04,LZ,Slovakia,1355,1257,15,4,98,42,41,83,11
2025-04-05,LZ,Slovakia,1400,1344,2,1,56,27,27,54,1
2025-04-06,LZ,Slovakia,1392,1330,2,0,62,27,33,60,2
2025-04-07,LZ,Slovakia,1309,1242,5,1,67,29,33,62,4
2025-04-08,LZ,Slovakia,1373,1274,15,3,99,46,38,84,12
2025-04-09,LZ,Slovakia,1319,1232,11,6,87,37,39,76,5
2025-04-10,LZ,Slovakia,1376,1292,1,0,84,40,43,83,1
2025-04-11,LZ,Slovakia,1445,1349,10,2,96,45,41,86,8
2025-04-12,LZ,Slovakia,1465,1405,2,2,60,30,28,58,0
2025-04-13,LZ,Slovakia,1417,1352,1,0,65,32,32,64,1
2025-04-14,LZ,Slovakia,1399,1326,12,6,73,29,32,61,6
2025-04-15,LZ,Slovakia,1369,1300,2,2,69,34,33,67,0
2025-04-16,LZ,Slovakia,1455,1355,9,6,100,44,47,91,3
2025-04-17,LZ,Slovakia,1564,1483,2,1,81,41,38,79,1
2025-04-18,LZ,Slovakia,1454,1389,0,0,65,31,34,65,0
2025-04-19,LZ,Slovakia,1567,1516,1,0,51,27,23,50,1
2025-04-20,LZ,Slovakia,1488,1424,4,2,64,30,30,60,2
2025-04-21,LZ,Slovakia,1394,1333,0,0,61,28,33,61,0
2025-04-22,LZ,Slovakia,1452,1365,16,9,87,34,37,71,7
2025-04-23,LZ,Slovakia,1480,1393,16,8,87,36,35,71,8
2025-04-24,LZ,Slovakia,1525,1432,15,4,93,39,39,78,11
2025-04-25,LZ,Slovakia,1571,1490,0,0,81,41,40,81,0
2025-04-26,LZ,Slovakia,1683,1622,5,1,61,28,28,56,4
2025-04-27,LZ,Slovakia,1697,1628,8,5,69,29,32,61,3
2025-04-28,LZ,Slovakia,1558,1483,10,8,75,35,30,65,2
2025-04-29,LZ,Slovakia,1525,1440,9,6,85,35,41,76,3
2025-04-30,LZ,Slovakia,1603,1511,7,4,92,44,41,85,3
2025-05-01,LZ,Slovakia,1527,1450,5,3,77,37,35,72,2
2025-05-02,LZ,Slovakia,1582,1498,6,4,84,38,40,78,2
2025-05-03,LZ,Slovakia,1829,1763,5,2,66,31,30,61,3
2025-05-04,LZ,Slovakia,1845,1758,3,0,87,41,43,84,3
2025-05-05,LZ,Slovakia,1477,1408,5,3,69,32,32,64,2
2025-05-06,LZ,Slovakia,1443,1354,12,5,89,39,38,77,7
2025-05-07,LZ,Slovakia,1481,1399,0,0,82,41,41,82,0
2025-05-08,LZ,Slovakia,1523,1452,2,1,71,37,32,69,1
2025-05-09,LZ,Slovakia,1611,1524,5,1,87,38,44,82,4
2025-05-10,LZ,Slovakia,1721,1667,2,2,54,28,24,52,0
2025-05-11,LZ,Slovakia,1699,1614,3,3,85,38,44,82,0
2025-05-12,LZ,Slovakia,1554,1462,12,6,92,41,39,80,6
2025-05-13,LZ,Slovakia,1517,1412,6,3,105,48,51,99,3
2025-05-14,LZ,Slovakia,1496,1402,18,7,94,38,38,76,11
2025-05-15,LZ,Slovakia,1623,1527,18,5,96,40,38,78,13
2025-05-16,LZ,Slovakia,1656,1569,5,2,87,43,39,82,3
2025-05-17,LZ,Slovakia,1796,1732,4,3,64,32,28,60,1
2025-05-18,LZ,Slovakia,1843,1770,0,0,73,35,38,73,0
2025-05-19,LZ,Slovakia,1524,1450,10,4,74,32,32,64,6
2025-05-20,LZ,Slovakia,1565,1457,12,4,108,48,48,96,8
2025-05-21,LZ,Slovakia,1626,1510,14,4,116,51,51,102,10
2025-05-22,LZ,Slovakia,1686,1584,10,6,102,47,45,92,4
2025-05-23,LZ,Slovakia,1715,1622,7,3,93,41,45,86,4
2025-05-24,LZ,Slovakia,1879,1817,6,3,62,28,28,56,3
2025-05-25,LZ,Slovakia,1854,1764,9,1,90,41,40,81,8
2025-05-26,LZ,Slovakia,1680,1607,5,4,73,35,33,68,1
2025-05-27,LZ,Slovakia,1705,1585,15,6,120,52,53,105,9
2025-05-28,LZ,Slovakia,1738,1649,7,0,89,41,41,82,7
2025-05-29,LZ,Slovakia,1713,1613,5,4,100,48,47,95,1
2025-05-30,LZ,Slovakia,1814,1727,7,0,87,38,42,80,7
2025-05-31,LZ,Slovakia,2081,2010,3,0,71,35,33,68,3
2025-06-01,LZ,Slovakia,2288,2181,4,2,107,47,56,103,2
2025-06-02,LZ,Slovakia,1990,1898,6,5,92,45,41,86,1
2025-06-03,LZ,Slovakia,1859,1754,7,4,105,50,48,98,3
2025-06-04,LZ,Slovakia,1893,1759,16,9,134,58,60,118,7
2025-06-05,LZ,Slovakia,1955,1821,9,5,134,62,63,125,4
2025-06-06,LZ,Slovakia,1953,1827,4,1,126,61,61,122,3
2025-06-07,LZ,Slovakia,2008,1918,2,2,90,44,44,88,0
2025-06-08,LZ,Slovakia,2050,1944,1,0,106,51,54,105,1
2025-06-09,LZ,Slovakia,1791,1659,12,10,132,58,62,120,2
2025-06-10,LZ,Slovakia,1901,1753,16,10,148,66,66,132,6
2025-06-11,LZ,Slovakia,1939,1783,19,8,156,69,68,137,11
2025-06-12,LZ,Slovakia,1846,1703,11,6,143,65,67,132,5
2025-06-13,LZ,Slovakia,1947,1810,8,7,137,62,67,129,1
2025-06-14,LZ,Slovakia,1973,1869,2,0,104,53,49,102,2
2025-06-15,LZ,Slovakia,2026,1914,3,2,112,53,56,109,1
2025-06-16,LZ,Slovakia,1840,1725,7,4,115,56,52,108,3
2025-06-17,LZ,Slovakia,1862,1717,6,4,145,71,68,139,2
2025-06-18,LZ,Slovakia,1932,1793,3,1,139,67,69,136,2
2025-06-19,LZ,Slovakia,1914,1758,7,2,156,75,74,149,5
2025-06-20,LZ,Slovakia,2066,1926,7,4,140,63,70,133,3
2025-06-21,LZ,Slovakia,2109,1984,3,2,125,66,56,122,1
2025-06-22,LZ,Slovakia,2033,1913,5,0,120,50,65,115,5
2025-06-23,LZ,Slovakia,2090,1951,16,6,139,65,58,123,10
2025-06-24,LZ,Slovakia,1947,1784,14,8,163,77,72,149,6
2025-06-25,LZ,Slovakia,1929,1763,12,6,166,76,78,154,6
2025-06-26,LZ,Slovakia,2325,2164,11,3,161,77,73,150,8
2025-06-27,LZ,Slovakia,2224,2068,7,3,156,74,75,149,4
2025-06-28,LZ,Slovakia,2218,2100,2,2,118,57,59,116,0
2025-06-29,LZ,Slovakia,2166,2051,4,3,115,55,56,111,1
2025-06-30,LZ,Slovakia,1972,1847,9,5,125,58,58,116,4
2025-07-01,LZ,Slovakia,2115,1943,13,2,172,78,81,159,11
2025-07-02,LZ,Slovakia,2076,1934,7,5,142,67,68,135,2
2025-07-03,LZ,Slovakia,2348,2191,8,4,157,74,75,149,4
2025-07-04,LZ,Slovakia,2218,2083,2,0,135,66,67,133,2
2025-07-05,LZ,Slovakia,2192,2069,1,0,123,63,59,122,1
2025-07-06,LZ,Slovakia,2266,2140,2,0,126,65,59,124,2
2025-07-07,LZ,Slovakia,2130,1993,6,6,137,64,67,131,0
2025-07-08,LZ,Slovakia,2119,1975,4,0,144,66,74,140,4
2025-07-09,LZ,Slovakia,2113,1963,4,1,150,74,72,146,3
2025-07-10,LZ,Slovakia,2064,1910,8,4,154,74,72,146,4
2025-07-11,LZ,Slovakia,2204,2060,3,0,144,70,71,141,3
2025-07-12,LZ,Slovakia,2246,2129,0,0,117,60,57,117,0
2025-07-13,LZ,Slovakia,2294,2179,3,1,115,56,56,112,2
2025-07-14,LZ,Slovakia,2083,1958,7,6,125,61,57,118,1
2025-07-15,LZ,Slovakia,2120,1970,8,6,150,69,73,142,2
2025-07-16,LZ,Slovakia,2231,2096,8,3,135,66,61,127,5
2025-07-17,LZ,Slovakia,2091,1954,4,0,137,66,67,133,4
2025-07-18,LZ,Slovakia,2258,2120,1,0,138,66,71,137,1
2025-07-19,LZ,Slovakia,2341,2226,1,0,115,58,56,114,1
2025-07-20,LZ,Slovakia,2231,2110,4,2,121,58,59,117,2
2025-07-21,LZ,Slovakia,2173,2035,12,4,138,61,65,126,8
2025-07-22,LZ,Slovakia,2229,2074,6,3,155,75,74,149,3
2025-07-23,LZ,Slovakia,2197,2050,3,3,147,71,73,144,0
2025-07-24,LZ,Slovakia,2410,2258,11,4,152,73,68,141,7
2025-07-25,LZ,Slovakia,2550,2413,3,2,137,65,69,134,1
2025-07-26,LZ,Slovakia,2647,2531,7,0,116,54,55,109,7
2025-07-27,LZ,Slovakia,2339,2220,4,0,119,57,58,115,4
2025-07-28,LZ,Slovakia,2278,2171,2,2,107,53,52,105,0
2025-07-29,LZ,Slovakia,2273,2120,8,5,153,71,74,145,3
2025-07-30,LZ,Slovakia,2224,2071,8,5,153,72,73,145,3
2025-07-31,LZ,Slovakia,2168,2016,6,3,152,75,71,146,3
2025-08-01,LZ,Slovakia,2463,2326,6,1,137,64,67,131,5
2025-08-02,LZ,Slovakia,2590,2476,4,4,114,55,55,110,0
2025-08-03,LZ,Slovakia,2436,2320,2,0,116,56,58,114,2
2025-08-04,LZ,Slovakia,2097,1983,7,6,114,55,52,107,1
2025-08-05,LZ,Slovakia,2197,2048,16,10,149,66,67,133,6
2025-08-06,LZ,Slovakia,2172,2018,8,2,154,71,75,146,6
2025-08-07,LZ,Slovakia,2123,1964,6,4,159,74,79,153,2
2025-08-08,LZ,Slovakia,2212,2065,5,2,147,72,70,142,3
2025-08-09,LZ,Slovakia,2269,2161,2,0,108,55,51,106,2
2025-08-10,LZ,Slovakia,2253,2134,1,0,119,57,61,118,1
2025-08-11,LZ,Slovakia,1993,1878,10,4,115,54,51,105,6
2025-08-12,LZ,Slovakia,2110,1959,7,1,151,70,74,144,6
2025-08-13,LZ,Slovakia,2096,1957,10,3,139,65,64,129,7
2025-08-14,LZ,Slovakia,2134,1982,5,1,152,72,75,147,4
2025-08-15,LZ,Slovakia,2240,2097,3,0,143,70,70,140,3
2025-08-16,LZ,Slovakia,2525,2414,2,1,111,57,52,109,1
2025-08-17,LZ,Slovakia,2199,2071,1,1,128,60,67,127,0
2025-08-18,LZ,Slovakia,1972,1850,10,7,122,59,53,112,3
2025-08-19,LZ,Slovakia,2088,1929,10,6,159,73,76,149,4
2025-08-20,LZ,Slovakia,2154,2007,14,11,147,65,68,133,3
2025-08-21,LZ,Slovakia,2211,2070,10,5,141,68,63,131,5
2025-08-22,LZ,Slovakia,2100,1946,5,3,154,73,76,149,2
2025-08-23,LZ,Slovakia,2247,2130,6,2,117,57,54,111,4
2025-08-24,LZ,Slovakia,2205,2087,5,1,118,56,57,113,4
2025-08-25,LZ,Slovakia,2077,1958,10,6,119,57,52,109,4
2025-08-26,LZ,Slovakia,2144,1988,11,6,156,69,76,145,5
2025-08-27,LZ,Slovakia,2115,1967,8,2,148,72,68,140,6
2025-08-28,LZ,Slovakia,2149,2003,0,0,146,76,70,146,0
2025-08-29,LZ,Slovakia,2261,2130,3,0,131,64,64,128,3
2025-01-01,LJ,Slovenia,1011,986,0,0,25,11,14,25,0
2025-01-02,LJ,Slovenia,1178,1138,0,0,40,19,21,40,0
2025-01-03,LJ,Slovenia,1240,1185,1,1,55,28,26,54,0
2025-01-04,LJ,Slovenia,1181,1133,4,3,48,20,24,44,1
2025-01-05,LJ,Slovenia,1309,1271,0,0,38,18,20,38,0
2025-01-06,LJ,Slovenia,1173,1121,0,0,52,26,26,52,0
2025-01-07,LJ,Slovenia,1024,985,1,1,39,19,19,38,0
2025-01-08,LJ,Slovenia,933,879,2,0,54,24,28,52,2
2025-01-09,LJ,Slovenia,1016,972,1,0,44,22,21,43,1
2025-01-10,LJ,Slovenia,1120,1064,0,0,56,28,28,56,0
2025-01-11,LJ,Slovenia,1027,992,0,0,35,19,16,35,0
2025-01-12,LJ,Slovenia,1191,1143,1,1,48,22,25,47,0
2025-01-13,LJ,Slovenia,970,925,0,0,45,25,20,45,0
2025-01-14,LJ,Slovenia,767,716,2,0,51,24,25,49,2
2025-01-15,LJ,Slovenia,790,735,7,6,55,22,26,48,1
2025-01-16,LJ,Slovenia,900,847,0,0,53,26,27,53,0
2025-01-17,LJ,Slovenia,1010,951,1,1,59,30,28,58,0
2025-01-18,LJ,Slovenia,975,934,4,4,41,19,18,37,0
2025-01-19,LJ,Slovenia,1006,965,3,2,41,18,20,38,1
2025-01-20,LJ,Slovenia,964,909,7,2,55,26,22,48,5
2025-01-21,LJ,Slovenia,764,718,3,1,46,22,21,43,2
2025-01-22,LJ,Slovenia,888,820,5,4,68,32,31,63,1
2025-01-23,LJ,Slovenia,993,939,1,1,54,28,25,53,0
2025-01-24,LJ,Slovenia,1105,1041,3,3,64,29,32,61,0
2025-01-25,LJ,Slovenia,987,949,1,1,38,18,19,37,0
2025-01-26,LJ,Slovenia,1093,1042,1,1,51,24,26,50,0
2025-01-27,LJ,Slovenia,998,946,1,1,52,27,24,51,0
2025-01-28,LJ,Slovenia,829,777,1,1,52,25,26,51,0
2025-01-29,LJ,Slovenia,856,792,7,4,64,28,29,57,3
2025-01-30,LJ,Slovenia,916,848,8,4,68,31,29,60,4
2025-01-31,LJ,Slovenia,1127,1056,4,1,71,35,32,67,3
2025-02-01,LJ,Slovenia,1016,990,1,1,26,12,13,25,0
2025-02-02,LJ,Slovenia,1101,1054,2,2,47,22,23,45,0
2025-02-03,LJ,Slovenia,1022,951,9,5,71,32,30,62,4
2025-02-04,LJ,Slovenia,855,787,13,1,68,27,28,55,12
2025-02-05,LJ,Slovenia,958,892,4,1,66,30,32,62,3
2025-02-06,LJ,Slovenia,979,920,4,2,59,26,29,55,2
2025-02-07,LJ,Slovenia,1137,1071,0,0,66,35,31,66,0
2025-02-08,LJ,Slovenia,1009,981,1,1,28,14,13,27,0
2025-02-09,LJ,Slovenia,1150,1104,1,1,46,20,25,45,0
2025-02-10,LJ,Slovenia,1065,1008,0,0,57,30,27,57,0
2025-02-11,LJ,Slovenia,845,802,2,2,43,21,20,41,0
2025-02-12,LJ,Slovenia,936,885,1,0,51,23,27,50,1
2025-02-13,LJ,Slovenia,932,884,0,0,48,25,23,48,0
2025-02-14,LJ,Slovenia,1156,1102,0,0,54,28,26,54,0
2025-02-15,LJ,Slovenia,1069,1030,2,2,39,19,18,37,0
2025-02-16,LJ,Slovenia,1199,1158,1,0,41,19,21,40,1
2025-02-17,LJ,Slovenia,1053,997,2,2,56,27,27,54,0
2025-02-18,LJ,Slovenia,930,875,6,2,55,24,25,49,4
2025-02-19,LJ,Slovenia,1023,962,9,3,61,25,27,52,6
2025-02-20,LJ,Slovenia,979,914,5,3,65,30,30,60,2
2025-02-21,LJ,Slovenia,1154,1098,5,3,56,26,25,51,2
2025-02-22,LJ,Slovenia,1064,1026,0,0,38,18,20,38,0
2025-02-23,LJ,Slovenia,1213,1160,0,0,53,25,28,53,0
2025-02-24,LJ,Slovenia,1087,1033,3,0,54,25,26,51,3
2025-02-25,LJ,Slovenia,961,905,4,3,56,24,28,52,1
2025-02-26,LJ,Slovenia,992,945,1,1,47,24,22,46,0
2025-02-27,LJ,Slovenia,977,929,0,0,48,26,22,48,0
2025-02-28,LJ,Slovenia,1030,983,3,3,47,23,21,44,0
2025-03-01,LJ,Slovenia,1110,1076,0,0,34,15,19,34,0
2025-03-02,LJ,Slovenia,1210,1142,3,1,68,32,33,65,2
2025-03-03,LJ,Slovenia,1080,1013,9,4,67,29,29,58,5
2025-03-04,LJ,Slovenia,1009,952,11,7,57,23,23,46,4
2025-03-05,LJ,Slovenia,1001,924,10,5,77,30,37,67,5
2025-03-06,LJ,Slovenia,1069,984,12,5,85,38,35,73,7
2025-03-07,LJ,Slovenia,1258,1167,11,6,91,40,40,80,5
2025-03-08,LJ,Slovenia,1126,1080,4,3,46,21,21,42,1
2025-03-09,LJ,Slovenia,1212,1151,5,1,61,27,29,56,4
2025-03-10,LJ,Slovenia,897,842,3,2,55,27,25,52,1
2025-03-11,LJ,Slovenia,997,949,6,4,48,21,21,42,2
2025-03-12,LJ,Slovenia,1044,987,2,2,57,27,28,55,0
2025-03-13,LJ,Slovenia,1013,961,4,2,52,25,23,48,2
2025-03-14,LJ,Slovenia,1196,1140,0,0,56,30,26,56,0
2025-03-15,LJ,Slovenia,1094,1050,1,1,44,22,21,43,0
2025-03-16,LJ,Slovenia,1183,1140,0,0,43,21,22,43,0
2025-03-17,LJ,Slovenia,1116,1059,1,0,57,28,28,56,1
2025-03-18,LJ,Slovenia,945,886,12,4,59,22,25,47,8
2025-03-19,LJ,Slovenia,1006,928,7,5,78,35,36,71,2
2025-03-20,LJ,Slovenia,1038,961,8,4,77,36,33,69,4
2025-03-21,LJ,Slovenia,1218,1140,2,2,78,41,35,76,0
2025-03-22,LJ,Slovenia,1166,1126,0,0,40,19,21,40,0
2025-03-23,LJ,Slovenia,1218,1162,0,0,56,27,29,56,0
2025-03-24,LJ,Slovenia,1150,1092,4,3,58,29,25,54,1
2025-03-25,LJ,Slovenia,1042,983,3,3,59,26,30,56,0
2025-03-26,LJ,Slovenia,1015,953,3,3,62,30,29,59,0
2025-03-27,LJ,Slovenia,1015,961,3,1,54,26,25,51,2
2025-03-28,LJ,Slovenia,1160,1099,0,0,61,31,30,61,0
2025-03-29,LJ,Slovenia,1045,1016,0,0,29,15,14,29,0
2025-03-30,LJ,Slovenia,1440,1369,4,4,71,34,33,67,0
2025-03-31,LJ,Slovenia,1254,1185,7,5,69,31,31,62,2
2025-04-01,LJ,Slovenia,1314,1253,0,0,61,30,31,61,0
2025-04-02,LJ,Slovenia,1384,1318,2,0,66,34,30,64,2
2025-04-03,LJ,Slovenia,1418,1332,10,4,86,38,38,76,6
2025-04-04,LJ,Slovenia,1466,1378,6,4,88,39,43,82,2
2025-04-05,LJ,Slovenia,1605,1556,1,0,49,23,25,48,1
2025-04-06,LJ,Slovenia,1544,1492,0,0,52,27,25,52,0
2025-04-07,LJ,Slovenia,1386,1315,7,1,71,33,31,64,6
2025-04-08,LJ,Slovenia,1355,1289,5,1,66,30,31,61,4
2025-04-09,LJ,Slovenia,1288,1211,6,1,77,35,36,71,5
2025-04-10,LJ,Slovenia,1475,1407,2,2,68,33,33,66,0
2025-04-11,LJ,Slovenia,1662,1572,10,5,90,40,40,80,5
2025-04-12,LJ,Slovenia,1646,1597,2,2,49,23,24,47,0
2025-04-13,LJ,Slovenia,1694,1626,3,2,68,32,33,65,1
2025-04-14,LJ,Slovenia,1483,1419,1,1,64,32,31,63,0
2025-04-15,LJ,Slovenia,1494,1429,0,0,65,30,35,65,0
2025-04-16,LJ,Slovenia,1589,1502,8,2,87,42,37,79,6
2025-04-17,LJ,Slovenia,1445,1371,2,2,74,36,36,72,0
2025-04-18,LJ,Slovenia,1708,1636,2,0,72,35,35,70,2
2025-04-19,LJ,Slovenia,1674,1613,2,0,61,28,31,59,2
2025-04-20,LJ,Slovenia,1658,1598,0,0,60,29,31,60,0
2025-04-21,LJ,Slovenia,1548,1482,3,1,66,34,29,63,2
2025-04-22,LJ,Slovenia,1540,1461,2,0,79,35,42,77,2
2025-04-23,LJ,Slovenia,1543,1459,3,1,84,41,40,81,2
2025-04-24,LJ,Slovenia,1670,1599,1,0,71,36,34,70,1
2025-04-25,LJ,Slovenia,1559,1485,0,0,74,37,37,74,0
2025-04-26,LJ,Slovenia,1673,1624,0,0,49,25,24,49,0
2025-04-27,LJ,Slovenia,1808,1734,8,3,74,33,33,66,5
2025-04-28,LJ,Slovenia,1542,1466,5,4,76,35,36,71,1
2025-04-29,LJ,Slovenia,1557,1470,5,1,87,42,40,82,4
2025-04-30,LJ,Slovenia,1578,1502,1,1,76,34,41,75,0
2025-05-01,LJ,Slovenia,1771,1688,0,0,83,40,43,83,0
2025-05-02,LJ,Slovenia,1721,1649,0,0,72,37,35,72,0
2025-05-03,LJ,Slovenia,1874,1810,0,0,64,33,31,64,0
2025-05-04,LJ,Slovenia,1925,1850,0,0,75,38,37,75,0
2025-05-05,LJ,Slovenia,1616,1544,0,0,72,38,34,72,0
2025-05-06,LJ,Slovenia,1671,1601,0,0,70,35,35,70,0
2025-05-07,LJ,Slovenia,1716,1637,1,0,79,39,39,78,1
2025-05-08,LJ,Slovenia,1775,1688,3,1,87,41,43,84,2
2025-05-09,LJ,Slovenia,1721,1636,0,0,85,44,41,85,0
2025-05-10,LJ,Slovenia,1865,1807,4,1,58,27,27,54,3
2025-05-11,LJ,Slovenia,1859,1788,0,0,71,33,38,71,0
2025-05-12,LJ,Slovenia,1717,1642,4,2,75,36,35,71,2
2025-05-13,LJ,Slovenia,1695,1616,11,4,79,34,34,68,7
2025-05-14,LJ,Slovenia,1758,1662,5,2,96,46,45,91,3
2025-05-15,LJ,Slovenia,1815,1728,4,3,87,39,44,83,1
2025-05-16,LJ,Slovenia,1833,1708,5,4,125,65,55,120,1
2025-05-17,LJ,Slovenia,1957,1897,1,1,60,27,32,59,0
2025-05-18,LJ,Slovenia,1923,1853,0,0,70,33,37,70,0
2025-05-19,LJ,Slovenia,1765,1682,9,2,83,38,36,74,7
2025-05-20,LJ,Slovenia,1761,1672,8,3,89,42,39,81,5
2025-05-21,LJ,Slovenia,1669,1601,1,0,68,32,35,67,1
2025-05-22,LJ,Slovenia,1924,1837,3,3,87,41,43,84,0
2025-05-23,LJ,Slovenia,1802,1727,3,1,75,35,37,72,2
2025-05-24,LJ,Slovenia,1998,1929,5,3,69,31,33,64,2
2025-05-25,LJ,Slovenia,1939,1871,8,1,68,31,29,60,7
2025-05-26,LJ,Slovenia,1882,1792,6,3,90,41,43,84,3
2025-05-27,LJ,Slovenia,1897,1806,7,1,91,44,40,84,6
2025-05-28,LJ,Slovenia,1853,1762,8,0,91,39,44,83,8
2025-05-29,LJ,Slovenia,1957,1860,12,6,97,40,45,85,6
2025-05-30,LJ,Slovenia,1910,1800,9,1,110,48,53,101,8
2025-05-31,LJ,Slovenia,2060,1987,0,0,73,39,34,73,0
2025-06-01,LJ,Slovenia,1975,1901,0,0,74,37,37,74,0
2025-06-02,LJ,Slovenia,1910,1831,2,1,79,38,39,77,1
2025-06-03,LJ,Slovenia,1941,1839,13,4,102,44,45,89,9
2025-06-04,LJ,Slovenia,1929,1824,8,3,105,47,50,97,5
2025-06-05,LJ,Slovenia,2003,1888,9,2,115,50,56,106,7
2025-06-06,LJ,Slovenia,2039,1930,13,5,109,45,51,96,8
2025-06-07,LJ,Slovenia,2177,2105,6,4,72,32,34,66,2
2025-06-08,LJ,Slovenia,2015,1923,4,1,92,45,43,88,3
2025-06-09,LJ,Slovenia,2036,1943,5,4,93,46,42,88,1
2025-06-10,LJ,Slovenia,1925,1814,5,2,111,55,51,106,3
2025-06-11,LJ,Slovenia,2016,1923,2,2,93,47,44,91,0
2025-06-12,LJ,Slovenia,2070,1973,7,2,97,42,48,90,5
2025-06-13,LJ,Slovenia,2126,2005,6,0,121,50,65,115,6
2025-06-14,LJ,Slovenia,2293,2213,6,0,80,36,38,74,6
2025-06-15,LJ,Slovenia,2048,1962,0,0,86,49,37,86,0
2025-06-16,LJ,Slovenia,2050,1971,4,4,79,38,37,75,0
2025-06-17,LJ,Slovenia,1990,1896,4,3,94,46,44,90,1
2025-06-18,LJ,Slovenia,2035,1952,8,4,83,38,37,75,4
2025-06-19,LJ,Slovenia,2097,1998,5,3,99,44,50,94,2
2025-06-20,LJ,Slovenia,2097,1994,9,5,103,47,47,94,4
2025-06-21,LJ,Slovenia,2312,2237,3,2,75,39,33,72,1
2025-06-22,LJ,Slovenia,2292,2207,1,0,85,41,43,84,1
2025-06-23,LJ,Slovenia,2096,2005,5,5,91,43,43,86,0
2025-06-24,LJ,Slovenia,2001,1905,6,4,96,48,42,90,2
2025-06-25,LJ,Slovenia,2064,1972,2,2,92,45,45,90,0
2025-06-26,LJ,Slovenia,1932,1838,3,1,94,45,46,91,2
2025-06-27,LJ,Slovenia,2014,1927,0,0,87,44,43,87,0
2025-06-28,LJ,Slovenia,2184,2113,5,3,71,30,36,66,2
2025-06-29,LJ,Slovenia,2129,2048,1,1,81,39,41,80,0
2025-06-30,LJ,Slovenia,2125,2036,3,3,89,44,42,86,0
2025-07-01,LJ,Slovenia,2003,1911,5,4,92,45,42,87,1
2025-07-02,LJ,Slovenia,2045,1958,4,3,87,40,43,83,1
2025-07-03,LJ,Slovenia,1996,1900,7,5,96,47,42,89,2
2025-07-04,LJ,Slovenia,1973,1892,5,4,81,36,40,76,1
2025-07-05,LJ,Slovenia,2230,2140,1,0,90,46,43,89,1
2025-07-06,LJ,Slovenia,2132,2062,0,0,70,35,35,70,0
2025-07-07,LJ,Slovenia,2027,1956,0,0,71,34,37,71,0
2025-07-08,LJ,Slovenia,2017,1928,2,2,89,44,43,87,0
2025-07-09,LJ,Slovenia,2036,1946,2,0,90,45,43,88,2
2025-07-10,LJ,Slovenia,2142,2047,6,3,95,45,44,89,3
2025-07-11,LJ,Slovenia,2113,2029,3,1,84,42,39,81,2
2025-07-12,LJ,Slovenia,2247,2175,1,1,72,34,37,71,0
2025-07-13,LJ,Slovenia,2214,2150,0,0,64,28,36,64,0
2025-07-14,LJ,Slovenia,2072,1985,5,1,87,45,37,82,4
2025-07-15,LJ,Slovenia,2115,2017,4,2,98,46,48,94,2
2025-07-16,LJ,Slovenia,2140,2062,0,0,78,40,38,78,0
2025-07-17,LJ,Slovenia,2089,1999,8,2,90,41,41,82,6
2025-07-18,LJ,Slovenia,2162,2070,4,2,92,46,42,88,2
2025-07-19,LJ,Slovenia,2126,2047,1,1,79,36,42,78,0
2025-07-20,LJ,Slovenia,2206,2127,0,0,79,43,36,79,0
2025-07-21,LJ,Slovenia,2019,1932,5,3,87,41,41,82,2
2025-07-22,LJ,Slovenia,2181,2095,2,2,86,39,45,84,0
2025-07-23,LJ,Slovenia,2153,2055,7,4,98,47,44,91,3
2025-07-24,LJ,Slovenia,1901,1826,1,0,75,36,38,74,1
2025-07-25,LJ,Slovenia,1987,1907,0,0,80,42,38,80,0
2025-07-26,LJ,Slovenia,1899,1823,1,1,76,38,37,75,0
2025-07-27,LJ,Slovenia,2006,1941,0,0,65,34,31,65,0
2025-07-28,LJ,Slovenia,1877,1799,6,2,78,37,35,72,4
2025-07-29,LJ,Slovenia,1998,1904,4,0,94,44,46,90,4
2025-07-30,LJ,Slovenia,2106,1993,3,0,113,53,57,110,3
2025-07-31,LJ,Slovenia,2109,2032,0,0,77,39,38,77,0
2025-08-01,LJ,Slovenia,1913,1838,1,1,75,37,37,74,0
2025-08-02,LJ,Slovenia,2009,1938,1,1,71,36,34,70,0
2025-08-03,LJ,Slovenia,1934,1860,1,1,74,34,39,73,0
2025-08-04,LJ,Slovenia,2089,2006,4,1,83,39,40,79,3
2025-08-05,LJ,Slovenia,2115,2032,1,0,83,42,40,82,1
2025-08-06,LJ,Slovenia,2161,2074,1,0,87,45,41,86,1
2025-08-07,LJ,Slovenia,2228,2138,4,1,90,43,43,86,3
2025-08-08,LJ,Slovenia,2171,2079,1,1,92,47,44,91,0
2025-08-09,LJ,Slovenia,2259,2177,0,0,82,37,45,82,0
2025-08-10,LJ,Slovenia,2084,2010,1,1,74,38,35,73,0
2025-08-11,LJ,Slovenia,2078,1999,1,1,79,41,37,78,0
2025-08-12,LJ,Slovenia,2147,2052,5,3,95,45,45,90,2
2025-08-13,LJ,Slovenia,2171,2055,6,1,116,55,55,110,5
2025-08-14,LJ,Slovenia,2064,1986,4,1,78,37,37,74,3
2025-08-15,LJ,Slovenia,2143,2078,0,0,65,34,31,65,0
2025-08-16,LJ,Slovenia,2154,2069,1,1,85,37,47,84,0
2025-08-17,LJ,Slovenia,2079,2009,0,0,70,34,36,70,0
2025-08-18,LJ,Slovenia,2131,2044,4,2,87,44,39,83,2
2025-08-19,LJ,Slovenia,2160,2075,4,1,85,40,41,81,3
2025-08-20,LJ,Slovenia,2093,2000,4,3,93,44,45,89,1
2025-08-21,LJ,Slovenia,2023,1947,3,1,76,38,35,73,2
2025-08-22,LJ,Slovenia,2153,2059,5,3,94,46,43,89,2
2025-08-23,LJ,Slovenia,2277,2196,1,1,81,40,40,80,0
2025-08-24,LJ,Slovenia,2226,2143,1,1,83,38,44,82,0
2025-08-25,LJ,Slovenia,2177,2084,15,3,93,40,38,78,12
2025-08-26,LJ,Slovenia,2112,2022,10,3,90,40,40,80,7
2025-08-27,LJ,Slovenia,2168,2063,14,8,105,44,47,91,6
2025-08-28,LJ,Slovenia,2149,2059,8,8,90,45,37,82,0
2025-08-29,LJ,Slovenia,1905,1826,4,4,79,38,37,75,0
2025-01-01,LE,Spain,4911,1026,937,0,3885,1479,1469,2948,937
2025-01-02,LE,Spain,5717,1095,1228,11,4622,1696,1698,3394,1217
2025-01-03,LE,Spain,5824,1121,1263,12,4703,1742,1698,3440,1251
2025-01-04,LE,Spain,5887,1224,1078,5,4663,1791,1794,3585,1073
2025-01-05,LE,Spain,5759,1180,1074,9,4579,1762,1743,3505,1065
2025-01-06,LE,Spain,5579,1211,1115,4,4368,1637,1616,3253,1111
2025-01-07,LE,Spain,4975,955,1097,24,4020,1457,1466,2923,1073
2025-01-08,LE,Spain,4214,818,1014,29,3396,1198,1184,2382,985
2025-01-09,LE,Spain,4448,876,1067,31,3572,1254,1251,2505,1036
2025-01-10,LE,Spain,5090,1016,1175,25,4074,1438,1461,2899,1150
2025-01-11,LE,Spain,4985,1026,935,9,3959,1509,1515,3024,926
2025-01-12,LE,Spain,5156,998,1124,10,4158,1531,1503,3034,1114
2025-01-13,LE,Spain,4762,916,1139,30,3846,1359,1348,2707,1109
2025-01-14,LE,Spain,3871,659,1018,46,3212,1097,1097,2194,972
2025-01-15,LE,Spain,3925,673,1080,49,3252,1081,1091,2172,1031
2025-01-16,LE,Spain,4271,768,1119,46,3503,1183,1201,2384,1073
2025-01-17,LE,Spain,5118,954,1255,29,4164,1458,1451,2909,1226
2025-01-18,LE,Spain,4926,966,1004,21,3960,1476,1480,2956,983
2025-01-19,LE,Spain,5145,971,1165,15,4174,1497,1512,3009,1150
2025-01-20,LE,Spain,4859,957,1143,22,3902,1376,1383,2759,1121
2025-01-21,LE,Spain,3921,688,1012,45,3233,1117,1104,2221,967
2025-01-22,LE,Spain,4039,727,1064,41,3312,1123,1125,2248,1023
2025-01-23,LE,Spain,4401,810,1098,32,3591,1251,1242,2493,1066
2025-01-24,LE,Spain,5022,912,1245,28,4110,1429,1436,2865,1217
2025-01-25,LE,Spain,4962,999,979,12,3963,1491,1493,2984,967
2025-01-26,LE,Spain,5132,997,1101,23,4135,1522,1512,3034,1078
2025-01-27,LE,Spain,4792,968,1090,18,3824,1370,1364,2734,1072
2025-01-28,LE,Spain,3920,714,1004,38,3206,1104,1098,2202,966
2025-01-29,LE,Spain,3942,710,1007,30,3232,1106,1119,2225,977
2025-01-30,LE,Spain,4427,773,1145,59,3654,1245,1264,2509,1086
2025-01-31,LE,Spain,5290,980,1295,35,4310,1498,1517,3015,1260
2025-02-01,LE,Spain,5274,1042,1041,11,4232,1602,1589,3191,1030
2025-02-02,LE,Spain,5420,1025,1208,25,4395,1597,1590,3187,1183
2025-02-03,LE,Spain,5153,1038,1197,31,4115,1460,1458,2918,1166
2025-02-04,LE,Spain,4389,760,1097,38,3629,1274,1258,2532,1059
2025-02-05,LE,Spain,4415,783,1145,46,3632,1237,1250,2487,1099
2025-02-06,LE,Spain,4964,852,1245,39,4112,1427,1440,2867,1206
2025-02-07,LE,Spain,5469,1033,1270,26,4436,1576,1590,3166,1244
2025-02-08,LE,Spain,5508,1101,1088,26,4407,1662,1657,3319,1062
2025-02-09,LE,Spain,5535,1049,1215,15,4486,1634,1637,3271,1200
2025-02-10,LE,Spain,5314,1062,1216,18,4252,1523,1513,3036,1198
2025-02-11,LE,Spain,4671,915,1102,33,3756,1335,1319,2654,1069
2025-02-12,LE,Spain,4731,951,1106,29,3780,1321,1353,2674,1077
2025-02-13,LE,Spain,5077,929,1242,47,4148,1452,1454,2906,1195
2025-02-14,LE,Spain,5775,1107,1348,30,4668,1659,1661,3320,1318
2025-02-15,LE,Spain,5772,1218,1101,17,4554,1720,1733,3453,1084
2025-02-16,LE,Spain,5762,1107,1226,17,4655,1716,1713,3429,1209
2025-02-17,LE,Spain,5504,1104,1237,40,4400,1592,1571,3163,1197
2025-02-18,LE,Spain,5121,1010,1132,47,4111,1489,1490,2979,1085
2025-02-19,LE,Spain,5160,1035,1149,53,4125,1489,1487,2976,1096
2025-02-20,LE,Spain,5549,1090,1247,42,4459,1606,1606,3212,1205
2025-02-21,LE,Spain,5804,1124,1324,21,4680,1679,1677,3356,1303
2025-02-22,LE,Spain,5816,1209,1109,7,4607,1757,1741,3498,1102
2025-02-23,LE,Spain,5912,1188,1245,15,4724,1748,1731,3479,1230
2025-02-24,LE,Spain,5592,1152,1269,35,4440,1585,1586,3171,1234
2025-02-25,LE,Spain,4875,958,1128,48,3917,1390,1399,2789,1080
2025-02-26,LE,Spain,4955,965,1194,51,3990,1401,1395,2796,1143
2025-02-27,LE,Spain,5359,1024,1242,40,4335,1535,1558,3093,1202
2025-02-28,LE,Spain,5732,1030,1349,24,4702,1674,1679,3353,1325
2025-03-01,LE,Spain,5934,1166,1189,18,4768,1788,1791,3579,1171
2025-03-02,LE,Spain,5873,1089,1248,11,4784,1749,1787,3536,1237
2025-03-03,LE,Spain,5582,1051,1275,22,4531,1643,1613,3256,1253
2025-03-04,LE,Spain,5153,866,1225,34,4287,1538,1524,3062,1191
2025-03-05,LE,Spain,5168,930,1189,36,4238,1531,1518,3049,1153
2025-03-06,LE,Spain,5513,989,1247,46,4524,1643,1634,3277,1201
2025-03-07,LE,Spain,5724,1029,1308,28,4695,1683,1704,3387,1280
2025-03-08,LE,Spain,5822,1167,1110,11,4655,1775,1770,3545,1099
2025-03-09,LE,Spain,5811,1093,1224,7,4718,1750,1744,3494,1217
2025-03-10,LE,Spain,5331,977,1264,32,4354,1546,1544,3090,1232
2025-03-11,LE,Spain,5102,923,1136,42,4179,1525,1518,3043,1094
2025-03-12,LE,Spain,5098,895,1170,39,4203,1510,1523,3033,1131
2025-03-13,LE,Spain,5426,920,1214,29,4506,1651,1641,3292,1185
2025-03-14,LE,Spain,5721,988,1347,37,4733,1688,1698,3386,1310
2025-03-15,LE,Spain,5819,1117,1163,19,4702,1754,1785,3539,1144
2025-03-16,LE,Spain,5865,1063,1267,21,4802,1777,1758,3535,1246
2025-03-17,LE,Spain,5528,1013,1250,26,4515,1639,1626,3265,1224
2025-03-18,LE,Spain,5118,877,1190,49,4241,1537,1514,3051,1141
2025-03-19,LE,Spain,5054,856,1186,49,4198,1497,1515,3012,1137
2025-03-20,LE,Spain,5519,955,1243,40,4564,1637,1684,3321,1203
2025-03-21,LE,Spain,5710,1001,1317,22,4709,1686,1706,3392,1295
2025-03-22,LE,Spain,5844,1141,1141,24,4703,1780,1782,3562,1117
2025-03-23,LE,Spain,5932,1077,1279,13,4855,1803,1773,3576,1266
2025-03-24,LE,Spain,5572,996,1306,36,4576,1645,1625,3270,1270
2025-03-25,LE,Spain,5173,876,1214,56,4297,1539,1544,3083,1158
2025-03-26,LE,Spain,5198,882,1246,62,4316,1534,1536,3070,1184
2025-03-27,LE,Spain,5581,991,1269,39,4590,1648,1673,3321,1230
2025-03-28,LE,Spain,5888,1061,1388,50,4827,1712,1727,3439,1338
2025-03-29,LE,Spain,5927,1145,1155,16,4782,1807,1820,3627,1139
2025-03-30,LE,Spain,6336,1111,1276,16,5225,1977,1972,3949,1260
2025-03-31,LE,Spain,6182,1140,1359,39,5042,1854,1829,3683,1320
2025-04-01,LE,Spain,6192,1150,1322,56,5042,1854,1866,3720,1266
2025-04-02,LE,Spain,6161,1163,1300,50,4998,1843,1855,3698,1250
2025-04-03,LE,Spain,6382,1226,1244,47,5156,1953,1959,3912,1197
2025-04-04,LE,Spain,6550,1190,1351,27,5360,1999,2010,4009,1324
2025-04-05,LE,Spain,6719,1299,1205,23,5420,2112,2103,4215,1182
2025-04-06,LE,Spain,6713,1225,1292,29,5488,2107,2089,4196,1263
2025-04-07,LE,Spain,6491,1246,1347,44,5245,1953,1945,3898,1303
2025-04-08,LE,Spain,6294,1160,1301,52,5134,1914,1919,3833,1249
2025-04-09,LE,Spain,6308,1168,1331,55,5140,1890,1919,3809,1276
2025-04-10,LE,Spain,6622,1213,1355,42,5409,2031,2023,4054,1313
2025-04-11,LE,Spain,6790,1190,1400,22,5600,2091,2109,4200,1378
2025-04-12,LE,Spain,6946,1274,1223,18,5672,2223,2226,4449,1205
2025-04-13,LE,Spain,6754,1241,1240,13,5513,2147,2126,4273,1227
2025-04-14,LE,Spain,6544,1258,1287,25,5286,1997,2002,3999,1262
2025-04-15,LE,Spain,6456,1253,1239,27,5203,1980,1984,3964,1212
2025-04-16,LE,Spain,6699,1283,1348,31,5416,2003,2065,4068,1317
2025-04-17,LE,Spain,6865,1284,1299,23,5581,2141,2141,4282,1276
2025-04-18,LE,Spain,6625,1288,1182,19,5337,2076,2079,4155,1163
2025-04-19,LE,Spain,6875,1269,1180,15,5606,2212,2214,4426,1165
2025-04-20,LE,Spain,6816,1224,1315,6,5592,2143,2134,4277,1309
2025-04-21,LE,Spain,6880,1282,1373,16,5598,2137,2088,4225,1357
2025-04-22,LE,Spain,6626,1223,1327,41,5403,2049,2027,4076,1286
2025-04-23,LE,Spain,6610,1266,1354,42,5344,1985,2005,3990,1312
2025-04-24,LE,Spain,6754,1239,1396,44,5515,2051,2068,4119,1352
2025-04-25,LE,Spain,6857,1229,1428,34,5628,2088,2112,4200,1394
2025-04-26,LE,Spain,6982,1341,1238,11,5641,2205,2198,4403,1227
2025-04-27,LE,Spain,6921,1246,1313,15,5675,2209,2153,4362,1298
2025-04-28,LE,Spain,5805,902,1192,23,4903,1839,1872,3711,1169
2025-04-29,LE,Spain,6486,1193,1313,30,5293,2015,1965,3980,1283
2025-04-30,LE,Spain,6608,1220,1325,36,5388,2026,2037,4063,1289
2025-05-01,LE,Spain,6645,1230,1208,21,5415,2070,2137,4207,1187
2025-05-02,LE,Spain,6653,1220,1268,14,5433,2088,2077,4165,1254
2025-05-03,LE,Spain,6942,1271,1182,13,5671,2237,2252,4489,1169
2025-05-04,LE,Spain,6974,1243,1293,9,5731,2246,2192,4438,1284
2025-05-05,LE,Spain,6706,1265,1309,21,5441,2079,2053,4132,1288
2025-05-06,LE,Spain,6598,1218,1286,31,5380,2044,2050,4094,1255
2025-05-07,LE,Spain,6662,1227,1338,37,5435,2035,2062,4097,1301
2025-05-08,LE,Spain,6817,1244,1357,32,5573,2108,2108,4216,1325
2025-05-09,LE,Spain,6817,1191,1397,15,5626,2100,2129,4229,1382
2025-05-10,LE,Spain,6991,1315,1204,8,5676,2224,2248,4472,1196
2025-05-11,LE,Spain,6972,1275,1278,11,5697,2229,2190,4419,1267
2025-05-12,LE,Spain,6777,1259,1347,34,5518,2100,2071,4171,1313
2025-05-13,LE,Spain,6606,1200,1309,35,5406,2044,2053,4097,1274
2025-05-14,LE,Spain,6622,1235,1306,39,5387,2038,2043,4081,1267
2025-05-15,LE,Spain,6831,1232,1354,37,5599,2108,2137,4245,1317
2025-05-16,LE,Spain,6840,1193,1408,41,5647,2111,2128,4239,1367
2025-05-17,LE,Spain,7030,1251,1259,18,5779,2257,2263,4520,1241
2025-05-18,LE,Spain,6983,1220,1331,10,5763,2232,2200,4432,1321
2025-05-19,LE,Spain,6723,1216,1351,35,5507,2088,2068,4156,1316
2025-05-20,LE,Spain,6648,1123,1341,47,5525,2092,2092,4184,1294
2025-05-21,LE,Spain,6821,1130,1420,45,5691,2094,2177,4271,1375
2025-05-22,LE,Spain,7152,1234,1400,38,5918,2287,2231,4518,1362
2025-05-23,LE,Spain,7043,1215,1430,35,5828,2184,2214,4398,1395
2025-05-24,LE,Spain,7208,1285,1241,13,5923,2325,2357,4682,1228
2025-05-25,LE,Spain,7070,1228,1319,17,5842,2266,2257,4523,1302
2025-05-26,LE,Spain,6940,1230,1382,32,5710,2178,2150,4328,1350
2025-05-27,LE,Spain,6857,1166,1337,32,5691,2178,2176,4354,1305
2025-05-28,LE,Spain,7033,1255,1372,43,5778,2194,2212,4406,1329
2025-05-29,LE,Spain,7168,1235,1449,53,5933,2220,2264,4484,1396
2025-05-30,LE,Spain,7040,1160,1439,29,5880,2217,2224,4441,1410
2025-05-31,LE,Spain,7261,1262,1290,22,5999,2350,2359,4709,1268
2025-06-01,LE,Spain,7315,1194,1373,13,6121,2414,2334,4748,1360
2025-06-02,LE,Spain,7053,1262,1407,37,5791,2214,2170,4384,1370
2025-06-03,LE,Spain,6928,1217,1337,35,5711,2192,2182,4374,1302
2025-06-04,LE,Spain,6953,1264,1407,49,5689,2137,2145,4282,1358
2025-06-05,LE,Spain,7124,1271,1405,38,5853,2217,2231,4448,1367
2025-06-06,LE,Spain,7282,1277,1436,28,6005,2258,2311,4569,1408
2025-06-07,LE,Spain,7327,1360,1270,15,5967,2332,2365,4697,1255
2025-06-08,LE,Spain,7210,1237,1357,15,5973,2335,2281,4616,1342
2025-06-09,LE,Spain,7085,1277,1408,40,5808,2224,2176,4400,1368
2025-06-10,LE,Spain,6983,1195,1401,55,5788,2200,2187,4387,1346
2025-06-11,LE,Spain,6981,1248,1379,43,5733,2172,2182,4354,1336
2025-06-12,LE,Spain,7126,1234,1381,30,5892,2240,2271,4511,1351
2025-06-13,LE,Spain,7219,1217,1483,31,6002,2245,2274,4519,1452
2025-06-14,LE,Spain,7339,1328,1259,20,6011,2358,2394,4752,1239
2025-06-15,LE,Spain,7250,1268,1333,19,5982,2353,2296,4649,1314
2025-06-16,LE,Spain,7129,1295,1422,46,5834,2214,2198,4412,1376
2025-06-17,LE,Spain,7018,1208,1406,51,5810,2195,2209,4404,1355
2025-06-18,LE,Spain,7097,1267,1375,39,5830,2215,2240,4455,1336
2025-06-19,LE,Spain,7201,1259,1400,32,5942,2265,2277,4542,1368
2025-06-20,LE,Spain,7310,1266,1474,27,6044,2269,2301,4570,1447
2025-06-21,LE,Spain,7480,1345,1320,28,6135,2401,2414,4815,1292
2025-06-22,LE,Spain,7350,1287,1328,18,6063,2396,2339,4735,1310
2025-06-23,LE,Spain,7146,1310,1394,35,5836,2217,2225,4442,1359
2025-06-24,LE,Spain,7168,1314,1380,48,5854,2251,2223,4474,1332
2025-06-25,LE,Spain,7008,1216,1418,42,5792,2179,2195,4374,1376
2025-06-26,LE,Spain,7333,1302,1472,34,6031,2276,2283,4559,1438
2025-06-27,LE,Spain,7409,1278,1469,39,6131,2335,2327,4662,1430
2025-06-28,LE,Spain,7552,1320,1325,21,6232,2440,2467,4907,1304
2025-06-29,LE,Spain,7503,1235,1392,20,6268,2441,2435,4876,1372
2025-06-30,LE,Spain,7415,1316,1459,47,6099,2318,2322,4640,1412
2025-07-01,LE,Spain,7335,1279,1408,44,6056,2336,2312,4648,1364
2025-07-02,LE,Spain,7283,1347,1420,26,5936,2261,2255,4516,1394
2025-07-03,LE,Spain,6721,1021,1477,31,5700,2066,2157,4223,1446
2025-07-04,LE,Spain,7198,1136,1535,32,6062,2281,2246,4527,1503
2025-07-05,LE,Spain,7683,1411,1271,16,6272,2512,2489,5001,1255
2025-07-06,LE,Spain,7567,1347,1317,24,6220,2445,2458,4903,1293
2025-07-07,LE,Spain,7500,1322,1484,31,6178,2365,2329,4694,1453
2025-07-08,LE,Spain,7383,1295,1412,43,6088,2340,2336,4676,1369
2025-07-09,LE,Spain,7418,1336,1438,50,6082,2313,2331,4644,1388
2025-07-10,LE,Spain,7547,1335,1445,31,6212,2371,2396,4767,1414
2025-07-11,LE,Spain,7551,1302,1488,30,6249,2389,2372,4761,1458
2025-07-12,LE,Spain,7558,1414,1258,10,6144,2435,2451,4886,1248
2025-07-13,LE,Spain,7665,1330,1362,10,6335,2497,2476,4973,1352
2025-07-14,LE,Spain,7520,1334,1493,26,6186,2354,2339,4693,1467
2025-07-15,LE,Spain,7434,1322,1422,36,6112,2351,2339,4690,1386
2025-07-16,LE,Spain,7423,1377,1448,47,6046,2296,2302,4598,1401
2025-07-17,LE,Spain,7529,1325,1479,53,6204,2356,2369,4725,1426
2025-07-18,LE,Spain,7555,1299,1469,26,6256,2395,2392,4787,1443
2025-07-19,LE,Spain,7629,1382,1287,13,6247,2472,2488,4960,1274
2025-07-20,LE,Spain,7612,1317,1360,7,6295,2475,2460,4935,1353
2025-07-21,LE,Spain,7471,1347,1472,41,6124,2336,2316,4652,1431
2025-07-22,LE,Spain,7431,1300,1398,33,6131,2370,2363,4733,1365
2025-07-23,LE,Spain,7393,1373,1404,53,6020,2308,2308,4616,1351
2025-07-24,LE,Spain,7438,1336,1408,47,6102,2340,2354,4694,1361
2025-07-25,LE,Spain,7480,1295,1445,34,6185,2373,2367,4740,1411
2025-07-26,LE,Spain,7716,1407,1333,24,6309,2482,2494,4976,1309
2025-07-27,LE,Spain,7587,1312,1359,18,6275,2458,2458,4916,1341
2025-07-28,LE,Spain,7456,1379,1451,35,6077,2322,2304,4626,1416
2025-07-29,LE,Spain,7406,1328,1377,47,6078,2362,2339,4701,1330
2025-07-30,LE,Spain,7380,1351,1419,51,6029,2294,2316,4610,1368
2025-07-31,LE,Spain,7535,1340,1419,43,6195,2374,2402,4776,1376
2025-08-01,LE,Spain,7566,1306,1451,30,6260,2410,2399,4809,1421
2025-08-02,LE,Spain,7675,1384,1286,14,6291,2501,2504,5005,1272
2025-08-03,LE,Spain,7546,1309,1323,15,6237,2473,2441,4914,1308
2025-08-04,LE,Spain,7429,1384,1409,17,6045,2316,2320,4636,1392
2025-08-05,LE,Spain,7427,1347,1412,40,6080,2350,2318,4668,1372
2025-08-06,LE,Spain,7322,1356,1361,46,5966,2300,2305,4605,1315
2025-08-07,LE,Spain,7482,1340,1410,42,6142,2357,2375,4732,1368
2025-08-08,LE,Spain,7528,1321,1447,22,6207,2378,2382,4760,1425
2025-08-09,LE,Spain,7718,1408,1288,16,6310,2518,2504,5022,1272
2025-08-10,LE,Spain,7533,1292,1348,15,6241,2448,2445,4893,1333
2025-08-11,LE,Spain,7310,1324,1420,34,5986,2286,2280,4566,1386
2025-08-12,LE,Spain,7253,1308,1340,47,5945,2298,2307,4605,1293
2025-08-13,LE,Spain,7259,1357,1355,44,5902,2283,2264,4547,1311
2025-08-14,LE,Spain,7316,1277,1395,46,6039,2314,2330,4644,1349
2025-08-15,LE,Spain,7321,1336,1359,17,5985,2306,2320,4626,1342
2025-08-16,LE,Spain,7599,1412,1256,24,6187,2458,2473,4931,1232
2025-08-17,LE,Spain,7448,1290,1355,14,6158,2411,2392,4803,1341
2025-08-18,LE,Spain,7279,1308,1398,31,5971,2295,2278,4573,1367
2025-08-19,LE,Spain,7224,1326,1336,27,5898,2288,2274,4562,1309
2025-08-20,LE,Spain,7199,1364,1322,46,5835,2246,2267,4513,1276
2025-08-21,LE,Spain,7405,1365,1386,48,6040,2342,2312,4654,1338
2025-08-22,LE,Spain,7388,1292,1417,38,6096,2329,2350,4679,1379
2025-08-23,LE,Spain,8038,1801,1329,27,6237,2447,2461,4908,1302
2025-08-24,LE,Spain,7890,1730,1344,29,6160,2424,2392,4816,1315
2025-08-25,LE,Spain,7759,1831,1380,28,5928,2275,2273,4548,1352
2025-08-26,LE,Spain,7683,1768,1357,38,5915,2277,2281,4558,1319
2025-08-27,LE,Spain,7602,1709,1363,44,5893,2262,2268,4530,1319
2025-08-28,LE,Spain,7726,1743,1381,53,5983,2297,2305,4602,1328
2025-08-29,LE,Spain,7922,1782,1465,28,6140,2326,2349,4675,1437
2025-01-01,ES,Sweden,1156,716,69,1,440,180,191,371,68
2025-01-02,ES,Sweden,1651,962,164,3,689,262,263,525,161
2025-01-03,ES,Sweden,1644,937,181,5,707,262,264,526,176
2025-01-04,ES,Sweden,1454,921,75,2,533,231,227,458,73
2025-01-05,ES,Sweden,1554,943,120,3,611,242,249,491,117
2025-01-06,ES,Sweden,1559,919,128,4,640,259,253,512,124
2025-01-07,ES,Sweden,1484,819,186,1,665,238,241,479,185
2025-01-08,ES,Sweden,1429,812,193,8,617,210,214,424,185
2025-01-09,ES,Sweden,1486,785,231,8,701,238,232,470,223
2025-01-10,ES,Sweden,1562,857,204,11,705,250,251,501,193
2025-01-11,ES,Sweden,1290,829,58,6,461,200,203,403,52
2025-01-12,ES,Sweden,1453,827,160,6,626,231,235,466,154
2025-01-13,ES,Sweden,1555,858,200,5,697,255,242,497,195
2025-01-14,ES,Sweden,1318,712,204,6,606,193,209,402,198
2025-01-15,ES,Sweden,1334,719,203,9,615,211,201,412,194
2025-01-16,ES,Sweden,1525,811,235,15,714,242,237,479,220
2025-01-17,ES,Sweden,1615,896,208,6,719,258,253,511,202
2025-01-18,ES,Sweden,1274,829,62,3,445,194,189,383,59
2025-01-19,ES,Sweden,1510,908,145,8,602,219,238,457,137
2025-01-20,ES,Sweden,1499,802,216,12,697,242,239,481,204
2025-01-21,ES,Sweden,1318,702,215,6,616,199,202,401,209
2025-01-22,ES,Sweden,1431,779,215,3,652,213,224,437,212
2025-01-23,ES,Sweden,1554,857,234,6,697,234,229,463,228
2025-01-24,ES,Sweden,1703,936,233,11,767,268,266,534,222
2025-01-25,ES,Sweden,1314,837,57,0,477,212,208,420,57
2025-01-26,ES,Sweden,1537,903,162,5,634,235,237,472,157
2025-01-27,ES,Sweden,1603,864,240,8,739,248,251,499,232
2025-01-28,ES,Sweden,1375,705,257,7,670,208,205,413,250
2025-01-29,ES,Sweden,1494,800,263,12,694,218,213,431,251
2025-01-30,ES,Sweden,1583,831,267,11,752,245,240,485,256
2025-01-31,ES,Sweden,1687,898,236,8,789,276,277,553,228
2025-02-01,ES,Sweden,1384,844,77,2,540,238,225,463,75
2025-02-02,ES,Sweden,1600,945,160,1,655,242,253,495,159
2025-02-03,ES,Sweden,1627,858,253,8,769,257,259,516,245
2025-02-04,ES,Sweden,1437,750,240,4,687,223,224,447,236
2025-02-05,ES,Sweden,1516,774,266,7,742,234,242,476,259
2025-02-06,ES,Sweden,1578,769,287,8,809,264,258,522,279
2025-02-07,ES,Sweden,1654,846,249,8,808,276,283,559,241
2025-02-08,ES,Sweden,1414,856,84,2,558,238,236,474,82
2025-02-09,ES,Sweden,1561,880,174,4,681,251,256,507,170
2025-02-10,ES,Sweden,1568,767,268,6,801,271,262,533,262
2025-02-11,ES,Sweden,1411,701,270,5,710,218,222,440,265
2025-02-12,ES,Sweden,1494,755,267,10,739,235,237,472,257
2025-02-13,ES,Sweden,1606,805,307,21,801,244,250,494,286
2025-02-14,ES,Sweden,1696,866,246,14,830,297,287,584,232
2025-02-15,ES,Sweden,1471,906,74,2,565,244,247,491,72
2025-02-16,ES,Sweden,1576,878,166,5,698,265,267,532,161
2025-02-17,ES,Sweden,1687,879,263,11,808,275,270,545,252
2025-02-18,ES,Sweden,1475,772,242,6,703,229,232,461,236
2025-02-19,ES,Sweden,1602,839,256,13,763,250,257,507,243
2025-02-20,ES,Sweden,1741,919,294,16,822,267,261,528,278
2025-02-21,ES,Sweden,1818,1015,230,0,803,278,295,573,230
2025-02-22,ES,Sweden,1568,924,76,2,644,291,277,568,74
2025-02-23,ES,Sweden,1703,1006,166,3,697,269,262,531,163
2025-02-24,ES,Sweden,1701,904,265,12,797,265,267,532,253
2025-02-25,ES,Sweden,1485,794,234,13,691,230,227,457,221
2025-02-26,ES,Sweden,1564,835,240,15,729,242,247,489,225
2025-02-27,ES,Sweden,1579,826,265,16,753,245,243,488,249
2025-02-28,ES,Sweden,1677,862,258,8,815,273,284,557,250
2025-03-01,ES,Sweden,1539,915,80,4,624,269,275,544,76
2025-03-02,ES,Sweden,1728,993,166,2,735,279,290,569,164
2025-03-03,ES,Sweden,1777,945,252,4,832,298,282,580,248
2025-03-04,ES,Sweden,1636,847,252,4,789,272,265,537,248
2025-03-05,ES,Sweden,1677,879,257,12,798,270,271,541,245
2025-03-06,ES,Sweden,1766,916,289,9,850,284,277,561,280
2025-03-07,ES,Sweden,1832,961,281,12,871,294,296,590,269
2025-03-08,ES,Sweden,1397,822,80,4,575,247,248,495,76
2025-03-09,ES,Sweden,1556,842,172,5,714,272,270,542,167
2025-03-10,ES,Sweden,1575,747,280,8,828,277,271,548,272
2025-03-11,ES,Sweden,1615,838,269,9,777,255,253,508,260
2025-03-12,ES,Sweden,1652,813,299,9,839,266,274,540,290
2025-03-13,ES,Sweden,1808,927,323,7,881,279,279,558,316
2025-03-14,ES,Sweden,1766,889,275,3,877,299,303,602,272
2025-03-15,ES,Sweden,1439,872,98,12,567,236,233,469,86
2025-03-16,ES,Sweden,1622,884,198,4,738,267,273,540,194
2025-03-17,ES,Sweden,1762,892,280,6,870,300,290,590,274
2025-03-18,ES,Sweden,1593,821,264,7,772,254,254,508,257
2025-03-19,ES,Sweden,1665,826,286,15,839,277,276,553,271
2025-03-20,ES,Sweden,1803,909,310,13,894,294,290,584,297
2025-03-21,ES,Sweden,1703,838,281,6,865,286,298,584,275
2025-03-22,ES,Sweden,1303,752,85,5,551,237,229,466,80
2025-03-23,ES,Sweden,1583,849,186,1,734,269,279,548,185
2025-03-24,ES,Sweden,1784,927,276,15,857,297,284,581,261
2025-03-25,ES,Sweden,1595,798,279,14,797,253,265,518,265
2025-03-26,ES,Sweden,1666,799,294,24,867,288,285,573,270
2025-03-27,ES,Sweden,1778,883,314,15,895,295,286,581,299
2025-03-28,ES,Sweden,1836,973,265,8,863,299,299,598,257
2025-03-29,ES,Sweden,1351,802,86,5,549,234,229,463,81
2025-03-30,ES,Sweden,1716,938,188,7,778,292,298,590,181
2025-03-31,ES,Sweden,1817,922,286,18,895,307,302,609,268
2025-04-01,ES,Sweden,1723,817,305,21,906,300,301,601,284
2025-04-02,ES,Sweden,1895,932,313,31,963,325,325,650,282
2025-04-03,ES,Sweden,1886,998,280,10,888,310,298,608,270
2025-04-04,ES,Sweden,1821,919,281,18,902,304,317,621,263
2025-04-05,ES,Sweden,1378,809,78,2,569,249,242,491,76
2025-04-06,ES,Sweden,1696,902,186,3,794,300,308,608,183
2025-04-07,ES,Sweden,1863,925,314,28,938,315,309,624,286
2025-04-08,ES,Sweden,1838,920,308,21,918,301,309,610,287
2025-04-09,ES,Sweden,1866,885,315,17,981,339,327,666,298
2025-04-10,ES,Sweden,1986,1060,294,13,926,319,313,632,281
2025-04-11,ES,Sweden,1966,1020,270,15,946,334,342,676,255
2025-04-12,ES,Sweden,1494,880,95,7,614,258,261,519,88
2025-04-13,ES,Sweden,1814,1019,179,2,795,306,310,616,177
2025-04-14,ES,Sweden,1916,1004,270,24,912,317,325,642,246
2025-04-15,ES,Sweden,1735,858,268,21,877,307,302,609,247
2025-04-16,ES,Sweden,1880,982,280,14,898,307,311,618,266
2025-04-17,ES,Sweden,1733,906,228,11,827,304,295,599,217
2025-04-18,ES,Sweden,1478,828,89,2,650,278,283,561,87
2025-04-19,ES,Sweden,1484,920,70,1,564,246,248,494,69
2025-04-20,ES,Sweden,1690,961,138,3,729,296,295,591,135
2025-04-21,ES,Sweden,1743,970,179,8,773,294,300,594,171
2025-04-22,ES,Sweden,1874,986,271,24,888,307,310,617,247
2025-04-23,ES,Sweden,1821,897,280,15,924,318,326,644,265
2025-04-24,ES,Sweden,1936,1001,287,18,935,329,319,648,269
2025-04-25,ES,Sweden,1954,1043,248,20,911,329,334,663,228
2025-04-26,ES,Sweden,1546,937,87,5,609,264,258,522,82
2025-04-27,ES,Sweden,1853,1015,197,3,838,320,321,641,194
2025-04-28,ES,Sweden,1943,1002,301,8,941,319,321,640,293
2025-04-29,ES,Sweden,1870,955,281,8,915,317,317,634,273
2025-04-30,ES,Sweden,1811,950,211,9,861,322,328,650,202
2025-05-01,ES,Sweden,1682,998,106,3,684,298,280,578,103
2025-05-02,ES,Sweden,1647,886,182,6,761,288,291,579,176
2025-05-03,ES,Sweden,1523,940,76,4,583,256,251,507,72
2025-05-04,ES,Sweden,1737,906,182,3,831,317,332,649,179
2025-05-05,ES,Sweden,1915,980,281,17,935,331,323,654,264
2025-05-06,ES,Sweden,1826,892,303,25,934,313,318,631,278
2025-05-07,ES,Sweden,1916,937,305,21,979,335,339,674,284
2025-05-08,ES,Sweden,2004,1007,310,17,997,347,340,687,293
2025-05-09,ES,Sweden,1978,1015,280,15,963,339,344,683,265
2025-05-10,ES,Sweden,1569,934,79,5,635,281,275,556,74
2025-05-11,ES,Sweden,1788,975,185,3,813,315,313,628,182
2025-05-12,ES,Sweden,2037,1053,299,18,984,339,346,685,281
2025-05-13,ES,Sweden,1905,979,282,9,926,324,320,644,273
2025-05-14,ES,Sweden,1870,901,295,18,969,334,340,674,277
2025-05-15,ES,Sweden,1943,979,305,16,964,330,329,659,289
2025-05-16,ES,Sweden,1919,942,263,18,977,359,355,714,245
2025-05-17,ES,Sweden,1556,917,73,2,639,283,283,566,71
2025-05-18,ES,Sweden,1823,969,189,5,854,328,337,665,184
2025-05-19,ES,Sweden,1882,907,304,16,975,335,336,671,288
2025-05-20,ES,Sweden,1919,957,307,16,962,330,325,655,291
2025-05-21,ES,Sweden,2037,1036,294,13,1001,357,350,707,281
2025-05-22,ES,Sweden,2108,1098,315,14,1010,344,351,695,301
2025-05-23,ES,Sweden,2109,1092,260,15,1017,380,377,757,245
2025-05-24,ES,Sweden,1653,1026,68,0,627,281,278,559,68
2025-05-25,ES,Sweden,1948,1097,181,0,851,331,339,670,181
2025-05-26,ES,Sweden,2107,1106,283,20,1001,365,353,718,263
2025-05-27,ES,Sweden,1999,1057,282,13,942,327,333,660,269
2025-05-28,ES,Sweden,2015,1026,270,18,989,360,359,719,252
2025-05-29,ES,Sweden,1851,1079,154,10,772,307,311,618,144
2025-05-30,ES,Sweden,1780,967,165,10,813,322,326,648,155
2025-05-31,ES,Sweden,1651,975,88,3,676,291,297,588,85
2025-06-01,ES,Sweden,2002,1100,177,4,902,360,365,725,173
2025-06-02,ES,Sweden,2060,1047,294,14,1013,359,360,719,280
2025-06-03,ES,Sweden,2085,1061,317,25,1024,353,354,707,292
2025-06-04,ES,Sweden,2041,997,311,22,1044,364,369,733,289
2025-06-05,ES,Sweden,2112,1100,286,6,1012,365,361,726,280
2025-06-06,ES,Sweden,1967,1111,147,7,856,356,353,709,140
2025-06-07,ES,Sweden,1754,1066,88,2,688,303,297,600,86
2025-06-08,ES,Sweden,1949,1064,184,5,885,348,353,701,179
2025-06-09,ES,Sweden,2099,1100,290,9,999,354,355,709,281
2025-06-10,ES,Sweden,2052,1034,301,6,1018,359,358,717,295
2025-06-11,ES,Sweden,2071,1038,298,8,1033,365,370,735,290
2025-06-12,ES,Sweden,2253,1137,319,17,1116,388,409,797,302
2025-06-13,ES,Sweden,2180,1121,262,11,1059,394,403,797,251
2025-06-14,ES,Sweden,1727,987,99,7,740,328,313,641,92
2025-06-15,ES,Sweden,2063,1109,191,8,954,385,378,763,183
2025-06-16,ES,Sweden,2148,1105,311,13,1043,367,365,732,298
2025-06-17,ES,Sweden,1995,980,275,8,1015,364,376,740,267
2025-06-18,ES,Sweden,2130,1072,302,14,1058,383,373,756,288
2025-06-19,ES,Sweden,2025,1014,263,14,1011,374,374,748,249
2025-06-20,ES,Sweden,1818,1073,67,5,745,340,338,678,62
2025-06-21,ES,Sweden,1635,972,70,2,663,295,298,593,68
2025-06-22,ES,Sweden,2003,1133,160,4,870,355,355,710,156
2025-06-23,ES,Sweden,2180,1151,296,12,1029,363,370,733,284
2025-06-24,ES,Sweden,2105,1071,299,8,1034,368,367,735,291
2025-06-25,ES,Sweden,2111,1069,303,13,1042,369,370,739,290
2025-06-26,ES,Sweden,2140,1105,305,18,1035,368,362,730,287
2025-06-27,ES,Sweden,2171,1184,244,10,987,368,375,743,234
2025-06-28,ES,Sweden,1793,1086,72,2,707,319,316,635,70
2025-06-29,ES,Sweden,2003,1174,132,6,829,349,348,697,126
2025-06-30,ES,Sweden,1970,1061,185,18,909,363,361,724,167
2025-07-01,ES,Sweden,1986,1096,189,7,890,355,346,701,182
2025-07-02,ES,Sweden,1935,1050,200,13,885,341,344,685,187
2025-07-03,ES,Sweden,2127,1182,209,8,945,370,366,736,201
2025-07-04,ES,Sweden,2012,1083,188,15,929,371,370,741,173
2025-07-05,ES,Sweden,1743,1065,62,2,678,309,307,616,60
2025-07-06,ES,Sweden,1942,1114,124,2,828,351,353,704,122
2025-07-07,ES,Sweden,1870,977,173,10,893,358,362,720,163
2025-07-08,ES,Sweden,1933,1054,171,15,879,358,350,708,156
2025-07-09,ES,Sweden,1898,1024,184,14,874,347,343,690,170
2025-07-10,ES,Sweden,1985,1080,182,10,905,362,361,723,172
2025-07-11,ES,Sweden,1954,1033,171,9,921,371,379,750,162
2025-07-12,ES,Sweden,1637,944,69,5,693,312,312,624,64
2025-07-13,ES,Sweden,1790,982,110,2,808,346,352,698,108
2025-07-14,ES,Sweden,1937,1088,163,6,849,345,341,686,157
2025-07-15,ES,Sweden,1904,1059,152,4,845,346,347,693,148
2025-07-16,ES,Sweden,2092,1221,176,11,871,350,345,695,165
2025-07-17,ES,Sweden,1980,1086,177,8,894,359,358,717,169
2025-07-18,ES,Sweden,2074,1160,164,7,914,381,369,750,157
2025-07-19,ES,Sweden,1753,1074,66,0,679,303,310,613,66
2025-07-20,ES,Sweden,1976,1166,126,6,810,339,345,684,120
2025-07-21,ES,Sweden,2017,1139,169,5,878,357,352,709,164
2025-07-22,ES,Sweden,1925,1062,165,2,863,343,355,698,163
2025-07-23,ES,Sweden,1900,1030,170,12,870,355,345,700,158
2025-07-24,ES,Sweden,2048,1167,187,9,881,347,347,694,178
2025-07-25,ES,Sweden,2002,1121,164,6,881,358,359,717,158
2025-07-26,ES,Sweden,1708,1034,68,0,674,298,308,606,68
2025-07-27,ES,Sweden,1895,1072,148,2,823,336,339,675,146
2025-07-28,ES,Sweden,1938,1058,166,6,880,359,355,714,160
2025-07-29,ES,Sweden,1950,1092,172,10,858,343,343,686,162
2025-07-30,ES,Sweden,2081,1188,184,9,893,355,354,709,175
2025-07-31,ES,Sweden,2045,1167,175,6,878,349,354,703,169
2025-08-01,ES,Sweden,2027,1118,176,11,909,362,371,733,165
2025-08-02,ES,Sweden,1764,1063,75,3,701,320,306,626,72
2025-08-03,ES,Sweden,1983,1184,126,1,799,331,342,673,125
2025-08-04,ES,Sweden,2086,1177,191,14,909,362,356,718,177
2025-08-05,ES,Sweden,1953,1089,179,11,864,340,345,685,168
2025-08-06,ES,Sweden,2049,1149,192,9,900,359,349,708,183
2025-08-07,ES,Sweden,2087,1166,219,15,921,351,351,702,204
2025-08-08,ES,Sweden,2089,1162,185,5,927,368,374,742,180
2025-08-09,ES,Sweden,1778,1080,75,0,698,307,316,623,75
2025-08-10,ES,Sweden,1981,1138,144,5,843,350,349,699,139
2025-08-11,ES,Sweden,2136,1151,250,12,985,368,367,735,238
2025-08-12,ES,Sweden,2007,1063,241,10,944,354,349,703,231
2025-08-13,ES,Sweden,1956,985,258,16,971,357,356,713,242
2025-08-14,ES,Sweden,2070,1100,247,12,970,364,359,723,235
2025-08-15,ES,Sweden,2083,1124,212,8,959,366,381,747,204
2025-08-16,ES,Sweden,1702,1019,82,9,683,302,299,601,73
2025-08-17,ES,Sweden,1888,1008,159,9,880,361,360,721,150
2025-08-18,ES,Sweden,2037,1049,271,9,988,357,360,717,262
2025-08-19,ES,Sweden,1997,1027,270,10,970,350,350,700,260
2025-08-20,ES,Sweden,1939,963,275,17,976,354,347,701,258
2025-08-21,ES,Sweden,2112,1073,289,20,1039,377,373,750,269
2025-08-22,ES,Sweden,2081,1124,236,22,957,355,366,721,214
2025-08-23,ES,Sweden,1692,1020,77,2,672,302,293,595,75
2025-08-24,ES,Sweden,1955,1066,173,1,889,357,359,716,172
2025-08-25,ES,Sweden,2056,1059,280,9,997,360,357,717,271
2025-08-26,ES,Sweden,1952,993,282,11,959,337,340,677,271
2025-08-27,ES,Sweden,2091,1062,298,13,1029,367,364,731,285
2025-08-28,ES,Sweden,2153,1099,304,10,1054,372,378,750,294
2025-08-29,ES,Sweden,2190,1141,274,7,1049,387,388,775,267
2025-01-01,LS,Switzerland,2399,1405,25,0,994,489,480,969,25
2025-01-02,LS,Switzerland,2844,1573,27,2,1271,619,625,1244,25
2025-01-03,LS,Switzerland,3006,1621,52,4,1385,665,668,1333,48
2025-01-04,LS,Switzerland,3032,1654,41,2,1378,654,683,1337,39
2025-01-05,LS,Switzerland,3124,1734,35,1,1390,699,656,1355,34
2025-01-06,LS,Switzerland,2802,1552,36,1,1250,604,610,1214,35
2025-01-07,LS,Switzerland,2309,1287,37,0,1022,496,489,985,37
2025-01-08,LS,Switzerland,2209,1179,35,1,1030,497,498,995,34
2025-01-09,LS,Switzerland,2320,1234,27,2,1086,528,531,1059,25
2025-01-10,LS,Switzerland,2608,1401,44,2,1207,582,581,1163,42
2025-01-11,LS,Switzerland,2465,1306,33,3,1159,562,564,1126,30
2025-01-12,LS,Switzerland,2720,1439,35,0,1281,625,621,1246,35
2025-01-13,LS,Switzerland,2522,1348,60,2,1174,552,562,1114,58
2025-01-14,LS,Switzerland,2120,1084,69,1,1036,479,488,967,68
2025-01-15,LS,Switzerland,2182,1146,62,7,1036,491,483,974,55
2025-01-16,LS,Switzerland,2358,1201,71,5,1157,545,541,1086,66
2025-01-17,LS,Switzerland,2618,1331,58,5,1287,601,628,1229,53
2025-01-18,LS,Switzerland,2373,1219,38,1,1154,566,550,1116,37
2025-01-19,LS,Switzerland,2657,1328,38,1,1329,644,647,1291,37
2025-01-20,LS,Switzerland,2614,1318,72,3,1296,590,634,1224,69
2025-01-21,LS,Switzerland,2033,1013,38,1,1020,489,493,982,37
2025-01-22,LS,Switzerland,2283,1131,51,3,1152,556,545,1101,48
2025-01-23,LS,Switzerland,2498,1206,64,6,1292,615,613,1228,58
2025-01-24,LS,Switzerland,2779,1339,80,0,1440,701,659,1360,80
2025-01-25,LS,Switzerland,2454,1247,41,0,1207,577,589,1166,41
2025-01-26,LS,Switzerland,2702,1425,34,1,1277,637,606,1243,33
2025-01-27,LS,Switzerland,2518,1380,52,1,1138,543,543,1086,51
2025-01-28,LS,Switzerland,2063,1069,45,6,994,477,472,949,39
2025-01-29,LS,Switzerland,2270,1172,57,2,1098,510,531,1041,55
2025-01-30,LS,Switzerland,2507,1283,62,2,1224,576,586,1162,60
2025-01-31,LS,Switzerland,2800,1484,44,0,1316,633,639,1272,44
2025-02-01,LS,Switzerland,2522,1345,33,2,1177,562,582,1144,31
2025-02-02,LS,Switzerland,2861,1485,60,3,1376,676,640,1316,57
2025-02-03,LS,Switzerland,2670,1463,65,2,1207,569,573,1142,63
2025-02-04,LS,Switzerland,2393,1285,73,3,1108,516,519,1035,70
2025-02-05,LS,Switzerland,2502,1331,62,2,1171,550,559,1109,60
2025-02-06,LS,Switzerland,2759,1483,76,3,1276,600,600,1200,73
2025-02-07,LS,Switzerland,2939,1574,67,2,1365,653,645,1298,65
2025-02-08,LS,Switzerland,2724,1458,40,1,1266,613,613,1226,39
2025-02-09,LS,Switzerland,2874,1563,36,0,1311,642,633,1275,36
2025-02-10,LS,Switzerland,2700,1434,38,6,1266,619,609,1228,32
2025-02-11,LS,Switzerland,2418,1304,39,4,1114,538,537,1075,35
2025-02-12,LS,Switzerland,2635,1420,63,2,1215,580,572,1152,61
2025-02-13,LS,Switzerland,2672,1448,62,2,1224,575,587,1162,60
2025-02-14,LS,Switzerland,3155,1682,48,3,1473,699,726,1425,45
2025-02-15,LS,Switzerland,3122,1585,57,2,1537,746,734,1480,55
2025-02-16,LS,Switzerland,3073,1665,40,1,1408,686,682,1368,39
2025-02-17,LS,Switzerland,2881,1561,74,2,1320,627,619,1246,72
2025-02-18,LS,Switzerland,2596,1407,65,4,1189,559,565,1124,61
2025-02-19,LS,Switzerland,2742,1435,87,9,1307,608,612,1220,78
2025-02-20,LS,Switzerland,2862,1531,66,1,1331,643,622,1265,65
2025-02-21,LS,Switzerland,3029,1582,51,0,1447,689,707,1396,51
2025-02-22,LS,Switzerland,3020,1553,53,3,1467,712,702,1414,50
2025-02-23,LS,Switzerland,3193,1616,37,2,1577,780,760,1540,35
2025-02-24,LS,Switzerland,2905,1552,63,2,1353,640,650,1290,61
2025-02-25,LS,Switzerland,2495,1322,61,4,1173,557,555,1112,57
2025-02-26,LS,Switzerland,2653,1405,39,1,1248,601,608,1209,38
2025-02-27,LS,Switzerland,2736,1435,37,1,1301,627,637,1264,36
2025-02-28,LS,Switzerland,2984,1569,46,0,1415,697,672,1369,46
2025-03-01,LS,Switzerland,2932,1571,34,1,1361,657,670,1327,33
2025-03-02,LS,Switzerland,3061,1665,29,0,1396,687,680,1367,29
2025-03-03,LS,Switzerland,2841,1527,52,3,1314,631,631,1262,49
2025-03-04,LS,Switzerland,2671,1439,57,1,1232,591,584,1175,56
2025-03-05,LS,Switzerland,2727,1449,49,5,1278,606,623,1229,44
2025-03-06,LS,Switzerland,2899,1555,68,6,1344,635,641,1276,62
2025-03-07,LS,Switzerland,3082,1659,58,0,1423,686,679,1365,58
2025-03-08,LS,Switzerland,2894,1569,40,0,1325,647,638,1285,40
2025-03-09,LS,Switzerland,3063,1647,34,1,1416,692,690,1382,33
2025-03-10,LS,Switzerland,2551,1371,53,4,1180,566,561,1127,49
2025-03-11,LS,Switzerland,2655,1457,50,5,1198,564,584,1148,45
2025-03-12,LS,Switzerland,2796,1545,45,3,1251,608,598,1206,42
2025-03-13,LS,Switzerland,2876,1563,47,6,1313,639,627,1266,41
2025-03-14,LS,Switzerland,3032,1697,31,2,1335,647,657,1304,29
2025-03-15,LS,Switzerland,2773,1538,21,0,1235,612,602,1214,21
2025-03-16,LS,Switzerland,3007,1680,26,1,1327,646,655,1301,25
2025-03-17,LS,Switzerland,2905,1601,60,1,1304,624,620,1244,59
2025-03-18,LS,Switzerland,2557,1363,57,5,1194,569,568,1137,52
2025-03-19,LS,Switzerland,2789,1534,77,7,1255,602,576,1178,70
2025-03-20,LS,Switzerland,2865,1555,74,9,1310,615,621,1236,65
2025-03-21,LS,Switzerland,2949,1611,58,1,1338,643,637,1280,57
2025-03-22,LS,Switzerland,2721,1521,29,0,1200,581,590,1171,29
2025-03-23,LS,Switzerland,2988,1652,34,1,1336,650,652,1302,33
2025-03-24,LS,Switzerland,2896,1600,57,7,1296,622,617,1239,50
2025-03-25,LS,Switzerland,2511,1405,35,3,1106,539,532,1071,32
2025-03-26,LS,Switzerland,2759,1513,49,2,1246,599,598,1197,47
2025-03-27,LS,Switzerland,2902,1577,49,6,1325,642,634,1276,43
2025-03-28,LS,Switzerland,3087,1636,70,9,1451,694,687,1381,61
2025-03-29,LS,Switzerland,2668,1490,26,0,1178,565,587,1152,26
2025-03-30,LS,Switzerland,3254,1886,30,1,1368,673,665,1338,29
2025-03-31,LS,Switzerland,3024,1722,46,2,1302,630,626,1256,44
2025-04-01,LS,Switzerland,2926,1693,48,4,1233,590,595,1185,44
2025-04-02,LS,Switzerland,3073,1794,57,3,1279,608,614,1222,54
2025-04-03,LS,Switzerland,3156,1797,52,3,1359,648,659,1307,49
2025-04-04,LS,Switzerland,3320,1913,46,5,1407,687,674,1361,41
2025-04-05,LS,Switzerland,3217,1926,34,1,1291,629,628,1257,33
2025-04-06,LS,Switzerland,3403,2038,31,2,1365,660,674,1334,29
2025-04-07,LS,Switzerland,3295,1902,64,2,1393,677,652,1329,62
2025-04-08,LS,Switzerland,3039,1770,51,4,1269,608,610,1218,47
2025-04-09,LS,Switzerland,3246,1963,44,2,1283,617,622,1239,42
2025-04-10,LS,Switzerland,3413,2041,63,4,1372,660,649,1309,59
2025-04-11,LS,Switzerland,3525,2104,57,4,1421,695,669,1364,53
2025-04-12,LS,Switzerland,3340,2064,37,3,1276,625,614,1239,34
2025-04-13,LS,Switzerland,3399,2088,24,1,1311,635,652,1287,23
2025-04-14,LS,Switzerland,3331,2005,56,3,1326,639,631,1270,53
2025-04-15,LS,Switzerland,3041,1832,53,5,1209,572,584,1156,48
2025-04-16,LS,Switzerland,3312,1990,43,1,1322,640,639,1279,42
2025-04-17,LS,Switzerland,3517,2155,25,1,1362,680,657,1337,24
2025-04-18,LS,Switzerland,3451,2098,31,1,1353,670,652,1322,30
2025-04-19,LS,Switzerland,3240,2040,32,2,1200,583,585,1168,30
2025-04-20,LS,Switzerland,3229,2015,24,1,1214,590,600,1190,23
2025-04-21,LS,Switzerland,3401,2087,36,0,1314,632,646,1278,36
2025-04-22,LS,Switzerland,3168,1917,49,2,1251,610,592,1202,47
2025-04-23,LS,Switzerland,3291,2006,48,4,1285,611,626,1237,44
2025-04-24,LS,Switzerland,3375,2077,49,4,1298,631,618,1249,45
2025-04-25,LS,Switzerland,3479,2097,37,2,1382,673,672,1345,35
2025-04-26,LS,Switzerland,3348,2159,28,1,1189,578,583,1161,27
2025-04-27,LS,Switzerland,3472,2165,32,1,1307,627,648,1275,31
2025-04-28,LS,Switzerland,3357,2009,51,2,1348,656,641,1297,49
2025-04-29,LS,Switzerland,3110,1868,41,3,1242,604,597,1201,38
2025-04-30,LS,Switzerland,3522,2187,56,2,1335,636,643,1279,54
2025-05-01,LS,Switzerland,3388,2054,72,1,1334,644,618,1262,71
2025-05-02,LS,Switzerland,3443,2131,58,5,1312,632,622,1254,53
2025-05-03,LS,Switzerland,3412,2205,27,2,1207,582,598,1180,25
2025-05-04,LS,Switzerland,3727,2359,28,1,1368,660,680,1340,27
2025-05-05,LS,Switzerland,3529,2189,38,0,1340,661,641,1302,38
2025-05-06,LS,Switzerland,3285,2047,29,0,1238,596,613,1209,29
2025-05-07,LS,Switzerland,3411,2130,42,2,1281,622,617,1239,40
2025-05-08,LS,Switzerland,3526,2174,50,3,1352,662,640,1302,47
2025-05-09,LS,Switzerland,3502,2147,50,3,1355,655,650,1305,47
2025-05-10,LS,Switzerland,3363,2177,33,2,1186,579,574,1153,31
2025-05-11,LS,Switzerland,3574,2238,31,1,1336,637,668,1305,30
2025-05-12,LS,Switzerland,3583,2201,47,2,1382,669,666,1335,45
2025-05-13,LS,Switzerland,3292,2047,48,3,1245,599,598,1197,45
2025-05-14,LS,Switzerland,3473,2155,49,3,1318,635,634,1269,46
2025-05-15,LS,Switzerland,3683,2268,61,4,1415,675,679,1354,57
2025-05-16,LS,Switzerland,3783,2327,58,5,1456,718,680,1398,53
2025-05-17,LS,Switzerland,3416,2237,29,3,1179,574,576,1150,26
2025-05-18,LS,Switzerland,3601,2251,37,2,1350,637,676,1313,35
2025-05-19,LS,Switzerland,3706,2304,51,2,1402,684,667,1351,49
2025-05-20,LS,Switzerland,3329,2058,54,1,1271,598,619,1217,53
2025-05-21,LS,Switzerland,3635,2296,37,3,1339,657,645,1302,34
2025-05-22,LS,Switzerland,3628,2264,46,4,1364,663,655,1318,42
2025-05-23,LS,Switzerland,3852,2369,51,2,1483,733,699,1432,49
2025-05-24,LS,Switzerland,3482,2300,32,0,1182,574,576,1150,32
2025-05-25,LS,Switzerland,3658,2348,32,3,1310,621,657,1278,29
2025-05-26,LS,Switzerland,3807,2370,47,3,1437,702,688,1390,44
2025-05-27,LS,Switzerland,3476,2150,65,1,1326,633,628,1261,64
2025-05-28,LS,Switzerland,3868,2389,62,5,1479,713,704,1417,57
2025-05-29,LS,Switzerland,3683,2364,49,1,1319,650,620,1270,48
2025-05-30,LS,Switzerland,3721,2345,57,6,1376,656,663,1319,51
2025-05-31,LS,Switzerland,3679,2459,22,1,1220,608,590,1198,21
2025-06-01,LS,Switzerland,4005,2549,34,1,1456,681,741,1422,33
2025-06-02,LS,Switzerland,3721,2302,56,1,1419,686,677,1363,55
2025-06-03,LS,Switzerland,3553,2203,41,2,1350,659,650,1309,39
2025-06-04,LS,Switzerland,3575,2269,39,2,1306,626,641,1267,37
2025-06-05,LS,Switzerland,3782,2329,55,2,1453,708,690,1398,53
2025-06-06,LS,Switzerland,3911,2396,50,4,1515,740,725,1465,46
2025-06-07,LS,Switzerland,3682,2452,23,3,1230,611,596,1207,20
2025-06-08,LS,Switzerland,3766,2443,28,1,1323,646,649,1295,27
2025-06-09,LS,Switzerland,3847,2405,52,1,1442,675,715,1390,51
2025-06-10,LS,Switzerland,3757,2389,78,6,1368,655,635,1290,72
2025-06-11,LS,Switzerland,3866,2439,64,6,1427,677,686,1363,58
2025-06-12,LS,Switzerland,3915,2431,85,6,1484,697,702,1399,79
2025-06-13,LS,Switzerland,3938,2478,51,7,1460,715,694,1409,44
2025-06-14,LS,Switzerland,3786,2525,38,3,1261,616,607,1223,35
2025-06-15,LS,Switzerland,3850,2510,30,2,1340,639,671,1310,28
2025-06-16,LS,Switzerland,4008,2569,54,2,1439,692,693,1385,52
2025-06-17,LS,Switzerland,3828,2467,47,3,1361,655,659,1314,44
2025-06-18,LS,Switzerland,3973,2516,34,2,1457,719,704,1423,32
2025-06-19,LS,Switzerland,3991,2550,47,4,1441,700,694,1394,43
2025-06-20,LS,Switzerland,3963,2482,52,4,1481,723,706,1429,48
2025-06-21,LS,Switzerland,3633,2373,23,1,1260,611,626,1237,22
2025-06-22,LS,Switzerland,3979,2557,33,2,1422,694,695,1389,31
2025-06-23,LS,Switzerland,3977,2555,45,3,1422,688,689,1377,42
2025-06-24,LS,Switzerland,3793,2433,53,3,1360,655,652,1307,50
2025-06-25,LS,Switzerland,3866,2474,40,2,1392,680,672,1352,38
2025-06-26,LS,Switzerland,4049,2647,51,2,1402,661,690,1351,49
2025-06-27,LS,Switzerland,4028,2465,52,1,1563,762,749,1511,51
2025-06-28,LS,Switzerland,3894,2503,37,0,1391,685,669,1354,37
2025-06-29,LS,Switzerland,4059,2583,33,2,1476,717,726,1443,31
2025-06-30,LS,Switzerland,3924,2405,44,2,1519,735,740,1475,42
2025-07-01,LS,Switzerland,3733,2299,46,1,1434,697,691,1388,45
2025-07-02,LS,Switzerland,3844,2400,43,1,1444,708,693,1401,42
2025-07-03,LS,Switzerland,3653,2322,47,2,1331,636,648,1284,45
2025-07-04,LS,Switzerland,3663,2191,60,3,1472,710,702,1412,57
2025-07-05,LS,Switzerland,4041,2654,41,2,1387,682,664,1346,39
2025-07-06,LS,Switzerland,4085,2607,35,2,1478,711,732,1443,33
2025-07-07,LS,Switzerland,3978,2431,51,3,1547,751,745,1496,48
2025-07-08,LS,Switzerland,3841,2477,32,0,1364,666,666,1332,32
2025-07-09,LS,Switzerland,3983,2523,58,3,1460,695,707,1402,55
2025-07-10,LS,Switzerland,3926,2469,53,5,1457,715,689,1404,48
2025-07-11,LS,Switzerland,4063,2570,54,7,1493,710,729,1439,47
2025-07-12,LS,Switzerland,3936,2575,26,1,1361,675,660,1335,25
2025-07-13,LS,Switzerland,3902,2466,26,1,1436,696,714,1410,25
2025-07-14,LS,Switzerland,4062,2582,40,0,1480,717,723,1440,40
2025-07-15,LS,Switzerland,3785,2402,48,1,1383,658,677,1335,47
2025-07-16,LS,Switzerland,3866,2439,37,2,1427,706,684,1390,35
2025-07-17,LS,Switzerland,3844,2435,57,5,1409,684,668,1352,52
2025-07-18,LS,Switzerland,4075,2521,54,0,1554,756,744,1500,54
2025-07-19,LS,Switzerland,3899,2534,34,4,1365,665,666,1331,30
2025-07-20,LS,Switzerland,3979,2515,33,1,1464,717,714,1431,32
2025-07-21,LS,Switzerland,3866,2441,48,3,1425,687,690,1377,45
2025-07-22,LS,Switzerland,3795,2459,47,4,1336,645,644,1289,43
2025-07-23,LS,Switzerland,3930,2510,45,2,1420,681,694,1375,43
2025-07-24,LS,Switzerland,3915,2517,49,4,1398,685,664,1349,45
2025-07-25,LS,Switzerland,4005,2541,50,6,1464,712,702,1414,44
2025-07-26,LS,Switzerland,3961,2607,33,2,1354,667,654,1321,31
2025-07-27,LS,Switzerland,3963,2578,28,2,1385,669,688,1357,26
2025-07-28,LS,Switzerland,3882,2433,45,6,1449,698,706,1404,39
2025-07-29,LS,Switzerland,3727,2386,49,2,1341,640,652,1292,47
2025-07-30,LS,Switzerland,3948,2503,49,6,1445,706,690,1396,43
2025-07-31,LS,Switzerland,3914,2489,61,1,1425,683,681,1364,60
2025-08-01,LS,Switzerland,4063,2595,40,1,1468,729,699,1428,39
2025-08-02,LS,Switzerland,3951,2601,34,1,1350,653,663,1316,33
2025-08-03,LS,Switzerland,3882,2462,31,1,1420,681,708,1389,30
2025-08-04,LS,Switzerland,3746,2277,40,1,1469,715,714,1429,39
2025-08-05,LS,Switzerland,3553,2235,43,0,1318,638,637,1275,43
2025-08-06,LS,Switzerland,3691,2319,37,0,1372,670,665,1335,37
2025-08-07,LS,Switzerland,3748,2385,61,0,1363,653,649,1302,61
2025-08-08,LS,Switzerland,3941,2463,40,4,1478,716,722,1438,36
2025-08-09,LS,Switzerland,3945,2537,44,3,1408,690,674,1364,41
2025-08-10,LS,Switzerland,3948,2455,33,1,1493,724,736,1460,32
2025-08-11,LS,Switzerland,3684,2258,51,3,1426,684,691,1375,48
2025-08-12,LS,Switzerland,3600,2296,35,1,1304,638,631,1269,34
2025-08-13,LS,Switzerland,3688,2281,53,5,1407,689,665,1354,48
2025-08-14,LS,Switzerland,3639,2317,38,2,1322,635,649,1284,36
2025-08-15,LS,Switzerland,3703,2257,41,1,1446,714,691,1405,40
2025-08-16,LS,Switzerland,3909,2575,34,0,1334,653,647,1300,34
2025-08-17,LS,Switzerland,3848,2435,36,0,1413,676,701,1377,36
2025-08-18,LS,Switzerland,3761,2264,50,2,1497,723,724,1447,48
2025-08-19,LS,Switzerland,3632,2278,60,2,1354,639,655,1294,58
2025-08-20,LS,Switzerland,3659,2226,57,3,1433,699,677,1376,54
2025-08-21,LS,Switzerland,3665,2277,49,1,1388,668,671,1339,48
2025-08-22,LS,Switzerland,3937,2392,60,5,1545,753,732,1485,55
2025-08-23,LS,Switzerland,3680,2358,41,2,1322,645,636,1281,39
2025-08-24,LS,Switzerland,3832,2352,34,1,1480,719,727,1446,33
2025-08-25,LS,Switzerland,3799,2298,46,1,1501,730,725,1455,45
2025-08-26,LS,Switzerland,3676,2292,72,6,1384,661,651,1312,66
2025-08-27,LS,Switzerland,3708,2315,51,4,1393,669,673,1342,47
2025-08-28,LS,Switzerland,3632,2275,48,2,1357,659,650,1309,46
2025-08-29,LS,Switzerland,3955,2473,41,1,1482,720,721,1441,40
2025-01-01,LT,Türkiye,3879,1436,752,1,2443,850,841,1691,751
2025-01-02,LT,Türkiye,4307,1577,797,3,2730,977,956,1933,794
2025-01-03,LT,Türkiye,4379,1548,843,9,2831,997,991,1988,834
2025-01-04,LT,Türkiye,4381,1613,779,4,2768,990,999,1989,775
2025-01-05,LT,Türkiye,4456,1676,801,2,2780,997,982,1979,799
2025-01-06,LT,Türkiye,4215,1596,799,3,2619,901,919,1820,796
2025-01-07,LT,Türkiye,4024,1522,784,5,2502,859,859,1718,779
2025-01-08,LT,Türkiye,4075,1558,760,1,2517,876,881,1757,759
2025-01-09,LT,Türkiye,4157,1543,819,7,2614,907,888,1795,812
2025-01-10,LT,Türkiye,4242,1524,856,2,2718,932,930,1862,854
2025-01-11,LT,Türkiye,4190,1564,786,2,2626,911,929,1840,784
2025-01-12,LT,Türkiye,4272,1612,797,2,2660,936,927,1863,795
2025-01-13,LT,Türkiye,3983,1482,807,6,2501,835,859,1694,801
2025-01-14,LT,Türkiye,3921,1501,769,2,2420,823,828,1651,767
2025-01-15,LT,Türkiye,3956,1504,786,1,2452,843,823,1666,785
2025-01-16,LT,Türkiye,4220,1564,848,4,2656,902,906,1808,844
2025-01-17,LT,Türkiye,4228,1507,885,5,2721,936,900,1836,880
2025-01-18,LT,Türkiye,4231,1525,823,2,2706,938,945,1883,821
2025-01-19,LT,Türkiye,4397,1660,853,2,2737,944,940,1884,851
2025-01-20,LT,Türkiye,4078,1475,866,2,2603,861,876,1737,864
2025-01-21,LT,Türkiye,3914,1463,803,1,2451,820,828,1648,802
2025-01-22,LT,Türkiye,4001,1521,800,7,2480,837,843,1680,793
2025-01-23,LT,Türkiye,4130,1569,842,1,2561,859,860,1719,841
2025-01-24,LT,Türkiye,4168,1509,884,3,2659,904,871,1775,881
2025-01-25,LT,Türkiye,4162,1519,821,4,2643,899,923,1822,817
2025-01-26,LT,Türkiye,4265,1609,844,3,2656,917,895,1812,841
2025-01-27,LT,Türkiye,3928,1451,823,0,2477,810,844,1654,823
2025-01-28,LT,Türkiye,3895,1466,820,3,2429,812,797,1609,817
2025-01-29,LT,Türkiye,3941,1489,790,2,2452,836,826,1662,788
2025-01-30,LT,Türkiye,4130,1515,843,2,2615,889,883,1772,841
2025-01-31,LT,Türkiye,4237,1512,879,2,2725,930,916,1846,877
2025-02-01,LT,Türkiye,4259,1527,850,1,2732,927,955,1882,849
2025-02-02,LT,Türkiye,4405,1627,869,2,2778,967,942,1909,867
2025-02-03,LT,Türkiye,4034,1423,856,0,2611,859,896,1755,856
2025-02-04,LT,Türkiye,3920,1454,818,5,2466,820,828,1648,813
2025-02-05,LT,Türkiye,3827,1478,722,5,2349,814,813,1627,717
2025-02-06,LT,Türkiye,3772,1553,669,5,2219,773,777,1550,664
2025-02-07,LT,Türkiye,4118,1496,817,4,2622,925,880,1805,813
2025-02-08,LT,Türkiye,4194,1593,805,3,2601,886,910,1796,802
2025-02-09,LT,Türkiye,4224,1646,809,2,2578,892,877,1769,807
2025-02-10,LT,Türkiye,3928,1456,811,2,2472,826,835,1661,809
2025-02-11,LT,Türkiye,3736,1494,724,4,2242,753,765,1518,720
2025-02-12,LT,Türkiye,3790,1482,715,3,2308,800,793,1593,712
2025-02-13,LT,Türkiye,4008,1535,802,1,2473,838,833,1671,801
2025-02-14,LT,Türkiye,4223,1554,834,3,2669,929,906,1835,831
2025-02-15,LT,Türkiye,4247,1611,788,2,2636,909,939,1848,786
2025-02-16,LT,Türkiye,4370,1704,830,3,2666,928,908,1836,827
2025-02-17,LT,Türkiye,4002,1497,805,0,2505,846,854,1700,805
2025-02-18,LT,Türkiye,3912,1535,769,0,2377,801,807,1608,769
2025-02-19,LT,Türkiye,3850,1578,694,2,2272,777,801,1578,692
2025-02-20,LT,Türkiye,3792,1571,584,3,2221,830,807,1637,581
2025-02-21,LT,Türkiye,3394,1516,404,2,1878,724,750,1474,402
2025-02-22,LT,Türkiye,3704,1579,505,1,2125,803,817,1620,504
2025-02-23,LT,Türkiye,4102,1669,619,1,2433,914,900,1814,618
2025-02-24,LT,Türkiye,4044,1438,806,1,2606,907,893,1800,805
2025-02-25,LT,Türkiye,4061,1530,834,4,2531,847,850,1697,830
2025-02-26,LT,Türkiye,4052,1578,786,3,2474,856,832,1688,783
2025-02-27,LT,Türkiye,4173,1579,842,2,2594,872,880,1752,840
2025-02-28,LT,Türkiye,4253,1562,845,6,2691,937,909,1846,839
2025-03-01,LT,Türkiye,4195,1601,780,3,2594,899,915,1814,777
2025-03-02,LT,Türkiye,4309,1745,785,1,2564,901,878,1779,784
2025-03-03,LT,Türkiye,3931,1517,763,2,2414,811,840,1651,761
2025-03-04,LT,Türkiye,3777,1534,715,5,2243,762,766,1528,710
2025-03-05,LT,Türkiye,3943,1585,719,4,2358,817,822,1639,715
2025-03-06,LT,Türkiye,3951,1543,746,5,2408,838,824,1662,741
2025-03-07,LT,Türkiye,4062,1544,792,7,2518,871,855,1726,785
2025-03-08,LT,Türkiye,4043,1556,734,5,2487,872,881,1753,729
2025-03-09,LT,Türkiye,4151,1672,753,0,2479,862,864,1726,753
2025-03-10,LT,Türkiye,3626,1362,748,4,2264,753,763,1516,744
2025-03-11,LT,Türkiye,3780,1564,681,6,2216,768,767,1535,675
2025-03-12,LT,Türkiye,3906,1605,708,5,2301,798,795,1593,703
2025-03-13,LT,Türkiye,3929,1559,739,5,2370,818,813,1631,734
2025-03-14,LT,Türkiye,4179,1616,805,9,2563,890,868,1758,796
2025-03-15,LT,Türkiye,4137,1638,732,2,2499,878,889,1767,730
2025-03-16,LT,Türkiye,4295,1720,771,7,2575,914,890,1804,764
2025-03-17,LT,Türkiye,3964,1544,751,3,2420,814,855,1669,748
2025-03-18,LT,Türkiye,3798,1536,704,3,2262,782,776,1558,701
2025-03-19,LT,Türkiye,4036,1648,725,2,2388,829,834,1663,723
2025-03-20,LT,Türkiye,4081,1612,739,1,2469,877,853,1730,738
2025-03-21,LT,Türkiye,4132,1500,817,5,2632,905,910,1815,812
2025-03-22,LT,Türkiye,4219,1635,774,3,2584,896,914,1810,771
2025-03-23,LT,Türkiye,4304,1734,790,0,2570,900,880,1780,790
2025-03-24,LT,Türkiye,4028,1536,805,5,2492,828,859,1687,800
2025-03-25,LT,Türkiye,3923,1562,774,6,2361,793,794,1587,768
2025-03-26,LT,Türkiye,4107,1599,810,10,2508,854,844,1698,800
2025-03-27,LT,Türkiye,4326,1619,890,5,2707,925,892,1817,885
2025-03-28,LT,Türkiye,4545,1604,1007,5,2941,971,963,1934,1002
2025-03-29,LT,Türkiye,4628,1708,1011,0,2920,950,959,1909,1011
2025-03-30,LT,Türkiye,4707,1812,877,1,2895,1020,998,2018,876
2025-03-31,LT,Türkiye,4535,1637,914,0,2898,971,1013,1984,914
2025-04-01,LT,Türkiye,4629,1681,939,7,2948,1001,1008,2009,932
2025-04-02,LT,Türkiye,4743,1786,900,2,2957,1031,1026,2057,898
2025-04-03,LT,Türkiye,4773,1745,901,1,3028,1077,1050,2127,900
2025-04-04,LT,Türkiye,4885,1697,873,1,3188,1149,1166,2315,872
2025-04-05,LT,Türkiye,4932,1755,896,1,3177,1140,1141,2281,895
2025-04-06,LT,Türkiye,5038,1861,938,1,3177,1119,1120,2239,937
2025-04-07,LT,Türkiye,4717,1701,893,3,3016,1043,1080,2123,890
2025-04-08,LT,Türkiye,4639,1773,862,3,2866,994,1010,2004,859
2025-04-09,LT,Türkiye,4705,1826,847,4,2879,1023,1009,2032,843
2025-04-10,LT,Türkiye,4756,1770,881,8,2986,1057,1048,2105,873
2025-04-11,LT,Türkiye,5013,1782,883,7,3231,1167,1181,2348,876
2025-04-12,LT,Türkiye,4961,1714,843,2,3247,1212,1192,2404,841
2025-04-13,LT,Türkiye,5004,1853,850,2,3151,1156,1145,2301,848
2025-04-14,LT,Türkiye,4780,1726,855,2,3054,1087,1112,2199,853
2025-04-15,LT,Türkiye,4694,1742,819,1,2952,1063,1070,2133,818
2025-04-16,LT,Türkiye,4950,1873,855,4,3077,1121,1101,2222,851
2025-04-17,LT,Türkiye,4951,1802,855,6,3149,1150,1144,2294,849
2025-04-18,LT,Türkiye,5038,1749,872,5,3289,1212,1205,2417,867
2025-04-19,LT,Türkiye,5081,1798,817,3,3283,1232,1234,2466,814
2025-04-20,LT,Türkiye,5103,1858,830,2,3245,1202,1213,2415,828
2025-04-21,LT,Türkiye,4903,1757,862,0,3146,1131,1153,2284,862
2025-04-22,LT,Türkiye,4720,1712,819,2,3008,1103,1086,2189,817
2025-04-23,LT,Türkiye,4926,1815,861,4,3111,1128,1122,2250,857
2025-04-24,LT,Türkiye,4955,1767,916,6,3188,1136,1136,2272,910
2025-04-25,LT,Türkiye,5107,1751,877,3,3356,1249,1230,2479,874
2025-04-26,LT,Türkiye,5263,1790,825,2,3473,1320,1328,2648,823
2025-04-27,LT,Türkiye,5293,1870,859,5,3423,1280,1284,2564,854
2025-04-28,LT,Türkiye,4939,1715,887,3,3224,1171,1166,2337,884
2025-04-29,LT,Türkiye,4882,1690,880,1,3192,1149,1163,2312,879
2025-04-30,LT,Türkiye,5139,1854,877,8,3285,1210,1198,2408,869
2025-05-01,LT,Türkiye,5170,1769,929,8,3401,1239,1233,2472,921
2025-05-02,LT,Türkiye,5096,1701,874,2,3395,1258,1263,2521,872
2025-05-03,LT,Türkiye,5249,1780,842,4,3469,1302,1325,2627,838
2025-05-04,LT,Türkiye,5293,1815,884,1,3478,1304,1290,2594,883
2025-05-05,LT,Türkiye,4999,1659,909,5,3340,1210,1221,2431,904
2025-05-06,LT,Türkiye,4817,1602,873,6,3215,1160,1182,2342,867
2025-05-07,LT,Türkiye,4926,1686,902,11,3240,1181,1157,2338,891
2025-05-08,LT,Türkiye,5008,1658,904,4,3350,1223,1223,2446,900
2025-05-09,LT,Türkiye,5066,1633,891,4,3433,1267,1275,2542,887
2025-05-10,LT,Türkiye,5222,1726,845,4,3496,1329,1322,2651,841
2025-05-11,LT,Türkiye,5280,1776,865,3,3504,1328,1311,2639,862
2025-05-12,LT,Türkiye,4991,1642,899,5,3349,1221,1229,2450,894
2025-05-13,LT,Türkiye,4817,1588,902,4,3229,1153,1174,2327,898
2025-05-14,LT,Türkiye,4993,1701,888,1,3292,1203,1201,2404,887
2025-05-15,LT,Türkiye,5077,1708,916,1,3369,1225,1228,2453,915
2025-05-16,LT,Türkiye,5130,1634,916,4,3496,1300,1280,2580,912
2025-05-17,LT,Türkiye,5261,1732,873,5,3529,1331,1325,2656,868
2025-05-18,LT,Türkiye,5325,1852,863,3,3473,1311,1299,2610,860
2025-05-19,LT,Türkiye,5021,1623,955,1,3398,1211,1232,2443,954
2025-05-20,LT,Türkiye,4859,1592,886,2,3267,1190,1191,2381,884
2025-05-21,LT,Türkiye,5018,1690,887,7,3328,1233,1208,2441,880
2025-05-22,LT,Türkiye,5090,1680,895,1,3410,1259,1256,2515,894
2025-05-23,LT,Türkiye,5225,1645,895,3,3580,1333,1352,2685,892
2025-05-24,LT,Türkiye,5407,1697,864,1,3710,1409,1437,2846,863
2025-05-25,LT,Türkiye,5541,1890,893,5,3651,1389,1369,2758,888
2025-05-26,LT,Türkiye,5192,1626,913,3,3566,1315,1338,2653,910
2025-05-27,LT,Türkiye,5068,1672,882,11,3396,1255,1259,2514,871
2025-05-28,LT,Türkiye,5279,1736,891,7,3543,1339,1313,2652,884
2025-05-29,LT,Türkiye,5318,1735,897,9,3583,1336,1350,2686,888
2025-05-30,LT,Türkiye,5411,1674,928,4,3737,1400,1409,2809,924
2025-05-31,LT,Türkiye,5613,1739,911,7,3874,1491,1472,2963,904
2025-06-01,LT,Türkiye,5565,1750,917,1,3815,1450,1448,2898,916
2025-06-02,LT,Türkiye,5387,1647,956,8,3740,1382,1402,2784,948
2025-06-03,LT,Türkiye,5471,1773,996,8,3698,1345,1357,2702,988
2025-06-04,LT,Türkiye,5744,1839,1092,4,3905,1421,1392,2813,1088
2025-06-05,LT,Türkiye,5784,1774,1148,9,4010,1430,1432,2862,1139
2025-06-06,LT,Türkiye,5624,1722,973,6,3902,1460,1469,2929,967
2025-06-07,LT,Türkiye,5762,1787,911,5,3975,1536,1528,3064,906
2025-06-08,LT,Türkiye,5797,1863,948,6,3934,1493,1493,2986,942
2025-06-09,LT,Türkiye,5810,1733,1146,5,4077,1454,1477,2931,1141
2025-06-10,LT,Türkiye,5631,1751,1017,4,3880,1444,1419,2863,1013
2025-06-11,LT,Türkiye,5756,1810,985,4,3946,1482,1479,2961,981
2025-06-12,LT,Türkiye,5708,1760,987,6,3948,1481,1480,2961,981
2025-06-13,LT,Türkiye,5324,1409,977,5,3915,1462,1476,2938,972
2025-06-14,LT,Türkiye,5427,1399,949,4,4028,1537,1542,3079,945
2025-06-15,LT,Türkiye,5313,1364,947,2,3949,1498,1504,3002,945
2025-06-16,LT,Türkiye,5175,1305,993,1,3870,1434,1443,2877,992
2025-06-17,LT,Türkiye,5096,1327,974,4,3769,1399,1396,2795,970
2025-06-18,LT,Türkiye,5306,1408,1007,10,3898,1455,1436,2891,997
2025-06-19,LT,Türkiye,5277,1355,1027,4,3922,1435,1460,2895,1023
2025-06-20,LT,Türkiye,5430,1386,1040,3,4044,1510,1494,3004,1037
2025-06-21,LT,Türkiye,5651,1439,1027,4,4212,1583,1602,3185,1023
2025-06-22,LT,Türkiye,5415,1361,1005,5,4054,1516,1533,3049,1000
2025-06-23,LT,Türkiye,5108,1209,1006,4,3899,1437,1456,2893,1002
2025-06-24,LT,Türkiye,5090,1259,1014,4,3831,1425,1392,2817,1010
2025-06-25,LT,Türkiye,5311,1377,1012,3,3934,1467,1455,2922,1009
2025-06-26,LT,Türkiye,5415,1492,969,1,3923,1470,1484,2954,968
2025-06-27,LT,Türkiye,5667,1592,1001,2,4075,1539,1535,3074,999
2025-06-28,LT,Türkiye,5866,1698,966,4,4168,1600,1602,3202,962
2025-06-29,LT,Türkiye,5834,1723,959,4,4111,1562,1590,3152,955
2025-06-30,LT,Türkiye,5659,1584,1027,3,4075,1521,1527,3048,1024
2025-07-01,LT,Türkiye,5736,1707,993,2,4029,1522,1514,3036,991
2025-07-02,LT,Türkiye,5829,1745,1001,5,4084,1547,1536,3083,996
2025-07-03,LT,Türkiye,5845,1788,1000,2,4057,1518,1539,3057,998
2025-07-04,LT,Türkiye,5869,1719,1012,4,4150,1566,1572,3138,1008
2025-07-05,LT,Türkiye,6075,1781,986,3,4294,1656,1652,3308,983
2025-07-06,LT,Türkiye,5951,1772,981,4,4179,1594,1604,3198,977
2025-07-07,LT,Türkiye,5861,1691,1031,2,4170,1579,1560,3139,1029
2025-07-08,LT,Türkiye,5852,1769,1022,5,4083,1532,1529,3061,1017
2025-07-09,LT,Türkiye,5979,1836,1013,5,4143,1576,1554,3130,1008
2025-07-10,LT,Türkiye,5990,1844,1014,6,4146,1555,1577,3132,1008
2025-07-11,LT,Türkiye,6074,1818,1024,3,4256,1605,1627,3232,1021
2025-07-12,LT,Türkiye,6226,1871,980,2,4355,1690,1685,3375,978
2025-07-13,LT,Türkiye,6124,1907,960,2,4217,1636,1621,3257,958
2025-07-14,LT,Türkiye,5970,1814,1024,2,4156,1562,1570,3132,1022
2025-07-15,LT,Türkiye,6013,1910,1032,3,4103,1531,1540,3071,1029
2025-07-16,LT,Türkiye,6127,1911,1029,4,4216,1602,1585,3187,1025
2025-07-17,LT,Türkiye,6015,1858,1032,5,4157,1561,1564,3125,1027
2025-07-18,LT,Türkiye,6102,1821,1025,7,4281,1625,1631,3256,1018
2025-07-19,LT,Türkiye,6245,1894,971,9,4351,1682,1698,3380,962
2025-07-20,LT,Türkiye,6185,1888,1035,10,4297,1638,1624,3262,1025
2025-07-21,LT,Türkiye,6065,1781,1044,3,4284,1612,1628,3240,1041
2025-07-22,LT,Türkiye,6100,1920,1035,0,4180,1576,1569,3145,1035
2025-07-23,LT,Türkiye,6121,1894,1018,3,4227,1606,1603,3209,1015
2025-07-24,LT,Türkiye,6115,1919,1037,2,4196,1584,1575,3159,1035
2025-07-25,LT,Türkiye,6118,1805,1071,6,4313,1622,1620,3242,1065
2025-07-26,LT,Türkiye,6329,1873,990,0,4456,1723,1743,3466,990
2025-07-27,LT,Türkiye,6276,1934,1020,1,4342,1677,1645,3322,1019
2025-07-28,LT,Türkiye,5988,1812,1010,2,4176,1586,1580,3166,1008
2025-07-29,LT,Türkiye,6057,1893,1016,5,4164,1570,1578,3148,1011
2025-07-30,LT,Türkiye,6122,1921,1010,2,4201,1600,1591,3191,1008
2025-07-31,LT,Türkiye,6198,1951,1041,3,4247,1599,1607,3206,1038
2025-08-01,LT,Türkiye,6225,1856,1062,5,4369,1662,1645,3307,1057
2025-08-02,LT,Türkiye,6415,1929,988,6,4486,1743,1755,3498,982
2025-08-03,LT,Türkiye,6347,1994,1008,2,4353,1674,1671,3345,1006
2025-08-04,LT,Türkiye,6109,1838,1042,1,4271,1621,1608,3229,1041
2025-08-05,LT,Türkiye,6058,1897,1025,8,4161,1567,1569,3136,1017
2025-08-06,LT,Türkiye,6157,1979,1012,3,4178,1587,1579,3166,1009
2025-08-07,LT,Türkiye,6222,1960,1049,1,4262,1599,1614,3213,1048
2025-08-08,LT,Türkiye,6219,1872,1061,1,4347,1640,1646,3286,1060
2025-08-09,LT,Türkiye,6438,1947,1031,7,4491,1742,1718,3460,1024
2025-08-10,LT,Türkiye,6434,2043,1033,2,4391,1684,1674,3358,1031
2025-08-11,LT,Türkiye,6100,1854,1069,5,4246,1586,1591,3177,1064
2025-08-12,LT,Türkiye,6089,1940,1037,1,4149,1555,1557,3112,1036
2025-08-13,LT,Türkiye,6152,1937,1012,3,4215,1598,1605,3203,1009
2025-08-14,LT,Türkiye,6182,1974,1043,0,4208,1572,1593,3165,1043
2025-08-15,LT,Türkiye,6266,1895,1063,1,4371,1645,1663,3308,1062
2025-08-16,LT,Türkiye,6454,1984,1031,2,4470,1738,1701,3439,1029
2025-08-17,LT,Türkiye,6364,2007,1037,3,4357,1658,1662,3320,1034
2025-08-18,LT,Türkiye,6040,1828,1044,1,4212,1573,1595,3168,1043
2025-08-19,LT,Türkiye,6092,1946,1016,5,4146,1569,1561,3130,1011
2025-08-20,LT,Türkiye,6195,1944,1043,2,4251,1603,1605,3208,1041
2025-08-21,LT,Türkiye,6150,1912,1062,3,4238,1582,1594,3176,1059
2025-08-22,LT,Türkiye,6210,1872,1067,7,4338,1646,1625,3271,1060
2025-08-23,LT,Türkiye,6365,1945,1020,3,4420,1694,1706,3400,1017
2025-08-24,LT,Türkiye,6432,2058,1078,1,4374,1669,1627,3296,1077
2025-08-25,LT,Türkiye,6100,1824,1071,3,4276,1591,1614,3205,1068
2025-08-26,LT,Türkiye,6056,1890,1035,4,4166,1563,1568,3131,1031
2025-08-27,LT,Türkiye,6173,1975,1029,3,4198,1583,1586,3169,1026
2025-08-28,LT,Türkiye,6141,1890,1083,5,4251,1578,1590,3168,1078
2025-08-29,LT,Türkiye,6135,1866,1034,2,4269,1622,1613,3235,1032
2025-01-01,UK,Ukraine,4,4,0,0,0,0,0,0,0
2025-01-02,UK,Ukraine,0,0,0,0,0,0,0,0,0
2025-01-03,UK,Ukraine,2,2,0,0,0,0,0,0,0
2025-01-04,UK,Ukraine,1,1,0,0,0,0,0,0,0
2025-01-05,UK,Ukraine,0,0,0,0,0,0,0,0,0
2025-01-06,UK,Ukraine,1,1,0,0,0,0,0,0,0
2025-01-07,UK,Ukraine,1,1,0,0,0,0,0,0,0
2025-01-08,UK,Ukraine,1,1,0,0,0,0,0,0,0
2025-01-09,UK,Ukraine,1,1,0,0,0,0,0,0,0
2025-01-10,UK,Ukraine,2,2,0,0,0,0,0,0,0
2025-01-11,UK,Ukraine,1,1,0,0,0,0,0,0,0
2025-01-12,UK,Ukraine,0,0,0,0,0,0,0,0,0
2025-01-13,UK,Ukraine,0,0,0,0,0,0,0,0,0
2025-01-14,UK,Ukraine,0,0,0,0,0,0,0,0,0
2025-01-15,UK,Ukraine,1,0,0,0,1,1,0,1,0
2025-01-16,UK,Ukraine,1,1,0,0,0,0,0,0,0
2025-01-17,UK,Ukraine,1,1,0,0,0,0,0,0,0
2025-01-18,UK,Ukraine,0,0,0,0,0,0,0,0,0
2025-01-19,UK,Ukraine,0,0,0,0,0,0,0,0,0
2025-01-20,UK,Ukraine,2,2,0,0,0,0,0,0,0
2025-01-21,UK,Ukraine,0,0,0,0,0,0,0,0,0
2025-01-22,UK,Ukraine,2,2,0,0,0,0,0,0,0
2025-01-23,UK,Ukraine,1,1,0,0,0,0,0,0,0
2025-01-24,UK,Ukraine,1,1,0,0,0,0,0,0,0
2025-01-25,UK,Ukraine,2,2,0,0,0,0,0,0,0
2025-01-26,UK,Ukraine,1,1,0,0,0,0,0,0,0
2025-01-27,UK,Ukraine,1,1,0,0,0,0,0,0,0
2025-01-28,UK,Ukraine,1,1,0,0,0,0,0,0,0
2025-01-29,UK,Ukraine,0,0,0,0,0,0,0,0,0
2025-01-30,UK,Ukraine,2,2,0,0,0,0,0,0,0
2025-01-31,UK,Ukraine,1,1,0,0,0,0,0,0,0
2025-02-01,UK,Ukraine,4,4,0,0,0,0,0,0,0
2025-02-02,UK,Ukraine,1,1,0,0,0,0,0,0,0
2025-02-03,UK,Ukraine,2,2,0,0,0,0,0,0,0
2025-02-04,UK,Ukraine,1,1,0,0,0,0,0,0,0
2025-02-05,UK,Ukraine,2,2,0,0,0,0,0,0,0
2025-02-06,UK,Ukraine,0,0,0,0,0,0,0,0,0
2025-02-07,UK,Ukraine,0,0,0,0,0,0,0,0,0
2025-02-08,UK,Ukraine,1,1,0,0,0,0,0,0,0
2025-02-09,UK,Ukraine,1,1,0,0,0,0,0,0,0
2025-02-10,UK,Ukraine,2,2,0,0,0,0,0,0,0
2025-02-11,UK,Ukraine,1,1,0,0,0,0,0,0,0
2025-02-12,UK,Ukraine,2,2,0,0,0,0,0,0,0
2025-02-13,UK,Ukraine,0,0,0,0,0,0,0,0,0
2025-02-14,UK,Ukraine,1,1,0,0,0,0,0,0,0
2025-02-15,UK,Ukraine,1,1,0,0,0,0,0,0,0
2025-02-16,UK,Ukraine,0,0,0,0,0,0,0,0,0
2025-02-17,UK,Ukraine,1,1,0,0,0,0,0,0,0
2025-02-18,UK,Ukraine,1,0,0,0,1,0,1,1,0
2025-02-19,UK,Ukraine,1,1,0,0,0,0,0,0,0
2025-02-20,UK,Ukraine,1,0,0,0,1,1,0,1,0
2025-02-21,UK,Ukraine,0,0,0,0,0,0,0,0,0
2025-02-22,UK,Ukraine,1,1,0,0,0,0,0,0,0
2025-02-23,UK,Ukraine,4,3,0,0,1,0,1,1,0
2025-02-24,UK,Ukraine,3,2,0,0,1,1,0,1,0
2025-02-25,UK,Ukraine,2,2,0,0,0,0,0,0,0
2025-02-26,UK,Ukraine,1,1,0,0,0,0,0,0,0
2025-02-27,UK,Ukraine,2,2,0,0,0,0,0,0,0
2025-02-28,UK,Ukraine,1,1,0,0,0,0,0,0,0
2025-03-01,UK,Ukraine,0,0,0,0,0,0,0,0,0
2025-03-02,UK,Ukraine,2,2,0,0,0,0,0,0,0
2025-03-03,UK,Ukraine,2,1,0,0,1,0,1,1,0
2025-03-04,UK,Ukraine,0,0,0,0,0,0,0,0,0
2025-03-05,UK,Ukraine,0,0,0,0,0,0,0,0,0
2025-03-06,UK,Ukraine,2,1,0,0,1,1,0,1,0
2025-03-07,UK,Ukraine,1,1,0,0,0,0,0,0,0
2025-03-08,UK,Ukraine,1,1,0,0,0,0,0,0,0
2025-03-09,UK,Ukraine,0,-1,0,0,1,1,0,1,0
2025-03-10,UK,Ukraine,0,0,0,0,0,0,0,0,0
2025-03-11,UK,Ukraine,1,1,0,0,0,0,0,0,0
2025-03-12,UK,Ukraine,2,1,0,0,1,0,1,1,0
2025-03-13,UK,Ukraine,0,0,0,0,0,0,0,0,0
2025-03-14,UK,Ukraine,1,1,0,0,0,0,0,0,0
2025-03-15,UK,Ukraine,3,3,0,0,0,0,0,0,0
2025-03-16,UK,Ukraine,0,0,0,0,0,0,0,0,0
2025-03-17,UK,Ukraine,1,1,0,0,0,0,0,0,0
2025-03-18,UK,Ukraine,4,4,0,0,0,0,0,0,0
2025-03-19,UK,Ukraine,0,0,0,0,0,0,0,0,0
2025-03-20,UK,Ukraine,2,2,0,0,0,0,0,0,0
2025-03-21,UK,Ukraine,4,4,0,0,0,0,0,0,0
2025-03-22,UK,Ukraine,1,1,0,0,0,0,0,0,0
2025-03-23,UK,Ukraine,3,3,0,0,0,0,0,0,0
2025-03-24,UK,Ukraine,2,2,0,0,0,0,0,0,0
2025-03-25,UK,Ukraine,2,2,0,0,0,0,0,0,0
2025-03-26,UK,Ukraine,3,2,0,0,1,1,0,1,0
2025-03-27,UK,Ukraine,0,0,0,0,0,0,0,0,0
2025-03-28,UK,Ukraine,0,0,0,0,0,0,0,0,0
2025-03-29,UK,Ukraine,2,2,0,0,0,0,0,0,0
2025-03-30,UK,Ukraine,0,0,0,0,0,0,0,0,0
2025-03-31,UK,Ukraine,2,2,0,0,0,0,0,0,0
2025-04-01,UK,Ukraine,2,2,0,0,0,0,0,0,0
2025-04-02,UK,Ukraine,3,3,0,0,0,0,0,0,0
2025-04-03,UK,Ukraine,2,2,0,0,0,0,0,0,0
2025-04-04,UK,Ukraine,1,1,0,0,0,0,0,0,0
2025-04-05,UK,Ukraine,0,0,0,0,0,0,0,0,0
2025-04-06,UK,Ukraine,0,0,0,0,0,0,0,0,0
2025-04-07,UK,Ukraine,1,1,0,0,0,0,0,0,0
2025-04-08,UK,Ukraine,0,0,0,0,0,0,0,0,0
2025-04-09,UK,Ukraine,0,0,0,0,0,0,0,0,0
2025-04-10,UK,Ukraine,0,0,0,0,0,0,0,0,0
2025-04-11,UK,Ukraine,3,3,0,0,0,0,0,0,0
2025-04-12,UK,Ukraine,0,0,0,0,0,0,0,0,0
2025-04-13,UK,Ukraine,1,1,0,0,0,0,0,0,0
2025-04-14,UK,Ukraine,1,1,0,0,0,0,0,0,0
2025-04-15,UK,Ukraine,1,1,0,0,0,0,0,0,0
2025-04-16,UK,Ukraine,0,0,0,0,0,0,0,0,0
2025-04-17,UK,Ukraine,2,2,0,0,0,0,0,0,0
2025-04-18,UK,Ukraine,1,1,0,0,0,0,0,0,0
2025-04-19,UK,Ukraine,1,1,0,0,0,0,0,0,0
2025-04-20,UK,Ukraine,4,4,0,0,0,0,0,0,0
2025-04-21,UK,Ukraine,0,0,0,0,0,0,0,0,0
2025-04-22,UK,Ukraine,0,0,0,0,0,0,0,0,0
2025-04-23,UK,Ukraine,1,1,0,0,0,0,0,0,0
2025-04-24,UK,Ukraine,1,1,0,0,0,0,0,0,0
2025-04-25,UK,Ukraine,3,3,0,0,0,0,0,0,0
2025-04-26,UK,Ukraine,2,2,0,0,0,0,0,0,0
2025-04-27,UK,Ukraine,0,0,0,0,0,0,0,0,0
2025-04-28,UK,Ukraine,5,5,0,0,0,0,0,0,0
2025-04-29,UK,Ukraine,3,3,0,0,0,0,0,0,0
2025-04-30,UK,Ukraine,3,3,0,0,0,0,0,0,0
2025-05-01,UK,Ukraine,4,4,0,0,0,0,0,0,0
2025-05-02,UK,Ukraine,5,5,0,0,0,0,0,0,0
2025-05-03,UK,Ukraine,6,6,0,0,0,0,0,0,0
2025-05-04,UK,Ukraine,0,0,0,0,0,0,0,0,0
2025-05-05,UK,Ukraine,2,2,0,0,0,0,0,0,0
2025-05-06,UK,Ukraine,3,3,0,0,0,0,0,0,0
2025-05-07,UK,Ukraine,4,4,0,0,0,0,0,0,0
2025-05-08,UK,Ukraine,1,1,0,0,0,0,0,0,0
2025-05-09,UK,Ukraine,5,5,0,0,0,0,0,0,0
2025-05-10,UK,Ukraine,3,3,0,0,0,0,0,0,0
2025-05-11,UK,Ukraine,2,2,0,0,0,0,0,0,0
2025-05-12,UK,Ukraine,3,3,0,0,0,0,0,0,0
2025-05-13,UK,Ukraine,5,5,0,0,0,0,0,0,0
2025-05-14,UK,Ukraine,4,4,0,0,0,0,0,0,0
2025-05-15,UK,Ukraine,3,3,0,0,0,0,0,0,0
2025-05-16,UK,Ukraine,0,0,0,0,0,0,0,0,0
2025-05-17,UK,Ukraine,3,3,0,0,0,0,0,0,0
2025-05-18,UK,Ukraine,2,2,0,0,0,0,0,0,0
2025-05-19,UK,Ukraine,1,1,0,0,0,0,0,0,0
2025-05-20,UK,Ukraine,4,4,0,0,0,0,0,0,0
2025-05-21,UK,Ukraine,0,0,0,0,0,0,0,0,0
2025-05-22,UK,Ukraine,0,0,0,0,0,0,0,0,0
2025-05-23,UK,Ukraine,1,1,0,0,0,0,0,0,0
2025-05-24,UK,Ukraine,3,3,0,0,0,0,0,0,0
2025-05-25,UK,Ukraine,5,5,0,0,0,0,0,0,0
2025-05-26,UK,Ukraine,3,3,0,0,0,0,0,0,0
2025-05-27,UK,Ukraine,0,0,0,0,0,0,0,0,0
2025-05-28,UK,Ukraine,1,1,0,0,0,0,0,0,0
2025-05-29,UK,Ukraine,2,2,0,0,0,0,0,0,0
2025-05-30,UK,Ukraine,2,2,0,0,0,0,0,0,0
2025-05-31,UK,Ukraine,0,0,0,0,0,0,0,0,0
2025-06-01,UK,Ukraine,1,1,0,0,0,0,0,0,0
2025-06-02,UK,Ukraine,1,1,0,0,0,0,0,0,0
2025-06-03,UK,Ukraine,1,1,0,0,0,0,0,0,0
2025-06-04,UK,Ukraine,3,3,0,0,0,0,0,0,0
2025-06-05,UK,Ukraine,2,2,0,0,0,0,0,0,0
2025-06-06,UK,Ukraine,2,2,0,0,0,0,0,0,0
2025-06-07,UK,Ukraine,1,1,0,0,0,0,0,0,0
2025-06-08,UK,Ukraine,0,0,0,0,0,0,0,0,0
2025-06-09,UK,Ukraine,3,3,0,0,0,0,0,0,0
2025-06-10,UK,Ukraine,2,2,0,0,0,0,0,0,0
2025-06-11,UK,Ukraine,1,1,0,0,0,0,0,0,0
2025-06-12,UK,Ukraine,4,4,0,0,0,0,0,0,0
2025-06-13,UK,Ukraine,5,5,0,0,0,0,0,0,0
2025-06-14,UK,Ukraine,4,4,0,0,0,0,0,0,0
2025-06-15,UK,Ukraine,6,6,0,0,0,0,0,0,0
2025-06-16,UK,Ukraine,1,1,0,0,0,0,0,0,0
2025-06-17,UK,Ukraine,2,2,0,0,0,0,0,0,0
2025-06-18,UK,Ukraine,4,4,0,0,0,0,0,0,0
2025-06-19,UK,Ukraine,8,8,0,0,0,0,0,0,0
2025-06-20,UK,Ukraine,6,6,0,0,0,0,0,0,0
2025-06-21,UK,Ukraine,5,3,0,0,2,2,0,2,0
2025-06-22,UK,Ukraine,0,0,0,0,0,0,0,0,0
2025-06-23,UK,Ukraine,5,5,0,0,0,0,0,0,0
2025-06-24,UK,Ukraine,2,2,0,0,0,0,0,0,0
2025-06-25,UK,Ukraine,2,2,0,0,0,0,0,0,0
2025-06-26,UK,Ukraine,3,1,0,0,2,0,2,2,0
2025-06-27,UK,Ukraine,10,10,0,0,0,0,0,0,0
2025-06-28,UK,Ukraine,5,5,0,0,0,0,0,0,0
2025-06-29,UK,Ukraine,2,2,0,0,0,0,0,0,0
2025-06-30,UK,Ukraine,6,6,0,0,0,0,0,0,0
2025-07-01,UK,Ukraine,2,2,0,0,0,0,0,0,0
2025-07-02,UK,Ukraine,4,4,0,0,0,0,0,0,0
2025-07-03,UK,Ukraine,4,4,0,0,0,0,0,0,0
2025-07-04,UK,Ukraine,5,5,0,0,0,0,0,0,0
2025-07-05,UK,Ukraine,4,4,0,0,0,0,0,0,0
2025-07-06,UK,Ukraine,3,3,0,0,0,0,0,0,0
2025-07-07,UK,Ukraine,1,1,0,0,0,0,0,0,0
2025-07-08,UK,Ukraine,2,2,0,0,0,0,0,0,0
2025-07-09,UK,Ukraine,2,2,0,0,0,0,0,0,0
2025-07-10,UK,Ukraine,1,1,0,0,0,0,0,0,0
2025-07-11,UK,Ukraine,2,2,0,0,0,0,0,0,0
2025-07-12,UK,Ukraine,1,1,0,0,0,0,0,0,0
2025-07-13,UK,Ukraine,0,0,0,0,0,0,0,0,0
2025-07-14,UK,Ukraine,1,1,0,0,0,0,0,0,0
2025-07-15,UK,Ukraine,4,4,0,0,0,0,0,0,0
2025-07-16,UK,Ukraine,1,1,0,0,0,0,0,0,0
2025-07-17,UK,Ukraine,4,4,0,0,0,0,0,0,0
2025-07-18,UK,Ukraine,0,0,0,0,0,0,0,0,0
2025-07-19,UK,Ukraine,4,4,0,0,0,0,0,0,0
2025-07-20,UK,Ukraine,3,3,0,0,0,0,0,0,0
2025-07-21,UK,Ukraine,3,3,0,0,0,0,0,0,0
2025-07-22,UK,Ukraine,0,0,0,0,0,0,0,0,0
2025-07-23,UK,Ukraine,8,8,0,0,0,0,0,0,0
2025-07-24,UK,Ukraine,6,4,0,0,2,1,1,2,0
2025-07-25,UK,Ukraine,4,2,0,0,2,1,1,2,0
2025-07-26,UK,Ukraine,1,1,0,0,0,0,0,0,0
2025-07-27,UK,Ukraine,1,1,0,0,0,0,0,0,0
2025-07-28,UK,Ukraine,4,2,0,0,2,1,1,2,0
2025-07-29,UK,Ukraine,2,2,0,0,0,0,0,0,0
2025-07-30,UK,Ukraine,4,4,0,0,0,0,0,0,0
2025-07-31,UK,Ukraine,1,1,0,0,0,0,0,0,0
2025-08-01,UK,Ukraine,3,3,0,0,0,0,0,0,0
2025-08-02,UK,Ukraine,5,5,0,0,0,0,0,0,0
2025-08-03,UK,Ukraine,0,0,0,0,0,0,0,0,0
2025-08-04,UK,Ukraine,5,3,0,0,2,1,1,2,0
2025-08-05,UK,Ukraine,4,2,0,0,2,1,1,2,0
2025-08-06,UK,Ukraine,2,2,0,0,0,0,0,0,0
2025-08-07,UK,Ukraine,9,9,0,0,0,0,0,0,0
2025-08-08,UK,Ukraine,5,4,0,0,1,0,1,1,0
2025-08-09,UK,Ukraine,2,2,0,0,0,0,0,0,0
2025-08-10,UK,Ukraine,2,2,0,0,0,0,0,0,0
2025-08-11,UK,Ukraine,8,6,0,0,2,1,1,2,0
2025-08-12,UK,Ukraine,2,2,0,0,0,0,0,0,0
2025-08-13,UK,Ukraine,12,8,0,0,4,3,1,4,0
2025-08-14,UK,Ukraine,6,6,0,0,0,0,0,0,0
2025-08-15,UK,Ukraine,5,5,0,0,0,0,0,0,0
2025-08-16,UK,Ukraine,2,2,0,0,0,0,0,0,0
2025-08-17,UK,Ukraine,1,1,0,0,0,0,0,0,0
2025-08-18,UK,Ukraine,2,2,0,0,0,0,0,0,0
2025-08-19,UK,Ukraine,0,0,0,0,0,0,0,0,0
2025-08-20,UK,Ukraine,4,2,0,0,2,1,1,2,0
2025-08-21,UK,Ukraine,3,1,0,0,2,1,1,2,0
2025-08-22,UK,Ukraine,0,0,0,0,0,0,0,0,0
2025-08-23,UK,Ukraine,5,5,0,0,0,0,0,0,0
2025-08-24,UK,Ukraine,3,3,0,0,0,0,0,0,0
2025-08-25,UK,Ukraine,2,2,0,0,0,0,0,0,0
2025-08-26,UK,Ukraine,4,3,0,0,1,1,0,1,0
2025-08-27,UK,Ukraine,3,3,0,0,0,0,0,0,0
2025-08-28,UK,Ukraine,8,5,0,0,3,2,1,3,0
2025-08-29,UK,Ukraine,2,2,0,0,0,0,0,0,0
2025-01-01,EG,United Kingdom,5233,1189,426,1,4044,1804,1814,3618,425
2025-01-02,EG,United Kingdom,6380,1301,726,12,5079,2151,2202,4353,714
2025-01-03,EG,United Kingdom,6871,1405,856,14,5466,2294,2316,4610,842
2025-01-04,EG,United Kingdom,6430,1457,551,9,4973,2220,2202,4422,542
2025-01-05,EG,United Kingdom,6415,1480,617,5,4935,2136,2182,4318,612
2025-01-06,EG,United Kingdom,6466,1413,772,10,5053,2151,2130,4281,762
2025-01-07,EG,United Kingdom,5378,1161,651,16,4217,1783,1783,3566,635
2025-01-08,EG,United Kingdom,5003,1163,687,15,3840,1571,1582,3153,672
2025-01-09,EG,United Kingdom,5334,1224,747,20,4110,1671,1692,3363,727
2025-01-10,EG,United Kingdom,6152,1291,858,17,4861,2020,1983,4003,841
2025-01-11,EG,United Kingdom,5526,1312,440,8,4214,1896,1878,3774,432
2025-01-12,EG,United Kingdom,5990,1313,645,12,4677,2008,2024,4032,633
2025-01-13,EG,United Kingdom,5891,1328,762,18,4563,1900,1901,3801,744
2025-01-14,EG,United Kingdom,4791,1149,702,31,3642,1464,1476,2940,671
2025-01-15,EG,United Kingdom,4812,1144,664,16,3668,1501,1503,3004,648
2025-01-16,EG,United Kingdom,5383,1209,761,20,4174,1711,1702,3413,741
2025-01-17,EG,United Kingdom,6171,1327,867,12,4844,1993,1984,3977,855
2025-01-18,EG,United Kingdom,5547,1327,466,7,4220,1863,1891,3754,459
2025-01-19,EG,United Kingdom,5894,1257,609,13,4637,2006,2022,4028,596
2025-01-20,EG,United Kingdom,5957,1317,792,13,4640,1941,1907,3848,779
2025-01-21,EG,United Kingdom,4736,1074,689,19,3662,1477,1496,2973,670
2025-01-22,EG,United Kingdom,5030,1175,738,18,3855,1556,1561,3117,720
2025-01-23,EG,United Kingdom,5403,1167,791,20,4236,1737,1708,3445,771
2025-01-24,EG,United Kingdom,5154,1128,308,9,4026,1865,1853,3718,299
2025-01-25,EG,United Kingdom,5730,1301,502,11,4429,1958,1969,3927,491
2025-01-26,EG,United Kingdom,5882,1239,574,4,4643,2025,2044,4069,570
2025-01-27,EG,United Kingdom,5856,1235,793,16,4621,1918,1910,3828,777
2025-01-28,EG,United Kingdom,4840,1091,743,22,3749,1498,1508,3006,721
2025-01-29,EG,United Kingdom,4971,1086,759,22,3885,1574,1552,3126,737
2025-01-30,EG,United Kingdom,5520,1203,839,29,4317,1734,1744,3478,810
2025-01-31,EG,United Kingdom,6262,1249,883,14,5013,2060,2070,4130,869
2025-02-01,EG,United Kingdom,5790,1363,470,11,4427,1983,1974,3957,459
2025-02-02,EG,United Kingdom,6164,1243,667,12,4921,2107,2147,4254,655
2025-02-03,EG,United Kingdom,6062,1273,821,21,4789,2008,1960,3968,800
2025-02-04,EG,United Kingdom,5113,1099,743,20,4014,1644,1627,3271,723
2025-02-05,EG,United Kingdom,5234,1088,781,28,4146,1678,1687,3365,753
2025-02-06,EG,United Kingdom,5852,1227,834,25,4625,1906,1885,3791,809
2025-02-07,EG,United Kingdom,6596,1311,889,9,5285,2199,2197,4396,880
2025-02-08,EG,United Kingdom,6000,1362,502,6,4638,2060,2076,4136,496
2025-02-09,EG,United Kingdom,6337,1309,681,8,5028,2160,2187,4347,673
2025-02-10,EG,United Kingdom,6390,1329,876,11,5061,2094,2091,4185,865
2025-02-11,EG,United Kingdom,5412,1121,797,27,4291,1732,1762,3494,770
2025-02-12,EG,United Kingdom,5558,1106,813,16,4452,1814,1825,3639,797
2025-02-13,EG,United Kingdom,6209,1313,855,21,4896,2031,2010,4041,834
2025-02-14,EG,United Kingdom,7018,1383,904,6,5635,2360,2371,4731,898
2025-02-15,EG,United Kingdom,6577,1399,550,4,5178,2332,2296,4628,546
2025-02-16,EG,United Kingdom,6666,1373,668,7,5293,2313,2312,4625,661
2025-02-17,EG,United Kingdom,6592,1352,864,21,5240,2202,2174,4376,843
2025-02-18,EG,United Kingdom,5864,1194,795,24,4670,1937,1938,3875,771
2025-02-19,EG,United Kingdom,5937,1208,797,21,4729,1965,1967,3932,776
2025-02-20,EG,United Kingdom,6324,1234,822,21,5090,2132,2136,4268,801
2025-02-21,EG,United Kingdom,6776,1384,787,5,5392,2298,2307,4605,782
2025-02-22,EG,United Kingdom,6546,1385,559,13,5161,2276,2326,4602,546
2025-02-23,EG,United Kingdom,6803,1351,620,10,5452,2402,2430,4832,610
2025-02-24,EG,United Kingdom,6683,1336,897,12,5347,2246,2204,4450,885
2025-02-25,EG,United Kingdom,5672,1187,798,15,4485,1840,1847,3687,783
2025-02-26,EG,United Kingdom,5782,1238,795,13,4544,1873,1876,3749,782
2025-02-27,EG,United Kingdom,6229,1241,870,17,4988,2079,2039,4118,853
2025-02-28,EG,United Kingdom,6820,1403,908,23,5417,2259,2250,4509,885
2025-03-01,EG,United Kingdom,6194,1420,519,5,4774,2133,2122,4255,514
2025-03-02,EG,United Kingdom,6627,1426,676,5,5201,2241,2284,4525,671
2025-03-03,EG,United Kingdom,6749,1419,915,20,5330,2213,2202,4415,895
2025-03-04,EG,United Kingdom,5893,1286,812,23,4607,1895,1900,3795,789
2025-03-05,EG,United Kingdom,6063,1352,814,18,4711,1955,1942,3897,796
2025-03-06,EG,United Kingdom,6407,1336,882,28,5071,2090,2099,4189,854
2025-03-07,EG,United Kingdom,7044,1487,945,19,5557,2305,2307,4612,926
2025-03-08,EG,United Kingdom,6300,1469,549,5,4831,2150,2132,4282,544
2025-03-09,EG,United Kingdom,6700,1506,670,10,5194,2253,2271,4524,660
2025-03-10,EG,United Kingdom,6376,1293,860,13,5083,2119,2104,4223,847
2025-03-11,EG,United Kingdom,5948,1289,820,18,4659,1922,1917,3839,802
2025-03-12,EG,United Kingdom,6076,1361,814,13,4715,1948,1953,3901,801
2025-03-13,EG,United Kingdom,6541,1407,868,15,5134,2131,2135,4266,853
2025-03-14,EG,United Kingdom,7066,1500,925,9,5566,2341,2300,4641,916
2025-03-15,EG,United Kingdom,6323,1507,548,9,4816,2129,2139,4268,539
2025-03-16,EG,United Kingdom,6681,1471,660,6,5210,2252,2298,4550,654
2025-03-17,EG,United Kingdom,6781,1476,884,11,5305,2219,2202,4421,873
2025-03-18,EG,United Kingdom,5953,1292,841,17,4661,1911,1909,3820,824
2025-03-19,EG,United Kingdom,5949,1316,775,14,4633,1911,1947,3858,761
2025-03-20,EG,United Kingdom,6539,1424,870,21,5115,2132,2113,4245,849
2025-03-21,EG,United Kingdom,5875,1490,764,17,4385,1783,1838,3621,747
2025-03-22,EG,United Kingdom,6257,1488,547,8,4769,2115,2107,4222,539
2025-03-23,EG,United Kingdom,6726,1495,683,8,5231,2271,2277,4548,675
2025-03-24,EG,United Kingdom,6749,1458,884,25,5291,2203,2204,4407,859
2025-03-25,EG,United Kingdom,5940,1328,829,17,4612,1902,1881,3783,812
2025-03-26,EG,United Kingdom,6118,1351,848,30,4767,1954,1965,3919,818
2025-03-27,EG,United Kingdom,6557,1431,842,17,5126,2145,2139,4284,825
2025-03-28,EG,United Kingdom,7011,1469,941,14,5542,2302,2299,4601,927
2025-03-29,EG,United Kingdom,6278,1445,568,6,4833,2143,2122,4265,562
2025-03-30,EG,United Kingdom,7008,1675,642,8,5333,2326,2365,4691,634
2025-03-31,EG,United Kingdom,7266,1686,873,24,5580,2343,2364,4707,849
2025-04-01,EG,United Kingdom,7103,1648,872,27,5455,2303,2280,4583,845
2025-04-02,EG,United Kingdom,7219,1685,884,31,5534,2319,2331,4650,853
2025-04-03,EG,United Kingdom,7490,1692,891,21,5798,2459,2448,4907,870
2025-04-04,EG,United Kingdom,7679,1717,891,11,5962,2547,2524,5071,880
2025-04-05,EG,United Kingdom,7069,1709,537,14,5360,2412,2411,4823,523
2025-04-06,EG,United Kingdom,7318,1726,675,12,5592,2458,2459,4917,663
2025-04-07,EG,United Kingdom,7544,1737,879,25,5807,2467,2461,4928,854
2025-04-08,EG,United Kingdom,7204,1664,839,23,5540,2349,2352,4701,816
2025-04-09,EG,United Kingdom,7196,1722,851,25,5474,2324,2299,4623,826
2025-04-10,EG,United Kingdom,7625,1779,878,13,5846,2490,2478,4968,865
2025-04-11,EG,United Kingdom,7716,1808,877,17,5908,2514,2517,5031,860
2025-04-12,EG,United Kingdom,7111,1766,542,8,5345,2406,2397,4803,534
2025-04-13,EG,United Kingdom,7327,1687,699,4,5640,2443,2498,4941,695
2025-04-14,EG,United Kingdom,7450,1662,874,16,5788,2463,2451,4914,858
2025-04-15,EG,United Kingdom,7147,1644,823,11,5503,2350,2330,4680,812
2025-04-16,EG,United Kingdom,7220,1651,827,16,5569,2370,2372,4742,811
2025-04-17,EG,United Kingdom,7660,1752,925,19,5908,2492,2491,4983,906
2025-04-18,EG,United Kingdom,7471,1705,780,1,5766,2495,2491,4986,779
2025-04-19,EG,United Kingdom,6881,1654,536,5,5227,2357,2334,4691,531
2025-04-20,EG,United Kingdom,7225,1726,631,6,5499,2426,2442,4868,625
2025-04-21,EG,United Kingdom,7539,1745,780,4,5794,2488,2526,5014,776
2025-04-22,EG,United Kingdom,7237,1674,831,18,5563,2355,2377,4732,813
2025-04-23,EG,United Kingdom,7339,1727,834,16,5612,2389,2389,4778,818
2025-04-24,EG,United Kingdom,7626,1793,877,14,5833,2488,2468,4956,863
2025-04-25,EG,United Kingdom,7791,1751,937,11,6040,2565,2538,5103,926
2025-04-26,EG,United Kingdom,6905,1687,541,9,5218,2333,2344,4677,532
2025-04-27,EG,United Kingdom,7353,1732,708,7,5621,2445,2468,4913,701
2025-04-28,EG,United Kingdom,7365,1646,864,26,5719,2416,2439,4855,838
2025-04-29,EG,United Kingdom,7286,1736,857,29,5550,2359,2334,4693,828
2025-04-30,EG,United Kingdom,7454,1788,883,31,5666,2394,2389,4783,852
2025-05-01,EG,United Kingdom,7856,1774,909,21,6082,2589,2584,5173,888
2025-05-02,EG,United Kingdom,8039,1814,930,16,6225,2651,2644,5295,914
2025-05-03,EG,United Kingdom,7319,1823,561,9,5496,2484,2451,4935,552
2025-05-04,EG,United Kingdom,7648,1837,658,7,5811,2576,2577,5153,651
2025-05-05,EG,United Kingdom,7830,1854,771,7,5976,2571,2634,5205,764
2025-05-06,EG,United Kingdom,7617,1764,835,25,5853,2505,2513,5018,810
2025-05-07,EG,United Kingdom,7735,1816,854,23,5919,2532,2533,5065,831
2025-05-08,EG,United Kingdom,8044,1839,943,17,6205,2622,2640,5262,926
2025-05-09,EG,United Kingdom,8141,1895,933,16,6246,2656,2657,5313,917
2025-05-10,EG,United Kingdom,7398,1821,593,17,5577,2508,2476,4984,576
2025-05-11,EG,United Kingdom,7796,1861,724,5,5935,2598,2613,5211,719
2025-05-12,EG,United Kingdom,8047,1861,902,18,6186,2639,2645,5284,884
2025-05-13,EG,United Kingdom,7697,1819,839,16,5878,2508,2531,5039,823
2025-05-14,EG,United Kingdom,7811,1802,895,20,6009,2556,2558,5114,875
2025-05-15,EG,United Kingdom,8167,1870,944,20,6297,2674,2679,5353,924
2025-05-16,EG,United Kingdom,8217,1871,915,10,6346,2729,2702,5431,905
2025-05-17,EG,United Kingdom,7414,1786,602,14,5628,2507,2519,5026,588
2025-05-18,EG,United Kingdom,7794,1836,678,8,5958,2636,2644,5280,670
2025-05-19,EG,United Kingdom,8144,1936,909,23,6208,2645,2654,5299,886
2025-05-20,EG,United Kingdom,7967,1886,865,16,6081,2603,2613,5216,849
2025-05-21,EG,United Kingdom,8090,1878,872,12,6212,2689,2651,5340,860
2025-05-22,EG,United Kingdom,8576,1886,932,9,6690,2857,2901,5758,923
2025-05-23,EG,United Kingdom,8603,1894,941,8,6709,2900,2868,5768,933
2025-05-24,EG,United Kingdom,7728,1805,568,4,5923,2706,2649,5355,564
2025-05-25,EG,United Kingdom,7962,1838,701,3,6124,2715,2708,5423,698
2025-05-26,EG,United Kingdom,8291,1882,836,8,6409,2770,2803,5573,828
2025-05-27,EG,United Kingdom,7963,1773,808,7,6190,2690,2692,5382,801
2025-05-28,EG,United Kingdom,7989,1735,856,12,6254,2705,2693,5398,844
2025-05-29,EG,United Kingdom,8266,1940,885,11,6326,2717,2724,5441,874
2025-05-30,EG,United Kingdom,8376,1887,939,15,6489,2771,2779,5550,924
2025-05-31,EG,United Kingdom,7731,1844,583,7,5887,2657,2647,5304,576
2025-06-01,EG,United Kingdom,8206,1915,694,5,6291,2783,2814,5597,689
2025-06-02,EG,United Kingdom,8367,1929,914,14,6438,2763,2761,5524,900
2025-06-03,EG,United Kingdom,8073,1860,861,11,6213,2664,2688,5352,850
2025-06-04,EG,United Kingdom,8223,1909,886,18,6314,2716,2712,5428,868
2025-06-05,EG,United Kingdom,8414,1948,921,18,6466,2769,2776,5545,903
2025-06-06,EG,United Kingdom,8478,1885,939,13,6593,2826,2828,5654,926
2025-06-07,EG,United Kingdom,7736,1837,599,11,5899,2659,2641,5300,588
2025-06-08,EG,United Kingdom,8133,1844,744,8,6289,2741,2804,5545,736
2025-06-09,EG,United Kingdom,8385,1899,916,15,6486,2799,2771,5570,901
2025-06-10,EG,United Kingdom,8216,1954,874,18,6262,2689,2699,5388,856
2025-06-11,EG,United Kingdom,8313,1965,884,21,6348,2735,2729,5464,863
2025-06-12,EG,United Kingdom,8491,2006,882,25,6485,2824,2779,5603,857
2025-06-13,EG,United Kingdom,8435,1942,903,14,6493,2808,2782,5590,889
2025-06-14,EG,United Kingdom,7984,2119,549,8,5865,2665,2651,5316,541
2025-06-15,EG,United Kingdom,8248,2046,703,7,6202,2716,2783,5499,696
2025-06-16,EG,United Kingdom,8477,2017,890,22,6460,2776,2794,5570,868
2025-06-17,EG,United Kingdom,8144,1928,845,27,6216,2687,2684,5371,818
2025-06-18,EG,United Kingdom,8337,1990,873,25,6347,2729,2745,5474,848
2025-06-19,EG,United Kingdom,8563,2062,921,23,6501,2784,2796,5580,898
2025-06-20,EG,United Kingdom,8582,1956,939,12,6626,2860,2827,5687,927
2025-06-21,EG,United Kingdom,7926,1978,590,18,5948,2678,2680,5358,572
2025-06-22,EG,United Kingdom,8328,2018,733,8,6310,2772,2805,5577,725
2025-06-23,EG,United Kingdom,8425,1953,877,12,6472,2795,2800,5595,865
2025-06-24,EG,United Kingdom,8269,2041,790,13,6228,2726,2712,5438,777
2025-06-25,EG,United Kingdom,8414,2146,857,22,6268,2701,2710,5411,835
2025-06-26,EG,United Kingdom,8520,1991,945,16,6529,2803,2781,5584,929
2025-06-27,EG,United Kingdom,8630,2054,876,10,6576,2842,2858,5700,866
2025-06-28,EG,United Kingdom,8029,2045,566,14,5984,2719,2699,5418,552
2025-06-29,EG,United Kingdom,8466,2103,705,15,6363,2795,2863,5658,690
2025-06-30,EG,United Kingdom,8635,2050,932,25,6585,2838,2815,5653,907
2025-07-01,EG,United Kingdom,8380,2035,835,15,6345,2745,2765,5510,820
2025-07-02,EG,United Kingdom,8388,2016,871,21,6372,2741,2760,5501,850
2025-07-03,EG,United Kingdom,8295,2064,909,20,6231,2674,2648,5322,889
2025-07-04,EG,United Kingdom,8523,1977,902,16,6546,2812,2832,5644,886
2025-07-05,EG,United Kingdom,8102,2004,587,7,6098,2768,2743,5511,580
2025-07-06,EG,United Kingdom,8267,2013,699,4,6254,2767,2788,5555,695
2025-07-07,EG,United Kingdom,8672,2041,911,12,6631,2856,2864,5720,899
2025-07-08,EG,United Kingdom,8312,1992,833,18,6320,2752,2735,5487,815
2025-07-09,EG,United Kingdom,8484,2025,848,18,6459,2789,2822,5611,830
2025-07-10,EG,United Kingdom,8743,2062,910,19,6681,2894,2877,5771,891
2025-07-11,EG,United Kingdom,8727,1998,917,13,6729,2882,2930,5812,904
2025-07-12,EG,United Kingdom,8208,1999,638,12,6209,2796,2775,5571,626
2025-07-13,EG,United Kingdom,8454,1982,748,21,6472,2852,2872,5724,727
2025-07-14,EG,United Kingdom,8692,2053,893,14,6639,2919,2827,5746,879
2025-07-15,EG,United Kingdom,8292,1926,817,23,6366,2782,2767,5549,794
2025-07-16,EG,United Kingdom,8408,2011,825,19,6397,2775,2797,5572,806
2025-07-17,EG,United Kingdom,8603,2063,892,36,6540,2822,2826,5648,856
2025-07-18,EG,United Kingdom,8721,1978,913,17,6743,2911,2919,5830,896
2025-07-19,EG,United Kingdom,8006,1988,594,6,6018,2716,2708,5424,588
2025-07-20,EG,United Kingdom,8436,2082,726,8,6354,2791,2837,5628,718
2025-07-21,EG,United Kingdom,8610,2038,867,13,6572,2873,2832,5705,854
2025-07-22,EG,United Kingdom,8369,2018,809,19,6351,2782,2760,5542,790
2025-07-23,EG,United Kingdom,8431,2021,853,12,6410,2764,2793,5557,841
2025-07-24,EG,United Kingdom,8617,2089,908,12,6528,2812,2808,5620,896
2025-07-25,EG,United Kingdom,8663,1992,916,11,6671,2871,2884,5755,905
2025-07-26,EG,United Kingdom,7992,1934,562,4,6058,2774,2722,5496,558
2025-07-27,EG,United Kingdom,8324,1991,687,2,6333,2810,2836,5646,685
2025-07-28,EG,United Kingdom,8426,1940,887,16,6486,2799,2800,5599,871
2025-07-29,EG,United Kingdom,8340,2020,802,17,6320,2759,2759,5518,785
2025-07-30,EG,United Kingdom,8059,1881,834,23,6178,2691,2653,5344,811
2025-07-31,EG,United Kingdom,8639,2099,889,24,6540,2822,2829,5651,865
2025-08-01,EG,United Kingdom,8622,1991,881,17,6631,2870,2880,5750,864
2025-08-02,EG,United Kingdom,8047,2044,557,6,6003,2739,2707,5446,551
2025-08-03,EG,United Kingdom,8239,1961,690,3,6278,2766,2822,5588,687
2025-08-04,EG,United Kingdom,8205,1932,709,15,6273,2786,2778,5564,694
2025-08-05,EG,United Kingdom,8160,1938,795,14,6222,2719,2708,5427,781
2025-08-06,EG,United Kingdom,8332,2032,867,23,6300,2721,2712,5433,844
2025-08-07,EG,United Kingdom,8485,2047,880,14,6438,2787,2771,5558,866
2025-08-08,EG,United Kingdom,8567,1972,917,21,6595,2835,2843,5678,896
2025-08-09,EG,United Kingdom,8011,2012,567,7,5999,2739,2693,5432,560
2025-08-10,EG,United Kingdom,8327,2047,701,6,6280,2775,2804,5579,695
2025-08-11,EG,United Kingdom,8450,2006,877,26,6444,2778,2789,5567,851
2025-08-12,EG,United Kingdom,8226,1988,781,26,6238,2729,2728,5457,755
2025-08-13,EG,United Kingdom,8249,1987,813,25,6262,2729,2720,5449,788
2025-08-14,EG,United Kingdom,8498,2039,882,19,6459,2778,2799,5577,863
2025-08-15,EG,United Kingdom,8556,1999,879,15,6557,2848,2830,5678,864
2025-08-16,EG,United Kingdom,7920,1889,601,6,6031,2720,2710,5430,595
2025-08-17,EG,United Kingdom,8198,1919,708,11,6279,2778,2793,5571,697
2025-08-18,EG,United Kingdom,8528,2009,896,16,6519,2807,2816,5623,880
2025-08-19,EG,United Kingdom,8182,1999,791,7,6183,2708,2684,5392,784
2025-08-20,EG,United Kingdom,8279,2032,810,17,6247,2705,2732,5437,793
2025-08-21,EG,United Kingdom,8644,2134,905,25,6510,2803,2802,5605,880
2025-08-22,EG,United Kingdom,8695,2058,891,10,6637,2880,2866,5746,881
2025-08-23,EG,United Kingdom,8030,1957,581,10,6073,2760,2732,5492,571
2025-08-24,EG,United Kingdom,8312,1951,720,10,6361,2836,2805,5641,710
2025-08-25,EG,United Kingdom,8379,1985,780,21,6394,2783,2831,5614,759
2025-08-26,EG,United Kingdom,8394,2041,799,10,6353,2782,2772,5554,789
2025-08-27,EG,United Kingdom,8294,1998,782,8,6296,2746,2768,5514,774
2025-08-28,EG,United Kingdom,8558,2035,853,13,6523,2835,2835,5670,840
2025-08-29,EG,United Kingdom,8696,2051,874,8,6645,2908,2863,5771,866
