entry_date,country_icao_code,country_name,flt_daio,flt_o,flt_i,flt_c,flt_dai,flt_d,flt_a,flt_da,flt_i_excl_c
2022-01-01,LA,Albania,450,398,0,0,52,26,26,52,0
2022-01-02,LA,Albania,581,482,0,0,99,47,52,99,0
2022-01-03,LA,Albania,433,341,0,0,92,47,45,92,0
2022-01-04,LA,Albania,406,316,0,0,90,46,44,90,0
2022-01-05,LA,Albania,430,348,0,0,82,41,41,82,0
2022-01-06,LA,Albania,458,362,0,0,96,47,49,96,0
2022-01-07,LA,Albania,451,361,0,0,90,45,45,90,0
2022-01-08,LA,Albania,531,456,0,0,75,38,37,75,0
2022-01-09,LA,Albania,526,440,0,0,86,44,42,86,0
2022-01-10,LA,Albania,340,252,0,0,88,42,46,88,0
2022-01-11,LA,Albania,288,221,0,0,67,34,33,67,0
2022-01-12,LA,Albania,272,213,0,0,59,30,29,59,0
2022-01-13,LA,Albania,299,221,0,0,78,38,40,78,0
2022-01-14,LA,Albania,411,328,0,0,83,42,41,83,0
2022-01-15,LA,Albania,386,321,0,0,65,33,32,65,0
2022-01-16,LA,Albania,404,333,0,0,71,35,36,71,0
2022-01-17,LA,Albania,322,233,1,1,89,43,45,88,0
2022-01-18,LA,Albania,273,212,1,1,61,31,29,60,0
2022-01-19,LA,Albania,251,197,0,0,54,27,27,54,0
2022-01-20,LA,Albania,296,221,0,0,75,38,37,75,0
2022-01-21,LA,Albania,354,285,0,0,69,35,34,69,0
2022-01-22,LA,Albania,365,309,0,0,56,28,28,56,0
2022-01-23,LA,Albania,349,278,0,0,71,35,36,71,0
2022-01-24,LA,Albania,238,176,0,0,62,32,30,62,0
2022-01-25,LA,Albania,210,155,0,0,55,27,28,55,0
2022-01-26,LA,Albania,247,203,0,0,44,21,23,44,0
2022-01-27,LA,Albania,250,177,0,0,73,37,36,73,0
2022-01-28,LA,Albania,351,273,0,0,78,39,39,78,0
2022-01-29,LA,Albania,320,271,0,0,49,25,24,49,0
2022-01-30,LA,Albania,389,314,0,0,75,37,38,75,0
2022-01-31,LA,Albania,277,216,0,0,61,31,30,61,0
2022-02-01,LA,Albania,256,205,0,0,51,25,26,51,0
2022-02-02,LA,Albania,259,214,0,0,45,23,22,45,0
2022-02-03,LA,Albania,249,183,0,0,66,33,33,66,0
2022-02-04,LA,Albania,385,307,2,0,78,37,39,76,2
2022-02-05,LA,Albania,389,340,0,0,49,25,24,49,0
2022-02-06,LA,Albania,358,283,0,0,75,37,38,75,0
2022-02-07,LA,Albania,277,207,0,0,70,36,34,70,0
2022-02-08,LA,Albania,231,182,0,0,49,24,25,49,0
2022-02-09,LA,Albania,273,230,0,0,43,21,22,43,0
2022-02-10,LA,Albania,309,234,0,0,75,38,37,75,0
2022-02-11,LA,Albania,383,310,0,0,73,36,37,73,0
2022-02-12,LA,Albania,413,358,0,0,55,27,28,55,0
2022-02-13,LA,Albania,423,343,0,0,80,41,39,80,0
2022-02-14,LA,Albania,277,212,0,0,65,34,31,65,0
2022-02-15,LA,Albania,259,207,0,0,52,25,27,52,0
2022-02-16,LA,Albania,302,248,0,0,54,26,28,54,0
2022-02-17,LA,Albania,318,231,0,0,87,44,43,87,0
2022-02-18,LA,Albania,396,321,0,0,75,37,38,75,0
2022-02-19,LA,Albania,414,357,0,0,57,30,27,57,0
2022-02-20,LA,Albania,434,355,0,0,79,39,40,79,0
2022-02-21,LA,Albania,316,247,0,0,69,34,35,69,0
2022-02-22,LA,Albania,285,220,0,0,65,33,32,65,0
2022-02-23,LA,Albania,297,255,0,0,42,21,21,42,0
2022-02-24,LA,Albania,308,232,0,0,76,38,38,76,0
2022-02-25,LA,Albania,438,364,0,0,74,36,38,74,0
2022-02-26,LA,Albania,391,335,0,0,56,29,27,56,0
2022-02-27,LA,Albania,421,338,0,0,83,40,43,83,0
2022-02-28,LA,Albania,336,262,0,0,74,38,36,74,0
2022-03-01,LA,Albania,299,233,0,0,66,33,33,66,0
2022-03-02,LA,Albania,268,208,0,0,60,29,31,60,0
2022-03-03,LA,Albania,351,271,0,0,80,40,40,80,0
2022-03-04,LA,Albania,399,317,0,0,82,41,41,82,0
2022-03-05,LA,Albania,377,318,0,0,59,30,29,59,0
2022-03-06,LA,Albania,401,323,0,0,78,38,40,78,0
2022-03-07,LA,Albania,346,265,0,0,81,42,39,81,0
2022-03-08,LA,Albania,309,244,0,0,65,33,32,65,0
2022-03-09,LA,Albania,315,253,0,0,62,30,32,62,0
2022-03-10,LA,Albania,326,246,0,0,80,40,40,80,0
2022-03-11,LA,Albania,415,333,0,0,82,41,41,82,0
2022-03-12,LA,Albania,422,364,0,0,58,28,30,58,0
2022-03-13,LA,Albania,415,336,0,0,79,39,40,79,0
2022-03-14,LA,Albania,397,317,0,0,80,41,39,80,0
2022-03-15,LA,Albania,349,288,0,0,61,30,31,61,0
2022-03-16,LA,Albania,378,316,0,0,62,32,30,62,0
2022-03-17,LA,Albania,343,264,0,0,79,39,40,79,0
2022-03-18,LA,Albania,405,324,0,0,81,41,40,81,0
2022-03-19,LA,Albania,468,404,0,0,64,32,32,64,0
2022-03-20,LA,Albania,433,357,0,0,76,37,39,76,0
2022-03-21,LA,Albania,357,277,0,0,80,40,40,80,0
2022-03-22,LA,Albania,333,263,0,0,70,35,35,70,0
2022-03-23,LA,Albania,357,284,0,0,73,36,37,73,0
2022-03-24,LA,Albania,381,285,0,0,96,49,47,96,0
2022-03-25,LA,Albania,449,365,0,0,84,41,43,84,0
2022-03-26,LA,Albania,444,378,0,0,66,34,32,66,0
2022-03-27,LA,Albania,545,453,0,0,92,46,46,92,0
2022-03-28,LA,Albania,407,326,0,0,81,41,40,81,0
2022-03-29,LA,Albania,395,318,0,0,77,39,38,77,0
2022-03-30,LA,Albania,447,358,0,0,89,44,45,89,0
2022-03-31,LA,Albania,441,355,0,0,86,42,44,86,0
2022-04-01,LA,Albania,479,391,0,0,88,44,44,88,0
2022-04-02,LA,Albania,554,475,0,0,79,40,39,79,0
2022-04-03,LA,Albania,578,482,0,0,96,47,49,96,0
2022-04-04,LA,Albania,423,333,0,0,90,46,44,90,0
2022-04-05,LA,Albania,411,331,0,0,80,41,39,80,0
2022-04-06,LA,Albania,473,382,0,0,91,44,47,91,0
2022-04-07,LA,Albania,423,335,0,0,88,44,44,88,0
2022-04-08,LA,Albania,583,491,0,0,92,46,46,92,0
2022-04-09,LA,Albania,686,601,2,0,85,42,41,83,2
2022-04-10,LA,Albania,670,570,0,0,100,49,51,100,0
2022-04-11,LA,Albania,540,442,0,0,98,49,49,98,0
2022-04-12,LA,Albania,502,413,0,0,89,45,44,89,0
2022-04-13,LA,Albania,607,503,0,0,104,51,53,104,0
2022-04-14,LA,Albania,557,454,0,0,103,52,51,103,0
2022-04-15,LA,Albania,703,597,0,0,106,53,53,106,0
2022-04-16,LA,Albania,752,658,0,0,94,48,46,94,0
2022-04-17,LA,Albania,666,563,0,0,103,51,52,103,0
2022-04-18,LA,Albania,528,415,0,0,113,56,57,113,0
2022-04-19,LA,Albania,469,381,0,0,88,45,43,88,0
2022-04-20,LA,Albania,576,460,0,0,116,57,59,116,0
2022-04-21,LA,Albania,585,484,0,0,101,52,49,101,0
2022-04-22,LA,Albania,639,522,0,0,117,56,61,117,0
2022-04-23,LA,Albania,745,650,2,0,95,48,45,93,2
2022-04-24,LA,Albania,810,701,0,0,109,53,56,109,0
2022-04-25,LA,Albania,598,492,0,0,106,54,52,106,0
2022-04-26,LA,Albania,540,444,0,0,96,48,48,96,0
2022-04-27,LA,Albania,620,513,0,0,107,54,53,107,0
2022-04-28,LA,Albania,551,442,0,0,109,53,56,109,0
2022-04-29,LA,Albania,712,597,0,0,115,58,57,115,0
2022-04-30,LA,Albania,821,721,2,0,100,50,48,98,2
2022-05-01,LA,Albania,795,686,0,0,109,53,56,109,0
2022-05-02,LA,Albania,615,513,0,0,102,52,50,102,0
2022-05-03,LA,Albania,606,492,2,0,114,56,56,112,2
2022-05-04,LA,Albania,602,489,0,0,113,57,56,113,0
2022-05-05,LA,Albania,589,485,0,0,104,51,53,104,0
2022-05-06,LA,Albania,797,685,0,0,112,57,55,112,0
2022-05-07,LA,Albania,832,733,2,0,99,48,49,97,2
2022-05-08,LA,Albania,797,692,0,0,105,52,53,105,0
2022-05-09,LA,Albania,594,475,0,0,119,59,60,119,0
2022-05-10,LA,Albania,591,472,3,1,119,58,58,116,2
2022-05-11,LA,Albania,615,500,0,0,115,58,57,115,0
2022-05-12,LA,Albania,580,471,0,0,109,55,54,109,0
2022-05-13,LA,Albania,708,600,0,0,108,54,54,108,0
2022-05-14,LA,Albania,889,788,2,0,101,49,50,99,2
2022-05-15,LA,Albania,813,713,0,0,100,50,50,100,0
2022-05-16,LA,Albania,649,529,0,0,120,61,59,120,0
2022-05-17,LA,Albania,655,547,0,0,108,53,55,108,0
2022-05-18,LA,Albania,676,556,0,0,120,60,60,120,0
2022-05-19,LA,Albania,582,477,0,0,105,54,51,105,0
2022-05-20,LA,Albania,800,682,0,0,118,56,62,118,0
2022-05-21,LA,Albania,949,846,2,0,103,51,50,101,2
2022-05-22,LA,Albania,888,785,0,0,103,51,52,103,0
2022-05-23,LA,Albania,668,557,0,0,111,57,54,111,0
2022-05-24,LA,Albania,718,572,2,0,146,69,75,144,2
2022-05-25,LA,Albania,766,613,0,0,153,68,85,153,0
2022-05-26,LA,Albania,791,611,0,0,180,101,79,180,0
2022-05-27,LA,Albania,895,770,0,0,125,63,62,125,0
2022-05-28,LA,Albania,1064,952,2,0,112,56,54,110,2
2022-05-29,LA,Albania,938,844,0,0,94,48,46,94,0
2022-05-30,LA,Albania,788,665,1,1,123,61,61,122,0
2022-05-31,LA,Albania,800,682,2,0,118,57,59,116,2
2022-06-01,LA,Albania,858,741,0,0,117,58,59,117,0
2022-06-02,LA,Albania,792,679,1,1,113,56,56,112,0
2022-06-03,LA,Albania,968,847,0,0,121,61,60,121,0
2022-06-04,LA,Albania,1083,971,0,0,112,56,56,112,0
2022-06-05,LA,Albania,993,885,1,0,108,54,53,107,1
2022-06-06,LA,Albania,942,806,0,0,136,67,69,136,0
2022-06-07,LA,Albania,865,746,0,0,119,60,59,119,0
2022-06-08,LA,Albania,846,743,0,0,103,53,50,103,0
2022-06-09,LA,Albania,675,556,0,0,119,58,61,119,0
2022-06-10,LA,Albania,911,777,0,0,134,64,70,134,0
2022-06-11,LA,Albania,1039,912,2,0,127,67,58,125,2
2022-06-12,LA,Albania,978,871,0,0,107,53,54,107,0
2022-06-13,LA,Albania,925,796,0,0,129,63,66,129,0
2022-06-14,LA,Albania,829,708,0,0,121,60,61,121,0
2022-06-15,LA,Albania,915,808,0,0,107,55,52,107,0
2022-06-16,LA,Albania,870,731,0,0,139,69,70,139,0
2022-06-17,LA,Albania,960,831,0,0,129,64,65,129,0
2022-06-18,LA,Albania,1113,994,0,0,119,61,58,119,0
2022-06-19,LA,Albania,1009,904,0,0,105,53,52,105,0
2022-06-20,LA,Albania,913,768,0,0,145,70,75,145,0
2022-06-21,LA,Albania,904,788,0,0,116,60,56,116,0
2022-06-22,LA,Albania,967,850,0,0,117,58,59,117,0
2022-06-23,LA,Albania,819,677,0,0,142,69,73,142,0
2022-06-24,LA,Albania,1014,880,0,0,134,67,67,134,0
2022-06-25,LA,Albania,1094,959,0,0,135,68,67,135,0
2022-06-26,LA,Albania,1052,930,0,0,122,61,61,122,0
2022-06-27,LA,Albania,956,802,0,0,154,77,77,154,0
2022-06-28,LA,Albania,934,796,2,0,138,66,70,136,2
2022-06-29,LA,Albania,881,761,0,0,120,62,58,120,0
2022-06-30,LA,Albania,866,725,0,0,141,69,72,141,0
2022-07-01,LA,Albania,1016,879,0,0,137,69,68,137,0
2022-07-02,LA,Albania,1162,1036,0,0,126,64,62,126,0
2022-07-03,LA,Albania,1087,953,0,0,134,68,66,134,0
2022-07-04,LA,Albania,967,813,0,0,154,75,79,154,0
2022-07-05,LA,Albania,1118,967,0,0,151,76,75,151,0
2022-07-06,LA,Albania,1051,915,0,0,136,68,68,136,0
2022-07-07,LA,Albania,994,845,0,0,149,73,76,149,0
2022-07-08,LA,Albania,1150,1003,0,0,147,75,72,147,0
2022-07-09,LA,Albania,1164,1027,0,0,137,69,68,137,0
2022-07-10,LA,Albania,1116,995,0,0,121,59,62,121,0
2022-07-11,LA,Albania,1009,859,0,0,150,73,77,150,0
2022-07-12,LA,Albania,1047,903,2,0,144,72,70,142,2
2022-07-13,LA,Albania,988,864,0,0,124,63,61,124,0
2022-07-14,LA,Albania,968,817,0,0,151,74,77,151,0
2022-07-15,LA,Albania,1117,971,0,0,146,73,73,146,0
2022-07-16,LA,Albania,1240,1112,0,0,128,65,63,128,0
2022-07-17,LA,Albania,1164,1042,0,0,122,61,61,122,0
2022-07-18,LA,Albania,1006,845,1,1,161,80,80,160,0
2022-07-19,LA,Albania,961,815,2,0,146,72,72,144,2
2022-07-20,LA,Albania,989,857,0,0,132,68,64,132,0
2022-07-21,LA,Albania,1001,855,0,0,146,72,74,146,0
2022-07-22,LA,Albania,1134,981,0,0,153,76,77,153,0
2022-07-23,LA,Albania,1202,1061,0,0,141,70,71,141,0
2022-07-24,LA,Albania,1211,1078,0,0,133,66,67,133,0
2022-07-25,LA,Albania,1056,888,0,0,168,84,84,168,0
2022-07-26,LA,Albania,1063,914,2,0,149,75,72,147,2
2022-07-27,LA,Albania,1045,910,0,0,135,69,66,135,0
2022-07-28,LA,Albania,952,804,0,0,148,72,76,148,0
2022-07-29,LA,Albania,1163,998,0,0,165,84,81,165,0
2022-07-30,LA,Albania,1218,1077,2,0,141,70,69,139,2
2022-07-31,LA,Albania,1156,1015,0,0,141,69,72,141,0
2022-08-01,LA,Albania,1096,930,0,0,166,82,84,166,0
2022-08-02,LA,Albania,993,849,2,0,144,71,71,142,2
2022-08-03,LA,Albania,1043,903,0,0,140,72,68,140,0
2022-08-04,LA,Albania,984,830,0,0,154,75,79,154,0
2022-08-05,LA,Albania,1099,936,0,0,163,83,80,163,0
2022-08-06,LA,Albania,1205,1066,2,0,139,69,68,137,2
2022-08-07,LA,Albania,1158,1015,0,0,143,69,74,143,0
2022-08-08,LA,Albania,1057,874,1,1,183,91,91,182,0
2022-08-09,LA,Albania,997,843,4,1,154,77,73,150,3
2022-08-10,LA,Albania,1018,881,0,0,137,70,67,137,0
2022-08-11,LA,Albania,985,836,0,0,149,74,75,149,0
2022-08-12,LA,Albania,1181,1008,0,0,173,87,86,173,0
2022-08-13,LA,Albania,1170,1031,2,0,139,70,67,137,2
2022-08-14,LA,Albania,1053,908,0,0,145,66,79,145,0
2022-08-15,LA,Albania,1042,868,0,0,174,88,86,174,0
2022-08-16,LA,Albania,990,841,1,0,149,74,74,148,1
2022-08-17,LA,Albania,965,831,0,0,134,69,65,134,0
2022-08-18,LA,Albania,1005,848,0,0,157,78,79,157,0
2022-08-19,LA,Albania,1093,935,0,0,158,79,79,158,0
2022-08-20,LA,Albania,1200,1060,1,0,140,71,68,139,1
2022-08-21,LA,Albania,1044,903,0,0,141,69,72,141,0
2022-08-22,LA,Albania,969,802,0,0,167,81,86,167,0
2022-08-23,LA,Albania,1015,860,2,0,155,79,74,153,2
2022-08-24,LA,Albania,1031,894,0,0,137,69,68,137,0
2022-08-25,LA,Albania,1008,858,0,0,150,72,78,150,0
2022-08-26,LA,Albania,1087,921,0,0,166,84,82,166,0
2022-08-27,LA,Albania,1142,992,2,0,150,75,73,148,2
2022-08-28,LA,Albania,1122,982,0,0,140,70,70,140,0
2022-08-29,LA,Albania,1016,847,0,0,169,83,86,169,0
2022-08-30,LA,Albania,960,807,2,0,153,77,74,151,2
2022-08-31,LA,Albania,998,865,0,0,133,68,65,133,0
2022-09-01,LA,Albania,954,799,0,0,155,77,78,155,0
2022-09-02,LA,Albania,1005,856,0,0,149,76,73,149,0
2022-09-03,LA,Albania,1163,1026,0,0,137,68,69,137,0
2022-09-04,LA,Albania,1046,909,0,0,137,67,70,137,0
2022-09-05,LA,Albania,954,783,0,0,171,85,86,171,0
2022-09-06,LA,Albania,923,789,1,0,134,68,65,133,1
2022-09-07,LA,Albania,950,825,0,0,125,64,61,125,0
2022-09-08,LA,Albania,829,680,0,0,149,72,77,149,0
2022-09-09,LA,Albania,981,829,0,0,152,78,74,152,0
2022-09-10,LA,Albania,1050,919,2,0,131,66,63,129,2
2022-09-11,LA,Albania,945,814,0,0,131,63,68,131,0
2022-09-12,LA,Albania,929,773,0,0,156,75,81,156,0
2022-09-13,LA,Albania,880,757,0,0,123,64,59,123,0
2022-09-14,LA,Albania,902,781,0,0,121,62,59,121,0
2022-09-15,LA,Albania,815,680,0,0,135,67,68,135,0
2022-09-16,LA,Albania,950,812,0,0,138,68,70,138,0
2022-09-17,LA,Albania,1031,901,2,0,130,64,64,128,2
2022-09-18,LA,Albania,916,797,0,0,119,61,58,119,0
2022-09-19,LA,Albania,900,741,0,0,159,79,80,159,0
2022-09-20,LA,Albania,778,666,0,0,112,55,57,112,0
2022-09-21,LA,Albania,858,742,0,0,116,60,56,116,0
2022-09-22,LA,Albania,782,665,0,0,117,59,58,117,0
2022-09-23,LA,Albania,1016,882,0,0,134,65,69,134,0
2022-09-24,LA,Albania,1066,961,0,0,105,54,51,105,0
2022-09-25,LA,Albania,952,831,0,0,121,61,60,121,0
2022-09-26,LA,Albania,831,687,0,0,144,71,73,144,0
2022-09-27,LA,Albania,807,697,0,0,110,56,54,110,0
2022-09-28,LA,Albania,883,768,0,0,115,57,58,115,0
2022-09-29,LA,Albania,735,616,0,0,119,58,61,119,0
2022-09-30,LA,Albania,928,799,0,0,129,64,65,129,0
2022-10-01,LA,Albania,1030,924,0,0,106,55,51,106,0
2022-10-02,LA,Albania,962,852,0,0,110,54,56,110,0
2022-10-03,LA,Albania,814,697,0,0,117,61,56,117,0
2022-10-04,LA,Albania,702,595,0,0,107,51,56,107,0
2022-10-05,LA,Albania,763,653,0,0,110,56,54,110,0
2022-10-06,LA,Albania,699,592,0,0,107,53,54,107,0
2022-10-07,LA,Albania,871,747,0,0,124,62,62,124,0
2022-10-08,LA,Albania,1011,907,0,0,104,52,52,104,0
2022-10-09,LA,Albania,917,806,0,0,111,56,55,111,0
2022-10-10,LA,Albania,775,646,0,0,129,65,64,129,0
2022-10-11,LA,Albania,721,612,0,0,109,53,56,109,0
2022-10-12,LA,Albania,768,663,0,0,105,53,52,105,0
2022-10-13,LA,Albania,712,597,0,0,115,57,58,115,0
2022-10-14,LA,Albania,896,784,0,0,112,58,54,112,0
2022-10-15,LA,Albania,930,832,0,0,98,48,50,98,0
2022-10-16,LA,Albania,937,829,0,0,108,53,55,108,0
2022-10-17,LA,Albania,750,633,0,0,117,59,58,117,0
2022-10-18,LA,Albania,684,586,0,0,98,49,49,98,0
2022-10-19,LA,Albania,730,615,0,0,115,58,57,115,0
2022-10-20,LA,Albania,647,532,0,0,115,57,58,115,0
2022-10-21,LA,Albania,782,677,0,0,105,56,49,105,0
2022-10-22,LA,Albania,980,879,0,0,101,48,53,101,0
2022-10-23,LA,Albania,921,818,0,0,103,53,50,103,0
2022-10-24,LA,Albania,695,569,0,0,126,62,64,126,0
2022-10-25,LA,Albania,675,566,0,0,109,54,55,109,0
2022-10-26,LA,Albania,756,650,0,0,106,56,50,106,0
2022-10-27,LA,Albania,640,529,0,0,111,53,58,111,0
2022-10-28,LA,Albania,798,687,0,0,111,57,54,111,0
2022-10-29,LA,Albania,991,896,0,0,95,47,48,95,0
2022-10-30,LA,Albania,819,712,0,0,107,54,53,107,0
2022-10-31,LA,Albania,572,466,0,0,106,53,53,106,0
2022-11-01,LA,Albania,520,423,0,0,97,48,49,97,0
2022-11-02,LA,Albania,499,405,0,0,94,48,46,94,0
2022-11-03,LA,Albania,496,403,0,0,93,45,48,93,0
2022-11-04,LA,Albania,546,446,0,0,100,52,48,100,0
2022-11-05,LA,Albania,643,563,0,0,80,38,42,80,0
2022-11-06,LA,Albania,678,569,0,0,109,54,55,109,0
2022-11-07,LA,Albania,489,390,0,0,99,50,49,99,0
2022-11-08,LA,Albania,478,387,0,0,91,47,44,91,0
2022-11-09,LA,Albania,466,375,0,0,91,44,47,91,0
2022-11-10,LA,Albania,456,367,0,0,89,45,44,89,0
2022-11-11,LA,Albania,475,378,0,0,97,49,48,97,0
2022-11-12,LA,Albania,494,412,0,0,82,40,42,82,0
2022-11-13,LA,Albania,549,449,0,0,100,49,51,100,0
2022-11-14,LA,Albania,449,345,0,0,104,53,51,104,0
2022-11-15,LA,Albania,410,312,0,0,98,50,48,98,0
2022-11-16,LA,Albania,430,342,0,0,88,43,45,88,0
2022-11-17,LA,Albania,461,376,0,0,85,41,44,85,0
2022-11-18,LA,Albania,491,389,0,0,102,52,50,102,0
2022-11-19,LA,Albania,499,409,0,0,90,45,45,90,0
2022-11-20,LA,Albania,518,413,0,0,105,54,51,105,0
2022-11-21,LA,Albania,424,327,0,0,97,49,48,97,0
2022-11-22,LA,Albania,396,313,0,0,83,40,43,83,0
2022-11-23,LA,Albania,399,310,0,0,89,45,44,89,0
2022-11-24,LA,Albania,453,367,0,0,86,42,44,86,0
2022-11-25,LA,Albania,517,414,0,0,103,51,52,103,0
2022-11-26,LA,Albania,488,400,0,0,88,43,45,88,0
2022-11-27,LA,Albania,557,454,0,0,103,53,50,103,0
2022-11-28,LA,Albania,408,311,0,0,97,49,48,97,0
2022-11-29,LA,Albania,395,302,0,0,93,47,46,93,0
2022-11-30,LA,Albania,389,295,0,0,94,47,47,94,0
2022-12-01,LA,Albania,381,296,0,0,85,42,43,85,0
2022-12-02,LA,Albania,471,376,0,0,95,48,47,95,0
2022-12-03,LA,Albania,498,420,0,0,78,39,39,78,0
2022-12-04,LA,Albania,537,439,0,0,98,50,48,98,0
2022-12-05,LA,Albania,422,317,0,0,105,47,58,105,0
2022-12-06,LA,Albania,457,317,0,0,140,74,66,140,0
2022-12-07,LA,Albania,446,358,0,0,88,44,44,88,0
2022-12-08,LA,Albania,435,355,0,0,80,39,41,80,0
2022-12-09,LA,Albania,486,383,0,0,103,52,51,103,0
2022-12-10,LA,Albania,498,417,0,0,81,40,41,81,0
2022-12-11,LA,Albania,502,402,0,0,100,52,48,100,0
2022-12-12,LA,Albania,446,360,0,0,86,46,40,86,0
2022-12-13,LA,Albania,372,288,0,0,84,37,47,84,0
2022-12-14,LA,Albania,434,335,0,0,99,49,50,99,0
2022-12-15,LA,Albania,467,358,1,1,109,53,55,108,0
2022-12-16,LA,Albania,515,417,0,0,98,49,49,98,0
2022-12-17,LA,Albania,527,448,0,0,79,40,39,79,0
2022-12-18,LA,Albania,559,458,1,1,101,51,49,100,0
2022-12-19,LA,Albania,489,383,0,0,106,51,55,106,0
2022-12-20,LA,Albania,496,392,0,0,104,52,52,104,0
2022-12-21,LA,Albania,508,404,0,0,104,53,51,104,0
2022-12-22,LA,Albania,530,428,0,0,102,51,51,102,0
2022-12-23,LA,Albania,600,490,0,0,110,55,55,110,0
2022-12-24,LA,Albania,557,466,0,0,91,46,45,91,0
2022-12-25,LA,Albania,544,447,0,0,97,50,47,97,0
2022-12-26,LA,Albania,539,434,0,0,105,51,54,105,0
2022-12-27,LA,Albania,551,447,0,0,104,51,53,104,0
2022-01-01,UD,Armenia,116,54,0,0,62,30,32,62,0
2022-01-02,UD,Armenia,133,67,0,0,66,31,35,66,0
2022-01-03,UD,Armenia,120,56,0,0,64,32,32,64,0
2022-01-04,UD,Armenia,113,55,0,0,58,29,29,58,0
2022-01-05,UD,Armenia,107,48,0,0,59,29,30,59,0
2022-01-06,UD,Armenia,134,58,0,0,76,41,35,76,0
2022-01-07,UD,Armenia,140,67,0,0,73,36,37,73,0
2022-01-08,UD,Armenia,142,63,0,0,79,38,41,79,0
2022-01-09,UD,Armenia,145,64,0,0,81,39,42,81,0
2022-01-10,UD,Armenia,113,49,0,0,64,34,30,64,0
2022-01-11,UD,Armenia,114,54,0,0,60,31,29,60,0
2022-01-12,UD,Armenia,106,57,0,0,49,25,24,49,0
2022-01-13,UD,Armenia,132,77,0,0,55,29,26,55,0
2022-01-14,UD,Armenia,136,75,0,0,61,30,31,61,0
2022-01-15,UD,Armenia,112,55,0,0,57,27,30,57,0
2022-01-16,UD,Armenia,119,62,0,0,57,29,28,57,0
2022-01-17,UD,Armenia,100,54,0,0,46,24,22,46,0
2022-01-18,UD,Armenia,91,49,0,0,42,20,22,42,0
2022-01-19,UD,Armenia,106,58,0,0,48,23,25,48,0
2022-01-20,UD,Armenia,109,58,0,0,51,27,24,51,0
2022-01-21,UD,Armenia,103,58,0,0,45,23,22,45,0
2022-01-22,UD,Armenia,100,47,0,0,53,25,28,53,0
2022-01-23,UD,Armenia,94,40,0,0,54,27,27,54,0
2022-01-24,UD,Armenia,81,36,0,0,45,23,22,45,0
2022-01-25,UD,Armenia,83,44,0,0,39,20,19,39,0
2022-01-26,UD,Armenia,91,51,0,0,40,19,21,40,0
2022-01-27,UD,Armenia,99,53,0,0,46,24,22,46,0
2022-01-28,UD,Armenia,108,63,0,0,45,22,23,45,0
2022-01-29,UD,Armenia,100,46,0,0,54,27,27,54,0
2022-01-30,UD,Armenia,99,45,0,0,54,27,27,54,0
2022-01-31,UD,Armenia,94,45,0,0,49,25,24,49,0
2022-02-01,UD,Armenia,96,49,0,0,47,23,24,47,0
2022-02-02,UD,Armenia,91,42,0,0,49,24,25,49,0
2022-02-03,UD,Armenia,101,59,0,0,42,23,19,42,0
2022-02-04,UD,Armenia,107,59,0,0,48,23,25,48,0
2022-02-05,UD,Armenia,106,48,0,0,58,27,31,58,0
2022-02-06,UD,Armenia,100,45,0,0,55,28,27,55,0
2022-02-07,UD,Armenia,99,41,0,0,58,30,28,58,0
2022-02-08,UD,Armenia,80,45,0,0,35,19,16,35,0
2022-02-09,UD,Armenia,74,37,0,0,37,17,20,37,0
2022-02-10,UD,Armenia,98,52,0,0,46,24,22,46,0
2022-02-11,UD,Armenia,101,52,0,0,49,24,25,49,0
2022-02-12,UD,Armenia,110,55,0,0,55,26,29,55,0
2022-02-13,UD,Armenia,112,52,0,0,60,29,31,60,0
2022-02-14,UD,Armenia,95,42,0,0,53,27,26,53,0
2022-02-15,UD,Armenia,109,63,0,0,46,25,21,46,0
2022-02-16,UD,Armenia,89,49,0,0,40,19,21,40,0
2022-02-17,UD,Armenia,101,49,0,0,52,25,27,52,0
2022-02-18,UD,Armenia,115,62,0,0,53,27,26,53,0
2022-02-19,UD,Armenia,125,67,0,0,58,28,30,58,0
2022-02-20,UD,Armenia,124,68,0,0,56,29,27,56,0
2022-02-21,UD,Armenia,93,35,0,0,58,29,29,58,0
2022-02-22,UD,Armenia,103,62,0,0,41,21,20,41,0
2022-02-23,UD,Armenia,90,52,0,0,38,19,19,38,0
2022-02-24,UD,Armenia,102,56,0,0,46,25,21,46,0
2022-02-25,UD,Armenia,112,72,0,0,40,19,21,40,0
2022-02-26,UD,Armenia,124,77,0,0,47,23,24,47,0
2022-02-27,UD,Armenia,107,58,0,0,49,24,25,49,0
2022-02-28,UD,Armenia,133,79,0,0,54,26,28,54,0
2022-03-01,UD,Armenia,139,91,0,0,48,25,23,48,0
2022-03-02,UD,Armenia,162,89,0,0,73,37,36,73,0
2022-03-03,UD,Armenia,163,103,0,0,60,28,32,60,0
2022-03-04,UD,Armenia,216,106,0,0,110,55,55,110,0
2022-03-05,UD,Armenia,206,106,0,0,100,48,52,100,0
2022-03-06,UD,Armenia,189,88,0,0,101,51,50,101,0
2022-03-07,UD,Armenia,172,83,0,0,89,45,44,89,0
2022-03-08,UD,Armenia,166,91,0,0,75,39,36,75,0
2022-03-09,UD,Armenia,169,103,0,0,66,32,34,66,0
2022-03-10,UD,Armenia,156,99,0,0,57,28,29,57,0
2022-03-11,UD,Armenia,161,93,0,0,68,34,34,68,0
2022-03-12,UD,Armenia,156,89,0,0,67,34,33,67,0
2022-03-13,UD,Armenia,152,83,0,0,69,34,35,69,0
2022-03-14,UD,Armenia,145,101,0,0,44,23,21,44,0
2022-03-15,UD,Armenia,161,117,0,0,44,23,21,44,0
2022-03-16,UD,Armenia,177,115,0,0,62,31,31,62,0
2022-03-17,UD,Armenia,166,109,0,0,57,28,29,57,0
2022-03-18,UD,Armenia,188,118,0,0,70,35,35,70,0
2022-03-19,UD,Armenia,183,117,0,0,66,33,33,66,0
2022-03-20,UD,Armenia,168,101,0,0,67,34,33,67,0
2022-03-21,UD,Armenia,175,114,0,0,61,31,30,61,0
2022-03-22,UD,Armenia,161,106,0,0,55,27,28,55,0
2022-03-23,UD,Armenia,185,113,0,0,72,36,36,72,0
2022-03-24,UD,Armenia,178,117,0,0,61,31,30,61,0
2022-03-25,UD,Armenia,175,117,0,0,58,28,30,58,0
2022-03-26,UD,Armenia,199,130,0,0,69,35,34,69,0
2022-03-27,UD,Armenia,165,93,0,0,72,35,37,72,0
2022-03-28,UD,Armenia,159,90,0,0,69,35,34,69,0
2022-03-29,UD,Armenia,164,104,0,0,60,28,32,60,0
2022-03-30,UD,Armenia,159,115,0,0,44,23,21,44,0
2022-03-31,UD,Armenia,162,114,0,0,48,23,25,48,0
2022-04-01,UD,Armenia,177,99,0,0,78,39,39,78,0
2022-04-02,UD,Armenia,183,106,0,0,77,40,37,77,0
2022-04-03,UD,Armenia,150,89,0,0,61,31,30,61,0
2022-04-04,UD,Armenia,158,89,0,0,69,35,34,69,0
2022-04-05,UD,Armenia,167,97,0,0,70,35,35,70,0
2022-04-06,UD,Armenia,151,91,0,0,60,30,30,60,0
2022-04-07,UD,Armenia,169,98,0,0,71,34,37,71,0
2022-04-08,UD,Armenia,172,103,0,0,69,36,33,69,0
2022-04-09,UD,Armenia,194,115,0,0,79,39,40,79,0
2022-04-10,UD,Armenia,182,101,0,0,81,39,42,81,0
2022-04-11,UD,Armenia,166,91,0,0,75,37,38,75,0
2022-04-12,UD,Armenia,176,107,0,0,69,36,33,69,0
2022-04-13,UD,Armenia,157,96,0,0,61,31,30,61,0
2022-04-14,UD,Armenia,173,103,0,0,70,36,34,70,0
2022-04-15,UD,Armenia,168,93,0,0,75,37,38,75,0
2022-04-16,UD,Armenia,180,104,0,0,76,37,39,76,0
2022-04-17,UD,Armenia,163,90,0,0,73,36,37,73,0
2022-04-18,UD,Armenia,167,88,0,0,79,41,38,79,0
2022-04-19,UD,Armenia,179,101,0,0,78,39,39,78,0
2022-04-20,UD,Armenia,172,93,0,0,79,40,39,79,0
2022-04-21,UD,Armenia,170,100,0,0,70,34,36,70,0
2022-04-22,UD,Armenia,193,108,1,1,85,42,42,84,0
2022-04-23,UD,Armenia,189,103,0,0,86,43,43,86,0
2022-04-24,UD,Armenia,170,87,0,0,83,41,42,83,0
2022-04-25,UD,Armenia,170,96,0,0,74,38,36,74,0
2022-04-26,UD,Armenia,185,110,0,0,75,35,40,75,0
2022-04-27,UD,Armenia,160,98,0,0,62,30,32,62,0
2022-04-28,UD,Armenia,207,119,0,0,88,42,46,88,0
2022-04-29,UD,Armenia,225,134,0,0,91,48,43,91,0
2022-04-30,UD,Armenia,271,160,0,0,111,57,54,111,0
2022-05-01,UD,Armenia,224,136,0,0,88,43,45,88,0
2022-05-02,UD,Armenia,202,114,0,0,88,45,43,88,0
2022-05-03,UD,Armenia,221,141,0,0,80,38,42,80,0
2022-05-04,UD,Armenia,222,145,0,0,77,40,37,77,0
2022-05-05,UD,Armenia,230,143,0,0,87,43,44,87,0
2022-05-06,UD,Armenia,214,134,0,0,80,39,41,80,0
2022-05-07,UD,Armenia,229,136,0,0,93,47,46,93,0
2022-05-08,UD,Armenia,198,113,0,0,85,43,42,85,0
2022-05-09,UD,Armenia,205,112,0,0,93,47,46,93,0
2022-05-10,UD,Armenia,234,133,0,0,101,50,51,101,0
2022-05-11,UD,Armenia,203,120,0,0,83,42,41,83,0
2022-05-12,UD,Armenia,210,128,0,0,82,41,41,82,0
2022-05-13,UD,Armenia,216,131,0,0,85,42,43,85,0
2022-05-14,UD,Armenia,213,120,0,0,93,47,46,93,0
2022-05-15,UD,Armenia,193,109,0,0,84,43,41,84,0
2022-05-16,UD,Armenia,180,102,0,0,78,39,39,78,0
2022-05-17,UD,Armenia,211,131,0,0,80,39,41,80,0
2022-05-18,UD,Armenia,182,106,0,0,76,39,37,76,0
2022-05-19,UD,Armenia,227,143,0,0,84,41,43,84,0
2022-05-20,UD,Armenia,207,126,0,0,81,39,42,81,0
2022-05-21,UD,Armenia,240,143,0,0,97,50,47,97,0
2022-05-22,UD,Armenia,214,123,0,0,91,43,48,91,0
2022-05-23,UD,Armenia,212,120,0,0,92,48,44,92,0
2022-05-24,UD,Armenia,240,151,0,0,89,46,43,89,0
2022-05-25,UD,Armenia,230,153,0,0,77,38,39,77,0
2022-05-26,UD,Armenia,240,150,0,0,90,43,47,90,0
2022-05-27,UD,Armenia,229,145,0,0,84,43,41,84,0
2022-05-28,UD,Armenia,257,164,0,0,93,47,46,93,0
2022-05-29,UD,Armenia,225,137,0,0,88,43,45,88,0
2022-05-30,UD,Armenia,220,136,0,0,84,44,40,84,0
2022-05-31,UD,Armenia,248,167,0,0,81,39,42,81,0
2022-06-01,UD,Armenia,240,151,0,0,89,43,46,89,0
2022-06-02,UD,Armenia,253,164,0,0,89,46,43,89,0
2022-06-03,UD,Armenia,239,152,0,0,87,42,45,87,0
2022-06-04,UD,Armenia,308,189,0,0,119,59,60,119,0
2022-06-05,UD,Armenia,241,140,0,0,101,50,51,101,0
2022-06-06,UD,Armenia,253,153,0,0,100,51,49,100,0
2022-06-07,UD,Armenia,275,180,0,0,95,49,46,95,0
2022-06-08,UD,Armenia,258,170,0,0,88,43,45,88,0
2022-06-09,UD,Armenia,271,168,0,0,103,52,51,103,0
2022-06-10,UD,Armenia,276,178,0,0,98,47,51,98,0
2022-06-11,UD,Armenia,287,170,0,0,117,60,57,117,0
2022-06-12,UD,Armenia,257,157,0,0,100,49,51,100,0
2022-06-13,UD,Armenia,276,170,0,0,106,54,52,106,0
2022-06-14,UD,Armenia,272,163,0,0,109,56,53,109,0
2022-06-15,UD,Armenia,257,158,0,0,99,46,53,99,0
2022-06-16,UD,Armenia,283,162,0,0,121,60,61,121,0
2022-06-17,UD,Armenia,269,172,0,0,97,51,46,97,0
2022-06-18,UD,Armenia,291,170,0,0,121,60,61,121,0
2022-06-19,UD,Armenia,269,146,0,0,123,62,61,123,0
2022-06-20,UD,Armenia,264,150,0,0,114,58,56,114,0
2022-06-21,UD,Armenia,290,172,0,0,118,59,59,118,0
2022-06-22,UD,Armenia,270,156,0,0,114,56,58,114,0
2022-06-23,UD,Armenia,296,189,0,0,107,54,53,107,0
2022-06-24,UD,Armenia,283,177,0,0,106,52,54,106,0
2022-06-25,UD,Armenia,298,176,0,0,122,63,59,122,0
2022-06-26,UD,Armenia,278,167,0,0,111,55,56,111,0
2022-06-27,UD,Armenia,291,171,0,0,120,62,58,120,0
2022-06-28,UD,Armenia,298,180,0,0,118,57,61,118,0
2022-06-29,UD,Armenia,271,164,0,0,107,54,53,107,0
2022-06-30,UD,Armenia,321,197,0,0,124,62,62,124,0
2022-07-01,UD,Armenia,301,183,0,0,118,59,59,118,0
2022-07-02,UD,Armenia,319,183,0,0,136,69,67,136,0
2022-07-03,UD,Armenia,299,178,0,0,121,62,59,121,0
2022-07-04,UD,Armenia,295,172,0,0,123,60,63,123,0
2022-07-05,UD,Armenia,306,177,0,0,129,64,65,129,0
2022-07-06,UD,Armenia,302,185,0,0,117,58,59,117,0
2022-07-07,UD,Armenia,307,194,0,0,113,57,56,113,0
2022-07-08,UD,Armenia,289,175,0,0,114,54,60,114,0
2022-07-09,UD,Armenia,337,196,0,0,141,74,67,141,0
2022-07-10,UD,Armenia,310,173,0,0,137,68,69,137,0
2022-07-11,UD,Armenia,307,181,0,0,126,61,65,126,0
2022-07-12,UD,Armenia,340,202,0,0,138,69,69,138,0
2022-07-13,UD,Armenia,305,184,0,0,121,62,59,121,0
2022-07-14,UD,Armenia,297,173,0,0,124,61,63,124,0
2022-07-15,UD,Armenia,296,168,0,0,128,64,64,128,0
2022-07-16,UD,Armenia,317,175,0,0,142,72,70,142,0
2022-07-17,UD,Armenia,287,158,0,0,129,63,66,129,0
2022-07-18,UD,Armenia,294,170,0,0,124,61,63,124,0
2022-07-19,UD,Armenia,322,185,2,2,137,68,67,135,0
2022-07-20,UD,Armenia,302,172,0,0,130,67,63,130,0
2022-07-21,UD,Armenia,309,187,0,0,122,58,64,122,0
2022-07-22,UD,Armenia,309,181,0,0,128,66,62,128,0
2022-07-23,UD,Armenia,316,168,0,0,148,73,75,148,0
2022-07-24,UD,Armenia,310,176,0,0,134,68,66,134,0
2022-07-25,UD,Armenia,295,167,0,0,128,62,66,128,0
2022-07-26,UD,Armenia,331,196,0,0,135,70,65,135,0
2022-07-27,UD,Armenia,296,175,0,0,121,59,62,121,0
2022-07-28,UD,Armenia,287,167,0,0,120,60,60,120,0
2022-07-29,UD,Armenia,302,175,0,0,127,63,64,127,0
2022-07-30,UD,Armenia,311,171,0,0,140,71,69,140,0
2022-07-31,UD,Armenia,297,164,0,0,133,63,70,133,0
2022-08-01,UD,Armenia,304,180,0,0,124,64,60,124,0
2022-08-02,UD,Armenia,330,189,0,0,141,71,70,141,0
2022-08-03,UD,Armenia,302,174,0,0,128,67,61,128,0
2022-08-04,UD,Armenia,306,191,0,0,115,56,59,115,0
2022-08-05,UD,Armenia,311,183,0,0,128,63,65,128,0
2022-08-06,UD,Armenia,312,175,1,1,137,70,66,136,0
2022-08-07,UD,Armenia,311,180,0,0,131,66,65,131,0
2022-08-08,UD,Armenia,295,167,0,0,128,63,65,128,0
2022-08-09,UD,Armenia,328,186,0,0,142,72,70,142,0
2022-08-10,UD,Armenia,306,174,0,0,132,66,66,132,0
2022-08-11,UD,Armenia,305,192,0,0,113,56,57,113,0
2022-08-12,UD,Armenia,331,191,1,0,140,69,70,139,1
2022-08-13,UD,Armenia,308,177,0,0,131,66,65,131,0
2022-08-14,UD,Armenia,305,180,0,0,125,63,62,125,0
2022-08-15,UD,Armenia,304,182,0,0,122,61,61,122,0
2022-08-16,UD,Armenia,321,190,0,0,131,65,66,131,0
2022-08-17,UD,Armenia,317,181,0,0,136,70,66,136,0
2022-08-18,UD,Armenia,316,195,0,0,121,59,62,121,0
2022-08-19,UD,Armenia,329,196,0,0,133,66,67,133,0
2022-08-20,UD,Armenia,328,188,0,0,140,70,70,140,0
2022-08-21,UD,Armenia,315,182,0,0,133,66,67,133,0
2022-08-22,UD,Armenia,319,185,0,0,134,67,67,134,0
2022-08-23,UD,Armenia,328,190,1,1,138,69,68,137,0
2022-08-24,UD,Armenia,308,175,0,0,133,68,65,133,0
2022-08-25,UD,Armenia,334,199,0,0,135,63,72,135,0
2022-08-26,UD,Armenia,344,195,0,0,149,77,72,149,0
2022-08-27,UD,Armenia,332,186,0,0,146,73,73,146,0
2022-08-28,UD,Armenia,331,179,0,0,152,76,76,152,0
2022-08-29,UD,Armenia,315,176,0,0,139,71,68,139,0
2022-08-30,UD,Armenia,331,189,0,0,142,73,69,142,0
2022-08-31,UD,Armenia,300,167,0,0,133,67,66,133,0
2022-09-01,UD,Armenia,302,176,0,0,126,62,64,126,0
2022-09-02,UD,Armenia,293,168,0,0,125,61,64,125,0
2022-09-03,UD,Armenia,297,164,0,0,133,68,65,133,0
2022-09-04,UD,Armenia,294,170,0,0,124,62,62,124,0
2022-09-05,UD,Armenia,277,161,0,0,116,57,59,116,0
2022-09-06,UD,Armenia,312,188,0,0,124,62,62,124,0
2022-09-07,UD,Armenia,287,167,0,0,120,61,59,120,0
2022-09-08,UD,Armenia,287,170,0,0,117,58,59,117,0
2022-09-09,UD,Armenia,295,176,0,0,119,61,58,119,0
2022-09-10,UD,Armenia,285,152,0,0,133,66,67,133,0
2022-09-11,UD,Armenia,271,155,0,0,116,57,59,116,0
2022-09-12,UD,Armenia,262,151,0,0,111,55,56,111,0
2022-09-13,UD,Armenia,179,66,0,0,113,56,57,113,0
2022-09-14,UD,Armenia,164,45,0,0,119,59,60,119,0
2022-09-15,UD,Armenia,194,89,0,0,105,52,53,105,0
2022-09-16,UD,Armenia,211,103,0,0,108,55,53,108,0
2022-09-17,UD,Armenia,217,95,0,0,122,61,61,122,0
2022-09-18,UD,Armenia,204,95,0,0,109,54,55,109,0
2022-09-19,UD,Armenia,206,88,0,0,118,59,59,118,0
2022-09-20,UD,Armenia,219,109,0,0,110,56,54,110,0
2022-09-21,UD,Armenia,221,95,0,0,126,64,62,126,0
2022-09-22,UD,Armenia,227,107,0,0,120,60,60,120,0
2022-09-23,UD,Armenia,228,94,0,0,134,67,67,134,0
2022-09-24,UD,Armenia,226,87,0,0,139,69,70,139,0
2022-09-25,UD,Armenia,227,82,0,0,145,73,72,145,0
2022-09-26,UD,Armenia,228,92,0,0,136,70,66,136,0
2022-09-27,UD,Armenia,232,98,0,0,134,65,69,134,0
2022-09-28,UD,Armenia,251,99,0,0,152,76,76,152,0
2022-09-29,UD,Armenia,237,108,0,0,129,64,65,129,0
2022-09-30,UD,Armenia,226,89,0,0,137,67,70,137,0
2022-10-01,UD,Armenia,233,96,0,0,137,70,67,137,0
2022-10-02,UD,Armenia,236,105,0,0,131,65,66,131,0
2022-10-03,UD,Armenia,199,82,0,0,117,60,57,117,0
2022-10-04,UD,Armenia,247,120,0,0,127,62,65,127,0
2022-10-05,UD,Armenia,225,93,0,0,132,65,67,132,0
2022-10-06,UD,Armenia,209,102,0,0,107,54,53,107,0
2022-10-07,UD,Armenia,203,95,0,0,108,56,52,108,0
2022-10-08,UD,Armenia,245,117,0,0,128,62,66,128,0
2022-10-09,UD,Armenia,235,107,0,0,128,63,65,128,0
2022-10-10,UD,Armenia,226,98,0,0,128,66,62,128,0
2022-10-11,UD,Armenia,233,113,0,0,120,58,62,120,0
2022-10-12,UD,Armenia,206,97,0,0,109,57,52,109,0
2022-10-13,UD,Armenia,200,100,0,0,100,48,52,100,0
2022-10-14,UD,Armenia,225,109,0,0,116,60,56,116,0
2022-10-15,UD,Armenia,245,119,0,0,126,62,64,126,0
2022-10-16,UD,Armenia,210,100,0,0,110,56,54,110,0
2022-10-17,UD,Armenia,209,93,0,0,116,58,58,116,0
2022-10-18,UD,Armenia,225,111,0,0,114,57,57,114,0
2022-10-19,UD,Armenia,202,97,0,0,105,51,54,105,0
2022-10-20,UD,Armenia,231,119,0,0,112,52,60,112,0
2022-10-21,UD,Armenia,225,111,0,0,114,62,52,114,0
2022-10-22,UD,Armenia,224,98,0,0,126,63,63,126,0
2022-10-23,UD,Armenia,201,93,0,0,108,54,54,108,0
2022-10-24,UD,Armenia,209,100,0,0,109,55,54,109,0
2022-10-25,UD,Armenia,233,123,0,0,110,55,55,110,0
2022-10-26,UD,Armenia,221,111,0,0,110,54,56,110,0
2022-10-27,UD,Armenia,220,116,0,0,104,50,54,104,0
2022-10-28,UD,Armenia,223,109,1,0,114,59,54,113,1
2022-10-29,UD,Armenia,229,106,0,0,123,59,64,123,0
2022-10-30,UD,Armenia,221,95,0,0,126,64,62,126,0
2022-10-31,UD,Armenia,199,104,0,0,95,50,45,95,0
2022-11-01,UD,Armenia,220,113,0,0,107,54,53,107,0
2022-11-02,UD,Armenia,231,129,0,0,102,50,52,102,0
2022-11-03,UD,Armenia,217,123,0,0,94,45,49,94,0
2022-11-04,UD,Armenia,212,121,0,0,91,49,42,91,0
2022-11-05,UD,Armenia,241,131,0,0,110,53,57,110,0
2022-11-06,UD,Armenia,240,129,0,0,111,54,57,111,0
2022-11-07,UD,Armenia,224,123,0,0,101,53,48,101,0
2022-11-08,UD,Armenia,249,136,0,0,113,55,58,113,0
2022-11-09,UD,Armenia,231,128,0,0,103,51,52,103,0
2022-11-10,UD,Armenia,222,125,0,0,97,49,48,97,0
2022-11-11,UD,Armenia,226,129,0,0,97,48,49,97,0
2022-11-12,UD,Armenia,234,123,0,0,111,57,54,111,0
2022-11-13,UD,Armenia,202,98,0,0,104,51,53,104,0
2022-11-14,UD,Armenia,206,105,0,0,101,52,49,101,0
2022-11-15,UD,Armenia,202,96,0,0,106,52,54,106,0
2022-11-16,UD,Armenia,210,108,0,0,102,49,53,102,0
2022-11-17,UD,Armenia,199,102,0,0,97,49,48,97,0
2022-11-18,UD,Armenia,206,112,0,0,94,47,47,94,0
2022-11-19,UD,Armenia,223,115,0,0,108,55,53,108,0
2022-11-20,UD,Armenia,205,99,3,0,106,50,53,103,3
2022-11-21,UD,Armenia,193,104,0,0,89,45,44,89,0
2022-11-22,UD,Armenia,205,99,0,0,106,50,56,106,0
2022-11-23,UD,Armenia,212,99,0,0,113,60,53,113,0
2022-11-24,UD,Armenia,203,99,0,0,104,53,51,104,0
2022-11-25,UD,Armenia,209,113,0,0,96,46,50,96,0
2022-11-26,UD,Armenia,219,107,0,0,112,58,54,112,0
2022-11-27,UD,Armenia,206,104,0,0,102,49,53,102,0
2022-11-28,UD,Armenia,198,107,0,0,91,47,44,91,0
2022-11-29,UD,Armenia,207,98,0,0,109,54,55,109,0
2022-11-30,UD,Armenia,202,110,0,0,92,44,48,92,0
2022-12-01,UD,Armenia,248,143,0,0,105,52,53,105,0
2022-12-02,UD,Armenia,200,104,0,0,96,49,47,96,0
2022-12-03,UD,Armenia,241,121,0,0,120,61,59,120,0
2022-12-04,UD,Armenia,247,138,0,0,109,54,55,109,0
2022-12-05,UD,Armenia,204,117,0,0,87,45,42,87,0
2022-12-06,UD,Armenia,204,107,0,0,97,48,49,97,0
2022-12-07,UD,Armenia,180,93,0,0,87,42,45,87,0
2022-12-08,UD,Armenia,216,121,0,0,95,47,48,95,0
2022-12-09,UD,Armenia,222,125,0,0,97,49,48,97,0
2022-12-10,UD,Armenia,229,120,0,0,109,53,56,109,0
2022-12-11,UD,Armenia,218,111,0,0,107,55,52,107,0
2022-12-12,UD,Armenia,223,121,0,0,102,52,50,102,0
2022-12-13,UD,Armenia,213,106,0,0,107,54,53,107,0
2022-12-14,UD,Armenia,186,100,0,0,86,43,43,86,0
2022-12-15,UD,Armenia,216,112,0,0,104,51,53,104,0
2022-12-16,UD,Armenia,218,130,0,0,88,45,43,88,0
2022-12-17,UD,Armenia,240,132,1,0,108,51,56,107,1
2022-12-18,UD,Armenia,204,86,0,0,118,59,59,118,0
2022-12-19,UD,Armenia,201,99,0,0,102,52,50,102,0
2022-12-20,UD,Armenia,220,98,0,0,122,62,60,122,0
2022-12-21,UD,Armenia,191,94,0,0,97,47,50,97,0
2022-12-22,UD,Armenia,220,116,0,0,104,52,52,104,0
2022-12-23,UD,Armenia,226,121,0,0,105,53,52,105,0
2022-12-24,UD,Armenia,262,140,0,0,122,62,60,122,0
2022-12-25,UD,Armenia,241,122,0,0,119,58,61,119,0
2022-12-26,UD,Armenia,243,115,1,1,128,65,62,127,0
2022-12-27,UD,Armenia,249,116,0,0,133,66,67,133,0
2022-01-01,LO,Austria,2030,1600,13,1,430,214,203,417,12
2022-01-02,LO,Austria,3022,2205,19,1,817,406,392,798,18
2022-01-03,LO,Austria,2627,1992,9,0,635,305,321,626,9
2022-01-04,LO,Austria,2273,1780,33,2,493,233,227,460,31
2022-01-05,LO,Austria,2336,1815,14,1,521,254,253,507,13
2022-01-06,LO,Austria,2337,1850,15,1,487,238,234,472,14
2022-01-07,LO,Austria,2686,2054,42,0,632,292,298,590,42
2022-01-08,LO,Austria,2753,2068,16,0,685,331,338,669,16
2022-01-09,LO,Austria,2878,2197,20,3,681,339,322,661,17
2022-01-10,LO,Austria,2098,1607,17,1,491,232,242,474,16
2022-01-11,LO,Austria,1844,1431,23,2,413,200,190,390,21
2022-01-12,LO,Austria,1800,1326,47,3,474,211,216,427,44
2022-01-13,LO,Austria,1677,1219,41,5,458,204,213,417,36
2022-01-14,LO,Austria,2091,1516,44,1,575,268,263,531,43
2022-01-15,LO,Austria,2082,1480,33,2,602,290,279,569,31
2022-01-16,LO,Austria,2182,1606,11,0,576,283,282,565,11
2022-01-17,LO,Austria,1789,1352,16,2,437,201,220,421,14
2022-01-18,LO,Austria,1540,1186,9,0,354,178,167,345,9
2022-01-19,LO,Austria,1658,1178,44,7,480,221,215,436,37
2022-01-20,LO,Austria,1666,1253,18,0,413,195,200,395,18
2022-01-21,LO,Austria,2042,1521,22,0,521,243,256,499,22
2022-01-22,LO,Austria,1991,1464,18,0,527,258,251,509,18
2022-01-23,LO,Austria,2038,1519,13,1,519,253,253,506,12
2022-01-24,LO,Austria,1648,1198,11,0,450,216,223,439,11
2022-01-25,LO,Austria,1430,1097,20,0,333,157,156,313,20
2022-01-26,LO,Austria,1621,1165,25,2,456,218,213,431,23
2022-01-27,LO,Austria,1626,1167,25,4,459,215,219,434,21
2022-01-28,LO,Austria,2124,1617,17,0,507,250,240,490,17
2022-01-29,LO,Austria,2012,1432,19,2,580,284,277,561,17
2022-01-30,LO,Austria,1976,1477,9,2,499,243,247,490,7
2022-01-31,LO,Austria,1731,1316,19,0,415,194,202,396,19
2022-02-01,LO,Austria,1605,1250,15,1,355,171,169,340,14
2022-02-02,LO,Austria,1606,1177,12,2,429,209,208,417,10
2022-02-03,LO,Austria,1830,1351,32,1,479,224,223,447,31
2022-02-04,LO,Austria,2205,1635,34,1,570,260,276,536,33
2022-02-05,LO,Austria,2295,1655,38,5,640,308,294,602,33
2022-02-06,LO,Austria,2193,1628,18,1,565,275,272,547,17
2022-02-07,LO,Austria,1803,1363,19,4,440,206,215,421,15
2022-02-08,LO,Austria,1626,1271,17,2,355,162,176,338,15
2022-02-09,LO,Austria,1750,1241,33,5,509,241,235,476,28
2022-02-10,LO,Austria,1919,1426,33,2,493,237,223,460,31
2022-02-11,LO,Austria,2326,1735,23,1,591,281,287,568,22
2022-02-12,LO,Austria,2487,1763,52,0,724,340,332,672,52
2022-02-13,LO,Austria,2364,1720,30,3,644,300,314,614,27
2022-02-14,LO,Austria,2028,1480,49,9,548,248,251,499,40
2022-02-15,LO,Austria,1770,1423,8,0,347,171,168,339,8
2022-02-16,LO,Austria,1888,1386,33,0,502,237,232,469,33
2022-02-17,LO,Austria,1946,1490,12,1,456,218,226,444,11
2022-02-18,LO,Austria,2375,1748,44,5,627,294,289,583,39
2022-02-19,LO,Austria,2628,1887,29,0,741,363,349,712,29
2022-02-20,LO,Austria,2466,1820,17,4,646,314,315,629,13
2022-02-21,LO,Austria,2085,1585,10,1,500,235,255,490,9
2022-02-22,LO,Austria,1884,1448,17,0,436,213,206,419,17
2022-02-23,LO,Austria,1972,1446,22,1,526,252,252,504,21
2022-02-24,LO,Austria,2132,1577,46,6,555,259,250,509,40
2022-02-25,LO,Austria,2498,1879,31,2,619,290,298,588,29
2022-02-26,LO,Austria,2562,1822,26,0,740,365,349,714,26
2022-02-27,LO,Austria,2470,1812,24,0,658,308,326,634,24
2022-02-28,LO,Austria,2186,1660,27,1,526,243,256,499,26
2022-03-01,LO,Austria,2049,1586,30,3,463,222,211,433,27
2022-03-02,LO,Austria,2162,1572,32,4,590,281,277,558,28
2022-03-03,LO,Austria,2258,1716,28,1,542,257,257,514,27
2022-03-04,LO,Austria,2724,2036,40,1,688,319,329,648,39
2022-03-05,LO,Austria,2667,1920,26,1,747,367,354,721,25
2022-03-06,LO,Austria,2615,1969,16,0,646,315,315,630,16
2022-03-07,LO,Austria,2425,1849,24,1,576,277,275,552,23
2022-03-08,LO,Austria,2080,1589,31,1,491,232,228,460,30
2022-03-09,LO,Austria,2214,1660,32,1,554,264,258,522,31
2022-03-10,LO,Austria,2276,1690,37,3,586,274,275,549,34
2022-03-11,LO,Austria,2629,1944,26,2,685,329,330,659,24
2022-03-12,LO,Austria,2518,1824,29,3,694,338,327,665,26
2022-03-13,LO,Austria,2607,1941,28,0,666,310,328,638,28
2022-03-14,LO,Austria,2400,1804,37,3,596,280,279,559,34
2022-03-15,LO,Austria,2100,1630,32,2,470,223,215,438,30
2022-03-16,LO,Austria,2317,1725,24,2,592,284,284,568,22
2022-03-17,LO,Austria,2428,1825,28,0,603,285,290,575,28
2022-03-18,LO,Austria,2797,2083,48,5,714,333,333,666,43
2022-03-19,LO,Austria,2646,1954,38,2,692,335,319,654,36
2022-03-20,LO,Austria,2750,2022,34,0,728,340,354,694,34
2022-03-21,LO,Austria,2498,1873,37,0,625,286,302,588,37
2022-03-22,LO,Austria,2067,1547,37,0,520,248,235,483,37
2022-03-23,LO,Austria,2424,1782,41,1,642,302,299,601,40
2022-03-24,LO,Austria,2531,1899,36,1,632,298,298,596,35
2022-03-25,LO,Austria,2806,2097,40,0,709,331,338,669,40
2022-03-26,LO,Austria,2683,1993,27,2,690,331,332,663,25
2022-03-27,LO,Austria,3241,2507,26,1,734,353,355,708,25
2022-03-28,LO,Austria,3093,2379,39,0,714,335,340,675,39
2022-03-29,LO,Austria,2707,2143,27,1,564,274,263,537,26
2022-03-30,LO,Austria,2920,2251,29,6,669,324,316,640,23
2022-03-31,LO,Austria,3032,2351,25,3,681,328,328,656,22
2022-04-01,LO,Austria,3271,2541,24,2,730,354,352,706,22
2022-04-02,LO,Austria,3069,2456,22,3,613,292,299,591,19
2022-04-03,LO,Austria,3352,2661,13,0,691,335,343,678,13
2022-04-04,LO,Austria,3108,2426,35,2,682,325,322,647,33
2022-04-05,LO,Austria,2813,2271,18,0,542,261,263,524,18
2022-04-06,LO,Austria,3081,2397,36,2,684,329,319,648,34
2022-04-07,LO,Austria,3302,2579,51,2,723,338,334,672,49
2022-04-08,LO,Austria,3681,2850,33,1,831,401,397,798,32
2022-04-09,LO,Austria,3641,2928,20,2,713,346,347,693,18
2022-04-10,LO,Austria,3691,2963,25,1,728,351,352,703,24
2022-04-11,LO,Austria,3380,2697,20,0,683,330,333,663,20
2022-04-12,LO,Austria,3036,2460,26,0,576,274,276,550,26
2022-04-13,LO,Austria,3330,2625,27,0,705,342,336,678,27
2022-04-14,LO,Austria,3562,2826,41,2,736,348,347,695,39
2022-04-15,LO,Austria,3573,2839,27,1,734,360,347,707,26
2022-04-16,LO,Austria,3485,2834,19,2,651,313,319,632,17
2022-04-17,LO,Austria,3573,2931,13,0,642,316,313,629,13
2022-04-18,LO,Austria,3524,2795,22,0,729,351,356,707,22
2022-04-19,LO,Austria,3131,2462,23,4,669,319,327,646,19
2022-04-20,LO,Austria,3353,2638,36,3,715,341,338,679,33
2022-04-21,LO,Austria,3429,2726,49,3,703,323,331,654,46
2022-04-22,LO,Austria,3679,2939,29,2,740,358,353,711,27
2022-04-23,LO,Austria,3646,3023,21,0,623,299,303,602,21
2022-04-24,LO,Austria,3801,3071,28,0,730,345,357,702,28
2022-04-25,LO,Austria,3535,2759,43,3,776,378,355,733,40
2022-04-26,LO,Austria,3247,2602,21,2,645,311,313,624,19
2022-04-27,LO,Austria,3452,2707,33,1,745,355,357,712,32
2022-04-28,LO,Austria,3650,2863,40,2,787,369,378,747,38
2022-04-29,LO,Austria,3867,3036,37,3,831,406,388,794,34
2022-04-30,LO,Austria,3718,3067,20,2,651,305,326,631,18
2022-05-01,LO,Austria,3972,3189,20,1,783,379,384,763,19
2022-05-02,LO,Austria,3658,2903,27,1,755,365,363,728,26
2022-05-03,LO,Austria,3624,2925,34,2,699,327,338,665,32
2022-05-04,LO,Austria,3445,2717,23,2,728,361,344,705,21
2022-05-05,LO,Austria,3683,2921,25,0,762,373,364,737,25
2022-05-06,LO,Austria,3900,3075,44,0,825,386,395,781,44
2022-05-07,LO,Austria,3935,3252,34,0,683,331,318,649,34
2022-05-08,LO,Austria,4043,3250,27,0,793,378,388,766,27
2022-05-09,LO,Austria,3701,2941,33,2,760,367,360,727,31
2022-05-10,LO,Austria,3502,2792,34,3,710,335,341,676,31
2022-05-11,LO,Austria,3568,2773,46,2,795,377,372,749,44
2022-05-12,LO,Austria,3791,2970,47,3,821,391,383,774,44
2022-05-13,LO,Austria,3995,3170,31,0,825,400,394,794,31
2022-05-14,LO,Austria,4013,3288,46,0,725,339,340,679,46
2022-05-15,LO,Austria,4198,3368,39,4,830,381,410,791,35
2022-05-16,LO,Austria,3620,2818,21,1,802,394,387,781,20
2022-05-17,LO,Austria,3554,2862,19,2,692,338,335,673,17
2022-05-18,LO,Austria,3609,2795,46,4,814,375,393,768,42
2022-05-19,LO,Austria,3863,3006,50,3,857,405,402,807,47
2022-05-20,LO,Austria,4182,3316,46,3,866,418,402,820,43
2022-05-21,LO,Austria,4131,3415,25,0,716,346,345,691,25
2022-05-22,LO,Austria,4409,3555,45,3,854,399,410,809,42
2022-05-23,LO,Austria,3904,3102,33,2,802,390,379,769,31
2022-05-24,LO,Austria,4031,3284,38,2,747,351,358,709,36
2022-05-25,LO,Austria,4405,3537,39,6,868,419,410,829,33
2022-05-26,LO,Austria,4344,3500,40,0,844,406,398,804,40
2022-05-27,LO,Austria,4146,3380,20,1,766,373,373,746,19
2022-05-28,LO,Austria,4264,3491,30,1,773,372,371,743,29
2022-05-29,LO,Austria,4519,3605,35,3,914,424,455,879,32
2022-05-30,LO,Austria,4214,3330,46,9,884,423,415,838,37
2022-05-31,LO,Austria,3908,3134,35,1,774,365,374,739,34
2022-06-01,LO,Austria,4065,3199,43,4,866,414,409,823,39
2022-06-02,LO,Austria,4125,3274,46,3,851,402,403,805,43
2022-06-03,LO,Austria,4479,3550,37,4,929,457,435,892,33
2022-06-04,LO,Austria,4538,3720,29,7,818,398,391,789,22
2022-06-05,LO,Austria,4251,3471,27,4,780,380,373,753,23
2022-06-06,LO,Austria,4314,3444,27,1,870,405,438,843,26
2022-06-07,LO,Austria,4074,3249,25,1,825,402,398,800,24
2022-06-08,LO,Austria,4127,3214,43,2,913,435,435,870,41
2022-06-09,LO,Austria,4150,3273,23,1,877,426,428,854,22
2022-06-10,LO,Austria,4499,3595,43,0,904,430,431,861,43
2022-06-11,LO,Austria,4445,3600,25,0,845,408,412,820,25
2022-06-12,LO,Austria,4582,3677,27,1,905,445,433,878,26
2022-06-13,LO,Austria,4340,3469,41,1,871,409,421,830,40
2022-06-14,LO,Austria,4107,3279,43,6,828,396,389,785,37
2022-06-15,LO,Austria,4628,3706,41,1,922,444,437,881,40
2022-06-16,LO,Austria,4313,3478,29,1,835,406,400,806,28
2022-06-17,LO,Austria,4433,3605,23,1,828,403,402,805,22
2022-06-18,LO,Austria,4447,3649,30,1,798,380,388,768,29
2022-06-19,LO,Austria,4680,3748,31,1,932,439,462,901,30
2022-06-20,LO,Austria,4260,3396,32,4,864,426,406,832,28
2022-06-21,LO,Austria,4194,3348,33,2,846,403,410,813,31
2022-06-22,LO,Austria,4242,3312,34,0,930,455,441,896,34
2022-06-23,LO,Austria,4321,3392,50,0,929,439,440,879,50
2022-06-24,LO,Austria,4182,3361,35,2,821,392,394,786,33
2022-06-25,LO,Austria,4454,3668,21,4,786,377,388,765,17
2022-06-26,LO,Austria,4581,3708,26,0,873,416,431,847,26
2022-06-27,LO,Austria,4287,3446,37,0,841,405,399,804,37
2022-06-28,LO,Austria,4381,3550,41,2,831,397,393,790,39
2022-06-29,LO,Austria,4468,3538,42,4,930,447,441,888,38
2022-06-30,LO,Austria,4392,3520,42,1,872,421,409,830,41
2022-07-01,LO,Austria,4485,3609,39,2,876,416,421,837,37
2022-07-02,LO,Austria,4708,3863,30,1,845,406,409,815,29
2022-07-03,LO,Austria,4685,3759,25,0,926,444,457,901,25
2022-07-04,LO,Austria,4323,3437,39,1,886,431,416,847,38
2022-07-05,LO,Austria,4329,3498,31,2,831,400,400,800,29
2022-07-06,LO,Austria,4493,3561,44,4,932,444,444,888,40
2022-07-07,LO,Austria,4622,3676,31,1,946,449,466,915,30
2022-07-08,LO,Austria,4707,3741,51,0,966,449,466,915,51
2022-07-09,LO,Austria,4639,3770,28,1,869,417,424,841,27
2022-07-10,LO,Austria,4769,3782,39,0,987,483,465,948,39
2022-07-11,LO,Austria,4465,3531,32,0,934,455,447,902,32
2022-07-12,LO,Austria,4489,3605,34,0,884,422,428,850,34
2022-07-13,LO,Austria,4491,3579,36,2,912,444,432,876,34
2022-07-14,LO,Austria,4517,3606,48,2,911,431,432,863,46
2022-07-15,LO,Austria,4656,3737,39,3,919,444,436,880,36
2022-07-16,LO,Austria,4730,3870,27,1,860,417,416,833,26
2022-07-17,LO,Austria,4653,3755,27,0,898,437,434,871,27
2022-07-18,LO,Austria,4498,3589,40,2,909,426,443,869,38
2022-07-19,LO,Austria,4474,3588,51,4,886,417,418,835,47
2022-07-20,LO,Austria,4466,3598,29,3,868,432,407,839,26
2022-07-21,LO,Austria,4509,3629,45,1,880,418,417,835,44
2022-07-22,LO,Austria,4611,3706,41,3,905,433,431,864,38
2022-07-23,LO,Austria,4639,3800,21,2,839,409,409,818,19
2022-07-24,LO,Austria,4689,3809,30,2,880,420,430,850,28
2022-07-25,LO,Austria,4446,3574,33,3,872,421,418,839,30
2022-07-26,LO,Austria,4480,3670,41,4,810,389,380,769,37
2022-07-27,LO,Austria,4299,3439,50,5,860,400,410,810,45
2022-07-28,LO,Austria,4485,3581,39,4,904,436,429,865,35
2022-07-29,LO,Austria,4515,3632,28,1,883,424,431,855,27
2022-07-30,LO,Austria,4660,3791,20,2,869,424,425,849,18
2022-07-31,LO,Austria,4778,3842,29,2,936,456,451,907,27
2022-08-01,LO,Austria,4416,3570,24,2,846,417,405,822,22
2022-08-02,LO,Austria,4398,3588,21,0,810,386,403,789,21
2022-08-03,LO,Austria,4480,3593,33,0,887,429,425,854,33
2022-08-04,LO,Austria,4431,3555,37,1,876,418,421,839,36
2022-08-05,LO,Austria,4457,3573,19,2,884,430,435,865,17
2022-08-06,LO,Austria,4671,3829,15,2,842,415,412,827,13
2022-08-07,LO,Austria,4733,3828,22,1,905,440,443,883,21
2022-08-08,LO,Austria,4523,3663,30,1,860,419,411,830,29
2022-08-09,LO,Austria,4379,3538,34,0,841,398,409,807,34
2022-08-10,LO,Austria,4509,3621,26,0,888,429,433,862,26
2022-08-11,LO,Austria,4400,3532,26,2,868,419,423,842,24
2022-08-12,LO,Austria,4633,3716,29,0,917,445,443,888,29
2022-08-13,LO,Austria,4671,3838,23,0,833,404,406,810,23
2022-08-14,LO,Austria,4685,3787,15,0,898,441,442,883,15
2022-08-15,LO,Austria,4382,3510,28,2,872,428,416,844,26
2022-08-16,LO,Austria,4418,3575,33,0,843,402,408,810,33
2022-08-17,LO,Austria,4505,3601,32,3,904,438,434,872,29
2022-08-18,LO,Austria,4451,3551,35,1,900,432,433,865,34
2022-08-19,LO,Austria,4377,3477,24,1,900,441,435,876,23
2022-08-20,LO,Austria,4482,3616,16,0,866,419,431,850,16
2022-08-21,LO,Austria,4766,3807,24,1,959,466,469,935,23
2022-08-22,LO,Austria,4460,3585,28,4,875,424,423,847,24
2022-08-23,LO,Austria,4378,3517,37,4,861,416,408,824,33
2022-08-24,LO,Austria,4546,3610,55,3,936,447,434,881,52
2022-08-25,LO,Austria,4398,3470,33,0,928,444,451,895,33
2022-08-26,LO,Austria,4492,3546,46,2,946,456,444,900,44
2022-08-27,LO,Austria,4626,3759,32,0,867,418,417,835,32
2022-08-28,LO,Austria,4726,3805,26,1,921,439,456,895,25
2022-08-29,LO,Austria,4326,3452,26,0,874,435,413,848,26
2022-08-30,LO,Austria,4477,3600,39,3,877,416,422,838,36
2022-08-31,LO,Austria,4572,3605,33,4,967,453,481,934,29
2022-09-01,LO,Austria,4611,3660,38,2,951,447,466,913,36
2022-09-02,LO,Austria,4471,3513,32,1,958,458,468,926,31
2022-09-03,LO,Austria,4542,3677,26,0,865,418,421,839,26
2022-09-04,LO,Austria,4700,3751,22,1,949,468,459,927,21
2022-09-05,LO,Austria,4466,3555,40,3,911,447,424,871,37
2022-09-06,LO,Austria,4323,3461,37,2,862,409,416,825,35
2022-09-07,LO,Austria,4583,3613,45,3,970,470,455,925,42
2022-09-08,LO,Austria,4576,3627,40,2,949,455,454,909,38
2022-09-09,LO,Austria,4533,3584,43,5,949,458,448,906,38
2022-09-10,LO,Austria,4469,3650,27,2,819,394,398,792,25
2022-09-11,LO,Austria,4588,3687,22,1,901,433,446,879,21
2022-09-12,LO,Austria,4326,3411,36,7,915,443,436,879,29
2022-09-13,LO,Austria,4196,3307,45,1,889,418,426,844,44
2022-09-14,LO,Austria,4273,3346,39,3,927,449,439,888,36
2022-09-15,LO,Austria,4362,3426,36,2,936,445,455,900,34
2022-09-16,LO,Austria,4544,3660,31,1,884,433,420,853,30
2022-09-17,LO,Austria,4463,3655,23,2,808,394,391,785,21
2022-09-18,LO,Austria,4496,3605,24,0,891,422,445,867,24
2022-09-19,LO,Austria,4171,3290,31,6,881,426,424,850,25
2022-09-20,LO,Austria,4111,3255,35,3,856,417,404,821,32
2022-09-21,LO,Austria,4205,3313,38,2,892,425,429,854,36
2022-09-22,LO,Austria,4342,3413,36,3,929,445,448,893,33
2022-09-23,LO,Austria,4506,3523,52,3,983,467,464,931,49
2022-09-24,LO,Austria,4436,3634,35,3,802,383,384,767,32
2022-09-25,LO,Austria,4519,3635,28,0,884,425,431,856,28
2022-09-26,LO,Austria,4076,3208,36,2,868,418,414,832,34
2022-09-27,LO,Austria,4082,3237,35,1,845,404,406,810,34
2022-09-28,LO,Austria,4172,3258,40,2,914,432,442,874,38
2022-09-29,LO,Austria,4458,3558,41,4,900,433,426,859,37
2022-09-30,LO,Austria,4439,3533,48,1,906,428,430,858,47
2022-10-01,LO,Austria,4296,3511,29,1,785,380,376,756,28
2022-10-02,LO,Austria,4392,3547,26,3,845,403,416,819,23
2022-10-03,LO,Austria,4120,3319,31,0,801,389,381,770,31
2022-10-04,LO,Austria,3875,3113,39,0,762,368,355,723,39
2022-10-05,LO,Austria,3894,3040,47,1,854,398,409,807,46
2022-10-06,LO,Austria,3956,3094,44,4,862,410,408,818,40
2022-10-07,LO,Austria,4277,3396,42,2,881,433,406,839,40
2022-10-08,LO,Austria,4292,3536,36,4,756,361,359,720,32
2022-10-09,LO,Austria,4363,3529,26,4,834,395,413,808,22
2022-10-10,LO,Austria,3972,3125,42,4,847,405,400,805,38
2022-10-11,LO,Austria,3793,3008,32,3,785,367,386,753,29
2022-10-12,LO,Austria,3890,3010,47,2,880,422,411,833,45
2022-10-13,LO,Austria,3960,3090,54,2,870,409,407,816,52
2022-10-14,LO,Austria,4088,3210,44,0,878,419,415,834,44
2022-10-15,LO,Austria,4073,3350,25,3,723,349,349,698,22
2022-10-16,LO,Austria,4278,3435,20,2,843,405,418,823,18
2022-10-17,LO,Austria,3844,3044,42,3,800,382,376,758,39
2022-10-18,LO,Austria,3728,2977,38,2,751,359,354,713,36
2022-10-19,LO,Austria,3696,2896,46,1,800,376,378,754,45
2022-10-20,LO,Austria,3865,3015,52,6,850,398,400,798,46
2022-10-21,LO,Austria,3886,3015,48,2,871,419,404,823,46
2022-10-22,LO,Austria,4130,3418,23,4,712,341,348,689,19
2022-10-23,LO,Austria,4077,3270,20,0,807,388,399,787,20
2022-10-24,LO,Austria,3845,3026,37,2,819,392,390,782,35
2022-10-25,LO,Austria,3750,2941,51,2,809,385,373,758,49
2022-10-26,LO,Austria,3763,2905,32,3,858,419,407,826,29
2022-10-27,LO,Austria,3882,3051,38,2,831,392,401,793,36
2022-10-28,LO,Austria,4052,3217,36,0,835,397,402,799,36
2022-10-29,LO,Austria,4078,3370,18,3,708,350,340,690,15
2022-10-30,LO,Austria,3732,3014,20,2,718,338,360,698,18
2022-10-31,LO,Austria,3401,2684,29,2,717,342,346,688,27
2022-11-01,LO,Austria,2976,2322,24,0,654,316,314,630,24
2022-11-02,LO,Austria,3019,2293,32,2,726,344,350,694,30
2022-11-03,LO,Austria,3129,2379,38,3,750,357,355,712,35
2022-11-04,LO,Austria,3314,2548,24,3,766,371,371,742,21
2022-11-05,LO,Austria,3131,2543,26,1,588,275,287,562,25
2022-11-06,LO,Austria,3384,2650,31,0,734,363,340,703,31
2022-11-07,LO,Austria,3056,2303,36,1,753,358,359,717,35
2022-11-08,LO,Austria,2671,2049,15,0,622,304,303,607,15
2022-11-09,LO,Austria,2730,2049,31,2,681,327,323,650,29
2022-11-10,LO,Austria,2891,2166,40,2,725,344,341,685,38
2022-11-11,LO,Austria,3074,2289,40,1,785,369,376,745,39
2022-11-12,LO,Austria,2688,2133,18,1,555,260,277,537,17
2022-11-13,LO,Austria,2987,2291,33,2,696,338,325,663,31
2022-11-14,LO,Austria,2869,2160,34,7,709,340,335,675,27
2022-11-15,LO,Austria,2588,1982,28,0,606,291,287,578,28
2022-11-16,LO,Austria,2709,1997,30,1,712,347,335,682,29
2022-11-17,LO,Austria,2801,2113,28,3,688,324,336,660,25
2022-11-18,LO,Austria,2981,2241,30,1,740,355,355,710,29
2022-11-19,LO,Austria,2699,2149,12,1,550,269,269,538,11
2022-11-20,LO,Austria,2997,2316,19,0,681,331,331,662,19
2022-11-21,LO,Austria,2790,2077,21,0,713,349,343,692,21
2022-11-22,LO,Austria,2439,1867,18,0,572,277,277,554,18
2022-11-23,LO,Austria,2538,1865,33,2,673,324,316,640,31
2022-11-24,LO,Austria,2672,1967,28,3,705,339,338,677,25
2022-11-25,LO,Austria,3023,2228,48,5,795,369,378,747,43
2022-11-26,LO,Austria,2632,2055,23,1,577,274,280,554,22
2022-11-27,LO,Austria,2955,2259,33,3,696,333,330,663,30
2022-11-28,LO,Austria,2822,2085,37,2,737,348,352,700,35
2022-11-29,LO,Austria,2525,1911,32,0,614,297,285,582,32
2022-11-30,LO,Austria,2610,1942,31,2,668,314,323,637,29
2022-12-01,LO,Austria,2926,2201,29,1,725,344,352,696,28
2022-12-02,LO,Austria,3114,2346,24,1,768,371,373,744,23
2022-12-03,LO,Austria,2669,2131,17,1,538,257,264,521,16
2022-12-04,LO,Austria,2992,2295,23,3,697,336,338,674,20
2022-12-05,LO,Austria,2818,2098,35,2,720,340,345,685,33
2022-12-06,LO,Austria,2522,1930,24,1,592,288,280,568,23
2022-12-07,LO,Austria,2696,1980,30,0,716,346,340,686,30
2022-12-08,LO,Austria,2879,2126,29,1,753,367,357,724,28
2022-12-09,LO,Austria,3045,2271,33,0,774,367,374,741,33
2022-12-10,LO,Austria,2751,2144,15,1,607,295,297,592,14
2022-12-11,LO,Austria,2839,2110,19,0,729,360,350,710,19
2022-12-12,LO,Austria,2805,2055,37,4,750,352,361,713,33
2022-12-13,LO,Austria,2600,1940,47,1,660,307,306,613,46
2022-12-14,LO,Austria,2694,1983,38,0,711,338,335,673,38
2022-12-15,LO,Austria,2875,2172,27,2,703,341,335,676,25
2022-12-16,LO,Austria,3143,2327,28,1,816,387,401,788,27
2022-12-17,LO,Austria,2960,2267,19,1,693,335,339,674,18
2022-12-18,LO,Austria,3048,2306,34,3,742,356,352,708,31
2022-12-19,LO,Austria,3017,2257,31,3,760,362,367,729,28
2022-12-20,LO,Austria,2856,2176,35,3,680,328,317,645,32
2022-12-21,LO,Austria,2845,2099,25,0,746,358,363,721,25
2022-12-22,LO,Austria,3128,2358,26,1,770,371,373,744,25
2022-12-23,LO,Austria,3364,2520,36,1,844,406,402,808,35
2022-12-24,LO,Austria,2640,2037,12,0,603,287,304,591,12
2022-12-25,LO,Austria,2158,1731,5,1,427,217,205,422,4
2022-12-26,LO,Austria,2877,2234,16,1,643,315,312,627,15
2022-12-27,LO,Austria,2793,2125,20,0,668,321,327,648,20
2022-01-01,EB,Belgium and Luxembourg,1880,1257,2,1,623,313,308,621,1
2022-01-02,EB,Belgium and Luxembourg,2511,1626,8,0,885,440,437,877,8
2022-01-03,EB,Belgium and Luxembourg,2407,1496,8,4,911,444,459,903,4
2022-01-04,EB,Belgium and Luxembourg,2139,1347,11,7,792,389,392,781,4
2022-01-05,EB,Belgium and Luxembourg,2169,1321,11,10,848,420,417,837,1
2022-01-06,EB,Belgium and Luxembourg,2174,1369,22,9,805,392,391,783,13
2022-01-07,EB,Belgium and Luxembourg,2387,1430,19,12,957,472,466,938,7
2022-01-08,EB,Belgium and Luxembourg,2263,1518,7,1,745,368,370,738,6
2022-01-09,EB,Belgium and Luxembourg,2419,1560,8,2,859,427,424,851,6
2022-01-10,EB,Belgium and Luxembourg,1912,1177,17,10,735,351,367,718,7
2022-01-11,EB,Belgium and Luxembourg,1775,1097,38,20,678,314,326,640,18
2022-01-12,EB,Belgium and Luxembourg,1783,1096,20,5,687,336,331,667,15
2022-01-13,EB,Belgium and Luxembourg,1726,1064,16,7,662,318,328,646,9
2022-01-14,EB,Belgium and Luxembourg,1948,1144,14,8,804,410,380,790,6
2022-01-15,EB,Belgium and Luxembourg,1775,1225,19,3,550,266,265,531,16
2022-01-16,EB,Belgium and Luxembourg,1940,1214,14,2,726,356,356,712,12
2022-01-17,EB,Belgium and Luxembourg,1742,1064,26,15,678,312,340,652,11
2022-01-18,EB,Belgium and Luxembourg,1520,902,24,14,618,295,299,594,10
2022-01-19,EB,Belgium and Luxembourg,1730,1012,24,5,718,354,340,694,19
2022-01-20,EB,Belgium and Luxembourg,1696,1045,33,10,651,305,313,618,23
2022-01-21,EB,Belgium and Luxembourg,1975,1163,19,14,812,406,387,793,5
2022-01-22,EB,Belgium and Luxembourg,1802,1244,14,10,558,276,268,544,4
2022-01-23,EB,Belgium and Luxembourg,1979,1268,11,3,711,349,351,700,8
2022-01-24,EB,Belgium and Luxembourg,1714,1041,19,6,673,312,342,654,13
2022-01-25,EB,Belgium and Luxembourg,1473,909,15,3,564,274,275,549,12
2022-01-26,EB,Belgium and Luxembourg,1728,1024,16,4,704,347,341,688,12
2022-01-27,EB,Belgium and Luxembourg,1730,1065,20,8,665,326,319,645,12
2022-01-28,EB,Belgium and Luxembourg,1997,1182,13,7,815,412,390,802,6
2022-01-29,EB,Belgium and Luxembourg,1749,1199,4,2,550,276,270,546,2
2022-01-30,EB,Belgium and Luxembourg,1964,1254,4,0,710,356,350,706,4
2022-01-31,EB,Belgium and Luxembourg,1668,998,6,1,670,310,354,664,5
2022-02-01,EB,Belgium and Luxembourg,1697,1033,11,7,664,327,326,653,4
2022-02-02,EB,Belgium and Luxembourg,1781,1027,26,12,754,363,365,728,14
2022-02-03,EB,Belgium and Luxembourg,1866,1152,18,8,714,350,346,696,10
2022-02-04,EB,Belgium and Luxembourg,2145,1290,19,6,855,425,411,836,13
2022-02-05,EB,Belgium and Luxembourg,1995,1374,20,10,621,305,296,601,10
2022-02-06,EB,Belgium and Luxembourg,2037,1327,6,2,710,350,354,704,4
2022-02-07,EB,Belgium and Luxembourg,1896,1113,24,12,783,366,393,759,12
2022-02-08,EB,Belgium and Luxembourg,1707,1028,27,12,679,329,323,652,15
2022-02-09,EB,Belgium and Luxembourg,1891,1085,26,20,806,385,395,780,6
2022-02-10,EB,Belgium and Luxembourg,2037,1210,31,14,827,399,397,796,17
2022-02-11,EB,Belgium and Luxembourg,2306,1387,25,9,919,468,426,894,16
2022-02-12,EB,Belgium and Luxembourg,2238,1539,13,3,699,341,345,686,10
2022-02-13,EB,Belgium and Luxembourg,2197,1413,5,0,784,386,393,779,5
2022-02-14,EB,Belgium and Luxembourg,2037,1256,13,5,781,371,397,768,8
2022-02-15,EB,Belgium and Luxembourg,1827,1129,15,9,698,336,347,683,6
2022-02-16,EB,Belgium and Luxembourg,1962,1186,22,9,776,372,382,754,13
2022-02-17,EB,Belgium and Luxembourg,2115,1267,16,4,848,402,430,832,12
2022-02-18,EB,Belgium and Luxembourg,2132,1243,10,0,889,467,412,879,10
2022-02-19,EB,Belgium and Luxembourg,2362,1615,8,2,747,381,358,739,6
2022-02-20,EB,Belgium and Luxembourg,2303,1499,6,0,804,392,406,798,6
2022-02-21,EB,Belgium and Luxembourg,2124,1278,11,0,846,418,417,835,11
2022-02-22,EB,Belgium and Luxembourg,1987,1232,34,14,755,352,369,721,20
2022-02-23,EB,Belgium and Luxembourg,2094,1271,31,20,823,399,393,792,11
2022-02-24,EB,Belgium and Luxembourg,2288,1392,28,13,896,425,443,868,15
2022-02-25,EB,Belgium and Luxembourg,2496,1446,30,18,1050,526,494,1020,12
2022-02-26,EB,Belgium and Luxembourg,2335,1513,21,9,822,409,392,801,12
2022-02-27,EB,Belgium and Luxembourg,2377,1483,22,9,894,443,429,872,13
2022-02-28,EB,Belgium and Luxembourg,2259,1398,30,15,861,403,428,831,15
2022-03-01,EB,Belgium and Luxembourg,2200,1345,26,10,855,416,413,829,16
2022-03-02,EB,Belgium and Luxembourg,2251,1364,28,12,887,430,429,859,16
2022-03-03,EB,Belgium and Luxembourg,2385,1489,28,10,896,432,436,868,18
2022-03-04,EB,Belgium and Luxembourg,2596,1588,45,14,1008,494,469,963,31
2022-03-05,EB,Belgium and Luxembourg,2444,1620,25,9,824,399,400,799,16
2022-03-06,EB,Belgium and Luxembourg,2524,1582,14,2,942,463,465,928,12
2022-03-07,EB,Belgium and Luxembourg,2341,1432,25,16,909,431,453,884,9
2022-03-08,EB,Belgium and Luxembourg,2159,1317,37,13,842,402,403,805,24
2022-03-09,EB,Belgium and Luxembourg,2267,1382,16,13,885,430,439,869,3
2022-03-10,EB,Belgium and Luxembourg,2409,1473,20,8,936,464,452,916,12
2022-03-11,EB,Belgium and Luxembourg,2544,1591,19,9,953,477,457,934,10
2022-03-12,EB,Belgium and Luxembourg,2338,1621,11,6,717,353,353,706,5
2022-03-13,EB,Belgium and Luxembourg,2463,1619,5,1,844,423,416,839,4
2022-03-14,EB,Belgium and Luxembourg,2317,1388,14,3,929,440,475,915,11
2022-03-15,EB,Belgium and Luxembourg,2250,1374,17,10,876,432,427,859,7
2022-03-16,EB,Belgium and Luxembourg,2347,1418,18,9,929,459,452,911,9
2022-03-17,EB,Belgium and Luxembourg,2502,1584,25,13,918,455,438,893,12
2022-03-18,EB,Belgium and Luxembourg,2598,1564,21,11,1034,502,511,1013,10
2022-03-19,EB,Belgium and Luxembourg,2378,1651,13,6,727,364,350,714,7
2022-03-20,EB,Belgium and Luxembourg,2516,1647,11,0,869,429,429,858,11
2022-03-21,EB,Belgium and Luxembourg,2448,1500,20,11,948,451,477,928,9
2022-03-22,EB,Belgium and Luxembourg,2188,1328,20,7,860,413,427,840,13
2022-03-23,EB,Belgium and Luxembourg,2362,1452,24,11,910,433,453,886,13
2022-03-24,EB,Belgium and Luxembourg,2584,1618,21,11,966,477,468,945,10
2022-03-25,EB,Belgium and Luxembourg,2771,1707,28,14,1064,534,502,1036,14
2022-03-26,EB,Belgium and Luxembourg,2413,1667,12,5,746,374,360,734,7
2022-03-27,EB,Belgium and Luxembourg,2825,1931,8,4,894,448,438,886,4
2022-03-28,EB,Belgium and Luxembourg,2860,1824,23,10,1036,499,514,1013,13
2022-03-29,EB,Belgium and Luxembourg,2625,1683,20,10,942,453,469,922,10
2022-03-30,EB,Belgium and Luxembourg,2796,1821,18,8,975,485,472,957,10
2022-03-31,EB,Belgium and Luxembourg,2794,1834,9,3,960,481,470,951,6
2022-04-01,EB,Belgium and Luxembourg,2926,1856,6,2,1070,538,526,1064,4
2022-04-02,EB,Belgium and Luxembourg,2790,1911,13,10,879,445,421,866,3
2022-04-03,EB,Belgium and Luxembourg,2907,1940,10,3,967,467,490,957,7
2022-04-04,EB,Belgium and Luxembourg,2959,1960,15,8,999,482,502,984,7
2022-04-05,EB,Belgium and Luxembourg,2647,1635,27,8,1012,488,497,985,19
2022-04-06,EB,Belgium and Luxembourg,2879,1878,15,5,1001,488,498,986,10
2022-04-07,EB,Belgium and Luxembourg,2841,1810,9,2,1031,523,499,1022,7
2022-04-08,EB,Belgium and Luxembourg,3040,1954,17,9,1086,554,515,1069,8
2022-04-09,EB,Belgium and Luxembourg,2703,1801,14,5,902,438,450,888,9
2022-04-10,EB,Belgium and Luxembourg,2936,1953,9,2,983,484,490,974,7
2022-04-11,EB,Belgium and Luxembourg,2802,1772,23,14,1030,488,519,1007,9
2022-04-12,EB,Belgium and Luxembourg,2732,1746,16,9,986,491,479,970,7
2022-04-13,EB,Belgium and Luxembourg,2897,1889,10,7,1008,497,501,998,3
2022-04-14,EB,Belgium and Luxembourg,3003,1960,17,6,1043,519,507,1026,11
2022-04-15,EB,Belgium and Luxembourg,2932,1890,13,9,1042,518,511,1029,4
2022-04-16,EB,Belgium and Luxembourg,2620,1748,17,7,872,431,424,855,10
2022-04-17,EB,Belgium and Luxembourg,2834,1878,8,2,956,471,477,948,6
2022-04-18,EB,Belgium and Luxembourg,2953,1920,16,7,1033,489,528,1017,9
2022-04-19,EB,Belgium and Luxembourg,2876,1851,21,11,1025,507,497,1004,10
2022-04-20,EB,Belgium and Luxembourg,2845,1824,22,8,1021,497,502,999,14
2022-04-21,EB,Belgium and Luxembourg,2967,1902,36,12,1065,515,514,1029,24
2022-04-22,EB,Belgium and Luxembourg,2876,1898,24,10,978,489,465,954,14
2022-04-23,EB,Belgium and Luxembourg,2561,1786,16,11,775,375,384,759,5
2022-04-24,EB,Belgium and Luxembourg,2869,1981,5,3,888,446,437,883,2
2022-04-25,EB,Belgium and Luxembourg,2862,1806,20,12,1056,510,526,1036,8
2022-04-26,EB,Belgium and Luxembourg,2783,1759,17,9,1024,500,507,1007,8
2022-04-27,EB,Belgium and Luxembourg,2934,1891,20,10,1043,510,513,1023,10
2022-04-28,EB,Belgium and Luxembourg,3074,1973,28,18,1101,545,528,1073,10
2022-04-29,EB,Belgium and Luxembourg,3093,1986,24,13,1107,559,524,1083,11
2022-04-30,EB,Belgium and Luxembourg,2697,1833,14,4,864,428,422,850,10
2022-05-01,EB,Belgium and Luxembourg,2912,1966,7,2,946,458,481,939,5
2022-05-02,EB,Belgium and Luxembourg,3003,1947,21,11,1056,507,528,1035,10
2022-05-03,EB,Belgium and Luxembourg,3032,1992,20,12,1040,512,508,1020,8
2022-05-04,EB,Belgium and Luxembourg,3080,1992,29,15,1088,525,534,1059,14
2022-05-05,EB,Belgium and Luxembourg,3210,2120,21,7,1090,532,537,1069,14
2022-05-06,EB,Belgium and Luxembourg,3231,2072,23,10,1159,585,551,1136,13
2022-05-07,EB,Belgium and Luxembourg,2861,1954,15,6,907,446,446,892,9
2022-05-08,EB,Belgium and Luxembourg,3123,2114,7,0,1009,502,500,1002,7
2022-05-09,EB,Belgium and Luxembourg,3046,1963,13,9,1083,524,546,1070,4
2022-05-10,EB,Belgium and Luxembourg,2957,1908,16,6,1049,514,519,1033,10
2022-05-11,EB,Belgium and Luxembourg,3060,1930,16,6,1130,560,554,1114,10
2022-05-12,EB,Belgium and Luxembourg,3133,2031,18,9,1102,544,540,1084,9
2022-05-13,EB,Belgium and Luxembourg,3222,2054,19,10,1168,586,563,1149,9
2022-05-14,EB,Belgium and Luxembourg,2775,1889,15,5,886,431,440,871,10
2022-05-15,EB,Belgium and Luxembourg,3089,2060,7,1,1029,505,517,1022,6
2022-05-16,EB,Belgium and Luxembourg,3025,1911,25,12,1114,534,555,1089,13
2022-05-17,EB,Belgium and Luxembourg,2945,1884,13,5,1061,518,530,1048,8
2022-05-18,EB,Belgium and Luxembourg,3027,1929,9,6,1098,545,544,1089,3
2022-05-19,EB,Belgium and Luxembourg,3151,2021,23,7,1130,558,549,1107,16
2022-05-20,EB,Belgium and Luxembourg,2981,1863,11,2,1118,564,543,1107,9
2022-05-21,EB,Belgium and Luxembourg,2984,2011,15,9,973,486,472,958,6
2022-05-22,EB,Belgium and Luxembourg,3226,2200,9,3,1026,507,510,1017,6
2022-05-23,EB,Belgium and Luxembourg,3018,1953,12,5,1065,510,543,1053,7
2022-05-24,EB,Belgium and Luxembourg,3138,2059,17,5,1079,528,534,1062,12
2022-05-25,EB,Belgium and Luxembourg,3422,2209,22,13,1213,600,591,1191,9
2022-05-26,EB,Belgium and Luxembourg,3337,2236,15,6,1101,559,527,1086,9
2022-05-27,EB,Belgium and Luxembourg,3237,2110,17,8,1127,561,549,1110,9
2022-05-28,EB,Belgium and Luxembourg,2915,1974,14,5,941,463,464,927,9
2022-05-29,EB,Belgium and Luxembourg,3316,2214,10,4,1102,525,567,1092,6
2022-05-30,EB,Belgium and Luxembourg,3340,2147,20,6,1193,565,608,1173,14
2022-05-31,EB,Belgium and Luxembourg,3058,1939,13,8,1119,569,537,1106,5
2022-06-01,EB,Belgium and Luxembourg,3287,2166,20,15,1121,548,553,1101,5
2022-06-02,EB,Belgium and Luxembourg,3225,2080,22,10,1145,560,563,1123,12
2022-06-03,EB,Belgium and Luxembourg,3398,2223,16,8,1175,601,558,1159,8
2022-06-04,EB,Belgium and Luxembourg,2896,1938,15,2,958,473,470,943,13
2022-06-05,EB,Belgium and Luxembourg,3057,2086,5,1,971,478,488,966,4
2022-06-06,EB,Belgium and Luxembourg,3308,2197,13,5,1111,525,573,1098,8
2022-06-07,EB,Belgium and Luxembourg,3183,2048,16,7,1135,574,545,1119,9
2022-06-08,EB,Belgium and Luxembourg,3255,2120,9,3,1135,562,564,1126,6
2022-06-09,EB,Belgium and Luxembourg,3229,2038,23,12,1191,582,586,1168,11
2022-06-10,EB,Belgium and Luxembourg,3317,2143,18,7,1174,596,560,1156,11
2022-06-11,EB,Belgium and Luxembourg,3022,2047,17,8,975,475,483,958,9
2022-06-12,EB,Belgium and Luxembourg,3254,2186,17,5,1068,525,526,1051,12
2022-06-13,EB,Belgium and Luxembourg,3230,2077,26,9,1153,545,582,1127,17
2022-06-14,EB,Belgium and Luxembourg,3154,1994,32,17,1160,566,562,1128,15
2022-06-15,EB,Belgium and Luxembourg,3435,2260,26,11,1175,577,572,1149,15
2022-06-16,EB,Belgium and Luxembourg,3303,2135,29,17,1168,573,566,1139,12
2022-06-17,EB,Belgium and Luxembourg,3287,2098,32,12,1189,601,556,1157,20
2022-06-18,EB,Belgium and Luxembourg,2959,2000,16,9,959,469,474,943,7
2022-06-19,EB,Belgium and Luxembourg,3294,2214,12,1,1080,534,534,1068,11
2022-06-20,EB,Belgium and Luxembourg,2946,2131,23,13,815,377,415,792,10
2022-06-21,EB,Belgium and Luxembourg,3266,2093,34,17,1173,571,568,1139,17
2022-06-22,EB,Belgium and Luxembourg,3359,2146,35,12,1213,580,598,1178,23
2022-06-23,EB,Belgium and Luxembourg,3293,2150,26,12,1143,556,561,1117,14
2022-06-24,EB,Belgium and Luxembourg,3131,2128,29,11,1003,512,462,974,18
2022-06-25,EB,Belgium and Luxembourg,2970,2230,15,8,740,364,361,725,7
2022-06-26,EB,Belgium and Luxembourg,3405,2424,11,7,981,487,483,970,4
2022-06-27,EB,Belgium and Luxembourg,3263,2126,24,15,1137,545,568,1113,9
2022-06-28,EB,Belgium and Luxembourg,3408,2239,22,12,1169,568,579,1147,10
2022-06-29,EB,Belgium and Luxembourg,3396,2180,29,14,1216,602,585,1187,15
2022-06-30,EB,Belgium and Luxembourg,3325,2129,32,14,1196,577,587,1164,18
2022-07-01,EB,Belgium and Luxembourg,3383,2149,20,10,1234,628,586,1214,10
2022-07-02,EB,Belgium and Luxembourg,3096,2082,17,9,1014,492,505,997,8
2022-07-03,EB,Belgium and Luxembourg,3366,2262,6,0,1104,542,556,1098,6
2022-07-04,EB,Belgium and Luxembourg,3391,2195,20,11,1196,574,602,1176,9
2022-07-05,EB,Belgium and Luxembourg,3301,2126,18,9,1175,587,570,1157,9
2022-07-06,EB,Belgium and Luxembourg,3475,2254,27,9,1221,598,596,1194,18
2022-07-07,EB,Belgium and Luxembourg,3451,2251,25,16,1200,594,581,1175,9
2022-07-08,EB,Belgium and Luxembourg,3424,2219,27,11,1205,599,579,1178,16
2022-07-09,EB,Belgium and Luxembourg,3121,2101,19,7,1020,495,506,1001,12
2022-07-10,EB,Belgium and Luxembourg,3308,2192,10,0,1116,553,553,1106,10
2022-07-11,EB,Belgium and Luxembourg,3263,2073,26,9,1190,565,599,1164,17
2022-07-12,EB,Belgium and Luxembourg,3373,2173,37,22,1200,590,573,1163,15
2022-07-13,EB,Belgium and Luxembourg,3358,2109,31,19,1249,607,611,1218,12
2022-07-14,EB,Belgium and Luxembourg,3282,2095,15,12,1187,590,582,1172,3
2022-07-15,EB,Belgium and Luxembourg,3412,2196,18,10,1216,604,594,1198,8
2022-07-16,EB,Belgium and Luxembourg,3070,2033,15,4,1037,503,519,1022,11
2022-07-17,EB,Belgium and Luxembourg,3252,2155,13,4,1097,546,538,1084,9
2022-07-18,EB,Belgium and Luxembourg,3284,2075,20,9,1209,586,603,1189,11
2022-07-19,EB,Belgium and Luxembourg,3196,2042,19,12,1154,577,558,1135,7
2022-07-20,EB,Belgium and Luxembourg,3147,1993,17,7,1154,564,573,1137,10
2022-07-21,EB,Belgium and Luxembourg,3328,2168,13,5,1160,581,566,1147,8
2022-07-22,EB,Belgium and Luxembourg,3387,2213,15,8,1174,585,574,1159,7
2022-07-23,EB,Belgium and Luxembourg,3090,2130,6,3,960,473,481,954,3
2022-07-24,EB,Belgium and Luxembourg,3240,2184,2,1,1056,530,524,1054,1
2022-07-25,EB,Belgium and Luxembourg,3222,2058,22,10,1164,556,586,1142,12
2022-07-26,EB,Belgium and Luxembourg,3202,2054,25,13,1148,563,560,1123,12
2022-07-27,EB,Belgium and Luxembourg,3137,1984,19,9,1153,568,566,1134,10
2022-07-28,EB,Belgium and Luxembourg,3336,2136,14,8,1200,595,591,1186,6
2022-07-29,EB,Belgium and Luxembourg,3374,2159,20,9,1215,604,591,1195,11
2022-07-30,EB,Belgium and Luxembourg,3163,2095,16,6,1068,523,529,1052,10
2022-07-31,EB,Belgium and Luxembourg,3346,2223,7,1,1123,560,556,1116,6
2022-08-01,EB,Belgium and Luxembourg,3182,2025,25,8,1157,565,567,1132,17
2022-08-02,EB,Belgium and Luxembourg,3161,2044,15,12,1117,556,546,1102,3
2022-08-03,EB,Belgium and Luxembourg,3229,2067,20,15,1162,572,570,1142,5
2022-08-04,EB,Belgium and Luxembourg,3172,2076,18,12,1096,536,542,1078,6
2022-08-05,EB,Belgium and Luxembourg,3261,2153,9,3,1108,567,532,1099,6
2022-08-06,EB,Belgium and Luxembourg,3045,2057,6,4,988,489,493,982,2
2022-08-07,EB,Belgium and Luxembourg,3257,2174,11,3,1083,532,540,1072,8
2022-08-08,EB,Belgium and Luxembourg,3137,2047,24,14,1090,520,546,1066,10
2022-08-09,EB,Belgium and Luxembourg,3131,2016,17,9,1115,551,547,1098,8
2022-08-10,EB,Belgium and Luxembourg,3209,2075,18,10,1134,559,557,1116,8
2022-08-11,EB,Belgium and Luxembourg,3154,2015,19,11,1139,561,559,1120,8
2022-08-12,EB,Belgium and Luxembourg,3225,2080,16,9,1145,578,551,1129,7
2022-08-13,EB,Belgium and Luxembourg,3125,2112,13,4,1013,497,503,1000,9
2022-08-14,EB,Belgium and Luxembourg,3251,2185,3,0,1066,527,536,1063,3
2022-08-15,EB,Belgium and Luxembourg,3116,2035,6,1,1081,524,551,1075,5
2022-08-16,EB,Belgium and Luxembourg,3142,1978,21,10,1164,573,570,1143,11
2022-08-17,EB,Belgium and Luxembourg,3180,2041,9,5,1139,570,560,1130,4
2022-08-18,EB,Belgium and Luxembourg,3214,2090,12,8,1124,551,561,1112,4
2022-08-19,EB,Belgium and Luxembourg,3247,2093,23,13,1154,576,555,1131,10
2022-08-20,EB,Belgium and Luxembourg,3033,1997,12,7,1036,517,507,1024,5
2022-08-21,EB,Belgium and Luxembourg,3183,2087,8,4,1096,542,546,1088,4
2022-08-22,EB,Belgium and Luxembourg,3126,1996,8,6,1130,553,569,1122,2
2022-08-23,EB,Belgium and Luxembourg,3102,2004,12,9,1098,542,544,1086,3
2022-08-24,EB,Belgium and Luxembourg,3172,2005,22,17,1167,575,570,1145,5
2022-08-25,EB,Belgium and Luxembourg,3222,2073,15,9,1149,562,572,1134,6
2022-08-26,EB,Belgium and Luxembourg,3288,2112,15,8,1176,588,573,1161,7
2022-08-27,EB,Belgium and Luxembourg,3024,2011,12,6,1013,497,504,1001,6
2022-08-28,EB,Belgium and Luxembourg,3264,2129,9,1,1135,558,568,1126,8
2022-08-29,EB,Belgium and Luxembourg,3225,2057,19,11,1168,567,582,1149,8
2022-08-30,EB,Belgium and Luxembourg,3261,2087,20,8,1174,585,569,1154,12
2022-08-31,EB,Belgium and Luxembourg,3310,2125,16,6,1185,579,590,1169,10
2022-09-01,EB,Belgium and Luxembourg,3345,2204,21,12,1141,567,553,1120,9
2022-09-02,EB,Belgium and Luxembourg,3248,2094,26,19,1154,577,551,1128,7
2022-09-03,EB,Belgium and Luxembourg,2981,2005,14,5,976,476,486,962,9
2022-09-04,EB,Belgium and Luxembourg,3260,2189,13,2,1071,532,526,1058,11
2022-09-05,EB,Belgium and Luxembourg,3264,2104,16,4,1160,555,589,1144,12
2022-09-06,EB,Belgium and Luxembourg,3194,2042,20,7,1152,568,564,1132,13
2022-09-07,EB,Belgium and Luxembourg,3351,2138,17,10,1213,601,595,1196,7
2022-09-08,EB,Belgium and Luxembourg,3216,2039,12,7,1177,584,581,1165,5
2022-09-09,EB,Belgium and Luxembourg,3265,2100,12,1,1165,585,568,1153,11
2022-09-10,EB,Belgium and Luxembourg,2953,1981,9,5,972,483,480,963,4
2022-09-11,EB,Belgium and Luxembourg,3207,2113,8,2,1094,535,551,1086,6
2022-09-12,EB,Belgium and Luxembourg,3192,2036,31,15,1156,554,571,1125,16
2022-09-13,EB,Belgium and Luxembourg,3155,1962,35,17,1193,585,573,1158,18
2022-09-14,EB,Belgium and Luxembourg,3169,2018,37,9,1151,568,546,1114,28
2022-09-15,EB,Belgium and Luxembourg,3375,2147,28,13,1228,595,605,1200,15
2022-09-16,EB,Belgium and Luxembourg,3029,1935,20,8,1094,546,528,1074,12
2022-09-17,EB,Belgium and Luxembourg,3044,2050,17,8,994,488,489,977,9
2022-09-18,EB,Belgium and Luxembourg,3211,2143,12,2,1068,524,532,1056,10
2022-09-19,EB,Belgium and Luxembourg,3124,2016,12,6,1108,532,564,1096,6
2022-09-20,EB,Belgium and Luxembourg,3249,2078,19,5,1171,583,569,1152,14
2022-09-21,EB,Belgium and Luxembourg,3249,2102,15,4,1147,570,562,1132,11
2022-09-22,EB,Belgium and Luxembourg,3362,2180,18,6,1182,578,586,1164,12
2022-09-23,EB,Belgium and Luxembourg,3352,2212,10,3,1140,585,545,1130,7
2022-09-24,EB,Belgium and Luxembourg,2942,2040,3,0,902,442,457,899,3
2022-09-25,EB,Belgium and Luxembourg,3179,2143,6,1,1036,511,519,1030,5
2022-09-26,EB,Belgium and Luxembourg,3137,2016,13,4,1121,539,569,1108,9
2022-09-27,EB,Belgium and Luxembourg,3155,2059,7,4,1096,547,542,1089,3
2022-09-28,EB,Belgium and Luxembourg,3328,2167,20,7,1161,575,566,1141,13
2022-09-29,EB,Belgium and Luxembourg,3350,2191,10,4,1159,570,579,1149,6
2022-09-30,EB,Belgium and Luxembourg,3358,2187,16,1,1171,600,555,1155,15
2022-10-01,EB,Belgium and Luxembourg,2931,2028,7,3,903,443,453,896,4
2022-10-02,EB,Belgium and Luxembourg,3242,2195,11,0,1047,524,512,1036,11
2022-10-03,EB,Belgium and Luxembourg,3108,2019,18,6,1089,511,560,1071,12
2022-10-04,EB,Belgium and Luxembourg,3071,2006,19,10,1065,518,528,1046,9
2022-10-05,EB,Belgium and Luxembourg,3098,2045,10,6,1053,525,518,1043,4
2022-10-06,EB,Belgium and Luxembourg,3147,2040,21,11,1107,541,545,1086,10
2022-10-07,EB,Belgium and Luxembourg,3265,2162,14,9,1103,562,527,1089,5
2022-10-08,EB,Belgium and Luxembourg,2923,2061,7,2,862,426,429,855,5
2022-10-09,EB,Belgium and Luxembourg,3106,2121,12,5,985,487,486,973,7
2022-10-10,EB,Belgium and Luxembourg,3128,2066,11,7,1062,507,544,1051,4
2022-10-11,EB,Belgium and Luxembourg,3036,1960,9,4,1076,534,533,1067,5
2022-10-12,EB,Belgium and Luxembourg,3199,2051,11,3,1148,572,565,1137,8
2022-10-13,EB,Belgium and Luxembourg,3167,2039,15,4,1128,556,557,1113,11
2022-10-14,EB,Belgium and Luxembourg,3290,2151,11,8,1139,585,543,1128,3
2022-10-15,EB,Belgium and Luxembourg,2885,2015,10,5,870,432,428,860,5
2022-10-16,EB,Belgium and Luxembourg,3081,2096,6,4,985,484,495,979,2
2022-10-17,EB,Belgium and Luxembourg,3032,1972,20,9,1060,505,535,1040,11
2022-10-18,EB,Belgium and Luxembourg,3045,2010,25,10,1035,511,499,1010,15
2022-10-19,EB,Belgium and Luxembourg,2977,1914,12,6,1063,527,524,1051,6
2022-10-20,EB,Belgium and Luxembourg,3145,2039,11,4,1106,536,559,1095,7
2022-10-21,EB,Belgium and Luxembourg,3159,2102,10,1,1057,546,501,1047,9
2022-10-22,EB,Belgium and Luxembourg,2919,2069,4,2,850,422,424,846,2
2022-10-23,EB,Belgium and Luxembourg,2994,2034,11,1,960,472,477,949,10
2022-10-24,EB,Belgium and Luxembourg,3001,1936,12,5,1065,510,543,1053,7
2022-10-25,EB,Belgium and Luxembourg,3034,1966,10,2,1068,533,525,1058,8
2022-10-26,EB,Belgium and Luxembourg,3098,1985,16,4,1113,555,542,1097,12
2022-10-27,EB,Belgium and Luxembourg,3169,2045,21,7,1124,551,552,1103,14
2022-10-28,EB,Belgium and Luxembourg,3228,2060,19,8,1168,576,573,1149,11
2022-10-29,EB,Belgium and Luxembourg,2978,2028,18,9,950,471,461,932,9
2022-10-30,EB,Belgium and Luxembourg,3025,2021,10,2,1004,497,497,994,8
2022-10-31,EB,Belgium and Luxembourg,2859,1892,16,7,967,472,479,951,9
2022-11-01,EB,Belgium and Luxembourg,2662,1742,5,1,920,458,457,915,4
2022-11-02,EB,Belgium and Luxembourg,2744,1766,11,1,978,479,488,967,10
2022-11-03,EB,Belgium and Luxembourg,2794,1759,13,6,1035,509,513,1022,7
2022-11-04,EB,Belgium and Luxembourg,2850,1827,7,3,1023,524,492,1016,4
2022-11-05,EB,Belgium and Luxembourg,2591,1736,7,1,855,413,435,848,6
2022-11-06,EB,Belgium and Luxembourg,2865,1872,3,0,993,496,494,990,3
2022-11-07,EB,Belgium and Luxembourg,2759,1803,13,6,956,461,482,943,7
2022-11-08,EB,Belgium and Luxembourg,2531,1646,13,9,885,446,426,872,4
2022-11-09,EB,Belgium and Luxembourg,2259,1719,8,5,540,254,278,532,3
2022-11-10,EB,Belgium and Luxembourg,2795,1744,23,12,1051,525,503,1028,11
2022-11-11,EB,Belgium and Luxembourg,2816,1861,9,4,955,490,456,946,5
2022-11-12,EB,Belgium and Luxembourg,2322,1603,8,5,719,359,352,711,3
2022-11-13,EB,Belgium and Luxembourg,2723,1774,13,3,949,450,486,936,10
2022-11-14,EB,Belgium and Luxembourg,2650,1691,12,4,959,465,482,947,8
2022-11-15,EB,Belgium and Luxembourg,2524,1600,9,6,924,448,467,915,3
2022-11-16,EB,Belgium and Luxembourg,2586,1618,16,6,968,481,471,952,10
2022-11-17,EB,Belgium and Luxembourg,2691,1664,17,6,1027,510,500,1010,11
2022-11-18,EB,Belgium and Luxembourg,2812,1807,10,5,1005,510,485,995,5
2022-11-19,EB,Belgium and Luxembourg,2278,1536,7,3,742,365,370,735,4
2022-11-20,EB,Belgium and Luxembourg,2585,1718,5,0,867,427,435,862,5
2022-11-21,EB,Belgium and Luxembourg,2566,1633,11,8,933,452,470,922,3
2022-11-22,EB,Belgium and Luxembourg,2397,1503,16,10,894,439,439,878,6
2022-11-23,EB,Belgium and Luxembourg,2491,1571,16,7,920,456,448,904,9
2022-11-24,EB,Belgium and Luxembourg,2651,1649,23,11,1002,489,490,979,12
2022-11-25,EB,Belgium and Luxembourg,2780,1743,11,5,1037,524,502,1026,6
2022-11-26,EB,Belgium and Luxembourg,2237,1500,11,8,737,357,369,726,3
2022-11-27,EB,Belgium and Luxembourg,2633,1760,5,1,873,433,435,868,4
2022-11-28,EB,Belgium and Luxembourg,2558,1611,15,7,947,446,486,932,8
2022-11-29,EB,Belgium and Luxembourg,2381,1499,10,7,882,444,428,872,3
2022-11-30,EB,Belgium and Luxembourg,2563,1624,13,5,939,468,458,926,8
2022-12-01,EB,Belgium and Luxembourg,2651,1674,6,2,977,487,484,971,4
2022-12-02,EB,Belgium and Luxembourg,2846,1854,14,5,992,502,476,978,9
2022-12-03,EB,Belgium and Luxembourg,2299,1572,6,1,727,352,369,721,5
2022-12-04,EB,Belgium and Luxembourg,2693,1805,4,2,888,443,441,884,2
2022-12-05,EB,Belgium and Luxembourg,2604,1676,5,0,928,448,475,923,5
2022-12-06,EB,Belgium and Luxembourg,2428,1535,18,8,893,438,437,875,10
2022-12-07,EB,Belgium and Luxembourg,2651,1676,14,6,975,485,476,961,8
2022-12-08,EB,Belgium and Luxembourg,2696,1674,20,8,1022,500,502,1002,12
2022-12-09,EB,Belgium and Luxembourg,2782,1774,17,3,1008,505,486,991,14
2022-12-10,EB,Belgium and Luxembourg,2346,1626,5,1,720,354,361,715,4
2022-12-11,EB,Belgium and Luxembourg,2544,1668,7,2,876,435,434,869,5
2022-12-12,EB,Belgium and Luxembourg,2552,1572,13,6,980,474,493,967,7
2022-12-13,EB,Belgium and Luxembourg,2424,1509,16,6,915,440,459,899,10
2022-12-14,EB,Belgium and Luxembourg,2544,1586,27,12,958,467,464,931,15
2022-12-15,EB,Belgium and Luxembourg,2709,1689,28,12,1020,500,492,992,16
2022-12-16,EB,Belgium and Luxembourg,2705,1901,18,6,804,402,384,786,12
2022-12-17,EB,Belgium and Luxembourg,2576,1825,14,4,751,373,364,737,10
2022-12-18,EB,Belgium and Luxembourg,2672,1805,12,2,867,423,432,855,10
2022-12-19,EB,Belgium and Luxembourg,2676,1753,18,7,923,448,457,905,11
2022-12-20,EB,Belgium and Luxembourg,2665,1731,12,5,934,451,471,922,7
2022-12-21,EB,Belgium and Luxembourg,2634,1639,15,5,995,492,488,980,10
2022-12-22,EB,Belgium and Luxembourg,2861,1816,24,10,1045,511,510,1021,14
2022-12-23,EB,Belgium and Luxembourg,2985,1990,8,0,995,502,485,987,8
2022-12-24,EB,Belgium and Luxembourg,2275,1591,9,5,684,326,349,675,4
2022-12-25,EB,Belgium and Luxembourg,1817,1248,7,1,569,288,274,562,6
2022-12-26,EB,Belgium and Luxembourg,2551,1732,13,4,819,401,405,806,9
2022-12-27,EB,Belgium and Luxembourg,2544,1724,14,6,820,405,401,806,8
2022-01-01,LQ,Bosnia-Herzegovina,775,729,0,0,46,23,23,46,0
2022-01-02,LQ,Bosnia-Herzegovina,924,895,0,0,29,13,16,29,0
2022-01-03,LQ,Bosnia-Herzegovina,822,760,2,0,62,30,30,60,2
2022-01-04,LQ,Bosnia-Herzegovina,769,702,0,0,67,34,33,67,0
2022-01-05,LQ,Bosnia-Herzegovina,735,682,0,0,53,26,27,53,0
2022-01-06,LQ,Bosnia-Herzegovina,737,696,0,0,41,21,20,41,0
2022-01-07,LQ,Bosnia-Herzegovina,813,747,0,0,66,33,33,66,0
2022-01-08,LQ,Bosnia-Herzegovina,944,887,0,0,57,29,28,57,0
2022-01-09,LQ,Bosnia-Herzegovina,905,861,0,0,44,22,22,44,0
2022-01-10,LQ,Bosnia-Herzegovina,634,599,0,0,35,17,18,35,0
2022-01-11,LQ,Bosnia-Herzegovina,569,528,0,0,41,20,21,41,0
2022-01-12,LQ,Bosnia-Herzegovina,562,530,1,1,32,15,16,31,0
2022-01-13,LQ,Bosnia-Herzegovina,546,516,0,0,30,16,14,30,0
2022-01-14,LQ,Bosnia-Herzegovina,665,620,0,0,45,22,23,45,0
2022-01-15,LQ,Bosnia-Herzegovina,686,660,0,0,26,15,11,26,0
2022-01-16,LQ,Bosnia-Herzegovina,644,611,0,0,33,17,16,33,0
2022-01-17,LQ,Bosnia-Herzegovina,564,530,0,0,34,17,17,34,0
2022-01-18,LQ,Bosnia-Herzegovina,480,449,1,1,31,15,15,30,0
2022-01-19,LQ,Bosnia-Herzegovina,487,465,0,0,22,11,11,22,0
2022-01-20,LQ,Bosnia-Herzegovina,469,437,0,0,32,16,16,32,0
2022-01-21,LQ,Bosnia-Herzegovina,584,543,0,0,41,21,20,41,0
2022-01-22,LQ,Bosnia-Herzegovina,624,602,0,0,22,11,11,22,0
2022-01-23,LQ,Bosnia-Herzegovina,634,606,0,0,28,14,14,28,0
2022-01-24,LQ,Bosnia-Herzegovina,528,500,0,0,28,14,14,28,0
2022-01-25,LQ,Bosnia-Herzegovina,440,413,0,0,27,14,13,27,0
2022-01-26,LQ,Bosnia-Herzegovina,461,446,0,0,15,7,8,15,0
2022-01-27,LQ,Bosnia-Herzegovina,500,474,0,0,26,13,13,26,0
2022-01-28,LQ,Bosnia-Herzegovina,615,583,0,0,32,16,16,32,0
2022-01-29,LQ,Bosnia-Herzegovina,662,639,0,0,23,11,12,23,0
2022-01-30,LQ,Bosnia-Herzegovina,617,585,0,0,32,16,16,32,0
2022-01-31,LQ,Bosnia-Herzegovina,531,498,0,0,33,17,16,33,0
2022-02-01,LQ,Bosnia-Herzegovina,529,498,0,0,31,15,16,31,0
2022-02-02,LQ,Bosnia-Herzegovina,500,475,0,0,25,11,14,25,0
2022-02-03,LQ,Bosnia-Herzegovina,521,492,1,0,29,16,12,28,1
2022-02-04,LQ,Bosnia-Herzegovina,659,627,0,0,32,16,16,32,0
2022-02-05,LQ,Bosnia-Herzegovina,697,675,0,0,22,11,11,22,0
2022-02-06,LQ,Bosnia-Herzegovina,646,617,0,0,29,14,15,29,0
2022-02-07,LQ,Bosnia-Herzegovina,546,521,0,0,25,13,12,25,0
2022-02-08,LQ,Bosnia-Herzegovina,553,521,0,0,32,15,17,32,0
2022-02-09,LQ,Bosnia-Herzegovina,518,494,0,0,24,11,13,24,0
2022-02-10,LQ,Bosnia-Herzegovina,547,517,1,0,30,16,13,29,1
2022-02-11,LQ,Bosnia-Herzegovina,636,602,0,0,34,17,17,34,0
2022-02-12,LQ,Bosnia-Herzegovina,669,643,0,0,26,13,13,26,0
2022-02-13,LQ,Bosnia-Herzegovina,642,616,0,0,26,13,13,26,0
2022-02-14,LQ,Bosnia-Herzegovina,574,546,0,0,28,14,14,28,0
2022-02-15,LQ,Bosnia-Herzegovina,516,477,0,0,39,19,20,39,0
2022-02-16,LQ,Bosnia-Herzegovina,523,497,0,0,26,13,13,26,0
2022-02-17,LQ,Bosnia-Herzegovina,548,521,0,0,27,14,13,27,0
2022-02-18,LQ,Bosnia-Herzegovina,693,657,0,0,36,18,18,36,0
2022-02-19,LQ,Bosnia-Herzegovina,729,700,0,0,29,14,15,29,0
2022-02-20,LQ,Bosnia-Herzegovina,710,686,0,0,24,12,12,24,0
2022-02-21,LQ,Bosnia-Herzegovina,614,583,0,0,31,16,15,31,0
2022-02-22,LQ,Bosnia-Herzegovina,568,533,0,0,35,17,18,35,0
2022-02-23,LQ,Bosnia-Herzegovina,577,553,0,0,24,11,13,24,0
2022-02-24,LQ,Bosnia-Herzegovina,594,563,0,0,31,14,17,31,0
2022-02-25,LQ,Bosnia-Herzegovina,720,680,0,0,40,21,19,40,0
2022-02-26,LQ,Bosnia-Herzegovina,750,718,0,0,32,16,16,32,0
2022-02-27,LQ,Bosnia-Herzegovina,720,687,0,0,33,17,16,33,0
2022-02-28,LQ,Bosnia-Herzegovina,648,613,0,0,35,18,17,35,0
2022-03-01,LQ,Bosnia-Herzegovina,655,610,0,0,45,22,23,45,0
2022-03-02,LQ,Bosnia-Herzegovina,623,588,2,0,35,16,17,33,2
2022-03-03,LQ,Bosnia-Herzegovina,684,649,2,0,35,16,17,33,2
2022-03-04,LQ,Bosnia-Herzegovina,789,737,0,0,52,27,25,52,0
2022-03-05,LQ,Bosnia-Herzegovina,796,756,0,0,40,20,20,40,0
2022-03-06,LQ,Bosnia-Herzegovina,752,725,0,0,27,13,14,27,0
2022-03-07,LQ,Bosnia-Herzegovina,702,657,0,0,45,22,23,45,0
2022-03-08,LQ,Bosnia-Herzegovina,648,604,0,0,44,23,21,44,0
2022-03-09,LQ,Bosnia-Herzegovina,662,628,2,0,34,15,17,32,2
2022-03-10,LQ,Bosnia-Herzegovina,680,640,2,0,40,20,18,38,2
2022-03-11,LQ,Bosnia-Herzegovina,713,664,0,0,49,24,25,49,0
2022-03-12,LQ,Bosnia-Herzegovina,792,751,0,0,41,21,20,41,0
2022-03-13,LQ,Bosnia-Herzegovina,743,714,0,0,29,15,14,29,0
2022-03-14,LQ,Bosnia-Herzegovina,700,651,0,0,49,24,25,49,0
2022-03-15,LQ,Bosnia-Herzegovina,652,608,1,1,44,22,21,43,0
2022-03-16,LQ,Bosnia-Herzegovina,668,634,0,0,34,16,18,34,0
2022-03-17,LQ,Bosnia-Herzegovina,643,607,0,0,36,18,18,36,0
2022-03-18,LQ,Bosnia-Herzegovina,762,708,2,0,54,27,25,52,2
2022-03-19,LQ,Bosnia-Herzegovina,814,778,0,0,36,18,18,36,0
2022-03-20,LQ,Bosnia-Herzegovina,789,757,0,0,32,16,16,32,0
2022-03-21,LQ,Bosnia-Herzegovina,682,640,0,0,42,20,22,42,0
2022-03-22,LQ,Bosnia-Herzegovina,621,574,0,0,47,25,22,47,0
2022-03-23,LQ,Bosnia-Herzegovina,699,662,0,0,37,17,20,37,0
2022-03-24,LQ,Bosnia-Herzegovina,697,658,2,0,39,19,18,37,2
2022-03-25,LQ,Bosnia-Herzegovina,781,734,0,0,47,23,24,47,0
2022-03-26,LQ,Bosnia-Herzegovina,844,800,0,0,44,22,22,44,0
2022-03-27,LQ,Bosnia-Herzegovina,1029,983,0,0,46,22,24,46,0
2022-03-28,LQ,Bosnia-Herzegovina,936,859,4,2,77,36,37,73,2
2022-03-29,LQ,Bosnia-Herzegovina,833,773,2,1,60,29,29,58,1
2022-03-30,LQ,Bosnia-Herzegovina,856,809,2,1,47,23,22,45,1
2022-03-31,LQ,Bosnia-Herzegovina,894,841,3,1,53,25,25,50,2
2022-04-01,LQ,Bosnia-Herzegovina,1065,990,1,0,75,37,37,74,1
2022-04-02,LQ,Bosnia-Herzegovina,1079,1038,1,0,41,20,20,40,1
2022-04-03,LQ,Bosnia-Herzegovina,1060,1011,0,0,49,25,24,49,0
2022-04-04,LQ,Bosnia-Herzegovina,933,861,0,0,72,36,36,72,0
2022-04-05,LQ,Bosnia-Herzegovina,864,807,1,0,57,28,28,56,1
2022-04-06,LQ,Bosnia-Herzegovina,928,884,0,0,44,22,22,44,0
2022-04-07,LQ,Bosnia-Herzegovina,919,875,0,0,44,22,22,44,0
2022-04-08,LQ,Bosnia-Herzegovina,1165,1095,0,0,70,35,35,70,0
2022-04-09,LQ,Bosnia-Herzegovina,1233,1192,0,0,41,21,20,41,0
2022-04-10,LQ,Bosnia-Herzegovina,1218,1169,0,0,49,25,24,49,0
2022-04-11,LQ,Bosnia-Herzegovina,1076,1005,1,1,71,34,36,70,0
2022-04-12,LQ,Bosnia-Herzegovina,946,893,0,0,53,27,26,53,0
2022-04-13,LQ,Bosnia-Herzegovina,1070,1010,2,0,60,29,29,58,2
2022-04-14,LQ,Bosnia-Herzegovina,1146,1088,0,0,58,29,29,58,0
2022-04-15,LQ,Bosnia-Herzegovina,1203,1133,0,0,70,35,35,70,0
2022-04-16,LQ,Bosnia-Herzegovina,1238,1191,0,0,47,24,23,47,0
2022-04-17,LQ,Bosnia-Herzegovina,1246,1194,0,0,52,26,26,52,0
2022-04-18,LQ,Bosnia-Herzegovina,1166,1101,0,0,65,31,34,65,0
2022-04-19,LQ,Bosnia-Herzegovina,1004,949,0,0,55,28,27,55,0
2022-04-20,LQ,Bosnia-Herzegovina,1104,1041,2,0,63,30,31,61,2
2022-04-21,LQ,Bosnia-Herzegovina,1135,1076,0,0,59,30,29,59,0
2022-04-22,LQ,Bosnia-Herzegovina,1177,1108,0,0,69,35,34,69,0
2022-04-23,LQ,Bosnia-Herzegovina,1313,1267,0,0,46,23,23,46,0
2022-04-24,LQ,Bosnia-Herzegovina,1306,1257,0,0,49,25,24,49,0
2022-04-25,LQ,Bosnia-Herzegovina,1105,1040,0,0,65,32,33,65,0
2022-04-26,LQ,Bosnia-Herzegovina,1007,948,0,0,59,29,30,59,0
2022-04-27,LQ,Bosnia-Herzegovina,1074,1010,2,0,64,32,30,62,2
2022-04-28,LQ,Bosnia-Herzegovina,1151,1081,2,0,70,33,35,68,2
2022-04-29,LQ,Bosnia-Herzegovina,1240,1168,0,0,72,36,36,72,0
2022-04-30,LQ,Bosnia-Herzegovina,1366,1307,0,0,59,30,29,59,0
2022-05-01,LQ,Bosnia-Herzegovina,1418,1353,0,0,65,33,32,65,0
2022-05-02,LQ,Bosnia-Herzegovina,1289,1221,1,0,68,33,34,67,1
2022-05-03,LQ,Bosnia-Herzegovina,1198,1136,0,0,62,31,31,62,0
2022-05-04,LQ,Bosnia-Herzegovina,1150,1085,0,0,65,32,33,65,0
2022-05-05,LQ,Bosnia-Herzegovina,1282,1218,0,0,64,32,32,64,0
2022-05-06,LQ,Bosnia-Herzegovina,1329,1248,0,0,81,41,40,81,0
2022-05-07,LQ,Bosnia-Herzegovina,1487,1435,0,0,52,26,26,52,0
2022-05-08,LQ,Bosnia-Herzegovina,1419,1355,0,0,64,32,32,64,0
2022-05-09,LQ,Bosnia-Herzegovina,1262,1192,0,0,70,35,35,70,0
2022-05-10,LQ,Bosnia-Herzegovina,1214,1150,0,0,64,31,33,64,0
2022-05-11,LQ,Bosnia-Herzegovina,1260,1189,0,0,71,36,35,71,0
2022-05-12,LQ,Bosnia-Herzegovina,1230,1158,0,0,72,36,36,72,0
2022-05-13,LQ,Bosnia-Herzegovina,1403,1321,0,0,82,41,41,82,0
2022-05-14,LQ,Bosnia-Herzegovina,1454,1393,0,0,61,31,30,61,0
2022-05-15,LQ,Bosnia-Herzegovina,1450,1385,0,0,65,33,32,65,0
2022-05-16,LQ,Bosnia-Herzegovina,1241,1172,2,2,69,33,34,67,0
2022-05-17,LQ,Bosnia-Herzegovina,1162,1102,5,1,60,27,28,55,4
2022-05-18,LQ,Bosnia-Herzegovina,1240,1171,0,0,69,35,34,69,0
2022-05-19,LQ,Bosnia-Herzegovina,1257,1183,0,0,74,37,37,74,0
2022-05-20,LQ,Bosnia-Herzegovina,1395,1310,4,0,85,40,41,81,4
2022-05-21,LQ,Bosnia-Herzegovina,1556,1501,0,0,55,28,27,55,0
2022-05-22,LQ,Bosnia-Herzegovina,1464,1397,1,0,67,34,32,66,1
2022-05-23,LQ,Bosnia-Herzegovina,1250,1185,0,0,65,32,33,65,0
2022-05-24,LQ,Bosnia-Herzegovina,1291,1226,2,0,65,31,32,63,2
2022-05-25,LQ,Bosnia-Herzegovina,1551,1481,2,0,70,34,34,68,2
2022-05-26,LQ,Bosnia-Herzegovina,1411,1340,1,0,71,35,35,70,1
2022-05-27,LQ,Bosnia-Herzegovina,1509,1426,0,0,83,41,42,83,0
2022-05-28,LQ,Bosnia-Herzegovina,1584,1532,0,0,52,26,26,52,0
2022-05-29,LQ,Bosnia-Herzegovina,1544,1481,0,0,63,31,32,63,0
2022-05-30,LQ,Bosnia-Herzegovina,1433,1356,0,0,77,38,39,77,0
2022-05-31,LQ,Bosnia-Herzegovina,1296,1229,1,0,67,34,32,66,1
2022-06-01,LQ,Bosnia-Herzegovina,1483,1401,0,0,82,41,41,82,0
2022-06-02,LQ,Bosnia-Herzegovina,1445,1379,1,1,66,32,33,65,0
2022-06-03,LQ,Bosnia-Herzegovina,1585,1487,0,0,98,50,48,98,0
2022-06-04,LQ,Bosnia-Herzegovina,1712,1654,2,0,58,27,29,56,2
2022-06-05,LQ,Bosnia-Herzegovina,1541,1469,0,0,72,37,35,72,0
2022-06-06,LQ,Bosnia-Herzegovina,1512,1433,1,0,79,39,39,78,1
2022-06-07,LQ,Bosnia-Herzegovina,1479,1409,0,0,70,34,36,70,0
2022-06-08,LQ,Bosnia-Herzegovina,1374,1295,3,1,79,39,37,76,2
2022-06-09,LQ,Bosnia-Herzegovina,1446,1379,0,0,67,33,34,67,0
2022-06-10,LQ,Bosnia-Herzegovina,1619,1518,0,0,101,51,50,101,0
2022-06-11,LQ,Bosnia-Herzegovina,1675,1611,0,0,64,31,33,64,0
2022-06-12,LQ,Bosnia-Herzegovina,1666,1588,0,0,78,39,39,78,0
2022-06-13,LQ,Bosnia-Herzegovina,1544,1465,0,0,79,39,40,79,0
2022-06-14,LQ,Bosnia-Herzegovina,1504,1421,0,0,83,41,42,83,0
2022-06-15,LQ,Bosnia-Herzegovina,1607,1532,1,1,75,38,36,74,0
2022-06-16,LQ,Bosnia-Herzegovina,1527,1462,0,0,65,32,33,65,0
2022-06-17,LQ,Bosnia-Herzegovina,1673,1576,0,0,97,48,49,97,0
2022-06-18,LQ,Bosnia-Herzegovina,1754,1688,0,0,66,33,33,66,0
2022-06-19,LQ,Bosnia-Herzegovina,1684,1606,0,0,78,39,39,78,0
2022-06-20,LQ,Bosnia-Herzegovina,1600,1519,0,0,81,41,40,81,0
2022-06-21,LQ,Bosnia-Herzegovina,1514,1430,0,0,84,41,43,84,0
2022-06-22,LQ,Bosnia-Herzegovina,1543,1469,0,0,74,38,36,74,0
2022-06-23,LQ,Bosnia-Herzegovina,1464,1395,0,0,69,34,35,69,0
2022-06-24,LQ,Bosnia-Herzegovina,1636,1546,0,0,90,46,44,90,0
2022-06-25,LQ,Bosnia-Herzegovina,1737,1675,1,0,62,30,31,61,1
2022-06-26,LQ,Bosnia-Herzegovina,1668,1602,1,0,66,33,32,65,1
2022-06-27,LQ,Bosnia-Herzegovina,1579,1505,0,0,74,36,38,74,0
2022-06-28,LQ,Bosnia-Herzegovina,1619,1524,0,0,95,49,46,95,0
2022-06-29,LQ,Bosnia-Herzegovina,1633,1554,0,0,79,39,40,79,0
2022-06-30,LQ,Bosnia-Herzegovina,1547,1471,0,0,76,38,38,76,0
2022-07-01,LQ,Bosnia-Herzegovina,1670,1564,0,0,106,53,53,106,0
2022-07-02,LQ,Bosnia-Herzegovina,1754,1684,0,0,70,35,35,70,0
2022-07-03,LQ,Bosnia-Herzegovina,1671,1591,1,0,80,41,38,79,1
2022-07-04,LQ,Bosnia-Herzegovina,1465,1375,0,0,90,44,46,90,0
2022-07-05,LQ,Bosnia-Herzegovina,1507,1419,0,0,88,43,45,88,0
2022-07-06,LQ,Bosnia-Herzegovina,1702,1615,1,1,87,44,42,86,0
2022-07-07,LQ,Bosnia-Herzegovina,1625,1540,0,0,85,42,43,85,0
2022-07-08,LQ,Bosnia-Herzegovina,1688,1579,0,0,109,55,54,109,0
2022-07-09,LQ,Bosnia-Herzegovina,1906,1837,0,0,69,34,35,69,0
2022-07-10,LQ,Bosnia-Herzegovina,1766,1683,0,0,83,42,41,83,0
2022-07-11,LQ,Bosnia-Herzegovina,1616,1519,0,0,97,48,49,97,0
2022-07-12,LQ,Bosnia-Herzegovina,1588,1492,0,0,96,46,50,96,0
2022-07-13,LQ,Bosnia-Herzegovina,1635,1546,0,0,89,47,42,89,0
2022-07-14,LQ,Bosnia-Herzegovina,1558,1475,0,0,83,40,43,83,0
2022-07-15,LQ,Bosnia-Herzegovina,1705,1590,0,0,115,58,57,115,0
2022-07-16,LQ,Bosnia-Herzegovina,1806,1732,0,0,74,37,37,74,0
2022-07-17,LQ,Bosnia-Herzegovina,1735,1650,0,0,85,42,43,85,0
2022-07-18,LQ,Bosnia-Herzegovina,1604,1510,0,0,94,47,47,94,0
2022-07-19,LQ,Bosnia-Herzegovina,1576,1478,0,0,98,47,51,98,0
2022-07-20,LQ,Bosnia-Herzegovina,1580,1491,1,1,89,46,42,88,0
2022-07-21,LQ,Bosnia-Herzegovina,1636,1551,0,0,85,43,42,85,0
2022-07-22,LQ,Bosnia-Herzegovina,1653,1546,0,0,107,54,53,107,0
2022-07-23,LQ,Bosnia-Herzegovina,1712,1644,0,0,68,34,34,68,0
2022-07-24,LQ,Bosnia-Herzegovina,1685,1601,0,0,84,42,42,84,0
2022-07-25,LQ,Bosnia-Herzegovina,1607,1514,0,0,93,46,47,93,0
2022-07-26,LQ,Bosnia-Herzegovina,1574,1486,0,0,88,44,44,88,0
2022-07-27,LQ,Bosnia-Herzegovina,1574,1475,0,0,99,49,50,99,0
2022-07-28,LQ,Bosnia-Herzegovina,1485,1414,0,0,71,35,36,71,0
2022-07-29,LQ,Bosnia-Herzegovina,1712,1596,1,1,116,59,56,115,0
2022-07-30,LQ,Bosnia-Herzegovina,1775,1695,1,0,80,37,42,79,1
2022-07-31,LQ,Bosnia-Herzegovina,1733,1647,0,0,86,45,41,86,0
2022-08-01,LQ,Bosnia-Herzegovina,1611,1523,0,0,88,44,44,88,0
2022-08-02,LQ,Bosnia-Herzegovina,1623,1532,1,0,91,45,45,90,1
2022-08-03,LQ,Bosnia-Herzegovina,1645,1564,0,0,81,41,40,81,0
2022-08-04,LQ,Bosnia-Herzegovina,1606,1517,1,0,89,44,44,88,1
2022-08-05,LQ,Bosnia-Herzegovina,1591,1487,0,0,104,52,52,104,0
2022-08-06,LQ,Bosnia-Herzegovina,1731,1657,0,0,74,36,38,74,0
2022-08-07,LQ,Bosnia-Herzegovina,1687,1606,0,0,81,41,40,81,0
2022-08-08,LQ,Bosnia-Herzegovina,1504,1418,0,0,86,42,44,86,0
2022-08-09,LQ,Bosnia-Herzegovina,1516,1423,0,0,93,46,47,93,0
2022-08-10,LQ,Bosnia-Herzegovina,1555,1472,1,1,83,42,40,82,0
2022-08-11,LQ,Bosnia-Herzegovina,1586,1512,0,0,74,36,38,74,0
2022-08-12,LQ,Bosnia-Herzegovina,1618,1512,0,0,106,54,52,106,0
2022-08-13,LQ,Bosnia-Herzegovina,1692,1619,0,0,73,36,37,73,0
2022-08-14,LQ,Bosnia-Herzegovina,1633,1548,0,0,85,42,43,85,0
2022-08-15,LQ,Bosnia-Herzegovina,1552,1466,0,0,86,44,42,86,0
2022-08-16,LQ,Bosnia-Herzegovina,1473,1387,0,0,86,43,43,86,0
2022-08-17,LQ,Bosnia-Herzegovina,1551,1478,0,0,73,36,37,73,0
2022-08-18,LQ,Bosnia-Herzegovina,1554,1478,0,0,76,37,39,76,0
2022-08-19,LQ,Bosnia-Herzegovina,1515,1405,0,0,110,56,54,110,0
2022-08-20,LQ,Bosnia-Herzegovina,1582,1505,0,0,77,39,38,77,0
2022-08-21,LQ,Bosnia-Herzegovina,1527,1448,0,0,79,40,39,79,0
2022-08-22,LQ,Bosnia-Herzegovina,1390,1305,0,0,85,42,43,85,0
2022-08-23,LQ,Bosnia-Herzegovina,1415,1332,0,0,83,41,42,83,0
2022-08-24,LQ,Bosnia-Herzegovina,1560,1475,1,0,85,41,43,84,1
2022-08-25,LQ,Bosnia-Herzegovina,1540,1453,3,1,87,42,42,84,2
2022-08-26,LQ,Bosnia-Herzegovina,1563,1452,1,0,111,56,54,110,1
2022-08-27,LQ,Bosnia-Herzegovina,1636,1562,0,0,74,37,37,74,0
2022-08-28,LQ,Bosnia-Herzegovina,1577,1502,0,0,75,38,37,75,0
2022-08-29,LQ,Bosnia-Herzegovina,1413,1324,2,0,89,43,44,87,2
2022-08-30,LQ,Bosnia-Herzegovina,1522,1433,0,0,89,44,45,89,0
2022-08-31,LQ,Bosnia-Herzegovina,1540,1461,0,0,79,39,40,79,0
2022-09-01,LQ,Bosnia-Herzegovina,1520,1439,0,0,81,41,40,81,0
2022-09-02,LQ,Bosnia-Herzegovina,1512,1417,0,0,95,47,48,95,0
2022-09-03,LQ,Bosnia-Herzegovina,1685,1611,0,0,74,37,37,74,0
2022-09-04,LQ,Bosnia-Herzegovina,1574,1500,0,0,74,38,36,74,0
2022-09-05,LQ,Bosnia-Herzegovina,1560,1471,3,0,89,41,45,86,3
2022-09-06,LQ,Bosnia-Herzegovina,1574,1476,2,0,98,49,47,96,2
2022-09-07,LQ,Bosnia-Herzegovina,1550,1469,3,2,81,40,38,78,1
2022-09-08,LQ,Bosnia-Herzegovina,1505,1429,0,0,76,36,40,76,0
2022-09-09,LQ,Bosnia-Herzegovina,1445,1343,0,0,102,53,49,102,0
2022-09-10,LQ,Bosnia-Herzegovina,1577,1515,0,0,62,31,31,62,0
2022-09-11,LQ,Bosnia-Herzegovina,1494,1421,0,0,73,37,36,73,0
2022-09-12,LQ,Bosnia-Herzegovina,1515,1439,0,0,76,37,39,76,0
2022-09-13,LQ,Bosnia-Herzegovina,1512,1431,0,0,81,40,41,81,0
2022-09-14,LQ,Bosnia-Herzegovina,1488,1414,4,0,74,35,35,70,4
2022-09-15,LQ,Bosnia-Herzegovina,1456,1384,1,0,72,35,36,71,1
2022-09-16,LQ,Bosnia-Herzegovina,1556,1473,1,0,83,42,40,82,1
2022-09-17,LQ,Bosnia-Herzegovina,1592,1532,2,0,60,29,29,58,2
2022-09-18,LQ,Bosnia-Herzegovina,1607,1550,0,0,57,29,28,57,0
2022-09-19,LQ,Bosnia-Herzegovina,1433,1359,0,0,74,37,37,74,0
2022-09-20,LQ,Bosnia-Herzegovina,1403,1323,0,0,80,39,41,80,0
2022-09-21,LQ,Bosnia-Herzegovina,1518,1454,0,0,64,32,32,64,0
2022-09-22,LQ,Bosnia-Herzegovina,1493,1437,0,0,56,28,28,56,0
2022-09-23,LQ,Bosnia-Herzegovina,1574,1497,0,0,77,39,38,77,0
2022-09-24,LQ,Bosnia-Herzegovina,1658,1600,0,0,58,29,29,58,0
2022-09-25,LQ,Bosnia-Herzegovina,1576,1517,0,0,59,29,30,59,0
2022-09-26,LQ,Bosnia-Herzegovina,1359,1282,0,0,77,39,38,77,0
2022-09-27,LQ,Bosnia-Herzegovina,1371,1295,3,0,76,36,37,73,3
2022-09-28,LQ,Bosnia-Herzegovina,1497,1436,0,0,61,31,30,61,0
2022-09-29,LQ,Bosnia-Herzegovina,1429,1371,1,1,58,28,29,57,0
2022-09-30,LQ,Bosnia-Herzegovina,1518,1450,0,0,68,36,32,68,0
2022-10-01,LQ,Bosnia-Herzegovina,1532,1470,1,1,62,28,33,61,0
2022-10-02,LQ,Bosnia-Herzegovina,1502,1445,1,0,57,28,28,56,1
2022-10-03,LQ,Bosnia-Herzegovina,1441,1375,0,0,66,35,31,66,0
2022-10-04,LQ,Bosnia-Herzegovina,1334,1277,2,1,57,26,29,55,1
2022-10-05,LQ,Bosnia-Herzegovina,1323,1263,2,1,60,29,29,58,1
2022-10-06,LQ,Bosnia-Herzegovina,1330,1267,2,1,63,31,30,61,1
2022-10-07,LQ,Bosnia-Herzegovina,1523,1444,1,1,79,40,38,78,0
2022-10-08,LQ,Bosnia-Herzegovina,1595,1551,0,0,44,22,22,44,0
2022-10-09,LQ,Bosnia-Herzegovina,1506,1455,0,0,51,25,26,51,0
2022-10-10,LQ,Bosnia-Herzegovina,1375,1303,0,0,72,37,35,72,0
2022-10-11,LQ,Bosnia-Herzegovina,1342,1289,0,0,53,26,27,53,0
2022-10-12,LQ,Bosnia-Herzegovina,1380,1318,0,0,62,31,31,62,0
2022-10-13,LQ,Bosnia-Herzegovina,1302,1242,0,0,60,30,30,60,0
2022-10-14,LQ,Bosnia-Herzegovina,1449,1381,0,0,68,35,33,68,0
2022-10-15,LQ,Bosnia-Herzegovina,1566,1518,0,0,48,24,24,48,0
2022-10-16,LQ,Bosnia-Herzegovina,1480,1432,0,0,48,24,24,48,0
2022-10-17,LQ,Bosnia-Herzegovina,1344,1275,1,0,69,34,34,68,1
2022-10-18,LQ,Bosnia-Herzegovina,1281,1226,0,0,55,28,27,55,0
2022-10-19,LQ,Bosnia-Herzegovina,1283,1222,0,0,61,30,31,61,0
2022-10-20,LQ,Bosnia-Herzegovina,1269,1213,0,0,56,28,28,56,0
2022-10-21,LQ,Bosnia-Herzegovina,1342,1275,0,0,67,33,34,67,0
2022-10-22,LQ,Bosnia-Herzegovina,1534,1485,0,0,49,25,24,49,0
2022-10-23,LQ,Bosnia-Herzegovina,1437,1389,2,0,48,23,23,46,2
2022-10-24,LQ,Bosnia-Herzegovina,1298,1234,0,0,64,32,32,64,0
2022-10-25,LQ,Bosnia-Herzegovina,1259,1198,1,1,61,29,31,60,0
2022-10-26,LQ,Bosnia-Herzegovina,1277,1226,0,0,51,26,25,51,0
2022-10-27,LQ,Bosnia-Herzegovina,1282,1222,0,0,60,29,31,60,0
2022-10-28,LQ,Bosnia-Herzegovina,1363,1288,1,1,75,38,36,74,0
2022-10-29,LQ,Bosnia-Herzegovina,1555,1508,0,0,47,23,24,47,0
2022-10-30,LQ,Bosnia-Herzegovina,1314,1261,0,0,53,26,27,53,0
2022-10-31,LQ,Bosnia-Herzegovina,1135,1073,0,0,62,30,32,62,0
2022-11-01,LQ,Bosnia-Herzegovina,952,907,0,0,45,24,21,45,0
2022-11-02,LQ,Bosnia-Herzegovina,916,875,0,0,41,21,20,41,0
2022-11-03,LQ,Bosnia-Herzegovina,898,853,0,0,45,22,23,45,0
2022-11-04,LQ,Bosnia-Herzegovina,1030,965,1,1,65,32,32,64,0
2022-11-05,LQ,Bosnia-Herzegovina,1126,1079,0,0,47,23,24,47,0
2022-11-06,LQ,Bosnia-Herzegovina,1103,1050,0,0,53,27,26,53,0
2022-11-07,LQ,Bosnia-Herzegovina,914,850,2,2,64,30,32,62,0
2022-11-08,LQ,Bosnia-Herzegovina,786,737,2,0,49,25,22,47,2
2022-11-09,LQ,Bosnia-Herzegovina,800,761,1,1,39,19,19,38,0
2022-11-10,LQ,Bosnia-Herzegovina,805,758,2,1,47,21,24,45,1
2022-11-11,LQ,Bosnia-Herzegovina,950,886,0,0,64,33,31,64,0
2022-11-12,LQ,Bosnia-Herzegovina,1018,981,0,0,37,19,18,37,0
2022-11-13,LQ,Bosnia-Herzegovina,956,901,0,0,55,28,27,55,0
2022-11-14,LQ,Bosnia-Herzegovina,886,827,0,0,59,30,29,59,0
2022-11-15,LQ,Bosnia-Herzegovina,756,716,0,0,40,19,21,40,0
2022-11-16,LQ,Bosnia-Herzegovina,794,754,2,0,40,19,19,38,2
2022-11-17,LQ,Bosnia-Herzegovina,790,743,1,1,47,22,24,46,0
2022-11-18,LQ,Bosnia-Herzegovina,900,834,0,0,66,34,32,66,0
2022-11-19,LQ,Bosnia-Herzegovina,868,834,0,0,34,18,16,34,0
2022-11-20,LQ,Bosnia-Herzegovina,918,862,0,0,56,27,29,56,0
2022-11-21,LQ,Bosnia-Herzegovina,843,793,0,0,50,26,24,50,0
2022-11-22,LQ,Bosnia-Herzegovina,717,667,0,0,50,24,26,50,0
2022-11-23,LQ,Bosnia-Herzegovina,664,629,0,0,35,18,17,35,0
2022-11-24,LQ,Bosnia-Herzegovina,764,715,0,0,49,23,26,49,0
2022-11-25,LQ,Bosnia-Herzegovina,878,820,3,2,58,28,27,55,1
2022-11-26,LQ,Bosnia-Herzegovina,871,827,3,0,44,21,20,41,3
2022-11-27,LQ,Bosnia-Herzegovina,930,880,0,0,50,25,25,50,0
2022-11-28,LQ,Bosnia-Herzegovina,833,773,0,0,60,30,30,60,0
2022-11-29,LQ,Bosnia-Herzegovina,705,653,2,0,52,25,25,50,2
2022-11-30,LQ,Bosnia-Herzegovina,715,678,0,0,37,18,19,37,0
2022-12-01,LQ,Bosnia-Herzegovina,771,726,0,0,45,22,23,45,0
2022-12-02,LQ,Bosnia-Herzegovina,856,796,0,0,60,31,29,60,0
2022-12-03,LQ,Bosnia-Herzegovina,841,804,0,0,37,19,18,37,0
2022-12-04,LQ,Bosnia-Herzegovina,892,845,0,0,47,24,23,47,0
2022-12-05,LQ,Bosnia-Herzegovina,800,740,0,0,60,28,32,60,0
2022-12-06,LQ,Bosnia-Herzegovina,722,675,0,0,47,24,23,47,0
2022-12-07,LQ,Bosnia-Herzegovina,742,700,0,0,42,21,21,42,0
2022-12-08,LQ,Bosnia-Herzegovina,730,686,3,0,44,20,21,41,3
2022-12-09,LQ,Bosnia-Herzegovina,804,743,1,0,61,30,30,60,1
2022-12-10,LQ,Bosnia-Herzegovina,816,775,1,0,41,20,20,40,1
2022-12-11,LQ,Bosnia-Herzegovina,896,847,0,0,49,25,24,49,0
2022-12-12,LQ,Bosnia-Herzegovina,795,744,0,0,51,25,26,51,0
2022-12-13,LQ,Bosnia-Herzegovina,691,650,0,0,41,21,20,41,0
2022-12-14,LQ,Bosnia-Herzegovina,743,699,0,0,44,22,22,44,0
2022-12-15,LQ,Bosnia-Herzegovina,720,697,0,0,23,13,10,23,0
2022-12-16,LQ,Bosnia-Herzegovina,914,846,0,0,68,32,36,68,0
2022-12-17,LQ,Bosnia-Herzegovina,896,858,0,0,38,19,19,38,0
2022-12-18,LQ,Bosnia-Herzegovina,976,930,0,0,46,23,23,46,0
2022-12-19,LQ,Bosnia-Herzegovina,921,864,0,0,57,28,29,57,0
2022-12-20,LQ,Bosnia-Herzegovina,858,813,0,0,45,24,21,45,0
2022-12-21,LQ,Bosnia-Herzegovina,849,820,0,0,29,14,15,29,0
2022-12-22,LQ,Bosnia-Herzegovina,926,881,1,0,45,21,23,44,1
2022-12-23,LQ,Bosnia-Herzegovina,1040,977,0,0,63,33,30,63,0
2022-12-24,LQ,Bosnia-Herzegovina,917,878,0,0,39,19,20,39,0
2022-12-25,LQ,Bosnia-Herzegovina,746,713,0,0,33,17,16,33,0
2022-12-26,LQ,Bosnia-Herzegovina,894,846,0,0,48,23,25,48,0
2022-12-27,LQ,Bosnia-Herzegovina,829,773,1,1,56,27,28,55,0
2022-01-01,LB,Bulgaria,1349,1228,2,0,121,59,60,119,2
2022-01-02,LB,Bulgaria,1711,1490,7,0,221,103,111,214,7
2022-01-03,LB,Bulgaria,1512,1315,7,0,197,92,98,190,7
2022-01-04,LB,Bulgaria,1357,1189,8,2,168,80,80,160,6
2022-01-05,LB,Bulgaria,1359,1189,7,0,170,80,83,163,7
2022-01-06,LB,Bulgaria,1491,1331,5,0,160,78,77,155,5
2022-01-07,LB,Bulgaria,1544,1385,8,0,159,78,73,151,8
2022-01-08,LB,Bulgaria,1624,1441,4,0,183,88,91,179,4
2022-01-09,LB,Bulgaria,1615,1455,6,0,160,75,79,154,6
2022-01-10,LB,Bulgaria,1333,1203,14,3,130,59,57,116,11
2022-01-11,LB,Bulgaria,1179,1055,13,3,124,55,56,111,10
2022-01-12,LB,Bulgaria,1212,1097,13,1,115,53,49,102,12
2022-01-13,LB,Bulgaria,1218,1109,8,0,109,51,50,101,8
2022-01-14,LB,Bulgaria,1345,1220,11,0,125,58,56,114,11
2022-01-15,LB,Bulgaria,1350,1218,2,0,132,63,67,130,2
2022-01-16,LB,Bulgaria,1419,1295,8,0,124,59,57,116,8
2022-01-17,LB,Bulgaria,1156,1042,6,2,114,53,55,108,4
2022-01-18,LB,Bulgaria,1046,942,7,2,104,48,49,97,5
2022-01-19,LB,Bulgaria,1119,1005,10,1,114,53,51,104,9
2022-01-20,LB,Bulgaria,1166,1057,7,1,109,52,50,102,6
2022-01-21,LB,Bulgaria,1263,1137,9,0,126,58,59,117,9
2022-01-22,LB,Bulgaria,1314,1191,2,0,123,61,60,121,2
2022-01-23,LB,Bulgaria,1371,1253,6,0,118,56,56,112,6
2022-01-24,LB,Bulgaria,927,816,5,1,111,51,55,106,4
2022-01-25,LB,Bulgaria,800,704,7,2,96,45,44,89,5
2022-01-26,LB,Bulgaria,991,890,6,0,101,46,49,95,6
2022-01-27,LB,Bulgaria,1171,1056,4,0,115,57,54,111,4
2022-01-28,LB,Bulgaria,1273,1147,15,1,126,57,54,111,14
2022-01-29,LB,Bulgaria,1322,1196,3,1,126,61,62,123,2
2022-01-30,LB,Bulgaria,1318,1206,6,0,112,52,54,106,6
2022-01-31,LB,Bulgaria,1147,1022,6,0,125,61,58,119,6
2022-02-01,LB,Bulgaria,1077,979,6,0,98,45,47,92,6
2022-02-02,LB,Bulgaria,1069,970,7,0,99,45,47,92,7
2022-02-03,LB,Bulgaria,1221,1114,7,3,107,51,49,100,4
2022-02-04,LB,Bulgaria,1257,1111,14,1,146,68,64,132,13
2022-02-05,LB,Bulgaria,1373,1221,2,0,152,76,74,150,2
2022-02-06,LB,Bulgaria,1396,1265,7,1,131,58,66,124,6
2022-02-07,LB,Bulgaria,1149,1007,5,0,142,70,67,137,5
2022-02-08,LB,Bulgaria,1041,940,5,0,101,48,48,96,5
2022-02-09,LB,Bulgaria,1097,980,9,2,117,51,57,108,7
2022-02-10,LB,Bulgaria,1245,1118,17,2,127,56,54,110,15
2022-02-11,LB,Bulgaria,1363,1219,10,2,144,70,64,134,8
2022-02-12,LB,Bulgaria,1468,1314,6,4,154,72,76,148,2
2022-02-13,LB,Bulgaria,1514,1379,7,1,135,67,61,128,6
2022-02-14,LB,Bulgaria,1362,1234,8,2,128,61,59,120,6
2022-02-15,LB,Bulgaria,1299,1198,8,1,101,45,48,93,7
2022-02-16,LB,Bulgaria,1286,1175,9,0,111,52,50,102,9
2022-02-17,LB,Bulgaria,1382,1273,10,4,109,50,49,99,6
2022-02-18,LB,Bulgaria,1462,1321,9,1,141,66,66,132,8
2022-02-19,LB,Bulgaria,1681,1523,2,0,158,76,80,156,2
2022-02-20,LB,Bulgaria,1651,1505,7,0,146,66,73,139,7
2022-02-21,LB,Bulgaria,1337,1189,11,2,148,70,67,137,9
2022-02-22,LB,Bulgaria,1314,1191,19,9,123,50,54,104,10
2022-02-23,LB,Bulgaria,1299,1176,13,0,123,57,53,110,13
2022-02-24,LB,Bulgaria,1391,1274,16,0,117,53,48,101,16
2022-02-25,LB,Bulgaria,1481,1321,8,0,160,72,80,152,8
2022-02-26,LB,Bulgaria,1638,1503,3,1,135,69,63,132,2
2022-02-27,LB,Bulgaria,1557,1428,8,0,129,61,60,121,8
2022-02-28,LB,Bulgaria,1453,1331,5,0,122,58,59,117,5
2022-03-01,LB,Bulgaria,1388,1265,17,0,123,52,54,106,17
2022-03-02,LB,Bulgaria,1464,1343,9,1,121,58,54,112,8
2022-03-03,LB,Bulgaria,1535,1420,9,2,115,54,52,106,7
2022-03-04,LB,Bulgaria,1672,1527,10,1,145,66,69,135,9
2022-03-05,LB,Bulgaria,1789,1636,5,3,153,73,75,148,2
2022-03-06,LB,Bulgaria,1712,1559,7,1,153,71,75,146,6
2022-03-07,LB,Bulgaria,1523,1387,11,1,136,62,63,125,10
2022-03-08,LB,Bulgaria,1395,1262,12,1,133,61,60,121,11
2022-03-09,LB,Bulgaria,1448,1322,8,0,126,59,59,118,8
2022-03-10,LB,Bulgaria,1433,1304,13,0,129,56,60,116,13
2022-03-11,LB,Bulgaria,1535,1405,9,0,130,60,61,121,9
2022-03-12,LB,Bulgaria,1497,1368,2,0,129,63,64,127,2
2022-03-13,LB,Bulgaria,1590,1453,8,2,137,66,63,129,6
2022-03-14,LB,Bulgaria,1367,1237,10,2,130,61,59,120,8
2022-03-15,LB,Bulgaria,1375,1257,13,1,118,54,51,105,12
2022-03-16,LB,Bulgaria,1409,1286,13,1,123,53,57,110,12
2022-03-17,LB,Bulgaria,1533,1401,15,4,132,59,58,117,11
2022-03-18,LB,Bulgaria,1624,1482,16,0,142,62,64,126,16
2022-03-19,LB,Bulgaria,1657,1528,3,1,129,64,62,126,2
2022-03-20,LB,Bulgaria,1666,1528,7,1,138,68,63,131,6
2022-03-21,LB,Bulgaria,1454,1319,8,1,135,62,65,127,7
2022-03-22,LB,Bulgaria,1272,1154,7,2,118,54,57,111,5
2022-03-23,LB,Bulgaria,1461,1300,22,3,161,69,70,139,19
2022-03-24,LB,Bulgaria,1544,1415,15,3,129,57,57,114,12
2022-03-25,LB,Bulgaria,1652,1506,7,0,146,70,69,139,7
2022-03-26,LB,Bulgaria,1751,1611,4,2,140,67,69,136,2
2022-03-27,LB,Bulgaria,1825,1675,7,2,150,70,73,143,5
2022-03-28,LB,Bulgaria,1707,1547,11,0,160,76,73,149,11
2022-03-29,LB,Bulgaria,1639,1484,16,4,155,66,73,139,12
2022-03-30,LB,Bulgaria,1703,1532,12,1,171,81,78,159,11
2022-03-31,LB,Bulgaria,1781,1608,7,3,173,81,85,166,4
2022-04-01,LB,Bulgaria,1950,1764,8,0,186,92,86,178,8
2022-04-02,LB,Bulgaria,2082,1899,3,0,183,94,86,180,3
2022-04-03,LB,Bulgaria,2044,1886,5,0,158,76,77,153,5
2022-04-04,LB,Bulgaria,1771,1605,8,1,166,81,77,158,7
2022-04-05,LB,Bulgaria,1695,1548,4,0,147,71,72,143,4
2022-04-06,LB,Bulgaria,1836,1676,7,1,160,76,77,153,6
2022-04-07,LB,Bulgaria,1954,1768,5,1,186,91,90,181,4
2022-04-08,LB,Bulgaria,2084,1885,9,2,199,97,93,190,7
2022-04-09,LB,Bulgaria,2195,2011,4,0,184,88,92,180,4
2022-04-10,LB,Bulgaria,2167,1983,12,5,184,83,89,172,7
2022-04-11,LB,Bulgaria,1907,1734,6,0,173,84,83,167,6
2022-04-12,LB,Bulgaria,1805,1628,8,2,177,83,86,169,6
2022-04-13,LB,Bulgaria,1851,1669,16,1,182,83,83,166,15
2022-04-14,LB,Bulgaria,1984,1790,16,3,194,90,88,178,13
2022-04-15,LB,Bulgaria,2138,1949,10,1,189,92,87,179,9
2022-04-16,LB,Bulgaria,2218,2048,2,0,170,84,84,168,2
2022-04-17,LB,Bulgaria,2161,1986,7,0,175,83,85,168,7
2022-04-18,LB,Bulgaria,2063,1859,16,0,204,92,96,188,16
2022-04-19,LB,Bulgaria,1984,1794,9,3,190,91,90,181,6
2022-04-20,LB,Bulgaria,1961,1778,10,2,183,87,86,173,8
2022-04-21,LB,Bulgaria,2009,1807,17,4,202,96,89,185,13
2022-04-22,LB,Bulgaria,2217,2005,17,2,212,103,92,195,15
2022-04-23,LB,Bulgaria,2359,2179,2,0,180,87,91,178,2
2022-04-24,LB,Bulgaria,2252,2082,8,2,170,78,84,162,6
2022-04-25,LB,Bulgaria,2039,1846,10,2,193,91,92,183,8
2022-04-26,LB,Bulgaria,1948,1750,17,3,198,87,94,181,14
2022-04-27,LB,Bulgaria,1984,1797,10,1,187,89,88,177,9
2022-04-28,LB,Bulgaria,2069,1879,11,0,190,94,85,179,11
2022-04-29,LB,Bulgaria,2198,1997,13,0,201,96,92,188,13
2022-04-30,LB,Bulgaria,2436,2242,5,3,194,93,96,189,2
2022-05-01,LB,Bulgaria,2387,2196,8,0,191,91,92,183,8
2022-05-02,LB,Bulgaria,2078,1871,12,1,207,95,100,195,11
2022-05-03,LB,Bulgaria,2062,1862,9,1,200,97,94,191,8
2022-05-04,LB,Bulgaria,2067,1864,27,4,203,87,89,176,23
2022-05-05,LB,Bulgaria,2104,1899,11,3,205,100,94,194,8
2022-05-06,LB,Bulgaria,2195,2000,13,2,195,91,91,182,11
2022-05-07,LB,Bulgaria,2387,2196,3,0,191,91,97,188,3
2022-05-08,LB,Bulgaria,2354,2165,9,1,189,88,92,180,8
2022-05-09,LB,Bulgaria,2046,1825,19,4,221,102,100,202,15
2022-05-10,LB,Bulgaria,1996,1800,9,2,196,94,93,187,7
2022-05-11,LB,Bulgaria,2002,1821,17,3,181,82,82,164,14
2022-05-12,LB,Bulgaria,2088,1901,17,2,187,83,87,170,15
2022-05-13,LB,Bulgaria,2252,2035,11,0,217,104,102,206,11
2022-05-14,LB,Bulgaria,2465,2271,4,1,194,97,93,190,3
2022-05-15,LB,Bulgaria,2398,2213,9,0,185,85,91,176,9
2022-05-16,LB,Bulgaria,2107,1892,11,3,215,101,103,204,8
2022-05-17,LB,Bulgaria,1998,1806,11,4,192,90,91,181,7
2022-05-18,LB,Bulgaria,2066,1883,10,2,183,92,81,173,8
2022-05-19,LB,Bulgaria,2165,1954,15,2,211,96,100,196,13
2022-05-20,LB,Bulgaria,2323,2094,8,0,229,110,111,221,8
2022-05-21,LB,Bulgaria,2531,2324,5,1,207,99,103,202,4
2022-05-22,LB,Bulgaria,2477,2282,8,1,195,95,92,187,7
2022-05-23,LB,Bulgaria,2194,1990,10,2,204,96,98,194,8
2022-05-24,LB,Bulgaria,2175,1962,8,2,213,103,102,205,6
2022-05-25,LB,Bulgaria,2306,2100,10,0,206,101,95,196,10
2022-05-26,LB,Bulgaria,2350,2114,15,2,236,110,111,221,13
2022-05-27,LB,Bulgaria,2458,2213,9,1,245,116,120,236,8
2022-05-28,LB,Bulgaria,2646,2442,6,1,204,102,96,198,5
2022-05-29,LB,Bulgaria,2668,2463,16,4,205,93,96,189,12
2022-05-30,LB,Bulgaria,2272,2062,12,2,210,99,99,198,10
2022-05-31,LB,Bulgaria,2247,2031,17,2,216,99,100,199,15
2022-06-01,LB,Bulgaria,2355,2147,9,2,208,100,99,199,7
2022-06-02,LB,Bulgaria,2381,2148,14,2,233,111,108,219,12
2022-06-03,LB,Bulgaria,2636,2369,7,0,267,126,134,260,7
2022-06-04,LB,Bulgaria,2835,2618,9,0,217,109,99,208,9
2022-06-05,LB,Bulgaria,2715,2488,11,0,227,107,109,216,11
2022-06-06,LB,Bulgaria,2451,2229,7,0,222,110,105,215,7
2022-06-07,LB,Bulgaria,2394,2145,7,1,249,118,124,242,6
2022-06-08,LB,Bulgaria,2538,2326,29,3,212,93,90,183,26
2022-06-09,LB,Bulgaria,2595,2360,14,2,235,112,109,221,12
2022-06-10,LB,Bulgaria,2779,2476,6,0,303,147,150,297,6
2022-06-11,LB,Bulgaria,2903,2662,3,0,241,121,117,238,3
2022-06-12,LB,Bulgaria,2851,2598,12,0,253,119,122,241,12
2022-06-13,LB,Bulgaria,2518,2278,7,0,240,114,119,233,7
2022-06-14,LB,Bulgaria,2533,2260,10,0,273,130,133,263,10
2022-06-15,LB,Bulgaria,2560,2319,16,3,241,114,111,225,13
2022-06-16,LB,Bulgaria,2663,2413,14,2,250,117,119,236,12
2022-06-17,LB,Bulgaria,2855,2507,14,0,348,165,169,334,14
2022-06-18,LB,Bulgaria,2953,2705,2,0,248,126,120,246,2
2022-06-19,LB,Bulgaria,2852,2587,9,0,265,126,130,256,9
2022-06-20,LB,Bulgaria,2627,2348,11,1,279,133,135,268,10
2022-06-21,LB,Bulgaria,2701,2391,18,1,310,148,144,292,17
2022-06-22,LB,Bulgaria,2744,2482,29,7,262,113,120,233,22
2022-06-23,LB,Bulgaria,2786,2518,14,0,268,131,123,254,14
2022-06-24,LB,Bulgaria,2943,2589,21,2,354,168,165,333,19
2022-06-25,LB,Bulgaria,3088,2825,13,0,263,122,128,250,13
2022-06-26,LB,Bulgaria,3154,2878,14,1,276,130,132,262,13
2022-06-27,LB,Bulgaria,2866,2579,9,0,287,141,137,278,9
2022-06-28,LB,Bulgaria,2867,2531,12,2,336,162,162,324,10
2022-06-29,LB,Bulgaria,2962,2684,19,2,278,132,127,259,17
2022-06-30,LB,Bulgaria,2979,2705,15,1,274,125,134,259,14
2022-07-01,LB,Bulgaria,3141,2774,14,0,367,177,176,353,14
2022-07-02,LB,Bulgaria,3320,3016,12,0,304,142,150,292,12
2022-07-03,LB,Bulgaria,3248,2926,15,0,322,158,149,307,15
2022-07-04,LB,Bulgaria,2970,2671,9,0,299,144,146,290,9
2022-07-05,LB,Bulgaria,2957,2606,19,1,351,168,164,332,18
2022-07-06,LB,Bulgaria,3018,2741,13,1,277,130,134,264,12
2022-07-07,LB,Bulgaria,3084,2805,14,2,279,133,132,265,12
2022-07-08,LB,Bulgaria,3244,2853,13,1,391,186,192,378,12
2022-07-09,LB,Bulgaria,3328,3040,8,0,288,144,136,280,8
2022-07-10,LB,Bulgaria,3215,2906,15,2,309,146,148,294,13
2022-07-11,LB,Bulgaria,2962,2658,11,0,304,144,149,293,11
2022-07-12,LB,Bulgaria,2996,2649,17,1,347,164,166,330,16
2022-07-13,LB,Bulgaria,2971,2683,19,3,288,136,133,269,16
2022-07-14,LB,Bulgaria,2993,2706,12,0,287,140,135,275,12
2022-07-15,LB,Bulgaria,3149,2728,12,0,421,203,206,409,12
2022-07-16,LB,Bulgaria,3334,3033,8,0,301,151,142,293,8
2022-07-17,LB,Bulgaria,3228,2924,13,0,304,143,148,291,13
2022-07-18,LB,Bulgaria,2969,2658,11,0,311,150,150,300,11
2022-07-19,LB,Bulgaria,2971,2612,20,1,359,171,168,339,19
2022-07-20,LB,Bulgaria,3088,2792,14,1,296,142,140,282,13
2022-07-21,LB,Bulgaria,3064,2779,14,0,285,132,139,271,14
2022-07-22,LB,Bulgaria,3177,2778,13,1,399,192,194,386,12
2022-07-23,LB,Bulgaria,3361,3053,8,1,308,152,148,300,7
2022-07-24,LB,Bulgaria,3271,2973,12,0,298,146,140,286,12
2022-07-25,LB,Bulgaria,2951,2636,13,1,315,149,153,302,12
2022-07-26,LB,Bulgaria,3049,2683,18,1,366,175,173,348,17
2022-07-27,LB,Bulgaria,3056,2803,13,2,253,117,123,240,11
2022-07-28,LB,Bulgaria,3046,2753,17,3,293,142,134,276,14
2022-07-29,LB,Bulgaria,3185,2780,10,0,405,195,200,395,10
2022-07-30,LB,Bulgaria,3356,3045,9,0,311,152,150,302,9
2022-07-31,LB,Bulgaria,3313,3009,12,0,304,148,144,292,12
2022-08-01,LB,Bulgaria,2955,2639,15,0,316,147,154,301,15
2022-08-02,LB,Bulgaria,3105,2726,22,1,379,177,180,357,21
2022-08-03,LB,Bulgaria,3117,2836,14,0,281,133,134,267,14
2022-08-04,LB,Bulgaria,3046,2760,19,1,286,136,131,267,18
2022-08-05,LB,Bulgaria,3237,2821,16,0,416,198,202,400,16
2022-08-06,LB,Bulgaria,3364,3050,7,0,314,155,152,307,7
2022-08-07,LB,Bulgaria,3320,3011,15,0,309,149,145,294,15
2022-08-08,LB,Bulgaria,2976,2664,15,0,312,146,151,297,15
2022-08-09,LB,Bulgaria,3078,2726,15,0,352,171,166,337,15
2022-08-10,LB,Bulgaria,3121,2849,14,5,272,127,131,258,9
2022-08-11,LB,Bulgaria,3083,2798,20,0,285,133,132,265,20
2022-08-12,LB,Bulgaria,3297,2891,16,0,406,196,194,390,16
2022-08-13,LB,Bulgaria,3410,3110,9,2,300,146,145,291,7
2022-08-14,LB,Bulgaria,3274,2972,13,1,302,143,146,289,12
2022-08-15,LB,Bulgaria,3044,2746,10,0,298,144,144,288,10
2022-08-16,LB,Bulgaria,3074,2740,16,1,334,160,158,318,15
2022-08-17,LB,Bulgaria,3057,2788,15,3,269,126,128,254,12
2022-08-18,LB,Bulgaria,3104,2810,26,2,294,133,135,268,24
2022-08-19,LB,Bulgaria,3177,2787,12,2,390,190,188,378,10
2022-08-20,LB,Bulgaria,3278,2967,11,0,311,150,150,300,11
2022-08-21,LB,Bulgaria,3339,3036,14,0,303,147,142,289,14
2022-08-22,LB,Bulgaria,2967,2679,16,4,288,135,137,272,12
2022-08-23,LB,Bulgaria,3063,2717,17,3,346,162,167,329,14
2022-08-24,LB,Bulgaria,3082,2813,18,2,269,127,124,251,16
2022-08-25,LB,Bulgaria,3006,2708,20,2,298,139,139,278,18
2022-08-26,LB,Bulgaria,3167,2775,12,0,392,187,193,380,12
2022-08-27,LB,Bulgaria,3400,3097,9,0,303,152,142,294,9
2022-08-28,LB,Bulgaria,3241,2929,15,0,312,148,149,297,15
2022-08-29,LB,Bulgaria,2907,2607,11,2,300,143,146,289,9
2022-08-30,LB,Bulgaria,2993,2640,15,3,353,168,170,338,12
2022-08-31,LB,Bulgaria,3019,2743,16,0,276,132,128,260,16
2022-09-01,LB,Bulgaria,3032,2752,16,0,280,131,133,264,16
2022-09-02,LB,Bulgaria,3081,2684,15,4,397,191,191,382,11
2022-09-03,LB,Bulgaria,3365,3069,9,0,296,144,143,287,9
2022-09-04,LB,Bulgaria,3320,3011,14,0,309,146,149,295,14
2022-09-05,LB,Bulgaria,2866,2568,9,0,298,146,143,289,9
2022-09-06,LB,Bulgaria,2891,2551,15,1,340,160,165,325,14
2022-09-07,LB,Bulgaria,2932,2680,6,0,252,123,123,246,6
2022-09-08,LB,Bulgaria,2969,2702,14,1,267,127,126,253,13
2022-09-09,LB,Bulgaria,3041,2660,13,1,381,183,185,368,12
2022-09-10,LB,Bulgaria,3316,3046,8,0,270,135,127,262,8
2022-09-11,LB,Bulgaria,3180,2889,12,0,291,138,141,279,12
2022-09-12,LB,Bulgaria,2744,2471,9,1,273,133,131,264,8
2022-09-13,LB,Bulgaria,2721,2415,12,3,306,144,150,294,9
2022-09-14,LB,Bulgaria,2779,2543,8,1,236,116,112,228,7
2022-09-15,LB,Bulgaria,2782,2541,13,3,241,112,116,228,10
2022-09-16,LB,Bulgaria,2947,2607,12,1,340,164,164,328,11
2022-09-17,LB,Bulgaria,3222,2971,6,0,251,122,123,245,6
2022-09-18,LB,Bulgaria,3091,2837,7,1,254,124,123,247,6
2022-09-19,LB,Bulgaria,2757,2514,9,1,243,116,118,234,8
2022-09-20,LB,Bulgaria,2744,2469,10,2,275,134,131,265,8
2022-09-21,LB,Bulgaria,2767,2550,8,1,217,104,105,209,7
2022-09-22,LB,Bulgaria,2821,2576,11,1,245,119,115,234,10
2022-09-23,LB,Bulgaria,2821,2528,11,1,293,141,141,282,10
2022-09-24,LB,Bulgaria,3040,2809,4,1,231,113,114,227,3
2022-09-25,LB,Bulgaria,2979,2737,8,1,242,116,118,234,7
2022-09-26,LB,Bulgaria,2645,2411,9,2,234,116,109,225,7
2022-09-27,LB,Bulgaria,2530,2301,16,4,229,104,109,213,12
2022-09-28,LB,Bulgaria,2649,2433,14,2,216,102,100,202,12
2022-09-29,LB,Bulgaria,2744,2541,12,3,203,96,95,191,9
2022-09-30,LB,Bulgaria,2877,2608,10,2,269,123,136,259,8
2022-10-01,LB,Bulgaria,3180,2959,5,0,221,113,103,216,5
2022-10-02,LB,Bulgaria,3006,2789,9,0,217,102,106,208,9
2022-10-03,LB,Bulgaria,2554,2342,10,1,212,98,104,202,9
2022-10-04,LB,Bulgaria,2479,2276,9,5,203,96,98,194,4
2022-10-05,LB,Bulgaria,2430,2212,13,2,218,103,102,205,11
2022-10-06,LB,Bulgaria,2488,2274,11,1,214,103,100,203,10
2022-10-07,LB,Bulgaria,2627,2396,9,0,231,110,112,222,9
2022-10-08,LB,Bulgaria,2896,2686,2,0,210,107,101,208,2
2022-10-09,LB,Bulgaria,2816,2611,9,0,205,97,99,196,9
2022-10-10,LB,Bulgaria,2403,2198,9,1,205,99,97,196,8
2022-10-11,LB,Bulgaria,2333,2136,9,0,197,93,95,188,9
2022-10-12,LB,Bulgaria,2512,2314,10,1,198,95,93,188,9
2022-10-13,LB,Bulgaria,2502,2316,13,0,186,87,86,173,13
2022-10-14,LB,Bulgaria,2623,2389,9,1,234,113,112,225,8
2022-10-15,LB,Bulgaria,2821,2626,4,0,195,98,93,191,4
2022-10-16,LB,Bulgaria,2820,2626,8,2,194,89,97,186,6
2022-10-17,LB,Bulgaria,2326,2110,12,3,216,102,102,204,9
2022-10-18,LB,Bulgaria,2331,2150,5,0,181,88,88,176,5
2022-10-19,LB,Bulgaria,2383,2196,10,2,187,87,90,177,8
2022-10-20,LB,Bulgaria,2500,2308,10,0,192,97,85,182,10
2022-10-21,LB,Bulgaria,2541,2349,8,1,192,90,94,184,7
2022-10-22,LB,Bulgaria,2904,2722,3,0,182,91,88,179,3
2022-10-23,LB,Bulgaria,2742,2541,10,2,201,94,97,191,8
2022-10-24,LB,Bulgaria,2404,2202,14,1,202,95,93,188,13
2022-10-25,LB,Bulgaria,2300,2096,10,1,204,96,98,194,9
2022-10-26,LB,Bulgaria,2464,2272,6,0,192,92,94,186,6
2022-10-27,LB,Bulgaria,2468,2280,9,0,188,89,90,179,9
2022-10-28,LB,Bulgaria,2515,2309,11,1,206,101,94,195,10
2022-10-29,LB,Bulgaria,2797,2602,3,1,195,95,97,192,2
2022-10-30,LB,Bulgaria,2623,2433,5,0,190,89,96,185,5
2022-10-31,LB,Bulgaria,2236,2062,9,1,174,79,86,165,8
2022-11-01,LB,Bulgaria,2066,1915,6,2,151,73,72,145,4
2022-11-02,LB,Bulgaria,2201,2031,9,5,170,82,79,161,4
2022-11-03,LB,Bulgaria,2141,1989,5,1,152,73,74,147,4
2022-11-04,LB,Bulgaria,2203,2006,8,0,197,93,96,189,8
2022-11-05,LB,Bulgaria,2415,2254,4,1,161,79,78,157,3
2022-11-06,LB,Bulgaria,2404,2216,5,0,188,87,96,183,5
2022-11-07,LB,Bulgaria,2047,1868,7,0,179,83,89,172,7
2022-11-08,LB,Bulgaria,1889,1737,10,1,152,73,69,142,9
2022-11-09,LB,Bulgaria,1903,1753,15,2,150,67,68,135,13
2022-11-10,LB,Bulgaria,1956,1793,12,3,163,76,75,151,9
2022-11-11,LB,Bulgaria,2056,1887,8,1,169,77,84,161,7
2022-11-12,LB,Bulgaria,2148,1999,2,0,149,74,73,147,2
2022-11-13,LB,Bulgaria,2125,1952,4,0,173,84,85,169,4
2022-11-14,LB,Bulgaria,1936,1762,23,12,174,76,75,151,11
2022-11-15,LB,Bulgaria,1846,1687,22,13,159,71,66,137,9
2022-11-16,LB,Bulgaria,1840,1687,14,4,153,68,71,139,10
2022-11-17,LB,Bulgaria,1946,1767,16,7,179,82,81,163,9
2022-11-18,LB,Bulgaria,2022,1838,9,3,184,94,81,175,6
2022-11-19,LB,Bulgaria,2157,2002,6,4,155,73,76,149,2
2022-11-20,LB,Bulgaria,2163,1981,5,1,182,85,92,177,4
2022-11-21,LB,Bulgaria,1887,1716,14,10,171,79,78,157,4
2022-11-22,LB,Bulgaria,1761,1594,14,7,167,78,75,153,7
2022-11-23,LB,Bulgaria,1822,1679,11,4,143,66,66,132,7
2022-11-24,LB,Bulgaria,1842,1670,22,16,172,76,74,150,6
2022-11-25,LB,Bulgaria,1888,1715,7,0,173,82,84,166,7
2022-11-26,LB,Bulgaria,2049,1910,4,0,139,66,69,135,4
2022-11-27,LB,Bulgaria,2071,1885,4,0,186,89,93,182,4
2022-11-28,LB,Bulgaria,1808,1650,6,2,158,78,74,152,4
2022-11-29,LB,Bulgaria,1684,1544,11,4,140,64,65,129,7
2022-11-30,LB,Bulgaria,1805,1666,10,5,139,64,65,129,5
2022-12-01,LB,Bulgaria,1842,1699,5,1,143,67,71,138,4
2022-12-02,LB,Bulgaria,1933,1768,6,0,165,81,78,159,6
2022-12-03,LB,Bulgaria,2005,1864,2,0,141,68,71,139,2
2022-12-04,LB,Bulgaria,2035,1863,4,0,172,85,83,168,4
2022-12-05,LB,Bulgaria,1779,1626,10,5,153,72,71,143,5
2022-12-06,LB,Bulgaria,1668,1537,10,1,131,59,62,121,9
2022-12-07,LB,Bulgaria,1770,1626,8,2,144,68,68,136,6
2022-12-08,LB,Bulgaria,1840,1667,17,8,173,79,77,156,9
2022-12-09,LB,Bulgaria,1918,1739,7,0,179,88,84,172,7
2022-12-10,LB,Bulgaria,2021,1874,2,0,147,74,71,145,2
2022-12-11,LB,Bulgaria,2074,1910,6,1,164,78,80,158,5
2022-12-12,LB,Bulgaria,1836,1672,13,3,164,76,75,151,10
2022-12-13,LB,Bulgaria,1763,1596,11,7,167,79,77,156,4
2022-12-14,LB,Bulgaria,1846,1683,5,0,163,78,80,158,5
2022-12-15,LB,Bulgaria,1946,1764,7,1,182,89,86,175,6
2022-12-16,LB,Bulgaria,2059,1860,8,0,199,98,93,191,8
2022-12-17,LB,Bulgaria,2199,2015,4,0,184,90,90,180,4
2022-12-18,LB,Bulgaria,2144,1955,4,0,189,92,93,185,4
2022-12-19,LB,Bulgaria,1932,1769,8,1,163,75,80,155,7
2022-12-20,LB,Bulgaria,1923,1738,13,2,185,87,85,172,11
2022-12-21,LB,Bulgaria,1739,1550,12,1,189,88,89,177,11
2022-12-22,LB,Bulgaria,2108,1915,10,0,193,92,91,183,10
2022-12-23,LB,Bulgaria,2183,1978,7,0,205,100,98,198,7
2022-12-24,LB,Bulgaria,2008,1853,6,0,155,75,74,149,6
2022-12-25,LB,Bulgaria,1871,1787,2,0,84,40,42,82,2
2022-12-26,LB,Bulgaria,1916,1759,4,0,157,77,76,153,4
2022-12-27,LB,Bulgaria,1875,1696,4,0,179,93,82,175,4
2022-01-01,LD,Croatia,1209,1130,10,0,79,34,35,69,10
2022-01-02,LD,Croatia,1552,1425,16,1,127,56,55,111,15
2022-01-03,LD,Croatia,1348,1190,30,2,158,64,64,128,28
2022-01-04,LD,Croatia,1254,1131,22,0,123,51,50,101,22
2022-01-05,LD,Croatia,1218,1105,18,0,113,48,47,95,18
2022-01-06,LD,Croatia,1211,1098,21,0,113,46,46,92,21
2022-01-07,LD,Croatia,1355,1219,28,1,136,53,55,108,27
2022-01-08,LD,Croatia,1459,1353,12,0,106,49,45,94,12
2022-01-09,LD,Croatia,1464,1338,17,0,126,55,54,109,17
2022-01-10,LD,Croatia,1037,921,24,0,116,49,43,92,24
2022-01-11,LD,Croatia,921,838,11,0,83,34,38,72,11
2022-01-12,LD,Croatia,874,778,18,0,96,41,37,78,18
2022-01-13,LD,Croatia,875,772,22,1,103,40,41,81,21
2022-01-14,LD,Croatia,1091,972,21,2,119,45,53,98,19
2022-01-15,LD,Croatia,1066,973,17,1,93,37,39,76,16
2022-01-16,LD,Croatia,1079,969,18,1,110,48,44,92,17
2022-01-17,LD,Croatia,924,799,28,0,125,50,47,97,28
2022-01-18,LD,Croatia,788,699,21,0,89,33,35,68,21
2022-01-19,LD,Croatia,774,681,19,0,93,39,35,74,19
2022-01-20,LD,Croatia,814,697,23,0,117,46,48,94,23
2022-01-21,LD,Croatia,986,867,22,0,119,48,49,97,22
2022-01-22,LD,Croatia,993,910,13,0,83,34,36,70,13
2022-01-23,LD,Croatia,1047,937,17,0,110,47,46,93,17
2022-01-24,LD,Croatia,852,733,25,0,119,49,45,94,25
2022-01-25,LD,Croatia,715,616,24,1,99,36,39,75,23
2022-01-26,LD,Croatia,757,646,19,0,111,48,44,92,19
2022-01-27,LD,Croatia,795,688,27,4,107,40,40,80,23
2022-01-28,LD,Croatia,1002,893,20,0,109,45,44,89,20
2022-01-29,LD,Croatia,997,913,14,0,84,33,37,70,14
2022-01-30,LD,Croatia,995,889,21,3,106,43,42,85,18
2022-01-31,LD,Croatia,867,753,25,0,114,44,45,89,25
2022-02-01,LD,Croatia,840,739,19,1,101,42,40,82,18
2022-02-02,LD,Croatia,791,689,22,1,102,41,39,80,21
2022-02-03,LD,Croatia,842,716,26,3,126,48,52,100,23
2022-02-04,LD,Croatia,1110,978,21,0,132,55,56,111,21
2022-02-05,LD,Croatia,1088,992,16,3,96,38,42,80,13
2022-02-06,LD,Croatia,1080,964,17,1,116,49,50,99,16
2022-02-07,LD,Croatia,927,805,22,0,122,50,50,100,22
2022-02-08,LD,Croatia,869,762,18,3,107,46,43,89,15
2022-02-09,LD,Croatia,830,721,21,2,109,44,44,88,19
2022-02-10,LD,Croatia,924,804,21,0,120,50,49,99,21
2022-02-11,LD,Croatia,1078,954,23,0,124,50,51,101,23
2022-02-12,LD,Croatia,1129,1046,12,0,83,34,37,71,12
2022-02-13,LD,Croatia,1109,988,15,0,121,55,51,106,15
2022-02-14,LD,Croatia,939,823,27,1,116,44,45,89,26
2022-02-15,LD,Croatia,862,752,23,1,110,40,47,87,22
2022-02-16,LD,Croatia,862,753,20,0,109,46,43,89,20
2022-02-17,LD,Croatia,911,796,22,0,115,48,45,93,22
2022-02-18,LD,Croatia,1126,990,27,0,136,56,53,109,27
2022-02-19,LD,Croatia,1181,1064,17,0,117,48,52,100,17
2022-02-20,LD,Croatia,1177,1068,16,0,109,48,45,93,16
2022-02-21,LD,Croatia,1003,883,22,0,120,50,48,98,22
2022-02-22,LD,Croatia,913,803,20,0,110,45,45,90,20
2022-02-23,LD,Croatia,940,832,22,0,108,42,44,86,22
2022-02-24,LD,Croatia,978,850,27,2,128,50,51,101,25
2022-02-25,LD,Croatia,1190,1048,25,0,142,58,59,117,25
2022-02-26,LD,Croatia,1208,1107,15,0,101,45,41,86,15
2022-02-27,LD,Croatia,1195,1081,17,0,114,49,48,97,17
2022-02-28,LD,Croatia,1074,937,24,0,137,58,55,113,24
2022-03-01,LD,Croatia,1037,918,24,0,119,47,48,95,24
2022-03-02,LD,Croatia,978,865,20,1,113,45,48,93,19
2022-03-03,LD,Croatia,1121,979,24,0,142,58,60,118,24
2022-03-04,LD,Croatia,1294,1145,24,0,149,63,62,125,24
2022-03-05,LD,Croatia,1270,1164,13,0,106,44,49,93,13
2022-03-06,LD,Croatia,1243,1124,18,0,119,51,50,101,18
2022-03-07,LD,Croatia,1135,998,25,0,137,56,56,112,25
2022-03-08,LD,Croatia,1054,944,22,1,110,43,45,88,21
2022-03-09,LD,Croatia,1038,921,22,0,117,48,47,95,22
2022-03-10,LD,Croatia,1081,954,23,0,127,51,53,104,23
2022-03-11,LD,Croatia,1223,1079,27,0,144,57,60,117,27
2022-03-12,LD,Croatia,1270,1166,15,0,104,45,44,89,15
2022-03-13,LD,Croatia,1263,1142,18,0,121,54,49,103,18
2022-03-14,LD,Croatia,1190,1043,22,0,147,63,62,125,22
2022-03-15,LD,Croatia,1060,938,25,0,122,46,51,97,25
2022-03-16,LD,Croatia,1079,953,23,1,126,53,50,103,22
2022-03-17,LD,Croatia,1064,935,22,0,129,52,55,107,22
2022-03-18,LD,Croatia,1257,1106,23,0,151,67,61,128,23
2022-03-19,LD,Croatia,1298,1189,15,0,109,43,51,94,15
2022-03-20,LD,Croatia,1286,1160,15,0,126,55,56,111,15
2022-03-21,LD,Croatia,1129,978,29,1,151,63,59,122,28
2022-03-22,LD,Croatia,1031,916,22,1,115,46,47,93,21
2022-03-23,LD,Croatia,1114,979,22,1,135,56,57,113,21
2022-03-24,LD,Croatia,1150,1002,22,0,148,65,61,126,22
2022-03-25,LD,Croatia,1304,1153,22,0,151,59,70,129,22
2022-03-26,LD,Croatia,1337,1199,18,1,138,55,65,120,17
2022-03-27,LD,Croatia,1732,1531,15,0,201,99,87,186,15
2022-03-28,LD,Croatia,1475,1292,27,1,183,80,76,156,26
2022-03-29,LD,Croatia,1328,1158,22,1,170,75,73,148,21
2022-03-30,LD,Croatia,1386,1208,15,1,178,83,80,163,14
2022-03-31,LD,Croatia,1441,1258,22,1,183,80,81,161,21
2022-04-01,LD,Croatia,1652,1450,27,0,202,86,89,175,27
2022-04-02,LD,Croatia,1655,1461,17,0,194,90,87,177,17
2022-04-03,LD,Croatia,1731,1518,21,0,213,96,96,192,21
2022-04-04,LD,Croatia,1487,1291,28,0,196,85,83,168,28
2022-04-05,LD,Croatia,1354,1179,24,1,175,75,76,151,23
2022-04-06,LD,Croatia,1465,1282,22,1,183,79,82,161,21
2022-04-07,LD,Croatia,1514,1305,28,1,209,91,90,181,27
2022-04-08,LD,Croatia,1823,1611,37,0,212,88,87,175,37
2022-04-09,LD,Croatia,1969,1710,18,0,259,119,122,241,18
2022-04-10,LD,Croatia,1948,1711,20,0,237,108,109,217,20
2022-04-11,LD,Croatia,1696,1483,28,0,213,92,93,185,28
2022-04-12,LD,Croatia,1564,1377,23,3,187,82,82,164,20
2022-04-13,LD,Croatia,1728,1503,24,0,225,100,101,201,24
2022-04-14,LD,Croatia,1812,1546,35,2,266,112,119,231,33
2022-04-15,LD,Croatia,1968,1734,30,0,234,98,106,204,30
2022-04-16,LD,Croatia,2065,1800,18,0,265,123,124,247,18
2022-04-17,LD,Croatia,2028,1798,20,0,230,110,100,210,20
2022-04-18,LD,Croatia,1868,1616,32,0,252,114,106,220,32
2022-04-19,LD,Croatia,1610,1386,26,0,224,96,102,198,26
2022-04-20,LD,Croatia,1736,1520,19,0,216,100,97,197,19
2022-04-21,LD,Croatia,1858,1601,30,2,257,111,116,227,28
2022-04-22,LD,Croatia,1913,1690,34,2,223,95,94,189,32
2022-04-23,LD,Croatia,2147,1853,23,2,294,141,130,271,21
2022-04-24,LD,Croatia,2193,1911,22,3,282,131,129,260,19
2022-04-25,LD,Croatia,1852,1621,30,0,231,101,100,201,30
2022-04-26,LD,Croatia,1636,1412,25,1,224,98,101,199,24
2022-04-27,LD,Croatia,1742,1509,23,0,233,104,106,210,23
2022-04-28,LD,Croatia,1855,1571,36,0,284,121,127,248,36
2022-04-29,LD,Croatia,2013,1747,37,1,266,110,119,229,36
2022-04-30,LD,Croatia,2306,1974,23,1,332,151,158,309,22
2022-05-01,LD,Croatia,2342,2016,21,0,326,159,146,305,21
2022-05-02,LD,Croatia,2011,1764,27,0,247,109,111,220,27
2022-05-03,LD,Croatia,1917,1665,17,0,252,116,119,235,17
2022-05-04,LD,Croatia,1877,1611,24,0,266,124,118,242,24
2022-05-05,LD,Croatia,1991,1708,25,1,283,128,130,258,24
2022-05-06,LD,Croatia,2179,1921,23,0,258,122,113,235,23
2022-05-07,LD,Croatia,2504,2128,21,1,376,172,183,355,20
2022-05-08,LD,Croatia,2412,2088,20,1,324,156,148,304,19
2022-05-09,LD,Croatia,1975,1735,26,1,240,107,107,214,25
2022-05-10,LD,Croatia,1951,1677,28,1,274,119,127,246,27
2022-05-11,LD,Croatia,2051,1761,27,0,290,127,136,263,27
2022-05-12,LD,Croatia,2024,1723,26,2,301,137,138,275,24
2022-05-13,LD,Croatia,2250,1965,28,0,285,130,127,257,28
2022-05-14,LD,Croatia,2472,2079,20,0,393,183,190,373,20
2022-05-15,LD,Croatia,2494,2151,20,0,343,167,156,323,20
2022-05-16,LD,Croatia,2040,1769,26,0,271,124,121,245,26
2022-05-17,LD,Croatia,2023,1748,19,0,275,128,128,256,19
2022-05-18,LD,Croatia,2039,1747,22,1,292,133,137,270,21
2022-05-19,LD,Croatia,2077,1746,26,0,331,153,152,305,26
2022-05-20,LD,Croatia,2302,2007,30,0,295,128,137,265,30
2022-05-21,LD,Croatia,2762,2291,25,0,471,222,224,446,25
2022-05-22,LD,Croatia,2583,2199,24,0,384,187,173,360,24
2022-05-23,LD,Croatia,2093,1809,29,1,284,123,132,255,28
2022-05-24,LD,Croatia,2151,1854,21,0,297,139,137,276,21
2022-05-25,LD,Croatia,2417,2092,21,0,325,149,155,304,21
2022-05-26,LD,Croatia,2353,1997,20,1,356,159,177,336,19
2022-05-27,LD,Croatia,2484,2176,33,1,308,137,138,275,32
2022-05-28,LD,Croatia,2812,2353,24,0,459,217,218,435,24
2022-05-29,LD,Croatia,2786,2350,22,2,436,220,194,414,20
2022-05-30,LD,Croatia,2330,2059,25,0,271,123,123,246,25
2022-05-31,LD,Croatia,2161,1842,20,0,319,151,148,299,20
2022-06-01,LD,Croatia,2407,2048,22,0,359,166,171,337,22
2022-06-02,LD,Croatia,2450,2063,31,1,387,178,178,356,30
2022-06-03,LD,Croatia,2672,2311,29,2,361,157,175,332,27
2022-06-04,LD,Croatia,3012,2477,30,1,535,249,256,505,29
2022-06-05,LD,Croatia,2761,2309,27,0,452,216,209,425,27
2022-06-06,LD,Croatia,2550,2192,28,1,358,171,159,330,27
2022-06-07,LD,Croatia,2486,2108,26,0,378,175,177,352,26
2022-06-08,LD,Croatia,2348,1992,20,0,356,167,169,336,20
2022-06-09,LD,Croatia,2407,2014,29,0,393,181,183,364,29
2022-06-10,LD,Croatia,2773,2364,27,0,409,187,195,382,27
2022-06-11,LD,Croatia,2950,2415,23,1,535,254,258,512,22
2022-06-12,LD,Croatia,2910,2441,24,0,469,226,219,445,24
2022-06-13,LD,Croatia,2595,2210,31,3,385,177,177,354,28
2022-06-14,LD,Croatia,2450,2060,28,0,390,176,186,362,28
2022-06-15,LD,Croatia,2665,2266,27,0,399,185,187,372,27
2022-06-16,LD,Croatia,2642,2219,22,0,423,196,205,401,22
2022-06-17,LD,Croatia,2769,2351,29,0,418,192,197,389,29
2022-06-18,LD,Croatia,3063,2482,32,1,581,278,271,549,31
2022-06-19,LD,Croatia,2997,2499,24,0,498,250,224,474,24
2022-06-20,LD,Croatia,2659,2274,29,2,385,177,179,356,27
2022-06-21,LD,Croatia,2518,2134,28,2,384,179,177,356,26
2022-06-22,LD,Croatia,2596,2214,29,0,382,180,173,353,29
2022-06-23,LD,Croatia,2524,2091,21,1,433,203,209,412,20
2022-06-24,LD,Croatia,2756,2337,29,0,419,184,206,390,29
2022-06-25,LD,Croatia,3052,2461,26,1,591,281,284,565,25
2022-06-26,LD,Croatia,2992,2498,24,0,494,239,231,470,24
2022-06-27,LD,Croatia,2691,2231,27,0,460,214,219,433,27
2022-06-28,LD,Croatia,2701,2244,28,0,457,219,210,429,28
2022-06-29,LD,Croatia,2752,2310,27,1,442,212,203,415,26
2022-06-30,LD,Croatia,2623,2126,22,0,497,230,245,475,22
2022-07-01,LD,Croatia,2843,2344,30,1,499,231,238,469,29
2022-07-02,LD,Croatia,3140,2493,29,1,647,306,312,618,28
2022-07-03,LD,Croatia,3051,2485,23,1,566,274,269,543,22
2022-07-04,LD,Croatia,2672,2210,22,0,462,223,217,440,22
2022-07-05,LD,Croatia,2759,2317,31,1,442,205,206,411,30
2022-07-06,LD,Croatia,2924,2454,26,3,470,221,223,444,23
2022-07-07,LD,Croatia,2852,2388,28,0,464,218,218,436,28
2022-07-08,LD,Croatia,2910,2434,30,2,476,214,232,446,28
2022-07-09,LD,Croatia,3307,2615,30,1,692,331,331,662,29
2022-07-10,LD,Croatia,3134,2534,27,1,600,296,277,573,26
2022-07-11,LD,Croatia,2748,2287,32,1,461,213,216,429,31
2022-07-12,LD,Croatia,2760,2269,31,0,491,231,229,460,31
2022-07-13,LD,Croatia,2759,2295,30,1,464,214,220,434,29
2022-07-14,LD,Croatia,2703,2222,25,0,481,228,228,456,25
2022-07-15,LD,Croatia,2926,2441,28,0,485,225,232,457,28
2022-07-16,LD,Croatia,3242,2599,27,0,643,307,309,616,27
2022-07-17,LD,Croatia,3123,2520,26,0,603,292,285,577,26
2022-07-18,LD,Croatia,2795,2286,35,1,509,238,236,474,34
2022-07-19,LD,Croatia,2681,2182,33,3,499,232,234,466,30
2022-07-20,LD,Croatia,2713,2217,25,1,496,229,242,471,24
2022-07-21,LD,Croatia,2776,2280,25,1,496,235,236,471,24
2022-07-22,LD,Croatia,2841,2316,29,1,525,251,245,496,28
2022-07-23,LD,Croatia,3193,2492,32,0,701,331,338,669,32
2022-07-24,LD,Croatia,3083,2489,26,0,594,288,280,568,26
2022-07-25,LD,Croatia,2776,2271,22,0,505,245,238,483,22
2022-07-26,LD,Croatia,2722,2231,26,0,491,233,232,465,26
2022-07-27,LD,Croatia,2826,2345,28,0,481,224,229,453,28
2022-07-28,LD,Croatia,2644,2120,28,1,524,243,253,496,27
2022-07-29,LD,Croatia,2967,2449,26,0,518,242,250,492,26
2022-07-30,LD,Croatia,3289,2580,32,1,709,344,333,677,31
2022-07-31,LD,Croatia,3143,2530,30,0,613,295,288,583,30
2022-08-01,LD,Croatia,2788,2266,26,1,522,245,251,496,25
2022-08-02,LD,Croatia,2777,2266,33,0,511,235,243,478,33
2022-08-03,LD,Croatia,2820,2315,25,0,505,242,238,480,25
2022-08-04,LD,Croatia,2738,2205,23,0,533,260,250,510,23
2022-08-05,LD,Croatia,2790,2274,27,0,516,239,250,489,27
2022-08-06,LD,Croatia,3165,2446,26,0,719,346,347,693,26
2022-08-07,LD,Croatia,3061,2442,25,0,619,296,298,594,25
2022-08-08,LD,Croatia,2687,2204,24,1,483,230,229,459,23
2022-08-09,LD,Croatia,2621,2124,30,0,497,235,232,467,30
2022-08-10,LD,Croatia,2767,2255,21,0,512,245,246,491,21
2022-08-11,LD,Croatia,2804,2270,31,0,534,252,251,503,31
2022-08-12,LD,Croatia,2879,2349,31,0,530,246,253,499,31
2022-08-13,LD,Croatia,3101,2409,37,2,692,331,324,655,35
2022-08-14,LD,Croatia,3004,2412,27,1,592,280,285,565,26
2022-08-15,LD,Croatia,2756,2257,30,0,499,239,230,469,30
2022-08-16,LD,Croatia,2763,2239,33,0,524,245,246,491,33
2022-08-17,LD,Croatia,2732,2239,29,0,493,232,232,464,29
2022-08-18,LD,Croatia,2779,2286,26,0,493,237,230,467,26
2022-08-19,LD,Croatia,2816,2347,29,0,469,219,221,440,29
2022-08-20,LD,Croatia,3013,2323,33,2,690,333,324,657,31
2022-08-21,LD,Croatia,2886,2261,33,0,625,294,298,592,33
2022-08-22,LD,Croatia,2539,2075,26,0,464,215,223,438,26
2022-08-23,LD,Croatia,2567,2085,30,1,482,228,224,452,29
2022-08-24,LD,Croatia,2754,2262,27,0,492,230,235,465,27
2022-08-25,LD,Croatia,2724,2207,28,3,517,241,248,489,25
2022-08-26,LD,Croatia,2798,2304,24,1,494,234,236,470,23
2022-08-27,LD,Croatia,3068,2416,31,0,652,310,311,621,31
2022-08-28,LD,Croatia,2911,2346,26,0,565,278,261,539,26
2022-08-29,LD,Croatia,2527,2081,26,2,446,212,208,420,24
2022-08-30,LD,Croatia,2636,2166,27,0,470,221,222,443,27
2022-08-31,LD,Croatia,2678,2215,27,2,463,220,216,436,25
2022-09-01,LD,Croatia,2612,2145,31,1,467,213,223,436,30
2022-09-02,LD,Croatia,2633,2188,29,0,445,202,214,416,29
2022-09-03,LD,Croatia,3032,2395,28,0,637,305,304,609,28
2022-09-04,LD,Croatia,2961,2380,28,0,581,285,268,553,28
2022-09-05,LD,Croatia,2609,2190,31,0,419,195,193,388,31
2022-09-06,LD,Croatia,2607,2176,31,0,431,198,202,400,31
2022-09-07,LD,Croatia,2694,2281,26,1,413,195,192,387,25
2022-09-08,LD,Croatia,2643,2202,25,0,441,212,204,416,25
2022-09-09,LD,Croatia,2619,2207,24,0,412,193,195,388,24
2022-09-10,LD,Croatia,2790,2200,27,0,590,279,284,563,27
2022-09-11,LD,Croatia,2741,2239,25,1,502,242,235,477,24
2022-09-12,LD,Croatia,2533,2141,24,0,392,181,187,368,24
2022-09-13,LD,Croatia,2503,2115,30,0,388,180,178,358,30
2022-09-14,LD,Croatia,2502,2119,25,2,383,182,176,358,23
2022-09-15,LD,Croatia,2549,2140,24,2,409,194,191,385,22
2022-09-16,LD,Croatia,2532,2156,23,0,376,177,176,353,23
2022-09-17,LD,Croatia,2831,2280,28,0,551,259,264,523,28
2022-09-18,LD,Croatia,2784,2296,25,0,488,231,232,463,25
2022-09-19,LD,Croatia,2462,2065,24,0,397,186,187,373,24
2022-09-20,LD,Croatia,2370,1975,30,1,395,184,181,365,29
2022-09-21,LD,Croatia,2548,2153,31,0,395,183,181,364,31
2022-09-22,LD,Croatia,2490,2080,23,2,410,190,197,387,21
2022-09-23,LD,Croatia,2663,2251,31,0,412,194,187,381,31
2022-09-24,LD,Croatia,2865,2335,26,0,530,253,251,504,26
2022-09-25,LD,Croatia,2735,2254,21,0,481,236,224,460,21
2022-09-26,LD,Croatia,2248,1899,26,0,349,160,163,323,26
2022-09-27,LD,Croatia,2266,1910,29,2,356,164,163,327,27
2022-09-28,LD,Croatia,2412,2075,23,0,337,157,157,314,23
2022-09-29,LD,Croatia,2341,1976,27,3,365,169,169,338,24
2022-09-30,LD,Croatia,2576,2230,28,0,346,160,158,318,28
2022-10-01,LD,Croatia,2764,2268,28,0,496,231,237,468,28
2022-10-02,LD,Croatia,2623,2209,24,1,414,196,194,390,23
2022-10-03,LD,Croatia,2322,2002,30,2,320,141,149,290,28
2022-10-04,LD,Croatia,2162,1845,28,4,317,143,146,289,24
2022-10-05,LD,Croatia,2143,1841,18,1,302,149,135,284,17
2022-10-06,LD,Croatia,2177,1868,29,1,309,136,144,280,28
2022-10-07,LD,Croatia,2471,2157,39,2,314,136,139,275,37
2022-10-08,LD,Croatia,2733,2274,24,0,459,215,220,435,24
2022-10-09,LD,Croatia,2610,2222,26,0,388,190,172,362,26
2022-10-10,LD,Croatia,2224,1939,23,0,285,135,127,262,23
2022-10-11,LD,Croatia,2153,1861,21,2,292,135,136,271,19
2022-10-12,LD,Croatia,2194,1906,20,1,288,132,136,268,19
2022-10-13,LD,Croatia,2137,1840,33,1,297,134,130,264,32
2022-10-14,LD,Croatia,2361,2071,31,1,290,127,132,259,30
2022-10-15,LD,Croatia,2573,2181,23,0,392,183,186,369,23
2022-10-16,LD,Croatia,2581,2242,25,1,339,158,156,314,24
2022-10-17,LD,Croatia,2131,1845,31,1,286,128,127,255,30
2022-10-18,LD,Croatia,2055,1765,32,1,290,130,128,258,31
2022-10-19,LD,Croatia,2085,1812,21,2,273,124,128,252,19
2022-10-20,LD,Croatia,2067,1790,35,0,277,122,120,242,35
2022-10-21,LD,Croatia,2136,1853,39,0,283,119,125,244,39
2022-10-22,LD,Croatia,2606,2257,23,0,349,164,162,326,23
2022-10-23,LD,Croatia,2443,2146,28,1,297,136,133,269,27
2022-10-24,LD,Croatia,2078,1785,33,2,293,125,135,260,31
2022-10-25,LD,Croatia,2057,1787,30,4,270,128,112,240,26
2022-10-26,LD,Croatia,2119,1852,23,2,267,116,128,244,21
2022-10-27,LD,Croatia,2102,1796,35,2,306,129,142,271,33
2022-10-28,LD,Croatia,2289,2009,36,1,280,125,119,244,35
2022-10-29,LD,Croatia,2575,2232,23,0,343,159,161,320,23
2022-10-30,LD,Croatia,2123,1921,21,3,202,94,87,181,18
2022-10-31,LD,Croatia,1758,1572,24,2,186,81,81,162,22
2022-11-01,LD,Croatia,1517,1360,23,2,157,69,65,134,21
2022-11-02,LD,Croatia,1465,1307,23,0,158,70,65,135,23
2022-11-03,LD,Croatia,1446,1288,26,2,158,65,67,132,24
2022-11-04,LD,Croatia,1643,1466,26,0,177,76,75,151,26
2022-11-05,LD,Croatia,1787,1615,16,0,172,76,80,156,16
2022-11-06,LD,Croatia,1794,1630,19,0,164,77,68,145,19
2022-11-07,LD,Croatia,1463,1284,32,1,179,72,75,147,31
2022-11-08,LD,Croatia,1287,1135,23,0,152,66,63,129,23
2022-11-09,LD,Croatia,1264,1110,24,1,154,65,65,130,23
2022-11-10,LD,Croatia,1285,1141,25,1,144,60,59,119,24
2022-11-11,LD,Croatia,1513,1346,30,0,167,70,67,137,30
2022-11-12,LD,Croatia,1494,1383,13,0,111,47,51,98,13
2022-11-13,LD,Croatia,1509,1372,17,0,137,60,60,120,17
2022-11-14,LD,Croatia,1407,1237,24,0,170,71,75,146,24
2022-11-15,LD,Croatia,1178,1044,23,0,134,55,56,111,23
2022-11-16,LD,Croatia,1245,1101,22,0,144,62,60,122,22
2022-11-17,LD,Croatia,1287,1143,26,1,144,61,57,118,25
2022-11-18,LD,Croatia,1441,1294,25,0,147,61,61,122,25
2022-11-19,LD,Croatia,1441,1321,12,0,120,53,55,108,12
2022-11-20,LD,Croatia,1507,1374,17,0,133,58,58,116,17
2022-11-21,LD,Croatia,1355,1182,30,1,173,71,72,143,29
2022-11-22,LD,Croatia,1135,1010,23,0,125,52,50,102,23
2022-11-23,LD,Croatia,1151,1028,17,0,123,53,53,106,17
2022-11-24,LD,Croatia,1293,1155,25,0,138,56,57,113,25
2022-11-25,LD,Croatia,1459,1295,26,1,164,69,69,138,25
2022-11-26,LD,Croatia,1382,1249,15,1,133,59,59,118,14
2022-11-27,LD,Croatia,1489,1361,17,0,128,56,55,111,17
2022-11-28,LD,Croatia,1322,1153,26,0,169,69,74,143,26
2022-11-29,LD,Croatia,1157,1026,21,0,131,57,53,110,21
2022-11-30,LD,Croatia,1147,1022,17,0,125,53,55,108,17
2022-12-01,LD,Croatia,1223,1084,24,0,139,58,57,115,24
2022-12-02,LD,Croatia,1394,1228,27,1,166,70,69,139,26
2022-12-03,LD,Croatia,1325,1203,13,0,122,53,56,109,13
2022-12-04,LD,Croatia,1447,1322,17,0,125,57,51,108,17
2022-12-05,LD,Croatia,1266,1124,25,0,142,56,61,117,25
2022-12-06,LD,Croatia,1164,1020,26,1,144,57,61,118,25
2022-12-07,LD,Croatia,1197,1063,21,0,134,57,56,113,21
2022-12-08,LD,Croatia,1208,1077,23,0,131,56,52,108,23
2022-12-09,LD,Croatia,1354,1203,24,0,151,64,63,127,24
2022-12-10,LD,Croatia,1316,1197,14,0,119,52,53,105,14
2022-12-11,LD,Croatia,1463,1338,17,0,125,51,57,108,17
2022-12-12,LD,Croatia,1309,1155,25,0,154,63,66,129,25
2022-12-13,LD,Croatia,1151,1012,24,1,139,60,55,115,23
2022-12-14,LD,Croatia,1220,1083,17,0,137,59,61,120,17
2022-12-15,LD,Croatia,1254,1118,25,1,136,54,57,111,24
2022-12-16,LD,Croatia,1500,1314,25,0,186,84,77,161,25
2022-12-17,LD,Croatia,1439,1317,12,0,122,57,53,110,12
2022-12-18,LD,Croatia,1577,1444,17,0,133,56,60,116,17
2022-12-19,LD,Croatia,1445,1293,25,0,152,64,63,127,25
2022-12-20,LD,Croatia,1377,1238,22,0,139,58,59,117,22
2022-12-21,LD,Croatia,1416,1271,20,0,145,62,63,125,20
2022-12-22,LD,Croatia,1479,1343,27,0,136,57,52,109,27
2022-12-23,LD,Croatia,1663,1499,30,0,164,66,68,134,30
2022-12-24,LD,Croatia,1393,1299,10,0,94,41,43,84,10
2022-12-25,LD,Croatia,1185,1149,0,0,36,18,18,36,0
2022-12-26,LD,Croatia,1453,1310,27,0,143,60,56,116,27
2022-12-27,LD,Croatia,1350,1216,22,0,134,56,56,112,22
2022-01-01,LC,Cyprus,772,640,0,0,132,67,65,132,0
2022-01-02,LC,Cyprus,983,807,2,2,176,87,87,174,0
2022-01-03,LC,Cyprus,768,628,7,6,140,65,68,133,1
2022-01-04,LC,Cyprus,737,615,6,6,122,57,59,116,0
2022-01-05,LC,Cyprus,744,592,6,6,152,76,70,146,0
2022-01-06,LC,Cyprus,843,701,4,4,142,67,71,138,0
2022-01-07,LC,Cyprus,743,586,4,4,157,76,77,153,0
2022-01-08,LC,Cyprus,886,717,1,1,169,86,82,168,0
2022-01-09,LC,Cyprus,936,756,4,4,180,86,90,176,0
2022-01-10,LC,Cyprus,651,538,4,4,113,54,55,109,0
2022-01-11,LC,Cyprus,592,502,7,7,90,44,39,83,0
2022-01-12,LC,Cyprus,648,536,7,7,112,53,52,105,0
2022-01-13,LC,Cyprus,714,615,3,3,99,48,48,96,0
2022-01-14,LC,Cyprus,631,510,7,5,121,58,56,114,2
2022-01-15,LC,Cyprus,714,613,1,1,101,50,50,100,0
2022-01-16,LC,Cyprus,793,667,6,4,126,61,59,120,2
2022-01-17,LC,Cyprus,600,498,4,4,102,45,53,98,0
2022-01-18,LC,Cyprus,584,497,9,6,87,41,37,78,3
2022-01-19,LC,Cyprus,595,490,5,5,105,51,49,100,0
2022-01-20,LC,Cyprus,664,566,6,6,98,47,45,92,0
2022-01-21,LC,Cyprus,589,482,6,4,107,49,52,101,2
2022-01-22,LC,Cyprus,702,600,0,0,102,52,50,102,0
2022-01-23,LC,Cyprus,753,639,6,4,114,54,54,108,2
2022-01-24,LC,Cyprus,503,401,8,6,102,45,49,94,2
2022-01-25,LC,Cyprus,448,378,6,6,70,31,33,64,0
2022-01-26,LC,Cyprus,547,442,6,6,105,50,49,99,0
2022-01-27,LC,Cyprus,691,599,4,4,92,43,45,88,0
2022-01-28,LC,Cyprus,593,486,6,3,107,54,47,101,3
2022-01-29,LC,Cyprus,661,574,0,0,87,43,44,87,0
2022-01-30,LC,Cyprus,735,618,5,3,117,56,56,112,2
2022-01-31,LC,Cyprus,588,486,7,6,102,44,51,95,1
2022-02-01,LC,Cyprus,591,497,7,5,94,44,43,87,2
2022-02-02,LC,Cyprus,604,491,7,7,113,55,51,106,0
2022-02-03,LC,Cyprus,663,563,5,5,100,49,46,95,0
2022-02-04,LC,Cyprus,615,497,10,7,118,55,53,108,3
2022-02-05,LC,Cyprus,703,594,2,0,109,52,55,107,2
2022-02-06,LC,Cyprus,773,649,4,2,124,62,58,120,2
2022-02-07,LC,Cyprus,572,483,5,5,89,42,42,84,0
2022-02-08,LC,Cyprus,581,488,7,5,93,42,44,86,2
2022-02-09,LC,Cyprus,626,504,6,6,122,59,57,116,0
2022-02-10,LC,Cyprus,676,559,6,6,117,52,59,111,0
2022-02-11,LC,Cyprus,623,483,8,6,140,66,66,132,2
2022-02-12,LC,Cyprus,723,597,0,0,126,66,60,126,0
2022-02-13,LC,Cyprus,803,656,5,2,147,70,72,142,3
2022-02-14,LC,Cyprus,620,506,7,7,114,53,54,107,0
2022-02-15,LC,Cyprus,616,495,11,9,121,54,56,110,2
2022-02-16,LC,Cyprus,643,506,10,9,137,63,64,127,1
2022-02-17,LC,Cyprus,702,593,6,6,109,51,52,103,0
2022-02-18,LC,Cyprus,678,547,9,7,131,59,63,122,2
2022-02-19,LC,Cyprus,766,633,2,2,133,68,63,131,0
2022-02-20,LC,Cyprus,834,691,5,3,143,68,70,138,2
2022-02-21,LC,Cyprus,632,502,9,8,130,60,61,121,1
2022-02-22,LC,Cyprus,621,514,5,5,107,50,52,102,0
2022-02-23,LC,Cyprus,658,535,2,2,123,60,61,121,0
2022-02-24,LC,Cyprus,684,559,7,7,125,58,60,118,0
2022-02-25,LC,Cyprus,685,556,12,10,129,59,58,117,2
2022-02-26,LC,Cyprus,722,577,5,5,145,69,71,140,0
2022-02-27,LC,Cyprus,790,639,6,4,151,76,69,145,2
2022-02-28,LC,Cyprus,662,529,12,10,133,62,59,121,2
2022-03-01,LC,Cyprus,655,539,7,7,116,51,58,109,0
2022-03-02,LC,Cyprus,747,593,7,7,154,77,70,147,0
2022-03-03,LC,Cyprus,767,652,1,1,115,57,57,114,0
2022-03-04,LC,Cyprus,757,585,11,9,172,78,83,161,2
2022-03-05,LC,Cyprus,773,635,3,3,138,70,65,135,0
2022-03-06,LC,Cyprus,853,705,7,5,148,68,73,141,2
2022-03-07,LC,Cyprus,743,623,5,5,120,58,57,115,0
2022-03-08,LC,Cyprus,666,533,9,7,133,61,63,124,2
2022-03-09,LC,Cyprus,725,562,10,10,163,79,74,153,0
2022-03-10,LC,Cyprus,687,571,4,4,116,54,58,112,0
2022-03-11,LC,Cyprus,680,543,7,5,137,64,66,130,2
2022-03-12,LC,Cyprus,756,613,3,3,143,70,70,140,0
2022-03-13,LC,Cyprus,755,609,6,4,146,74,66,140,2
2022-03-14,LC,Cyprus,731,592,5,4,139,65,69,134,1
2022-03-15,LC,Cyprus,705,595,7,7,110,52,51,103,0
2022-03-16,LC,Cyprus,757,601,6,6,156,75,75,150,0
2022-03-17,LC,Cyprus,776,650,7,6,126,61,58,119,1
2022-03-18,LC,Cyprus,703,568,11,7,135,61,63,124,4
2022-03-19,LC,Cyprus,756,600,6,2,156,76,74,150,4
2022-03-20,LC,Cyprus,813,663,6,4,150,74,70,144,2
2022-03-21,LC,Cyprus,699,588,7,7,111,52,52,104,0
2022-03-22,LC,Cyprus,645,532,7,7,113,54,52,106,0
2022-03-23,LC,Cyprus,721,570,7,7,151,69,75,144,0
2022-03-24,LC,Cyprus,799,665,8,8,134,64,62,126,0
2022-03-25,LC,Cyprus,717,588,7,5,129,60,62,122,2
2022-03-26,LC,Cyprus,750,608,5,5,142,71,66,137,0
2022-03-27,LC,Cyprus,819,654,5,5,165,78,82,160,0
2022-03-28,LC,Cyprus,753,587,7,7,166,79,80,159,0
2022-03-29,LC,Cyprus,737,585,10,10,152,68,74,142,0
2022-03-30,LC,Cyprus,790,592,9,8,198,96,93,189,1
2022-03-31,LC,Cyprus,825,653,8,7,172,84,80,164,1
2022-04-01,LC,Cyprus,758,578,9,7,180,82,89,171,2
2022-04-02,LC,Cyprus,810,644,0,0,166,85,81,166,0
2022-04-03,LC,Cyprus,867,675,4,4,192,90,98,188,0
2022-04-04,LC,Cyprus,766,574,5,5,192,97,90,187,0
2022-04-05,LC,Cyprus,706,568,8,8,138,67,63,130,0
2022-04-06,LC,Cyprus,833,614,8,8,219,104,107,211,0
2022-04-07,LC,Cyprus,853,688,9,9,165,79,77,156,0
2022-04-08,LC,Cyprus,816,618,11,9,198,93,94,187,2
2022-04-09,LC,Cyprus,821,631,5,4,190,90,95,185,1
2022-04-10,LC,Cyprus,938,717,6,6,221,108,107,215,0
2022-04-11,LC,Cyprus,850,637,9,9,213,105,99,204,0
2022-04-12,LC,Cyprus,806,654,8,8,152,72,72,144,0
2022-04-13,LC,Cyprus,919,686,8,8,233,113,112,225,0
2022-04-14,LC,Cyprus,1076,862,10,9,214,97,107,204,1
2022-04-15,LC,Cyprus,940,711,6,5,229,107,116,223,1
2022-04-16,LC,Cyprus,954,722,2,2,232,119,111,230,0
2022-04-17,LC,Cyprus,1005,778,7,5,227,108,112,220,2
2022-04-18,LC,Cyprus,900,671,8,8,229,113,108,221,0
2022-04-19,LC,Cyprus,858,685,10,8,173,77,86,163,2
2022-04-20,LC,Cyprus,966,718,9,9,248,120,119,239,0
2022-04-21,LC,Cyprus,968,750,6,5,218,107,105,212,1
2022-04-22,LC,Cyprus,859,654,7,5,205,101,97,198,2
2022-04-23,LC,Cyprus,1007,765,1,0,242,126,115,241,1
2022-04-24,LC,Cyprus,1043,835,3,1,208,103,102,205,2
2022-04-25,LC,Cyprus,912,688,8,8,224,106,110,216,0
2022-04-26,LC,Cyprus,811,638,10,8,173,82,81,163,2
2022-04-27,LC,Cyprus,891,656,9,9,235,112,114,226,0
2022-04-28,LC,Cyprus,967,766,9,8,201,96,96,192,1
2022-04-29,LC,Cyprus,869,663,8,7,206,100,98,198,1
2022-04-30,LC,Cyprus,953,725,5,5,228,111,112,223,0
2022-05-01,LC,Cyprus,1073,827,8,5,246,120,118,238,3
2022-05-02,LC,Cyprus,963,716,8,7,247,120,119,239,1
2022-05-03,LC,Cyprus,904,733,14,11,171,78,79,157,3
2022-05-04,LC,Cyprus,930,687,9,9,243,117,117,234,0
2022-05-05,LC,Cyprus,1027,812,10,9,215,98,107,205,1
2022-05-06,LC,Cyprus,986,773,7,6,213,106,100,206,1
2022-05-07,LC,Cyprus,1037,802,2,1,235,117,116,233,1
2022-05-08,LC,Cyprus,1045,802,6,3,243,120,117,237,3
2022-05-09,LC,Cyprus,959,726,8,8,233,111,114,225,0
2022-05-10,LC,Cyprus,852,677,11,9,175,82,82,164,2
2022-05-11,LC,Cyprus,893,664,8,8,229,111,110,221,0
2022-05-12,LC,Cyprus,967,741,9,8,226,107,110,217,1
2022-05-13,LC,Cyprus,845,635,9,7,210,97,104,201,2
2022-05-14,LC,Cyprus,860,633,2,1,227,115,110,225,1
2022-05-15,LC,Cyprus,1020,775,5,2,245,123,117,240,3
2022-05-16,LC,Cyprus,922,683,6,6,239,115,118,233,0
2022-05-17,LC,Cyprus,815,642,11,9,173,80,82,162,2
2022-05-18,LC,Cyprus,914,658,6,5,256,125,125,250,1
2022-05-19,LC,Cyprus,944,721,6,3,223,107,110,217,3
2022-05-20,LC,Cyprus,860,631,11,9,229,108,110,218,2
2022-05-21,LC,Cyprus,867,628,2,2,239,121,116,237,0
2022-05-22,LC,Cyprus,997,755,6,3,242,117,119,236,3
2022-05-23,LC,Cyprus,887,639,6,5,248,122,120,242,1
2022-05-24,LC,Cyprus,877,680,9,7,197,94,94,188,2
2022-05-25,LC,Cyprus,968,702,9,8,266,127,130,257,1
2022-05-26,LC,Cyprus,995,746,6,5,249,121,122,243,1
2022-05-27,LC,Cyprus,853,619,10,8,234,112,112,224,2
2022-05-28,LC,Cyprus,900,652,2,2,248,125,121,246,0
2022-05-29,LC,Cyprus,1015,767,5,2,248,121,122,243,3
2022-05-30,LC,Cyprus,966,697,8,8,269,129,132,261,0
2022-05-31,LC,Cyprus,895,690,8,6,205,103,94,197,2
2022-06-01,LC,Cyprus,996,730,5,5,266,130,131,261,0
2022-06-02,LC,Cyprus,1045,796,7,5,249,120,122,242,2
2022-06-03,LC,Cyprus,917,674,7,7,243,116,120,236,0
2022-06-04,LC,Cyprus,932,674,2,2,258,130,126,256,0
2022-06-05,LC,Cyprus,964,705,4,2,259,127,128,255,2
2022-06-06,LC,Cyprus,1012,742,3,3,270,135,132,267,0
2022-06-07,LC,Cyprus,947,729,5,5,218,106,107,213,0
2022-06-08,LC,Cyprus,997,726,6,6,271,128,137,265,0
2022-06-09,LC,Cyprus,1023,782,6,5,241,116,119,235,1
2022-06-10,LC,Cyprus,952,708,7,7,244,118,119,237,0
2022-06-11,LC,Cyprus,955,692,1,0,263,130,132,262,1
2022-06-12,LC,Cyprus,1062,813,3,2,249,126,120,246,1
2022-06-13,LC,Cyprus,998,723,6,5,275,138,131,269,1
2022-06-14,LC,Cyprus,951,742,7,5,209,99,103,202,2
2022-06-15,LC,Cyprus,1044,760,5,5,284,142,137,279,0
2022-06-16,LC,Cyprus,1067,817,9,5,250,118,123,241,4
2022-06-17,LC,Cyprus,957,723,5,5,234,116,113,229,0
2022-06-18,LC,Cyprus,936,689,0,0,247,123,124,247,0
2022-06-19,LC,Cyprus,1094,823,4,2,271,134,133,267,2
2022-06-20,LC,Cyprus,1002,745,4,4,257,127,126,253,0
2022-06-21,LC,Cyprus,1021,810,5,5,211,102,104,206,0
2022-06-22,LC,Cyprus,1105,811,5,5,294,145,144,289,0
2022-06-23,LC,Cyprus,1158,902,5,4,256,125,126,251,1
2022-06-24,LC,Cyprus,1022,779,4,4,243,121,118,239,0
2022-06-25,LC,Cyprus,1009,770,3,3,239,121,115,236,0
2022-06-26,LC,Cyprus,1177,912,5,2,265,128,132,260,3
2022-06-27,LC,Cyprus,1074,802,4,4,272,132,136,268,0
2022-06-28,LC,Cyprus,1037,803,7,7,234,115,112,227,0
2022-06-29,LC,Cyprus,1081,808,6,6,273,135,132,267,0
2022-06-30,LC,Cyprus,1136,888,11,9,248,114,123,237,2
2022-07-01,LC,Cyprus,1104,835,8,8,269,131,130,261,0
2022-07-02,LC,Cyprus,1006,756,1,1,250,128,121,249,0
2022-07-03,LC,Cyprus,1172,899,8,3,273,132,133,265,5
2022-07-04,LC,Cyprus,1113,845,2,2,268,133,133,266,0
2022-07-05,LC,Cyprus,1061,848,5,5,213,106,102,208,0
2022-07-06,LC,Cyprus,1161,874,8,8,287,137,142,279,0
2022-07-07,LC,Cyprus,1211,941,7,6,270,129,134,263,1
2022-07-08,LC,Cyprus,1096,838,6,6,258,129,123,252,0
2022-07-09,LC,Cyprus,1041,775,0,0,266,133,133,266,0
2022-07-10,LC,Cyprus,1210,933,5,4,277,132,140,272,1
2022-07-11,LC,Cyprus,1130,864,8,6,266,131,127,258,2
2022-07-12,LC,Cyprus,1094,851,7,7,243,117,119,236,0
2022-07-13,LC,Cyprus,1157,877,4,4,280,137,139,276,0
2022-07-14,LC,Cyprus,1206,943,5,4,263,128,130,258,1
2022-07-15,LC,Cyprus,1113,860,6,6,253,126,121,247,0
2022-07-16,LC,Cyprus,1101,834,3,3,267,133,131,264,0
2022-07-17,LC,Cyprus,1166,905,4,3,261,130,127,257,1
2022-07-18,LC,Cyprus,1128,852,4,4,276,137,135,272,0
2022-07-19,LC,Cyprus,1105,884,4,4,221,104,113,217,0
2022-07-20,LC,Cyprus,1194,890,7,7,304,148,149,297,0
2022-07-21,LC,Cyprus,1209,940,4,3,269,131,134,265,1
2022-07-22,LC,Cyprus,1057,798,3,3,259,130,126,256,0
2022-07-23,LC,Cyprus,1062,803,1,1,259,127,131,258,0
2022-07-24,LC,Cyprus,1221,939,1,0,282,142,139,281,1
2022-07-25,LC,Cyprus,1152,871,2,2,281,143,136,279,0
2022-07-26,LC,Cyprus,1113,880,1,1,233,115,117,232,0
2022-07-27,LC,Cyprus,1175,878,2,2,297,149,146,295,0
2022-07-28,LC,Cyprus,1176,911,5,5,265,130,130,260,0
2022-07-29,LC,Cyprus,1074,810,5,4,264,127,132,259,1
2022-07-30,LC,Cyprus,1061,798,1,1,263,131,131,262,0
2022-07-31,LC,Cyprus,1186,909,3,2,277,140,134,274,1
2022-08-01,LC,Cyprus,1123,852,3,3,271,131,137,268,0
2022-08-02,LC,Cyprus,1135,905,6,6,230,113,111,224,0
2022-08-03,LC,Cyprus,1174,883,6,6,291,142,143,285,0
2022-08-04,LC,Cyprus,1206,939,3,2,267,130,134,264,1
2022-08-05,LC,Cyprus,1104,838,6,6,266,128,132,260,0
2022-08-06,LC,Cyprus,1071,790,2,1,281,142,137,279,1
2022-08-07,LC,Cyprus,1183,908,3,2,275,135,137,272,1
2022-08-08,LC,Cyprus,1130,847,5,5,283,141,137,278,0
2022-08-09,LC,Cyprus,1136,892,7,6,244,117,120,237,1
2022-08-10,LC,Cyprus,1191,895,5,5,296,149,142,291,0
2022-08-11,LC,Cyprus,1208,950,4,3,258,123,131,254,1
2022-08-12,LC,Cyprus,1128,851,7,5,277,135,135,270,2
2022-08-13,LC,Cyprus,1063,778,1,1,285,143,141,284,0
2022-08-14,LC,Cyprus,1207,919,3,2,288,143,142,285,1
2022-08-15,LC,Cyprus,1180,888,7,7,292,144,141,285,0
2022-08-16,LC,Cyprus,1109,885,7,7,224,110,107,217,0
2022-08-17,LC,Cyprus,1195,910,6,6,285,138,141,279,0
2022-08-18,LC,Cyprus,1228,940,5,4,288,142,141,283,1
2022-08-19,LC,Cyprus,1148,862,4,4,286,139,143,282,0
2022-08-20,LC,Cyprus,1114,835,1,1,279,142,136,278,0
2022-08-21,LC,Cyprus,1246,955,3,2,291,144,144,288,1
2022-08-22,LC,Cyprus,1170,888,3,3,282,137,142,279,0
2022-08-23,LC,Cyprus,1116,888,5,5,228,115,108,223,0
2022-08-24,LC,Cyprus,1180,879,3,3,301,146,152,298,0
2022-08-25,LC,Cyprus,1234,966,7,6,268,129,132,261,1
2022-08-26,LC,Cyprus,1136,839,8,6,297,148,141,289,2
2022-08-27,LC,Cyprus,1121,831,1,1,290,146,143,289,0
2022-08-28,LC,Cyprus,1224,946,4,3,278,137,137,274,1
2022-08-29,LC,Cyprus,1137,865,4,4,272,132,136,268,0
2022-08-30,LC,Cyprus,1119,889,6,5,230,113,111,224,1
2022-08-31,LC,Cyprus,1154,869,4,4,285,135,146,281,0
2022-09-01,LC,Cyprus,1195,930,7,6,265,129,129,258,1
2022-09-02,LC,Cyprus,1021,768,4,3,253,125,124,249,1
2022-09-03,LC,Cyprus,1069,796,1,1,273,137,135,272,0
2022-09-04,LC,Cyprus,1181,905,3,2,276,137,136,273,1
2022-09-05,LC,Cyprus,1100,824,2,2,276,135,139,274,0
2022-09-06,LC,Cyprus,1033,818,6,3,215,105,104,209,3
2022-09-07,LC,Cyprus,1134,840,5,3,294,147,142,289,2
2022-09-08,LC,Cyprus,1172,911,6,5,261,127,128,255,1
2022-09-09,LC,Cyprus,1034,774,5,5,260,123,132,255,0
2022-09-10,LC,Cyprus,1066,774,2,1,292,148,142,290,1
2022-09-11,LC,Cyprus,1185,908,3,2,277,135,139,274,1
2022-09-12,LC,Cyprus,1050,780,3,3,270,135,132,267,0
2022-09-13,LC,Cyprus,1052,832,6,6,220,110,104,214,0
2022-09-14,LC,Cyprus,1094,813,4,4,281,137,140,277,0
2022-09-15,LC,Cyprus,1191,930,7,6,261,127,127,254,1
2022-09-16,LC,Cyprus,1039,776,7,6,263,128,128,256,1
2022-09-17,LC,Cyprus,1034,769,1,1,265,133,131,264,0
2022-09-18,LC,Cyprus,1192,924,3,2,268,131,134,265,1
2022-09-19,LC,Cyprus,1079,816,4,4,263,128,131,259,0
2022-09-20,LC,Cyprus,1088,882,6,6,206,99,101,200,0
2022-09-21,LC,Cyprus,1170,895,5,5,275,141,129,270,0
2022-09-22,LC,Cyprus,1228,966,4,3,262,127,131,258,1
2022-09-23,LC,Cyprus,1073,795,6,6,278,136,136,272,0
2022-09-24,LC,Cyprus,1025,758,1,1,267,133,133,266,0
2022-09-25,LC,Cyprus,1086,811,2,1,275,136,137,273,1
2022-09-26,LC,Cyprus,908,642,7,6,266,134,125,259,1
2022-09-27,LC,Cyprus,1018,789,6,6,229,110,113,223,0
2022-09-28,LC,Cyprus,1154,875,5,5,279,135,139,274,0
2022-09-29,LC,Cyprus,1233,959,7,4,274,132,135,267,3
2022-09-30,LC,Cyprus,1017,780,2,2,237,117,118,235,0
2022-10-01,LC,Cyprus,1068,787,3,1,281,141,137,278,2
2022-10-02,LC,Cyprus,1164,892,3,2,272,134,135,269,1
2022-10-03,LC,Cyprus,1058,779,6,5,279,135,138,273,1
2022-10-04,LC,Cyprus,825,617,6,5,208,101,101,202,1
2022-10-05,LC,Cyprus,729,471,5,5,258,128,125,253,0
2022-10-06,LC,Cyprus,1159,898,8,7,261,125,128,253,1
2022-10-07,LC,Cyprus,1070,807,6,5,263,126,131,257,1
2022-10-08,LC,Cyprus,1072,784,1,1,288,145,142,287,0
2022-10-09,LC,Cyprus,1118,854,2,1,264,133,129,262,1
2022-10-10,LC,Cyprus,955,686,3,2,269,132,134,266,1
2022-10-11,LC,Cyprus,1005,788,4,4,217,105,108,213,0
2022-10-12,LC,Cyprus,1118,832,6,5,286,141,139,280,1
2022-10-13,LC,Cyprus,1131,885,7,6,246,116,123,239,1
2022-10-14,LC,Cyprus,1017,760,6,6,257,124,127,251,0
2022-10-15,LC,Cyprus,1070,777,3,3,293,146,144,290,0
2022-10-16,LC,Cyprus,1150,869,4,2,281,141,136,277,2
2022-10-17,LC,Cyprus,1027,769,3,3,258,127,128,255,0
2022-10-18,LC,Cyprus,1014,803,10,9,211,100,101,201,1
2022-10-19,LC,Cyprus,1070,805,10,9,265,128,127,255,1
2022-10-20,LC,Cyprus,1147,877,10,7,270,130,130,260,3
2022-10-21,LC,Cyprus,966,733,5,4,233,110,118,228,1
2022-10-22,LC,Cyprus,1086,797,2,1,289,144,143,287,1
2022-10-23,LC,Cyprus,1145,866,5,4,279,137,137,274,1
2022-10-24,LC,Cyprus,1021,752,5,5,269,135,129,264,0
2022-10-25,LC,Cyprus,999,796,7,6,203,96,100,196,1
2022-10-26,LC,Cyprus,1060,789,7,6,271,129,135,264,1
2022-10-27,LC,Cyprus,1118,852,6,5,266,134,126,260,1
2022-10-28,LC,Cyprus,911,685,9,9,226,105,112,217,0
2022-10-29,LC,Cyprus,1064,772,1,0,292,145,146,291,1
2022-10-30,LC,Cyprus,1111,838,6,5,273,138,129,267,1
2022-10-31,LC,Cyprus,957,731,4,4,226,113,109,222,0
2022-11-01,LC,Cyprus,904,738,6,6,166,79,81,160,0
2022-11-02,LC,Cyprus,982,769,9,8,213,92,112,204,1
2022-11-03,LC,Cyprus,994,791,5,4,203,111,87,198,1
2022-11-04,LC,Cyprus,914,720,9,8,194,91,94,185,1
2022-11-05,LC,Cyprus,951,744,2,2,207,103,102,205,0
2022-11-06,LC,Cyprus,1074,865,3,3,209,106,100,206,0
2022-11-07,LC,Cyprus,971,780,4,4,191,92,95,187,0
2022-11-08,LC,Cyprus,894,737,7,6,157,78,72,150,1
2022-11-09,LC,Cyprus,942,747,5,5,195,96,94,190,0
2022-11-10,LC,Cyprus,948,806,3,3,142,67,72,139,0
2022-11-11,LC,Cyprus,890,711,4,3,179,84,91,175,1
2022-11-12,LC,Cyprus,929,737,1,1,192,97,94,191,0
2022-11-13,LC,Cyprus,1031,847,2,2,184,93,89,182,0
2022-11-14,LC,Cyprus,912,743,2,2,169,86,81,167,0
2022-11-15,LC,Cyprus,900,757,2,2,143,65,76,141,0
2022-11-16,LC,Cyprus,924,753,4,4,171,82,85,167,0
2022-11-17,LC,Cyprus,966,802,3,3,164,82,79,161,0
2022-11-18,LC,Cyprus,906,739,4,4,167,82,81,163,0
2022-11-19,LC,Cyprus,924,743,6,5,181,91,84,175,1
2022-11-20,LC,Cyprus,1041,857,3,2,184,88,93,181,1
2022-11-21,LC,Cyprus,905,742,3,3,163,82,78,160,0
2022-11-22,LC,Cyprus,844,720,3,3,124,64,57,121,0
2022-11-23,LC,Cyprus,943,772,7,7,171,79,85,164,0
2022-11-24,LC,Cyprus,1077,929,0,0,148,74,74,148,0
2022-11-25,LC,Cyprus,957,793,4,3,164,80,80,160,1
2022-11-26,LC,Cyprus,915,771,4,4,144,73,67,140,0
2022-11-27,LC,Cyprus,1035,853,4,3,182,88,90,178,1
2022-11-28,LC,Cyprus,920,744,6,5,176,85,85,170,1
2022-11-29,LC,Cyprus,857,732,3,2,125,62,60,122,1
2022-11-30,LC,Cyprus,910,755,9,8,155,74,72,146,1
2022-12-01,LC,Cyprus,947,788,7,6,159,73,79,152,1
2022-12-02,LC,Cyprus,848,686,8,7,162,77,77,154,1
2022-12-03,LC,Cyprus,882,733,3,3,149,76,70,146,0
2022-12-04,LC,Cyprus,1034,867,8,7,167,77,82,159,1
2022-12-05,LC,Cyprus,888,721,4,4,167,80,83,163,0
2022-12-06,LC,Cyprus,854,733,5,4,121,59,57,116,1
2022-12-07,LC,Cyprus,891,737,5,5,154,76,73,149,0
2022-12-08,LC,Cyprus,928,776,5,3,152,73,74,147,2
2022-12-09,LC,Cyprus,870,698,5,5,172,83,84,167,0
2022-12-10,LC,Cyprus,856,708,2,2,148,73,73,146,0
2022-12-11,LC,Cyprus,997,833,5,5,164,80,79,159,0
2022-12-12,LC,Cyprus,888,730,6,6,158,75,77,152,0
2022-12-13,LC,Cyprus,866,724,9,7,142,65,68,133,2
2022-12-14,LC,Cyprus,967,796,4,4,171,87,80,167,0
2022-12-15,LC,Cyprus,1017,851,7,7,166,78,81,159,0
2022-12-16,LC,Cyprus,933,743,6,5,190,90,94,184,1
2022-12-17,LC,Cyprus,912,755,4,4,157,78,75,153,0
2022-12-18,LC,Cyprus,1042,887,0,0,155,80,75,155,0
2022-12-19,LC,Cyprus,999,831,6,6,168,77,85,162,0
2022-12-20,LC,Cyprus,1018,853,2,2,165,86,77,163,0
2022-12-21,LC,Cyprus,997,831,5,5,166,80,81,161,0
2022-12-22,LC,Cyprus,1100,921,6,6,179,85,88,173,0
2022-12-23,LC,Cyprus,1036,868,3,3,168,82,83,165,0
2022-12-24,LC,Cyprus,971,834,1,1,137,70,66,136,0
2022-12-25,LC,Cyprus,956,866,4,4,90,45,41,86,0
2022-12-26,LC,Cyprus,1001,870,4,4,131,62,65,127,0
2022-12-27,LC,Cyprus,989,844,5,5,145,69,71,140,0
2022-01-01,LK,Czech Republic,1004,838,0,0,166,86,80,166,0
2022-01-02,LK,Czech Republic,1567,1233,3,0,334,162,169,331,3
2022-01-03,LK,Czech Republic,1468,1203,11,5,265,126,128,254,6
2022-01-04,LK,Czech Republic,1135,938,10,5,197,94,93,187,5
2022-01-05,LK,Czech Republic,1140,958,13,5,182,78,91,169,8
2022-01-06,LK,Czech Republic,1173,957,21,6,216,99,96,195,15
2022-01-07,LK,Czech Republic,1372,1099,28,7,273,126,119,245,21
2022-01-08,LK,Czech Republic,1225,1050,10,5,175,85,80,165,5
2022-01-09,LK,Czech Republic,1435,1170,7,0,265,124,134,258,7
2022-01-10,LK,Czech Republic,1164,960,5,1,204,99,100,199,4
2022-01-11,LK,Czech Republic,950,786,21,9,164,67,76,143,12
2022-01-12,LK,Czech Republic,959,767,17,8,192,87,88,175,9
2022-01-13,LK,Czech Republic,954,761,26,11,193,87,80,167,15
2022-01-14,LK,Czech Republic,1145,909,22,8,236,113,101,214,14
2022-01-15,LK,Czech Republic,980,841,8,6,139,66,65,131,2
2022-01-16,LK,Czech Republic,1092,870,8,2,222,95,119,214,6
2022-01-17,LK,Czech Republic,952,772,5,1,180,92,83,175,4
2022-01-18,LK,Czech Republic,826,649,20,6,177,75,82,157,14
2022-01-19,LK,Czech Republic,865,671,27,12,194,84,83,167,15
2022-01-20,LK,Czech Republic,910,726,8,3,184,89,87,176,5
2022-01-21,LK,Czech Republic,1062,836,22,11,226,105,99,204,11
2022-01-22,LK,Czech Republic,986,848,14,5,138,61,63,124,9
2022-01-23,LK,Czech Republic,1012,819,6,1,193,92,95,187,5
2022-01-24,LK,Czech Republic,924,740,7,1,184,87,90,177,6
2022-01-25,LK,Czech Republic,721,582,11,1,139,65,63,128,10
2022-01-26,LK,Czech Republic,830,667,17,6,163,72,74,146,11
2022-01-27,LK,Czech Republic,941,740,21,6,201,91,89,180,15
2022-01-28,LK,Czech Republic,1115,902,17,3,213,102,94,196,14
2022-01-29,LK,Czech Republic,968,838,3,1,130,63,64,127,2
2022-01-30,LK,Czech Republic,1037,846,2,0,191,93,96,189,2
2022-01-31,LK,Czech Republic,986,799,17,8,187,84,86,170,9
2022-02-01,LK,Czech Republic,912,751,15,5,161,73,73,146,10
2022-02-02,LK,Czech Republic,931,743,11,3,188,88,89,177,8
2022-02-03,LK,Czech Republic,993,776,16,5,217,104,97,201,11
2022-02-04,LK,Czech Republic,1170,905,29,15,265,125,111,236,14
2022-02-05,LK,Czech Republic,1040,892,13,7,148,66,69,135,6
2022-02-06,LK,Czech Republic,1128,903,5,1,225,104,116,220,4
2022-02-07,LK,Czech Republic,1068,868,18,9,200,93,89,182,9
2022-02-08,LK,Czech Republic,864,680,33,11,184,77,74,151,22
2022-02-09,LK,Czech Republic,996,757,30,16,239,107,102,209,14
2022-02-10,LK,Czech Republic,1084,839,34,16,245,108,103,211,18
2022-02-11,LK,Czech Republic,1261,998,20,6,263,127,116,243,14
2022-02-12,LK,Czech Republic,1167,981,17,11,186,82,87,169,6
2022-02-13,LK,Czech Republic,1233,962,19,8,271,120,132,252,11
2022-02-14,LK,Czech Republic,1140,904,22,10,236,105,109,214,12
2022-02-15,LK,Czech Republic,1013,804,21,12,209,96,92,188,9
2022-02-16,LK,Czech Republic,1002,780,26,11,222,97,99,196,15
2022-02-17,LK,Czech Republic,1044,860,5,0,184,90,89,179,5
2022-02-18,LK,Czech Republic,1252,961,19,8,291,141,131,272,11
2022-02-19,LK,Czech Republic,1215,1036,5,2,179,88,86,174,3
2022-02-20,LK,Czech Republic,1242,1013,4,2,229,106,119,225,2
2022-02-21,LK,Czech Republic,1118,890,5,1,228,112,111,223,4
2022-02-22,LK,Czech Republic,952,769,14,8,183,83,86,169,6
2022-02-23,LK,Czech Republic,1017,781,29,14,236,103,104,207,15
2022-02-24,LK,Czech Republic,1116,877,35,17,239,104,100,204,18
2022-02-25,LK,Czech Republic,1334,1045,24,11,289,137,128,265,13
2022-02-26,LK,Czech Republic,1179,1009,4,1,170,85,81,166,3
2022-02-27,LK,Czech Republic,1254,998,9,4,256,118,129,247,5
2022-02-28,LK,Czech Republic,1183,902,33,9,281,124,124,248,24
2022-03-01,LK,Czech Republic,1051,833,37,14,218,91,90,181,23
2022-03-02,LK,Czech Republic,1177,927,22,10,250,115,113,228,12
2022-03-03,LK,Czech Republic,1163,895,29,16,268,116,123,239,13
2022-03-04,LK,Czech Republic,1418,1116,14,5,302,149,139,288,9
2022-03-05,LK,Czech Republic,1244,1060,7,4,184,89,88,177,3
2022-03-06,LK,Czech Republic,1289,1034,11,6,255,116,128,244,5
2022-03-07,LK,Czech Republic,1287,1033,20,8,254,118,116,234,12
2022-03-08,LK,Czech Republic,1108,898,28,19,210,90,92,182,9
2022-03-09,LK,Czech Republic,1166,900,32,14,266,116,118,234,18
2022-03-10,LK,Czech Republic,1219,951,27,14,268,125,116,241,13
2022-03-11,LK,Czech Republic,1391,1081,21,16,310,145,144,289,5
2022-03-12,LK,Czech Republic,1184,1009,13,6,175,80,82,162,7
2022-03-13,LK,Czech Republic,1310,1040,8,3,270,127,135,262,5
2022-03-14,LK,Czech Republic,1227,974,23,13,253,114,116,230,10
2022-03-15,LK,Czech Republic,1139,915,27,16,224,99,98,197,11
2022-03-16,LK,Czech Republic,1223,965,35,13,258,117,106,223,22
2022-03-17,LK,Czech Republic,1298,1047,31,16,251,108,112,220,15
2022-03-18,LK,Czech Republic,1499,1198,22,10,301,144,135,279,12
2022-03-19,LK,Czech Republic,1221,1045,6,4,176,83,87,170,2
2022-03-20,LK,Czech Republic,1364,1091,12,6,273,127,134,261,6
2022-03-21,LK,Czech Republic,1332,1081,16,8,251,113,122,235,8
2022-03-22,LK,Czech Republic,1126,904,28,14,222,101,93,194,14
2022-03-23,LK,Czech Republic,1249,975,23,8,274,129,122,251,15
2022-03-24,LK,Czech Republic,1316,1024,29,13,292,135,128,263,16
2022-03-25,LK,Czech Republic,1557,1220,29,20,337,156,152,308,9
2022-03-26,LK,Czech Republic,1255,1085,5,3,170,84,81,165,2
2022-03-27,LK,Czech Republic,1469,1197,9,2,272,127,136,263,7
2022-03-28,LK,Czech Republic,1500,1198,21,12,302,137,144,281,9
2022-03-29,LK,Czech Republic,1389,1123,25,16,266,121,120,241,9
2022-03-30,LK,Czech Republic,1416,1143,15,9,273,131,127,258,6
2022-03-31,LK,Czech Republic,1531,1243,11,2,288,137,140,277,9
2022-04-01,LK,Czech Republic,1661,1321,15,7,340,166,159,325,8
2022-04-02,LK,Czech Republic,1452,1265,3,3,187,93,91,184,0
2022-04-03,LK,Czech Republic,1555,1278,9,8,277,125,143,268,1
2022-04-04,LK,Czech Republic,1580,1246,24,13,334,158,152,310,11
2022-04-05,LK,Czech Republic,1380,1138,5,3,242,122,115,237,2
2022-04-06,LK,Czech Republic,1542,1254,26,11,288,129,133,262,15
2022-04-07,LK,Czech Republic,1623,1319,14,10,304,146,144,290,4
2022-04-08,LK,Czech Republic,1782,1420,14,4,362,177,171,348,10
2022-04-09,LK,Czech Republic,1618,1418,1,0,200,104,95,199,1
2022-04-10,LK,Czech Republic,1726,1445,8,5,281,129,144,273,3
2022-04-11,LK,Czech Republic,1725,1398,21,13,327,154,152,306,8
2022-04-12,LK,Czech Republic,1559,1279,25,12,280,129,126,255,13
2022-04-13,LK,Czech Republic,1717,1367,25,11,350,165,160,325,14
2022-04-14,LK,Czech Republic,1841,1464,25,12,377,181,171,352,13
2022-04-15,LK,Czech Republic,1755,1411,16,10,344,172,156,328,6
2022-04-16,LK,Czech Republic,1499,1291,9,4,208,94,105,199,5
2022-04-17,LK,Czech Republic,1624,1344,9,5,280,132,139,271,4
2022-04-18,LK,Czech Republic,1693,1335,9,2,358,169,180,349,7
2022-04-19,LK,Czech Republic,1623,1353,13,8,270,131,126,257,5
2022-04-20,LK,Czech Republic,1704,1400,17,9,304,140,147,287,8
2022-04-21,LK,Czech Republic,1744,1427,20,12,317,150,147,297,8
2022-04-22,LK,Czech Republic,1857,1501,23,20,356,169,164,333,3
2022-04-23,LK,Czech Republic,1638,1431,10,5,207,100,97,197,5
2022-04-24,LK,Czech Republic,1731,1438,6,2,293,132,155,287,4
2022-04-25,LK,Czech Republic,1718,1412,10,5,306,152,144,296,5
2022-04-26,LK,Czech Republic,1588,1311,25,15,277,132,120,252,10
2022-04-27,LK,Czech Republic,1654,1347,9,5,307,149,149,298,4
2022-04-28,LK,Czech Republic,1813,1464,29,13,349,159,161,320,16
2022-04-29,LK,Czech Republic,1972,1564,21,4,408,195,192,387,17
2022-04-30,LK,Czech Republic,1649,1397,7,4,252,122,123,245,3
2022-05-01,LK,Czech Republic,1879,1572,12,5,307,139,156,295,7
2022-05-02,LK,Czech Republic,1743,1414,10,5,329,162,157,319,5
2022-05-03,LK,Czech Republic,1634,1363,16,7,271,128,127,255,9
2022-05-04,LK,Czech Republic,1777,1475,19,11,302,143,140,283,8
2022-05-05,LK,Czech Republic,1822,1490,20,10,332,159,153,312,10
2022-05-06,LK,Czech Republic,1901,1531,28,11,370,175,167,342,17
2022-05-07,LK,Czech Republic,1694,1460,8,5,234,109,117,226,3
2022-05-08,LK,Czech Republic,1910,1581,13,6,329,152,164,316,7
2022-05-09,LK,Czech Republic,1830,1467,27,13,363,168,168,336,14
2022-05-10,LK,Czech Republic,1585,1286,17,9,299,149,133,282,8
2022-05-11,LK,Czech Republic,1674,1338,21,14,336,157,158,315,7
2022-05-12,LK,Czech Republic,1752,1408,25,13,344,154,165,319,12
2022-05-13,LK,Czech Republic,1857,1475,22,12,382,187,173,360,10
2022-05-14,LK,Czech Republic,1763,1510,8,1,253,124,121,245,7
2022-05-15,LK,Czech Republic,1918,1573,15,6,345,154,176,330,9
2022-05-16,LK,Czech Republic,1803,1460,18,12,343,164,161,325,6
2022-05-17,LK,Czech Republic,1610,1293,19,8,317,152,146,298,11
2022-05-18,LK,Czech Republic,1758,1391,33,10,367,173,161,334,23
2022-05-19,LK,Czech Republic,1828,1453,32,12,375,174,169,343,20
2022-05-20,LK,Czech Republic,1941,1555,21,14,386,184,181,365,7
2022-05-21,LK,Czech Republic,1770,1499,7,2,271,134,130,264,5
2022-05-22,LK,Czech Republic,1905,1563,10,3,342,154,178,332,7
2022-05-23,LK,Czech Republic,1913,1589,8,6,324,161,155,316,2
2022-05-24,LK,Czech Republic,1744,1454,22,7,290,130,138,268,15
2022-05-25,LK,Czech Republic,1844,1480,23,2,364,173,168,341,21
2022-05-26,LK,Czech Republic,1842,1495,16,7,347,168,163,331,9
2022-05-27,LK,Czech Republic,1860,1485,20,7,375,185,170,355,13
2022-05-28,LK,Czech Republic,1848,1569,8,2,279,134,137,271,6
2022-05-29,LK,Czech Republic,2065,1709,7,5,356,171,178,349,2
2022-05-30,LK,Czech Republic,1973,1601,23,11,372,172,177,349,12
2022-05-31,LK,Czech Republic,1878,1531,34,14,347,152,161,313,20
2022-06-01,LK,Czech Republic,1931,1554,17,5,377,186,174,360,12
2022-06-02,LK,Czech Republic,2002,1603,23,10,399,192,184,376,13
2022-06-03,LK,Czech Republic,2141,1719,21,15,422,204,197,401,6
2022-06-04,LK,Czech Republic,1965,1665,8,5,300,148,144,292,3
2022-06-05,LK,Czech Republic,2159,1785,13,4,374,166,195,361,9
2022-06-06,LK,Czech Republic,1972,1571,20,2,401,193,188,381,18
2022-06-07,LK,Czech Republic,1921,1568,9,4,353,173,171,344,5
2022-06-08,LK,Czech Republic,1886,1504,21,11,382,183,178,361,10
2022-06-09,LK,Czech Republic,2057,1637,27,8,420,190,203,393,19
2022-06-10,LK,Czech Republic,2163,1692,18,6,471,236,217,453,12
2022-06-11,LK,Czech Republic,2003,1670,5,2,333,168,160,328,3
2022-06-12,LK,Czech Republic,2123,1720,12,4,403,183,208,391,8
2022-06-13,LK,Czech Republic,2063,1635,21,10,428,210,197,407,11
2022-06-14,LK,Czech Republic,1954,1562,21,7,392,186,185,371,14
2022-06-15,LK,Czech Republic,1657,1233,11,7,424,202,211,413,4
2022-06-16,LK,Czech Republic,1671,1241,15,2,430,202,213,415,13
2022-06-17,LK,Czech Republic,1986,1508,16,10,478,236,226,462,6
2022-06-18,LK,Czech Republic,1873,1522,12,8,351,171,168,339,4
2022-06-19,LK,Czech Republic,1969,1526,16,7,443,208,219,427,9
2022-06-20,LK,Czech Republic,2009,1562,18,7,447,215,214,429,11
2022-06-21,LK,Czech Republic,1935,1512,22,8,423,202,199,401,14
2022-06-22,LK,Czech Republic,1961,1506,19,11,455,216,220,436,8
2022-06-23,LK,Czech Republic,2006,1523,29,12,483,230,224,454,17
2022-06-24,LK,Czech Republic,2056,1597,15,7,459,222,222,444,8
2022-06-25,LK,Czech Republic,1999,1628,8,3,371,187,176,363,5
2022-06-26,LK,Czech Republic,2141,1683,16,5,458,212,230,442,11
2022-06-27,LK,Czech Republic,2251,1789,23,10,462,217,222,439,13
2022-06-28,LK,Czech Republic,2040,1630,21,8,410,196,193,389,13
2022-06-29,LK,Czech Republic,2095,1662,13,5,433,214,206,420,8
2022-06-30,LK,Czech Republic,2247,1742,39,11,505,225,241,466,28
2022-07-01,LK,Czech Republic,2349,1845,10,4,504,260,234,494,6
2022-07-02,LK,Czech Republic,2107,1685,22,5,422,207,193,400,17
2022-07-03,LK,Czech Republic,2155,1723,17,8,432,206,209,415,9
2022-07-04,LK,Czech Republic,2204,1788,11,7,416,206,199,405,4
2022-07-05,LK,Czech Republic,2004,1628,12,8,376,177,187,364,4
2022-07-06,LK,Czech Republic,2088,1675,16,10,413,196,201,397,6
2022-07-07,LK,Czech Republic,2159,1740,16,9,419,203,200,403,7
2022-07-08,LK,Czech Republic,2151,1700,15,8,451,219,217,436,7
2022-07-09,LK,Czech Republic,2146,1729,15,6,417,199,203,402,9
2022-07-10,LK,Czech Republic,2127,1681,10,3,446,217,219,436,7
2022-07-11,LK,Czech Republic,2182,1716,18,6,466,223,225,448,12
2022-07-12,LK,Czech Republic,2031,1604,23,14,427,199,205,404,9
2022-07-13,LK,Czech Republic,2018,1567,23,9,451,224,204,428,14
2022-07-14,LK,Czech Republic,2114,1689,17,7,425,205,203,408,10
2022-07-15,LK,Czech Republic,2202,1746,23,10,456,215,218,433,13
2022-07-16,LK,Czech Republic,2055,1685,10,5,370,179,181,360,5
2022-07-17,LK,Czech Republic,2075,1632,16,6,443,208,219,427,10
2022-07-18,LK,Czech Republic,2110,1656,21,11,454,219,214,433,10
2022-07-19,LK,Czech Republic,2010,1597,22,13,413,193,198,391,9
2022-07-20,LK,Czech Republic,2129,1691,20,10,438,209,209,418,10
2022-07-21,LK,Czech Republic,2244,1801,21,9,443,211,211,422,12
2022-07-22,LK,Czech Republic,2193,1726,22,10,467,224,221,445,12
2022-07-23,LK,Czech Republic,2281,1909,6,2,372,185,181,366,4
2022-07-24,LK,Czech Republic,2113,1687,13,8,426,199,214,413,5
2022-07-25,LK,Czech Republic,2240,1777,23,11,463,220,220,440,12
2022-07-26,LK,Czech Republic,2063,1672,14,8,391,191,186,377,6
2022-07-27,LK,Czech Republic,2086,1666,16,10,420,207,197,404,6
2022-07-28,LK,Czech Republic,2183,1762,36,16,421,195,190,385,20
2022-07-29,LK,Czech Republic,2337,1885,21,7,452,218,213,431,14
2022-07-30,LK,Czech Republic,2148,1777,7,2,371,179,185,364,5
2022-07-31,LK,Czech Republic,2200,1748,17,6,452,210,225,435,11
2022-08-01,LK,Czech Republic,2212,1775,7,2,437,218,212,430,5
2022-08-02,LK,Czech Republic,2085,1684,15,11,401,191,195,386,4
2022-08-03,LK,Czech Republic,2106,1686,14,10,420,209,197,406,4
2022-08-04,LK,Czech Republic,2104,1696,23,12,408,193,192,385,11
2022-08-05,LK,Czech Republic,2229,1789,17,3,440,211,212,423,14
2022-08-06,LK,Czech Republic,2156,1788,14,5,368,175,179,354,9
2022-08-07,LK,Czech Republic,2207,1784,11,3,423,200,212,412,8
2022-08-08,LK,Czech Republic,2185,1751,21,10,434,206,207,413,11
2022-08-09,LK,Czech Republic,2100,1711,19,12,389,186,184,370,7
2022-08-10,LK,Czech Republic,2163,1741,18,10,422,207,197,404,8
2022-08-11,LK,Czech Republic,2203,1790,22,7,413,194,197,391,15
2022-08-12,LK,Czech Republic,2338,1880,13,5,458,227,218,445,8
2022-08-13,LK,Czech Republic,2140,1767,4,4,373,190,179,369,0
2022-08-14,LK,Czech Republic,2157,1736,11,3,421,197,213,410,8
2022-08-15,LK,Czech Republic,2191,1764,12,7,427,203,212,415,5
2022-08-16,LK,Czech Republic,2101,1700,25,8,401,193,183,376,17
2022-08-17,LK,Czech Republic,2100,1662,28,15,438,203,207,410,13
2022-08-18,LK,Czech Republic,2245,1817,24,14,428,201,203,404,10
2022-08-19,LK,Czech Republic,2286,1800,19,11,486,238,229,467,8
2022-08-20,LK,Czech Republic,2162,1785,12,3,377,181,184,365,9
2022-08-21,LK,Czech Republic,2196,1757,10,4,439,209,220,429,6
2022-08-22,LK,Czech Republic,2140,1695,19,10,445,214,212,426,9
2022-08-23,LK,Czech Republic,2014,1640,6,4,374,183,185,368,2
2022-08-24,LK,Czech Republic,2151,1671,29,17,480,231,220,451,12
2022-08-25,LK,Czech Republic,2220,1769,28,17,451,208,215,423,11
2022-08-26,LK,Czech Republic,2228,1793,14,10,435,217,204,421,4
2022-08-27,LK,Czech Republic,2253,1887,9,5,366,186,171,357,4
2022-08-28,LK,Czech Republic,2210,1768,13,8,442,206,223,429,5
2022-08-29,LK,Czech Republic,2221,1739,36,20,482,209,237,446,16
2022-08-30,LK,Czech Republic,2084,1637,31,17,447,208,208,416,14
2022-08-31,LK,Czech Republic,2186,1689,51,19,497,230,216,446,32
2022-09-01,LK,Czech Republic,2247,1802,31,11,445,211,203,414,20
2022-09-02,LK,Czech Republic,2217,1744,20,10,473,225,228,453,10
2022-09-03,LK,Czech Republic,2227,1854,12,4,373,183,178,361,8
2022-09-04,LK,Czech Republic,2177,1754,11,5,423,192,220,412,6
2022-09-05,LK,Czech Republic,2076,1649,21,9,427,204,202,406,12
2022-09-06,LK,Czech Republic,2005,1603,23,10,402,190,189,379,13
2022-09-07,LK,Czech Republic,2058,1593,25,11,465,222,218,440,14
2022-09-08,LK,Czech Republic,2197,1743,13,6,454,219,222,441,7
2022-09-09,LK,Czech Republic,2243,1750,21,8,493,237,235,472,13
2022-09-10,LK,Czech Republic,2138,1758,16,6,380,188,176,364,10
2022-09-11,LK,Czech Republic,2235,1802,16,7,433,198,219,417,9
2022-09-12,LK,Czech Republic,2098,1656,27,15,442,208,207,415,12
2022-09-13,LK,Czech Republic,1907,1491,32,14,416,187,197,384,18
2022-09-14,LK,Czech Republic,2114,1669,20,6,445,214,211,425,14
2022-09-15,LK,Czech Republic,2157,1711,20,11,446,212,214,426,9
2022-09-16,LK,Czech Republic,2203,1724,29,13,479,226,224,450,16
2022-09-17,LK,Czech Republic,2095,1728,24,6,367,176,167,343,18
2022-09-18,LK,Czech Republic,2153,1750,15,4,403,188,200,388,11
2022-09-19,LK,Czech Republic,2131,1695,11,5,436,218,207,425,6
2022-09-20,LK,Czech Republic,1961,1574,23,10,387,185,179,364,13
2022-09-21,LK,Czech Republic,2118,1689,32,15,429,202,195,397,17
2022-09-22,LK,Czech Republic,2153,1674,34,22,479,225,220,445,12
2022-09-23,LK,Czech Republic,2112,1635,27,16,477,230,220,450,11
2022-09-24,LK,Czech Republic,1993,1650,17,11,343,164,162,326,6
2022-09-25,LK,Czech Republic,2117,1720,9,1,397,187,201,388,8
2022-09-26,LK,Czech Republic,2028,1616,30,23,412,190,192,382,7
2022-09-27,LK,Czech Republic,1928,1551,26,11,377,174,177,351,15
2022-09-28,LK,Czech Republic,2048,1658,18,9,390,190,182,372,9
2022-09-29,LK,Czech Republic,2131,1709,19,5,422,205,198,403,14
2022-09-30,LK,Czech Republic,2234,1781,21,7,453,213,219,432,14
2022-10-01,LK,Czech Republic,2026,1694,4,1,332,166,162,328,3
2022-10-02,LK,Czech Republic,2088,1689,8,4,399,186,205,391,4
2022-10-03,LK,Czech Republic,1947,1570,18,9,377,184,175,359,9
2022-10-04,LK,Czech Republic,1841,1503,31,15,338,156,151,307,16
2022-10-05,LK,Czech Republic,1820,1441,22,13,379,174,183,357,9
2022-10-06,LK,Czech Republic,1877,1467,22,8,410,186,202,388,14
2022-10-07,LK,Czech Republic,2015,1591,17,9,424,217,190,407,8
2022-10-08,LK,Czech Republic,1927,1631,17,6,296,141,138,279,11
2022-10-09,LK,Czech Republic,2016,1661,16,8,355,162,177,339,8
2022-10-10,LK,Czech Republic,1962,1596,32,15,366,166,168,334,17
2022-10-11,LK,Czech Republic,1796,1488,22,11,308,142,144,286,11
2022-10-12,LK,Czech Republic,1921,1545,28,12,376,180,168,348,16
2022-10-13,LK,Czech Republic,1957,1615,25,11,342,158,159,317,14
2022-10-14,LK,Czech Republic,2053,1661,25,12,392,186,181,367,13
2022-10-15,LK,Czech Republic,1819,1559,8,4,260,127,125,252,4
2022-10-16,LK,Czech Republic,1917,1579,11,4,338,155,172,327,7
2022-10-17,LK,Czech Republic,1887,1527,17,12,360,176,167,343,5
2022-10-18,LK,Czech Republic,1767,1468,19,7,299,138,142,280,12
2022-10-19,LK,Czech Republic,1800,1470,20,6,330,157,153,310,14
2022-10-20,LK,Czech Republic,1930,1559,30,20,371,169,172,341,10
2022-10-21,LK,Czech Republic,1955,1562,28,11,393,189,176,365,17
2022-10-22,LK,Czech Republic,1800,1548,9,3,252,118,125,243,6
2022-10-23,LK,Czech Republic,1881,1572,13,6,309,149,147,296,7
2022-10-24,LK,Czech Republic,1901,1544,26,14,357,168,163,331,12
2022-10-25,LK,Czech Republic,1806,1483,18,8,323,146,159,305,10
2022-10-26,LK,Czech Republic,1844,1510,19,10,334,164,151,315,9
2022-10-27,LK,Czech Republic,1853,1509,20,10,344,165,159,324,10
2022-10-28,LK,Czech Republic,1946,1602,7,7,344,175,162,337,0
2022-10-29,LK,Czech Republic,1792,1536,4,2,256,122,130,252,2
2022-10-30,LK,Czech Republic,1847,1474,8,3,373,167,198,365,5
2022-10-31,LK,Czech Republic,1674,1336,16,8,338,164,158,322,8
2022-11-01,LK,Czech Republic,1411,1155,8,3,256,125,123,248,5
2022-11-02,LK,Czech Republic,1535,1229,16,9,306,148,142,290,7
2022-11-03,LK,Czech Republic,1576,1257,17,11,319,150,152,302,6
2022-11-04,LK,Czech Republic,1725,1395,12,5,330,158,160,318,7
2022-11-05,LK,Czech Republic,1453,1251,5,2,202,100,97,197,3
2022-11-06,LK,Czech Republic,1631,1340,9,3,291,131,151,282,6
2022-11-07,LK,Czech Republic,1565,1247,23,11,318,151,144,295,12
2022-11-08,LK,Czech Republic,1399,1126,18,10,273,130,125,255,8
2022-11-09,LK,Czech Republic,1417,1136,28,15,281,130,123,253,13
2022-11-10,LK,Czech Republic,1459,1157,20,9,302,137,145,282,11
2022-11-11,LK,Czech Republic,1581,1248,14,7,333,164,155,319,7
2022-11-12,LK,Czech Republic,1303,1097,5,0,206,100,101,201,5
2022-11-13,LK,Czech Republic,1514,1197,10,1,317,147,160,307,9
2022-11-14,LK,Czech Republic,1504,1203,23,9,301,139,139,278,14
2022-11-15,LK,Czech Republic,1306,1064,8,4,242,117,117,234,4
2022-11-16,LK,Czech Republic,1465,1191,17,6,274,131,126,257,11
2022-11-17,LK,Czech Republic,1493,1241,11,0,252,123,118,241,11
2022-11-18,LK,Czech Republic,1630,1342,5,2,288,142,141,283,3
2022-11-19,LK,Czech Republic,1372,1162,6,2,210,101,103,204,4
2022-11-20,LK,Czech Republic,1558,1246,5,0,312,149,158,307,5
2022-11-21,LK,Czech Republic,1517,1224,17,4,293,142,134,276,13
2022-11-22,LK,Czech Republic,1362,1122,16,4,240,111,113,224,12
2022-11-23,LK,Czech Republic,1330,1082,15,6,248,116,117,233,9
2022-11-24,LK,Czech Republic,1404,1119,15,8,285,138,132,270,7
2022-11-25,LK,Czech Republic,1619,1301,7,3,318,156,155,311,4
2022-11-26,LK,Czech Republic,1314,1127,9,5,187,90,88,178,4
2022-11-27,LK,Czech Republic,1492,1206,10,3,286,131,145,276,7
2022-11-28,LK,Czech Republic,1464,1163,13,5,301,144,144,288,8
2022-11-29,LK,Czech Republic,1331,1097,12,8,234,112,110,222,4
2022-11-30,LK,Czech Republic,1418,1154,19,8,264,124,121,245,11
2022-12-01,LK,Czech Republic,1527,1244,20,11,283,131,132,263,9
2022-12-02,LK,Czech Republic,1676,1326,15,8,350,167,168,335,7
2022-12-03,LK,Czech Republic,1365,1172,3,0,193,95,95,190,3
2022-12-04,LK,Czech Republic,1566,1279,7,1,287,135,145,280,6
2022-12-05,LK,Czech Republic,1484,1185,13,5,299,145,141,286,8
2022-12-06,LK,Czech Republic,1370,1129,13,5,241,115,113,228,8
2022-12-07,LK,Czech Republic,1501,1231,11,7,270,132,127,259,4
2022-12-08,LK,Czech Republic,1535,1226,15,9,309,150,144,294,6
2022-12-09,LK,Czech Republic,1631,1295,20,11,336,154,162,316,9
2022-12-10,LK,Czech Republic,1364,1163,6,2,201,99,96,195,4
2022-12-11,LK,Czech Republic,1558,1268,4,0,290,141,145,286,4
2022-12-12,LK,Czech Republic,1453,1184,7,1,269,135,127,262,6
2022-12-13,LK,Czech Republic,1425,1157,19,13,268,126,123,249,6
2022-12-14,LK,Czech Republic,1414,1167,9,5,247,117,121,238,4
2022-12-15,LK,Czech Republic,1510,1218,17,8,292,137,138,275,9
2022-12-16,LK,Czech Republic,1599,1279,4,1,320,160,156,316,3
2022-12-17,LK,Czech Republic,1411,1212,5,1,199,99,95,194,4
2022-12-18,LK,Czech Republic,1519,1239,0,0,280,136,144,280,0
2022-12-19,LK,Czech Republic,1547,1256,9,2,291,141,141,282,7
2022-12-20,LK,Czech Republic,1473,1199,17,5,274,132,125,257,12
2022-12-21,LK,Czech Republic,1544,1269,11,2,275,128,136,264,9
2022-12-22,LK,Czech Republic,1553,1259,6,4,294,146,142,288,2
2022-12-23,LK,Czech Republic,1681,1374,11,6,307,144,152,296,5
2022-12-24,LK,Czech Republic,1222,1071,3,0,151,78,70,148,3
2022-12-25,LK,Czech Republic,998,828,1,0,170,82,87,169,1
2022-12-26,LK,Czech Republic,1384,1100,4,0,284,145,135,280,4
2022-12-27,LK,Czech Republic,1419,1173,14,6,246,120,112,232,8
2022-01-01,EK,Denmark,863,519,20,0,344,159,165,324,20
2022-01-02,EK,Denmark,1363,735,78,1,628,281,269,550,77
2022-01-03,EK,Denmark,1329,643,109,14,686,289,288,577,95
2022-01-04,EK,Denmark,1171,617,79,9,554,237,238,475,70
2022-01-05,EK,Denmark,1166,597,71,4,569,250,248,498,67
2022-01-06,EK,Denmark,1165,610,97,18,555,230,228,458,79
2022-01-07,EK,Denmark,1301,687,83,5,614,262,269,531,78
2022-01-08,EK,Denmark,1089,660,39,3,429,191,199,390,36
2022-01-09,EK,Denmark,1225,704,55,0,521,232,234,466,55
2022-01-10,EK,Denmark,1082,563,81,11,519,226,212,438,70
2022-01-11,EK,Denmark,953,497,75,6,456,189,192,381,69
2022-01-12,EK,Denmark,974,521,92,9,453,182,179,361,83
2022-01-13,EK,Denmark,997,514,116,18,483,183,184,367,98
2022-01-14,EK,Denmark,1089,557,94,12,532,220,218,438,82
2022-01-15,EK,Denmark,944,563,40,6,381,168,173,341,34
2022-01-16,EK,Denmark,1063,588,68,2,475,197,210,407,66
2022-01-17,EK,Denmark,1029,534,92,17,495,206,197,403,75
2022-01-18,EK,Denmark,903,487,97,11,416,163,156,319,86
2022-01-19,EK,Denmark,950,495,105,11,455,174,176,350,94
2022-01-20,EK,Denmark,970,517,86,8,453,186,181,367,78
2022-01-21,EK,Denmark,1113,569,98,14,544,219,227,446,84
2022-01-22,EK,Denmark,919,523,61,10,396,169,166,335,51
2022-01-23,EK,Denmark,1041,564,71,6,477,198,208,406,65
2022-01-24,EK,Denmark,1016,542,108,17,474,187,179,366,91
2022-01-25,EK,Denmark,851,420,106,23,431,157,168,325,83
2022-01-26,EK,Denmark,934,468,106,14,466,183,177,360,92
2022-01-27,EK,Denmark,989,531,102,8,458,181,175,356,94
2022-01-28,EK,Denmark,1075,545,102,23,530,213,215,428,79
2022-01-29,EK,Denmark,903,544,32,3,359,162,165,327,29
2022-01-30,EK,Denmark,1013,546,58,3,467,202,207,409,55
2022-01-31,EK,Denmark,966,481,87,18,485,205,193,398,69
2022-02-01,EK,Denmark,899,455,89,4,444,178,177,355,85
2022-02-02,EK,Denmark,1013,522,102,20,491,194,195,389,82
2022-02-03,EK,Denmark,994,502,87,8,492,204,201,405,79
2022-02-04,EK,Denmark,1129,532,95,13,597,246,256,502,82
2022-02-05,EK,Denmark,993,562,52,11,431,187,192,379,41
2022-02-06,EK,Denmark,1095,585,59,4,510,224,227,451,55
2022-02-07,EK,Denmark,1018,478,100,19,540,227,213,440,81
2022-02-08,EK,Denmark,904,438,102,19,466,181,183,364,83
2022-02-09,EK,Denmark,1010,487,100,14,523,207,216,423,86
2022-02-10,EK,Denmark,1044,498,103,16,546,220,223,443,87
2022-02-11,EK,Denmark,1193,549,90,14,644,283,271,554,76
2022-02-12,EK,Denmark,1098,599,44,9,499,224,231,455,35
2022-02-13,EK,Denmark,1122,593,58,3,529,238,233,471,55
2022-02-14,EK,Denmark,1083,545,94,14,538,224,220,444,80
2022-02-15,EK,Denmark,948,480,92,16,468,191,185,376,76
2022-02-16,EK,Denmark,1025,509,98,15,516,207,211,418,83
2022-02-17,EK,Denmark,1045,519,93,6,526,218,215,433,87
2022-02-18,EK,Denmark,1186,551,88,14,635,268,279,547,74
2022-02-19,EK,Denmark,1189,687,35,1,502,232,235,467,34
2022-02-20,EK,Denmark,1206,643,68,2,563,247,248,495,66
2022-02-21,EK,Denmark,1089,525,92,9,564,237,235,472,83
2022-02-22,EK,Denmark,994,473,94,22,521,213,214,427,72
2022-02-23,EK,Denmark,1097,543,112,27,554,222,220,442,85
2022-02-24,EK,Denmark,1095,534,99,21,561,232,230,462,78
2022-02-25,EK,Denmark,1224,588,95,15,636,270,271,541,80
2022-02-26,EK,Denmark,1119,617,43,7,502,226,233,459,36
2022-02-27,EK,Denmark,1216,626,77,9,590,257,256,513,68
2022-02-28,EK,Denmark,1178,565,115,25,613,250,248,498,90
2022-03-01,EK,Denmark,1022,477,109,18,545,216,220,436,91
2022-03-02,EK,Denmark,1125,535,115,20,590,234,241,475,95
2022-03-03,EK,Denmark,1143,528,130,27,615,245,240,485,103
2022-03-04,EK,Denmark,1223,553,106,23,670,283,281,564,83
2022-03-05,EK,Denmark,1064,566,44,4,498,227,227,454,40
2022-03-06,EK,Denmark,1152,586,68,7,566,248,250,498,61
2022-03-07,EK,Denmark,1158,513,123,18,645,262,260,522,105
2022-03-08,EK,Denmark,1006,456,105,23,550,225,220,445,82
2022-03-09,EK,Denmark,1113,531,105,19,582,235,242,477,86
2022-03-10,EK,Denmark,1096,489,104,10,607,254,249,503,94
2022-03-11,EK,Denmark,1258,582,96,19,676,288,292,580,77
2022-03-12,EK,Denmark,1085,592,43,5,493,223,227,450,38
2022-03-13,EK,Denmark,1211,630,69,9,581,254,258,512,60
2022-03-14,EK,Denmark,1237,570,114,17,667,280,273,553,97
2022-03-15,EK,Denmark,1042,458,119,16,584,234,231,465,103
2022-03-16,EK,Denmark,1125,531,116,20,594,237,241,478,96
2022-03-17,EK,Denmark,1135,500,117,12,635,257,261,518,105
2022-03-18,EK,Denmark,1272,560,104,18,712,303,305,608,86
2022-03-19,EK,Denmark,1063,552,53,9,511,229,229,458,44
2022-03-20,EK,Denmark,1160,571,70,5,589,258,261,519,65
2022-03-21,EK,Denmark,1228,540,126,27,688,285,277,562,99
2022-03-22,EK,Denmark,1013,457,94,14,556,234,228,462,80
2022-03-23,EK,Denmark,1133,537,105,20,596,246,245,491,85
2022-03-24,EK,Denmark,1099,466,112,16,633,260,261,521,96
2022-03-25,EK,Denmark,1300,584,112,22,716,298,306,604,90
2022-03-26,EK,Denmark,1035,518,48,11,517,232,237,469,37
2022-03-27,EK,Denmark,1303,599,85,5,704,307,312,619,80
2022-03-28,EK,Denmark,1375,593,131,30,782,332,319,651,101
2022-03-29,EK,Denmark,1268,542,118,19,726,304,304,608,99
2022-03-30,EK,Denmark,1317,613,90,10,704,309,305,614,80
2022-03-31,EK,Denmark,1391,603,119,22,788,332,337,669,97
2022-04-01,EK,Denmark,1430,620,117,20,810,345,348,693,97
2022-04-02,EK,Denmark,1084,541,44,6,543,244,255,499,38
2022-04-03,EK,Denmark,1329,614,77,5,715,321,317,638,72
2022-04-04,EK,Denmark,1355,593,109,5,762,329,324,653,104
2022-04-05,EK,Denmark,1279,544,116,15,735,312,307,619,101
2022-04-06,EK,Denmark,1397,628,113,6,769,323,333,656,107
2022-04-07,EK,Denmark,1491,648,135,15,843,359,349,708,120
2022-04-08,EK,Denmark,1546,672,120,14,874,378,376,754,106
2022-04-09,EK,Denmark,1239,602,68,3,637,284,285,569,65
2022-04-10,EK,Denmark,1357,612,72,0,745,337,336,673,72
2022-04-11,EK,Denmark,1425,623,109,14,802,347,346,693,95
2022-04-12,EK,Denmark,1341,566,108,25,775,336,331,667,83
2022-04-13,EK,Denmark,1395,640,108,23,755,325,322,647,85
2022-04-14,EK,Denmark,1329,599,86,15,730,320,324,644,71
2022-04-15,EK,Denmark,1281,617,74,11,664,293,297,590,63
2022-04-16,EK,Denmark,1168,563,66,14,605,269,270,539,52
2022-04-17,EK,Denmark,1330,620,67,5,710,322,321,643,62
2022-04-18,EK,Denmark,1488,688,93,8,800,350,357,707,85
2022-04-19,EK,Denmark,1452,653,115,18,799,341,343,684,97
2022-04-20,EK,Denmark,1471,676,113,25,795,343,339,682,88
2022-04-21,EK,Denmark,1465,642,108,19,823,359,356,715,89
2022-04-22,EK,Denmark,1523,650,125,20,873,376,372,748,105
2022-04-23,EK,Denmark,1139,537,51,10,602,270,281,551,41
2022-04-24,EK,Denmark,1401,642,80,10,759,339,340,679,70
2022-04-25,EK,Denmark,1480,628,129,28,852,362,361,723,101
2022-04-26,EK,Denmark,1398,596,124,21,802,341,337,678,103
2022-04-27,EK,Denmark,1436,640,129,23,796,334,333,667,106
2022-04-28,EK,Denmark,1510,662,129,24,848,362,357,719,105
2022-04-29,EK,Denmark,1531,692,125,11,839,361,353,714,114
2022-04-30,EK,Denmark,1127,540,43,3,587,265,279,544,40
2022-05-01,EK,Denmark,1398,633,82,2,765,337,346,683,80
2022-05-02,EK,Denmark,1484,634,124,15,850,368,358,726,109
2022-05-03,EK,Denmark,1440,597,127,14,843,355,361,716,113
2022-05-04,EK,Denmark,1484,668,124,21,816,349,343,692,103
2022-05-05,EK,Denmark,1558,666,131,14,892,383,378,761,117
2022-05-06,EK,Denmark,1607,685,143,14,922,384,395,779,129
2022-05-07,EK,Denmark,1231,556,60,10,675,304,311,615,50
2022-05-08,EK,Denmark,1413,603,81,9,810,362,367,729,72
2022-05-09,EK,Denmark,1546,686,124,18,860,376,360,736,106
2022-05-10,EK,Denmark,1429,613,125,22,816,345,346,691,103
2022-05-11,EK,Denmark,1503,668,135,16,835,352,348,700,119
2022-05-12,EK,Denmark,1595,677,143,22,918,386,389,775,121
2022-05-13,EK,Denmark,1561,688,103,4,873,382,388,770,99
2022-05-14,EK,Denmark,1257,587,55,8,670,305,310,615,47
2022-05-15,EK,Denmark,1495,671,90,10,824,365,369,734,80
2022-05-16,EK,Denmark,1527,633,124,20,894,385,385,770,104
2022-05-17,EK,Denmark,1411,598,127,20,813,343,343,686,107
2022-05-18,EK,Denmark,1542,667,139,25,875,370,366,736,114
2022-05-19,EK,Denmark,1581,658,146,11,923,391,386,777,135
2022-05-20,EK,Denmark,1608,673,135,14,935,397,403,800,121
2022-05-21,EK,Denmark,1329,623,56,5,706,321,329,650,51
2022-05-22,EK,Denmark,1508,663,83,4,845,378,384,762,79
2022-05-23,EK,Denmark,1567,649,129,15,918,400,389,789,114
2022-05-24,EK,Denmark,1490,657,122,14,833,354,357,711,108
2022-05-25,EK,Denmark,1669,773,124,13,896,386,386,772,111
2022-05-26,EK,Denmark,1488,696,92,4,792,353,347,700,88
2022-05-27,EK,Denmark,1473,693,93,2,780,343,344,687,91
2022-05-28,EK,Denmark,1267,608,54,2,659,303,302,605,52
2022-05-29,EK,Denmark,1580,720,88,4,860,385,387,772,84
2022-05-30,EK,Denmark,1643,723,123,11,920,404,393,797,112
2022-05-31,EK,Denmark,1513,660,132,11,853,356,365,721,121
2022-06-01,EK,Denmark,1629,728,126,14,901,387,388,775,112
2022-06-02,EK,Denmark,1597,670,157,17,927,387,383,770,140
2022-06-03,EK,Denmark,1665,701,141,9,964,409,414,823,132
2022-06-04,EK,Denmark,1277,588,58,4,689,315,316,631,54
2022-06-05,EK,Denmark,1453,639,79,6,814,367,368,735,73
2022-06-06,EK,Denmark,1584,719,113,8,865,379,373,752,105
2022-06-07,EK,Denmark,1577,703,130,19,874,369,375,744,111
2022-06-08,EK,Denmark,1678,751,155,25,927,384,388,772,130
2022-06-09,EK,Denmark,1755,801,162,24,954,395,397,792,138
2022-06-10,EK,Denmark,1713,728,166,23,985,414,405,819,143
2022-06-11,EK,Denmark,1348,638,60,7,710,325,325,650,53
2022-06-12,EK,Denmark,1575,718,86,4,857,379,392,771,82
2022-06-13,EK,Denmark,1678,756,134,14,922,392,396,788,120
2022-06-14,EK,Denmark,1629,723,138,18,906,386,382,768,120
2022-06-15,EK,Denmark,1666,749,157,22,917,379,381,760,135
2022-06-16,EK,Denmark,1705,756,169,19,949,391,389,780,150
2022-06-17,EK,Denmark,1754,761,165,29,993,411,417,828,136
2022-06-18,EK,Denmark,1448,689,112,10,759,317,330,647,102
2022-06-19,EK,Denmark,1584,717,100,8,867,389,378,767,92
2022-06-20,EK,Denmark,1622,688,125,13,934,408,401,809,112
2022-06-21,EK,Denmark,1681,777,128,16,904,387,389,776,112
2022-06-22,EK,Denmark,1689,775,139,27,914,385,390,775,112
2022-06-23,EK,Denmark,1713,747,148,34,966,412,406,818,114
2022-06-24,EK,Denmark,1654,728,130,13,926,391,405,796,117
2022-06-25,EK,Denmark,1432,696,50,2,736,345,341,686,48
2022-06-26,EK,Denmark,1643,806,77,1,837,380,380,760,76
2022-06-27,EK,Denmark,1661,750,98,9,911,413,400,813,89
2022-06-28,EK,Denmark,1607,747,106,12,860,372,382,754,94
2022-06-29,EK,Denmark,1687,793,108,9,894,395,391,786,99
2022-06-30,EK,Denmark,1663,755,106,13,908,401,401,802,93
2022-07-01,EK,Denmark,1698,769,127,5,929,401,401,802,122
2022-07-02,EK,Denmark,1523,754,53,4,769,359,357,716,49
2022-07-03,EK,Denmark,1653,766,77,7,887,404,406,810,70
2022-07-04,EK,Denmark,1671,785,96,5,886,393,397,790,91
2022-07-05,EK,Denmark,1517,716,102,11,801,349,350,699,91
2022-07-06,EK,Denmark,1593,750,106,21,843,373,364,737,85
2022-07-07,EK,Denmark,1549,718,113,9,831,361,357,718,104
2022-07-08,EK,Denmark,1650,779,109,14,871,373,389,762,95
2022-07-09,EK,Denmark,1369,666,47,3,703,332,324,656,44
2022-07-10,EK,Denmark,1506,722,74,5,784,351,359,710,69
2022-07-11,EK,Denmark,1569,724,105,10,845,375,365,740,95
2022-07-12,EK,Denmark,1511,721,108,12,790,336,346,682,96
2022-07-13,EK,Denmark,1529,702,112,12,827,356,359,715,100
2022-07-14,EK,Denmark,1578,718,124,18,860,369,367,736,106
2022-07-15,EK,Denmark,1595,738,105,17,857,374,378,752,88
2022-07-16,EK,Denmark,1403,682,50,2,721,336,335,671,48
2022-07-17,EK,Denmark,1495,684,78,7,811,359,374,733,71
2022-07-18,EK,Denmark,1584,711,102,8,873,386,385,771,94
2022-07-19,EK,Denmark,1531,692,98,11,839,373,368,741,87
2022-07-20,EK,Denmark,1592,729,88,8,863,391,384,775,80
2022-07-21,EK,Denmark,1605,709,112,8,896,395,389,784,104
2022-07-22,EK,Denmark,1657,745,119,15,912,395,398,793,104
2022-07-23,EK,Denmark,1463,719,55,2,744,345,344,689,53
2022-07-24,EK,Denmark,1582,712,73,5,870,398,399,797,68
2022-07-25,EK,Denmark,1662,757,110,10,905,402,393,795,100
2022-07-26,EK,Denmark,1596,734,116,12,862,370,376,746,104
2022-07-27,EK,Denmark,1556,717,103,14,839,365,371,736,89
2022-07-28,EK,Denmark,1607,706,110,11,901,399,392,791,99
2022-07-29,EK,Denmark,1696,777,104,8,919,404,411,815,96
2022-07-30,EK,Denmark,1505,746,45,2,759,355,359,714,43
2022-07-31,EK,Denmark,1624,745,80,6,879,402,397,799,74
2022-08-01,EK,Denmark,1673,745,110,12,928,404,414,818,98
2022-08-02,EK,Denmark,1612,742,110,9,870,375,385,760,101
2022-08-03,EK,Denmark,1622,751,113,12,871,380,378,758,101
2022-08-04,EK,Denmark,1580,677,100,7,903,398,405,803,93
2022-08-05,EK,Denmark,1654,736,114,13,918,403,401,804,101
2022-08-06,EK,Denmark,1430,663,57,3,767,358,352,710,54
2022-08-07,EK,Denmark,1560,697,80,3,863,389,394,783,77
2022-08-08,EK,Denmark,1695,750,109,16,945,417,419,836,93
2022-08-09,EK,Denmark,1567,717,112,15,850,368,370,738,97
2022-08-10,EK,Denmark,1629,760,108,18,869,377,384,761,90
2022-08-11,EK,Denmark,1640,729,124,19,911,393,394,787,105
2022-08-12,EK,Denmark,1679,747,119,6,932,408,405,813,113
2022-08-13,EK,Denmark,1433,676,52,3,757,352,353,705,49
2022-08-14,EK,Denmark,1544,676,78,3,868,399,391,790,75
2022-08-15,EK,Denmark,1578,679,109,11,899,401,389,790,98
2022-08-16,EK,Denmark,1488,667,115,12,821,348,358,706,103
2022-08-17,EK,Denmark,1528,680,129,15,848,365,354,719,114
2022-08-18,EK,Denmark,1569,665,128,11,904,381,395,776,117
2022-08-19,EK,Denmark,1665,739,146,10,926,392,388,780,136
2022-08-20,EK,Denmark,1378,656,59,5,722,334,329,663,54
2022-08-21,EK,Denmark,1550,682,88,1,868,387,393,780,87
2022-08-22,EK,Denmark,1630,721,124,13,909,397,388,785,111
2022-08-23,EK,Denmark,1498,665,119,12,833,353,361,714,107
2022-08-24,EK,Denmark,1569,689,121,13,880,376,383,759,108
2022-08-25,EK,Denmark,1617,677,136,9,940,403,401,804,127
2022-08-26,EK,Denmark,1705,743,131,5,962,416,415,831,126
2022-08-27,EK,Denmark,1363,646,54,1,717,333,330,663,53
2022-08-28,EK,Denmark,1474,633,68,2,841,386,387,773,66
2022-08-29,EK,Denmark,1601,672,114,20,929,413,402,815,94
2022-08-30,EK,Denmark,1525,664,134,25,861,362,365,727,109
2022-08-31,EK,Denmark,1597,697,129,22,900,388,383,771,107
2022-09-01,EK,Denmark,1587,644,134,16,943,401,408,809,118
2022-09-02,EK,Denmark,1592,674,125,13,918,398,395,793,112
2022-09-03,EK,Denmark,1296,606,40,2,690,325,325,650,38
2022-09-04,EK,Denmark,1519,662,78,3,857,388,391,779,75
2022-09-05,EK,Denmark,1623,684,121,16,939,411,407,818,105
2022-09-06,EK,Denmark,1525,682,115,8,843,365,363,728,107
2022-09-07,EK,Denmark,1584,703,124,16,881,380,377,757,108
2022-09-08,EK,Denmark,1614,666,133,8,948,403,412,815,125
2022-09-09,EK,Denmark,1730,715,158,12,1015,432,425,857,146
2022-09-10,EK,Denmark,1373,648,62,1,725,329,334,663,61
2022-09-11,EK,Denmark,1588,696,84,8,892,404,404,808,76
2022-09-12,EK,Denmark,1671,712,143,15,959,410,406,816,128
2022-09-13,EK,Denmark,1562,691,126,12,871,374,371,745,114
2022-09-14,EK,Denmark,1631,721,131,18,910,389,390,779,113
2022-09-15,EK,Denmark,1642,681,134,14,961,418,409,827,120
2022-09-16,EK,Denmark,1605,684,136,13,921,393,392,785,123
2022-09-17,EK,Denmark,1344,638,51,9,706,321,334,655,42
2022-09-18,EK,Denmark,1574,703,80,3,871,394,397,791,77
2022-09-19,EK,Denmark,1631,691,138,16,940,401,401,802,122
2022-09-20,EK,Denmark,1541,682,133,12,859,368,358,726,121
2022-09-21,EK,Denmark,1571,705,125,12,866,368,373,741,113
2022-09-22,EK,Denmark,1632,694,144,21,938,398,396,794,123
2022-09-23,EK,Denmark,1667,694,148,12,973,410,415,825,136
2022-09-24,EK,Denmark,1332,649,43,0,683,318,322,640,43
2022-09-25,EK,Denmark,1514,648,86,5,866,386,394,780,81
2022-09-26,EK,Denmark,1626,700,128,9,926,401,397,798,119
2022-09-27,EK,Denmark,1572,718,127,7,854,368,359,727,120
2022-09-28,EK,Denmark,1662,758,156,18,904,371,377,748,138
2022-09-29,EK,Denmark,1676,742,144,20,934,395,395,790,124
2022-09-30,EK,Denmark,1686,753,136,13,933,406,391,797,123
2022-10-01,EK,Denmark,1430,759,44,3,671,302,325,627,41
2022-10-02,EK,Denmark,1516,655,78,1,861,390,393,783,77
2022-10-03,EK,Denmark,1565,671,125,7,894,382,387,769,118
2022-10-04,EK,Denmark,1481,654,125,12,827,359,343,702,113
2022-10-05,EK,Denmark,1558,683,129,9,875,372,374,746,120
2022-10-06,EK,Denmark,1579,678,119,6,901,384,398,782,113
2022-10-07,EK,Denmark,1658,732,130,10,926,407,389,796,120
2022-10-08,EK,Denmark,1322,639,46,5,683,312,325,637,41
2022-10-09,EK,Denmark,1540,692,79,4,848,388,381,769,75
2022-10-10,EK,Denmark,1567,690,124,12,877,374,379,753,112
2022-10-11,EK,Denmark,1460,639,122,15,821,348,351,699,107
2022-10-12,EK,Denmark,1615,726,138,16,889,378,373,751,122
2022-10-13,EK,Denmark,1644,703,149,23,941,393,399,792,126
2022-10-14,EK,Denmark,1728,733,140,14,995,434,421,855,126
2022-10-15,EK,Denmark,1413,649,52,3,764,352,360,712,49
2022-10-16,EK,Denmark,1547,646,78,3,901,415,408,823,75
2022-10-17,EK,Denmark,1542,660,124,14,882,383,375,758,110
2022-10-18,EK,Denmark,1450,659,107,12,791,339,345,684,95
2022-10-19,EK,Denmark,1515,708,119,14,807,346,342,688,105
2022-10-20,EK,Denmark,1553,690,106,17,863,377,380,757,89
2022-10-21,EK,Denmark,1608,708,106,7,900,391,403,794,99
2022-10-22,EK,Denmark,1391,647,52,1,744,344,348,692,51
2022-10-23,EK,Denmark,1563,643,89,5,920,414,417,831,84
2022-10-24,EK,Denmark,1611,685,136,9,926,398,392,790,127
2022-10-25,EK,Denmark,1496,670,135,18,826,348,343,691,117
2022-10-26,EK,Denmark,1593,676,148,19,917,379,390,769,129
2022-10-27,EK,Denmark,1577,654,144,16,923,393,386,779,128
2022-10-28,EK,Denmark,1637,725,136,13,912,387,389,776,123
2022-10-29,EK,Denmark,1220,614,44,5,606,283,279,562,39
2022-10-30,EK,Denmark,1342,612,69,5,730,326,335,661,64
2022-10-31,EK,Denmark,1450,610,138,18,840,354,348,702,120
2022-11-01,EK,Denmark,1341,597,125,13,744,309,310,619,112
2022-11-02,EK,Denmark,1403,638,133,14,765,319,313,632,119
2022-11-03,EK,Denmark,1416,611,129,14,805,342,334,676,115
2022-11-04,EK,Denmark,1533,683,146,13,850,347,357,704,133
2022-11-05,EK,Denmark,1088,590,52,9,498,222,224,446,43
2022-11-06,EK,Denmark,1382,664,80,4,718,316,322,638,76
2022-11-07,EK,Denmark,1464,663,123,13,801,344,334,678,110
2022-11-08,EK,Denmark,1326,583,132,16,743,304,307,611,116
2022-11-09,EK,Denmark,1355,608,122,13,747,310,315,625,109
2022-11-10,EK,Denmark,1405,593,132,14,812,338,342,680,118
2022-11-11,EK,Denmark,1482,648,130,11,834,356,348,704,119
2022-11-12,EK,Denmark,998,517,41,2,481,219,221,440,39
2022-11-13,EK,Denmark,1263,571,80,4,692,302,310,612,76
2022-11-14,EK,Denmark,1417,591,145,18,826,343,338,681,127
2022-11-15,EK,Denmark,1337,581,145,18,756,307,304,611,127
2022-11-16,EK,Denmark,1308,588,106,4,720,305,309,614,102
2022-11-17,EK,Denmark,1381,635,95,6,746,324,327,651,89
2022-11-18,EK,Denmark,1479,674,126,11,805,340,339,679,115
2022-11-19,EK,Denmark,1032,562,51,11,470,208,211,419,40
2022-11-20,EK,Denmark,1294,623,66,3,671,303,302,605,63
2022-11-21,EK,Denmark,1355,606,100,8,749,328,321,649,92
2022-11-22,EK,Denmark,1275,596,95,4,679,291,293,584,91
2022-11-23,EK,Denmark,1312,547,156,20,765,305,304,609,136
2022-11-24,EK,Denmark,1412,635,135,12,777,318,324,642,123
2022-11-25,EK,Denmark,1505,681,135,10,824,351,338,689,125
2022-11-26,EK,Denmark,1011,556,43,4,455,201,211,412,39
2022-11-27,EK,Denmark,1299,622,77,5,677,300,300,600,72
2022-11-28,EK,Denmark,1468,680,131,15,788,329,328,657,116
2022-11-29,EK,Denmark,1256,575,111,12,681,283,287,570,99
2022-11-30,EK,Denmark,1314,569,130,11,745,311,304,615,119
2022-12-01,EK,Denmark,1333,584,115,9,749,321,313,634,106
2022-12-02,EK,Denmark,1443,646,107,4,797,339,351,690,103
2022-12-03,EK,Denmark,1008,544,37,1,464,212,215,427,36
2022-12-04,EK,Denmark,1259,610,60,0,649,295,294,589,60
2022-12-05,EK,Denmark,1411,648,101,6,763,331,331,662,95
2022-12-06,EK,Denmark,1257,591,102,6,666,283,281,564,96
2022-12-07,EK,Denmark,1321,619,97,2,702,305,300,605,95
2022-12-08,EK,Denmark,1358,617,106,6,741,314,321,635,100
2022-12-09,EK,Denmark,1452,682,100,4,770,338,332,670,96
2022-12-10,EK,Denmark,1004,563,40,4,441,195,206,401,36
2022-12-11,EK,Denmark,1265,652,58,4,613,281,274,555,54
2022-12-12,EK,Denmark,1391,640,89,7,751,330,332,662,82
2022-12-13,EK,Denmark,1231,592,90,16,639,278,271,549,74
2022-12-14,EK,Denmark,1264,597,80,4,667,292,295,587,76
2022-12-15,EK,Denmark,1363,627,87,13,736,329,320,649,74
2022-12-16,EK,Denmark,1419,640,102,11,779,337,340,677,91
2022-12-17,EK,Denmark,1086,597,40,3,489,219,230,449,37
2022-12-18,EK,Denmark,1323,657,73,4,666,295,298,593,69
2022-12-19,EK,Denmark,1290,585,71,3,705,316,318,634,68
2022-12-20,EK,Denmark,1313,623,111,16,690,291,288,579,95
2022-12-21,EK,Denmark,1325,605,96,4,720,311,313,624,92
2022-12-22,EK,Denmark,1454,669,128,11,785,329,328,657,117
2022-12-23,EK,Denmark,1406,666,85,3,740,320,335,655,82
2022-12-24,EK,Denmark,808,500,21,0,308,141,146,287,21
2022-12-25,EK,Denmark,762,420,15,0,342,168,159,327,15
2022-12-26,EK,Denmark,1212,621,70,0,591,260,261,521,70
2022-12-27,EK,Denmark,1165,581,72,10,584,257,255,512,62
2022-01-01,EE,Estonia,363,299,0,0,64,32,32,64,0
2022-01-02,EE,Estonia,427,346,8,1,81,37,36,73,7
2022-01-03,EE,Estonia,392,315,6,0,77,34,37,71,6
2022-01-04,EE,Estonia,367,271,9,3,96,45,42,87,6
2022-01-05,EE,Estonia,401,311,9,1,90,41,40,81,8
2022-01-06,EE,Estonia,368,280,12,4,88,39,37,76,8
2022-01-07,EE,Estonia,443,348,9,1,95,42,44,86,8
2022-01-08,EE,Estonia,386,315,4,0,71,33,34,67,4
2022-01-09,EE,Estonia,447,354,5,1,93,43,45,88,4
2022-01-10,EE,Estonia,402,310,10,2,92,39,43,82,8
2022-01-11,EE,Estonia,369,287,11,4,82,34,37,71,7
2022-01-12,EE,Estonia,403,309,16,5,94,42,36,78,11
2022-01-13,EE,Estonia,399,295,15,3,104,44,45,89,12
2022-01-14,EE,Estonia,406,310,10,2,96,42,44,86,8
2022-01-15,EE,Estonia,387,310,8,2,77,36,33,69,6
2022-01-16,EE,Estonia,381,299,4,0,82,39,39,78,4
2022-01-17,EE,Estonia,322,253,8,0,69,31,30,61,8
2022-01-18,EE,Estonia,350,265,11,3,85,39,35,74,8
2022-01-19,EE,Estonia,378,298,11,3,80,35,34,69,8
2022-01-20,EE,Estonia,339,261,9,3,78,32,37,69,6
2022-01-21,EE,Estonia,377,295,8,0,82,37,37,74,8
2022-01-22,EE,Estonia,380,310,6,2,70,34,30,64,4
2022-01-23,EE,Estonia,386,306,8,4,80,36,36,72,4
2022-01-24,EE,Estonia,359,279,10,2,80,33,37,70,8
2022-01-25,EE,Estonia,340,260,13,5,80,33,34,67,8
2022-01-26,EE,Estonia,377,297,13,7,80,33,34,67,6
2022-01-27,EE,Estonia,352,272,8,0,80,35,37,72,8
2022-01-28,EE,Estonia,375,285,9,1,90,40,41,81,8
2022-01-29,EE,Estonia,387,331,8,4,56,25,23,48,4
2022-01-30,EE,Estonia,358,279,2,0,79,39,38,77,2
2022-01-31,EE,Estonia,354,274,8,0,80,35,37,72,8
2022-02-01,EE,Estonia,293,222,12,3,71,29,30,59,9
2022-02-02,EE,Estonia,375,291,13,5,84,36,35,71,8
2022-02-03,EE,Estonia,328,240,13,5,88,38,37,75,8
2022-02-04,EE,Estonia,358,269,10,1,89,40,39,79,9
2022-02-05,EE,Estonia,323,253,6,2,70,31,33,64,4
2022-02-06,EE,Estonia,337,264,6,2,73,32,35,67,4
2022-02-07,EE,Estonia,292,221,7,1,71,34,30,64,6
2022-02-08,EE,Estonia,317,239,11,3,78,35,32,67,8
2022-02-09,EE,Estonia,345,277,13,5,68,28,27,55,8
2022-02-10,EE,Estonia,347,256,13,5,91,38,40,78,8
2022-02-11,EE,Estonia,372,278,11,3,94,41,42,83,8
2022-02-12,EE,Estonia,361,291,7,2,70,33,30,63,5
2022-02-13,EE,Estonia,353,279,5,1,74,36,33,69,4
2022-02-14,EE,Estonia,320,243,9,1,77,32,36,68,8
2022-02-15,EE,Estonia,321,241,13,5,80,35,32,67,8
2022-02-16,EE,Estonia,371,291,10,2,80,33,37,70,8
2022-02-17,EE,Estonia,325,239,8,0,86,37,41,78,8
2022-02-18,EE,Estonia,410,306,10,2,104,47,47,94,8
2022-02-19,EE,Estonia,363,294,4,0,69,33,32,65,4
2022-02-20,EE,Estonia,372,296,6,2,76,36,34,70,4
2022-02-21,EE,Estonia,328,248,9,1,80,34,37,71,8
2022-02-22,EE,Estonia,326,244,10,2,82,36,36,72,8
2022-02-23,EE,Estonia,351,268,11,3,83,37,35,72,8
2022-02-24,EE,Estonia,356,272,9,1,84,39,36,75,8
2022-02-25,EE,Estonia,385,292,9,1,93,41,43,84,8
2022-02-26,EE,Estonia,373,303,6,1,70,31,33,64,5
2022-02-27,EE,Estonia,302,222,4,0,80,37,39,76,4
2022-02-28,EE,Estonia,306,218,16,6,88,36,36,72,10
2022-03-01,EE,Estonia,325,229,16,6,96,39,41,80,10
2022-03-02,EE,Estonia,354,258,14,5,96,40,42,82,9
2022-03-03,EE,Estonia,337,234,17,8,103,44,42,86,9
2022-03-04,EE,Estonia,389,279,17,9,110,47,46,93,8
2022-03-05,EE,Estonia,356,282,7,3,74,34,33,67,4
2022-03-06,EE,Estonia,375,283,5,1,92,43,44,87,4
2022-03-07,EE,Estonia,364,267,12,4,97,44,41,85,8
2022-03-08,EE,Estonia,347,261,9,1,86,39,38,77,8
2022-03-09,EE,Estonia,357,264,14,6,93,41,38,79,8
2022-03-10,EE,Estonia,359,260,13,5,99,42,44,86,8
2022-03-11,EE,Estonia,360,263,11,3,97,43,43,86,8
2022-03-12,EE,Estonia,337,273,6,2,64,30,28,58,4
2022-03-13,EE,Estonia,357,270,9,4,87,41,37,78,5
2022-03-14,EE,Estonia,338,247,13,5,91,38,40,78,8
2022-03-15,EE,Estonia,310,226,15,7,84,34,35,69,8
2022-03-16,EE,Estonia,316,229,12,4,87,39,36,75,8
2022-03-17,EE,Estonia,321,225,15,7,96,41,40,81,8
2022-03-18,EE,Estonia,344,242,13,5,102,46,43,89,8
2022-03-19,EE,Estonia,309,250,7,5,59,26,26,52,2
2022-03-20,EE,Estonia,341,264,4,0,77,37,36,73,4
2022-03-21,EE,Estonia,312,226,13,5,86,37,36,73,8
2022-03-22,EE,Estonia,296,217,10,4,79,34,35,69,6
2022-03-23,EE,Estonia,317,223,14,6,94,39,41,80,8
2022-03-24,EE,Estonia,328,225,19,11,103,42,42,84,8
2022-03-25,EE,Estonia,345,243,13,5,102,43,46,89,8
2022-03-26,EE,Estonia,306,243,4,0,63,31,28,59,4
2022-03-27,EE,Estonia,333,234,5,1,99,50,44,94,4
2022-03-28,EE,Estonia,332,240,11,3,92,41,40,81,8
2022-03-29,EE,Estonia,296,206,13,5,90,37,40,77,8
2022-03-30,EE,Estonia,323,209,12,3,114,50,52,102,9
2022-03-31,EE,Estonia,314,206,14,3,108,45,49,94,11
2022-04-01,EE,Estonia,367,251,16,5,116,50,50,100,11
2022-04-02,EE,Estonia,291,216,8,4,75,34,33,67,4
2022-04-03,EE,Estonia,341,250,7,2,91,42,42,84,5
2022-04-04,EE,Estonia,334,244,12,3,90,40,38,78,9
2022-04-05,EE,Estonia,283,196,10,2,87,40,37,77,8
2022-04-06,EE,Estonia,338,234,11,3,104,46,47,93,8
2022-04-07,EE,Estonia,312,214,12,4,98,42,44,86,8
2022-04-08,EE,Estonia,366,245,16,6,121,50,55,105,10
2022-04-09,EE,Estonia,313,231,7,3,82,39,36,75,4
2022-04-10,EE,Estonia,322,231,5,1,91,44,42,86,4
2022-04-11,EE,Estonia,366,249,17,9,117,48,52,100,8
2022-04-12,EE,Estonia,314,211,11,5,103,45,47,92,6
2022-04-13,EE,Estonia,356,249,11,3,107,48,48,96,8
2022-04-14,EE,Estonia,358,243,12,3,115,52,51,103,9
2022-04-15,EE,Estonia,379,271,13,5,108,47,48,95,8
2022-04-16,EE,Estonia,334,247,8,4,87,41,38,79,4
2022-04-17,EE,Estonia,335,249,6,2,86,39,41,80,4
2022-04-18,EE,Estonia,367,263,11,3,104,48,45,93,8
2022-04-19,EE,Estonia,333,225,14,6,108,47,47,94,8
2022-04-20,EE,Estonia,342,234,15,7,108,47,46,93,8
2022-04-21,EE,Estonia,335,224,11,3,111,51,49,100,8
2022-04-22,EE,Estonia,396,281,14,5,115,49,52,101,9
2022-04-23,EE,Estonia,350,258,9,5,92,42,41,83,4
2022-04-24,EE,Estonia,377,270,9,4,107,49,49,98,5
2022-04-25,EE,Estonia,349,241,12,4,108,48,48,96,8
2022-04-26,EE,Estonia,341,229,12,4,112,49,51,100,8
2022-04-27,EE,Estonia,346,234,11,3,112,50,51,101,8
2022-04-28,EE,Estonia,358,251,11,3,107,46,50,96,8
2022-04-29,EE,Estonia,429,299,13,4,130,60,57,117,9
2022-04-30,EE,Estonia,363,277,11,7,86,39,36,75,4
2022-05-01,EE,Estonia,417,314,7,3,103,45,51,96,4
2022-05-02,EE,Estonia,416,300,13,5,116,51,52,103,8
2022-05-03,EE,Estonia,384,266,15,4,118,53,50,103,11
2022-05-04,EE,Estonia,396,279,17,6,117,51,49,100,11
2022-05-05,EE,Estonia,419,290,14,6,129,57,58,115,8
2022-05-06,EE,Estonia,452,320,15,7,132,60,57,117,8
2022-05-07,EE,Estonia,401,312,7,3,89,43,39,82,4
2022-05-08,EE,Estonia,417,309,7,3,108,48,53,101,4
2022-05-09,EE,Estonia,424,301,19,11,123,53,51,104,8
2022-05-10,EE,Estonia,419,305,12,4,114,51,51,102,8
2022-05-11,EE,Estonia,427,314,16,8,113,49,48,97,8
2022-05-12,EE,Estonia,399,281,16,8,118,50,52,102,8
2022-05-13,EE,Estonia,440,306,16,7,134,61,57,118,9
2022-05-14,EE,Estonia,384,294,9,5,90,40,41,81,4
2022-05-15,EE,Estonia,442,329,6,1,113,52,55,107,5
2022-05-16,EE,Estonia,413,286,16,8,127,51,60,111,8
2022-05-17,EE,Estonia,379,259,17,9,120,52,51,103,8
2022-05-18,EE,Estonia,422,303,15,7,119,53,51,104,8
2022-05-19,EE,Estonia,413,284,18,10,129,55,56,111,8
2022-05-20,EE,Estonia,420,295,18,9,125,56,51,107,9
2022-05-21,EE,Estonia,408,314,7,3,94,45,42,87,4
2022-05-22,EE,Estonia,408,309,9,4,99,44,46,90,5
2022-05-23,EE,Estonia,416,294,15,7,122,51,56,107,8
2022-05-24,EE,Estonia,395,263,15,8,132,59,58,117,7
2022-05-25,EE,Estonia,443,308,19,11,135,58,58,116,8
2022-05-26,EE,Estonia,414,282,22,14,132,56,54,110,8
2022-05-27,EE,Estonia,441,312,17,9,129,58,54,112,8
2022-05-28,EE,Estonia,393,305,5,1,88,42,41,83,4
2022-05-29,EE,Estonia,442,330,11,7,112,51,50,101,4
2022-05-30,EE,Estonia,424,297,17,8,127,55,55,110,9
2022-05-31,EE,Estonia,408,284,18,10,124,53,53,106,8
2022-06-01,EE,Estonia,436,314,14,6,122,56,52,108,8
2022-06-02,EE,Estonia,429,309,11,1,120,53,56,109,10
2022-06-03,EE,Estonia,470,349,16,8,121,53,52,105,8
2022-06-04,EE,Estonia,423,334,11,7,89,40,38,78,4
2022-06-05,EE,Estonia,472,355,12,8,117,50,55,105,4
2022-06-06,EE,Estonia,449,328,17,9,121,54,50,104,8
2022-06-07,EE,Estonia,438,314,18,9,124,52,54,106,9
2022-06-08,EE,Estonia,450,326,14,5,124,54,56,110,9
2022-06-09,EE,Estonia,456,333,13,5,123,55,55,110,8
2022-06-10,EE,Estonia,454,331,14,4,123,55,54,109,10
2022-06-11,EE,Estonia,445,357,7,3,88,41,40,81,4
2022-06-12,EE,Estonia,451,353,6,1,98,47,45,92,5
2022-06-13,EE,Estonia,445,330,10,2,115,50,55,105,8
2022-06-14,EE,Estonia,451,333,14,4,118,53,51,104,10
2022-06-15,EE,Estonia,447,322,15,7,125,56,54,110,8
2022-06-16,EE,Estonia,465,340,14,5,125,53,58,111,9
2022-06-17,EE,Estonia,467,342,16,6,125,55,54,109,10
2022-06-18,EE,Estonia,447,357,6,2,90,42,42,84,4
2022-06-19,EE,Estonia,463,365,7,3,98,46,45,91,4
2022-06-20,EE,Estonia,441,334,14,5,107,45,48,93,9
2022-06-21,EE,Estonia,471,350,16,7,121,53,52,105,9
2022-06-22,EE,Estonia,452,336,14,6,116,54,48,102,8
2022-06-23,EE,Estonia,454,344,15,3,110,46,49,95,12
2022-06-24,EE,Estonia,480,373,13,5,107,46,48,94,8
2022-06-25,EE,Estonia,423,339,7,3,84,40,37,77,4
2022-06-26,EE,Estonia,450,347,11,7,103,46,46,92,4
2022-06-27,EE,Estonia,469,351,12,4,118,54,52,106,8
2022-06-28,EE,Estonia,447,331,12,3,116,50,54,104,9
2022-06-29,EE,Estonia,460,335,15,4,125,58,52,110,11
2022-06-30,EE,Estonia,433,322,13,5,111,51,47,98,8
2022-07-01,EE,Estonia,473,356,15,7,117,48,54,102,8
2022-07-02,EE,Estonia,440,350,7,1,90,39,44,83,6
2022-07-03,EE,Estonia,436,332,11,6,104,47,46,93,5
2022-07-04,EE,Estonia,457,343,12,4,114,53,49,102,8
2022-07-05,EE,Estonia,424,325,11,3,99,44,44,88,8
2022-07-06,EE,Estonia,445,335,12,4,110,51,47,98,8
2022-07-07,EE,Estonia,434,320,12,4,114,48,54,102,8
2022-07-08,EE,Estonia,491,369,15,7,122,54,53,107,8
2022-07-09,EE,Estonia,427,341,6,2,86,38,42,80,4
2022-07-10,EE,Estonia,422,325,8,3,97,44,45,89,5
2022-07-11,EE,Estonia,437,322,17,8,115,51,47,98,9
2022-07-12,EE,Estonia,419,312,13,5,107,46,48,94,8
2022-07-13,EE,Estonia,450,336,14,6,114,51,49,100,8
2022-07-14,EE,Estonia,438,315,15,6,123,56,52,108,9
2022-07-15,EE,Estonia,462,338,19,10,124,52,53,105,9
2022-07-16,EE,Estonia,426,333,8,4,93,42,43,85,4
2022-07-17,EE,Estonia,440,329,10,6,111,51,50,101,4
2022-07-18,EE,Estonia,436,318,20,8,118,48,50,98,12
2022-07-19,EE,Estonia,429,322,15,6,107,48,44,92,9
2022-07-20,EE,Estonia,440,331,19,8,109,44,46,90,11
2022-07-21,EE,Estonia,453,331,16,6,122,52,54,106,10
2022-07-22,EE,Estonia,475,350,21,11,125,53,51,104,10
2022-07-23,EE,Estonia,417,331,6,1,86,38,42,80,5
2022-07-24,EE,Estonia,423,318,11,4,105,48,46,94,7
2022-07-25,EE,Estonia,431,320,16,7,111,46,49,95,9
2022-07-26,EE,Estonia,451,331,22,12,120,50,48,98,10
2022-07-27,EE,Estonia,435,313,20,11,122,49,53,102,9
2022-07-28,EE,Estonia,431,307,18,5,124,52,54,106,13
2022-07-29,EE,Estonia,454,349,14,6,105,47,44,91,8
2022-07-30,EE,Estonia,420,335,10,4,85,38,37,75,6
2022-07-31,EE,Estonia,413,312,5,1,101,46,50,96,4
2022-08-01,EE,Estonia,400,299,9,1,101,46,46,92,8
2022-08-02,EE,Estonia,445,330,19,8,115,48,48,96,11
2022-08-03,EE,Estonia,447,334,16,7,113,49,48,97,9
2022-08-04,EE,Estonia,464,339,14,5,125,56,55,111,9
2022-08-05,EE,Estonia,462,348,16,4,114,47,51,98,12
2022-08-06,EE,Estonia,415,326,6,2,89,42,41,83,4
2022-08-07,EE,Estonia,439,344,5,1,95,44,46,90,4
2022-08-08,EE,Estonia,431,319,12,3,112,50,50,100,9
2022-08-09,EE,Estonia,445,336,13,5,109,49,47,96,8
2022-08-10,EE,Estonia,447,336,17,6,111,49,45,94,11
2022-08-11,EE,Estonia,481,363,16,5,118,50,52,102,11
2022-08-12,EE,Estonia,479,369,13,5,110,50,47,97,8
2022-08-13,EE,Estonia,433,348,10,6,85,37,38,75,4
2022-08-14,EE,Estonia,440,340,5,1,100,47,48,95,4
2022-08-15,EE,Estonia,464,341,14,3,123,54,55,109,11
2022-08-16,EE,Estonia,418,315,13,5,103,43,47,90,8
2022-08-17,EE,Estonia,452,330,11,3,122,55,56,111,8
2022-08-18,EE,Estonia,431,314,11,2,117,53,53,106,9
2022-08-19,EE,Estonia,467,349,13,3,118,52,53,105,10
2022-08-20,EE,Estonia,420,342,6,1,78,37,35,72,5
2022-08-21,EE,Estonia,441,344,7,0,97,45,45,90,7
2022-08-22,EE,Estonia,423,302,13,3,121,52,56,108,10
2022-08-23,EE,Estonia,426,315,14,5,111,51,46,97,9
2022-08-24,EE,Estonia,455,338,12,4,117,53,52,105,8
2022-08-25,EE,Estonia,475,344,17,8,131,55,59,114,9
2022-08-26,EE,Estonia,484,359,17,7,125,55,53,108,10
2022-08-27,EE,Estonia,451,356,11,6,95,40,44,84,5
2022-08-28,EE,Estonia,449,341,11,6,108,48,49,97,5
2022-08-29,EE,Estonia,436,321,13,7,115,49,53,102,6
2022-08-30,EE,Estonia,426,314,13,5,112,51,48,99,8
2022-08-31,EE,Estonia,455,339,16,6,116,51,49,100,10
2022-09-01,EE,Estonia,463,344,12,3,119,53,54,107,9
2022-09-02,EE,Estonia,461,341,13,5,120,56,51,107,8
2022-09-03,EE,Estonia,407,331,4,0,76,35,37,72,4
2022-09-04,EE,Estonia,431,326,6,2,105,49,50,99,4
2022-09-05,EE,Estonia,434,315,16,8,119,51,52,103,8
2022-09-06,EE,Estonia,433,324,14,5,109,48,47,95,9
2022-09-07,EE,Estonia,470,338,19,10,132,56,57,113,9
2022-09-08,EE,Estonia,458,332,20,7,126,51,55,106,13
2022-09-09,EE,Estonia,497,373,14,6,124,56,54,110,8
2022-09-10,EE,Estonia,434,346,8,4,88,41,39,80,4
2022-09-11,EE,Estonia,441,334,5,1,107,52,50,102,4
2022-09-12,EE,Estonia,430,307,14,5,123,52,57,109,9
2022-09-13,EE,Estonia,449,328,19,5,121,53,49,102,14
2022-09-14,EE,Estonia,442,332,11,3,110,49,50,99,8
2022-09-15,EE,Estonia,431,311,19,3,120,50,51,101,16
2022-09-16,EE,Estonia,501,358,12,4,143,63,68,131,8
2022-09-17,EE,Estonia,415,330,6,2,85,39,40,79,4
2022-09-18,EE,Estonia,446,317,4,0,129,66,59,125,4
2022-09-19,EE,Estonia,440,324,10,2,116,51,55,106,8
2022-09-20,EE,Estonia,430,323,10,1,107,50,47,97,9
2022-09-21,EE,Estonia,450,332,9,1,118,54,55,109,8
2022-09-22,EE,Estonia,457,332,12,4,125,56,57,113,8
2022-09-23,EE,Estonia,492,373,10,2,119,55,54,109,8
2022-09-24,EE,Estonia,442,353,6,2,89,43,40,83,4
2022-09-25,EE,Estonia,437,328,6,2,109,51,52,103,4
2022-09-26,EE,Estonia,439,327,13,3,112,50,49,99,10
2022-09-27,EE,Estonia,439,325,14,6,114,50,50,100,8
2022-09-28,EE,Estonia,460,338,13,3,122,54,55,109,10
2022-09-29,EE,Estonia,438,308,13,5,130,58,59,117,8
2022-09-30,EE,Estonia,455,333,13,4,122,52,57,109,9
2022-10-01,EE,Estonia,417,335,5,1,82,40,37,77,4
2022-10-02,EE,Estonia,429,317,5,0,112,54,53,107,5
2022-10-03,EE,Estonia,384,280,10,2,104,48,46,94,8
2022-10-04,EE,Estonia,406,300,14,2,106,47,45,92,12
2022-10-05,EE,Estonia,444,325,15,6,119,49,55,104,9
2022-10-06,EE,Estonia,415,298,11,3,117,52,54,106,8
2022-10-07,EE,Estonia,441,314,17,9,127,57,53,110,8
2022-10-08,EE,Estonia,393,304,7,3,89,40,42,82,4
2022-10-09,EE,Estonia,401,295,8,4,106,50,48,98,4
2022-10-10,EE,Estonia,381,266,15,7,115,50,50,100,8
2022-10-11,EE,Estonia,372,262,15,7,110,47,48,95,8
2022-10-12,EE,Estonia,428,306,14,6,122,54,54,108,8
2022-10-13,EE,Estonia,415,297,13,5,118,51,54,105,8
2022-10-14,EE,Estonia,463,326,16,6,137,63,58,121,10
2022-10-15,EE,Estonia,417,326,10,5,91,40,41,81,5
2022-10-16,EE,Estonia,412,308,10,6,104,46,48,94,4
2022-10-17,EE,Estonia,411,302,15,7,109,47,47,94,8
2022-10-18,EE,Estonia,382,268,15,6,114,52,47,99,9
2022-10-19,EE,Estonia,405,281,15,7,124,53,56,109,8
2022-10-20,EE,Estonia,426,294,16,4,132,57,59,116,12
2022-10-21,EE,Estonia,445,312,16,7,133,58,59,117,9
2022-10-22,EE,Estonia,410,311,5,0,99,46,48,94,5
2022-10-23,EE,Estonia,419,302,15,8,117,51,51,102,7
2022-10-24,EE,Estonia,390,273,16,8,117,51,50,101,8
2022-10-25,EE,Estonia,375,264,8,1,111,55,48,103,7
2022-10-26,EE,Estonia,397,278,15,6,119,50,54,104,9
2022-10-27,EE,Estonia,408,284,17,7,124,52,55,107,10
2022-10-28,EE,Estonia,442,318,16,7,124,55,53,108,9
2022-10-29,EE,Estonia,391,301,4,0,90,42,44,86,4
2022-10-30,EE,Estonia,365,265,7,3,100,49,44,93,4
2022-10-31,EE,Estonia,357,260,17,11,97,40,40,80,6
2022-11-01,EE,Estonia,324,227,13,6,97,43,41,84,7
2022-11-02,EE,Estonia,345,240,18,8,105,44,43,87,10
2022-11-03,EE,Estonia,326,238,9,1,88,37,42,79,8
2022-11-04,EE,Estonia,377,262,12,6,115,53,50,103,6
2022-11-05,EE,Estonia,330,245,10,6,85,35,40,75,4
2022-11-06,EE,Estonia,337,249,6,2,88,43,39,82,4
2022-11-07,EE,Estonia,344,249,13,5,95,41,41,82,8
2022-11-08,EE,Estonia,315,219,14,8,96,42,40,82,6
2022-11-09,EE,Estonia,343,245,13,5,98,42,43,85,8
2022-11-10,EE,Estonia,313,223,13,5,90,38,39,77,8
2022-11-11,EE,Estonia,363,256,11,3,107,47,49,96,8
2022-11-12,EE,Estonia,333,258,7,3,75,35,33,68,4
2022-11-13,EE,Estonia,346,256,5,1,90,41,44,85,4
2022-11-14,EE,Estonia,347,249,12,4,98,46,40,86,8
2022-11-15,EE,Estonia,304,208,11,3,96,42,43,85,8
2022-11-16,EE,Estonia,334,241,13,5,93,39,41,80,8
2022-11-17,EE,Estonia,323,235,10,2,88,38,40,78,8
2022-11-18,EE,Estonia,351,246,10,2,105,47,48,95,8
2022-11-19,EE,Estonia,305,230,6,2,75,36,33,69,4
2022-11-20,EE,Estonia,300,218,4,0,82,39,39,78,4
2022-11-21,EE,Estonia,264,180,9,1,84,38,37,75,8
2022-11-22,EE,Estonia,289,200,8,0,89,41,40,81,8
2022-11-23,EE,Estonia,310,220,13,2,90,38,39,77,11
2022-11-24,EE,Estonia,331,236,12,2,95,42,41,83,10
2022-11-25,EE,Estonia,346,246,10,2,100,45,45,90,8
2022-11-26,EE,Estonia,308,239,5,1,69,31,33,64,4
2022-11-27,EE,Estonia,334,245,4,0,89,41,44,85,4
2022-11-28,EE,Estonia,315,227,11,3,88,40,37,77,8
2022-11-29,EE,Estonia,295,205,12,4,90,40,38,78,8
2022-11-30,EE,Estonia,319,232,12,4,87,36,39,75,8
2022-12-01,EE,Estonia,322,230,10,2,92,41,41,82,8
2022-12-02,EE,Estonia,355,243,16,6,112,47,49,96,10
2022-12-03,EE,Estonia,323,246,5,1,77,35,37,72,4
2022-12-04,EE,Estonia,326,239,5,1,87,40,42,82,4
2022-12-05,EE,Estonia,314,230,9,1,84,39,36,75,8
2022-12-06,EE,Estonia,295,209,6,0,86,42,38,80,6
2022-12-07,EE,Estonia,315,235,5,1,80,38,37,75,4
2022-12-08,EE,Estonia,321,234,9,0,87,37,41,78,9
2022-12-09,EE,Estonia,335,239,8,0,96,44,44,88,8
2022-12-10,EE,Estonia,293,219,5,1,74,35,34,69,4
2022-12-11,EE,Estonia,304,228,4,0,76,36,36,72,4
2022-12-12,EE,Estonia,268,218,2,0,50,25,23,48,2
2022-12-13,EE,Estonia,305,217,5,1,88,40,43,83,4
2022-12-14,EE,Estonia,311,217,12,4,94,41,41,82,8
2022-12-15,EE,Estonia,314,232,10,2,82,35,37,72,8
2022-12-16,EE,Estonia,335,233,7,1,102,49,46,95,6
2022-12-17,EE,Estonia,312,231,5,1,81,38,38,76,4
2022-12-18,EE,Estonia,324,242,5,1,82,39,38,77,4
2022-12-19,EE,Estonia,339,251,8,0,88,42,38,80,8
2022-12-20,EE,Estonia,291,212,7,0,79,36,36,72,7
2022-12-21,EE,Estonia,316,221,7,2,95,43,45,88,5
2022-12-22,EE,Estonia,310,229,10,2,81,36,35,71,8
2022-12-23,EE,Estonia,337,240,10,2,97,44,43,87,8
2022-12-24,EE,Estonia,262,197,7,3,65,29,29,58,4
2022-12-25,EE,Estonia,239,182,5,1,57,27,25,52,4
2022-12-26,EE,Estonia,310,237,9,1,73,32,32,64,8
2022-12-27,EE,Estonia,287,216,10,2,71,30,31,61,8
2022-01-01,EF,Finland,398,75,59,5,323,132,132,264,54
2022-01-02,EF,Finland,593,123,92,0,470,186,192,378,92
2022-01-03,EF,Finland,492,126,78,0,366,149,139,288,78
2022-01-04,EF,Finland,482,114,85,1,368,143,140,283,84
2022-01-05,EF,Finland,506,132,87,1,374,143,144,287,86
2022-01-06,EF,Finland,452,110,69,0,342,133,140,273,69
2022-01-07,EF,Finland,503,124,90,0,379,146,143,289,90
2022-01-08,EF,Finland,465,90,65,0,375,153,157,310,65
2022-01-09,EF,Finland,545,138,79,1,407,162,166,328,78
2022-01-10,EF,Finland,534,135,117,1,399,145,137,282,116
2022-01-11,EF,Finland,507,136,107,0,371,133,131,264,107
2022-01-12,EF,Finland,483,103,108,0,380,137,135,272,108
2022-01-13,EF,Finland,499,131,110,1,368,125,133,258,109
2022-01-14,EF,Finland,501,127,117,1,374,130,127,257,116
2022-01-15,EF,Finland,419,84,53,2,335,142,140,282,51
2022-01-16,EF,Finland,481,122,80,1,359,134,145,279,79
2022-01-17,EF,Finland,464,126,101,3,338,121,116,237,98
2022-01-18,EF,Finland,493,121,106,0,372,132,134,266,106
2022-01-19,EF,Finland,490,114,117,1,376,133,126,259,116
2022-01-20,EF,Finland,468,113,105,3,355,127,123,250,102
2022-01-21,EF,Finland,501,133,111,0,368,127,130,257,111
2022-01-22,EF,Finland,407,80,55,0,327,135,137,272,55
2022-01-23,EF,Finland,455,117,75,1,338,130,133,263,74
2022-01-24,EF,Finland,462,112,117,0,350,117,116,233,117
2022-01-25,EF,Finland,454,103,102,2,351,125,124,249,100
2022-01-26,EF,Finland,477,128,94,0,349,129,126,255,94
2022-01-27,EF,Finland,458,107,97,0,351,127,127,254,97
2022-01-28,EF,Finland,491,123,110,0,368,131,127,258,110
2022-01-29,EF,Finland,432,84,58,1,348,142,148,290,57
2022-01-30,EF,Finland,453,102,79,0,351,137,135,272,79
2022-01-31,EF,Finland,471,121,102,2,350,123,125,248,100
2022-02-01,EF,Finland,453,103,117,1,350,118,115,233,116
2022-02-02,EF,Finland,486,131,106,0,355,126,123,249,106
2022-02-03,EF,Finland,479,115,111,0,364,127,126,253,111
2022-02-04,EF,Finland,469,126,99,0,343,122,122,244,99
2022-02-05,EF,Finland,412,77,64,1,335,133,138,271,63
2022-02-06,EF,Finland,454,106,76,0,348,137,135,272,76
2022-02-07,EF,Finland,452,107,108,0,345,118,119,237,108
2022-02-08,EF,Finland,440,108,94,1,332,115,123,238,93
2022-02-09,EF,Finland,461,111,100,0,350,127,123,250,100
2022-02-10,EF,Finland,497,111,110,1,386,139,137,276,109
2022-02-11,EF,Finland,506,121,114,1,385,138,133,271,113
2022-02-12,EF,Finland,439,84,69,0,355,140,146,286,69
2022-02-13,EF,Finland,479,121,77,0,358,139,142,281,77
2022-02-14,EF,Finland,449,112,107,0,337,117,113,230,107
2022-02-15,EF,Finland,443,102,93,1,341,121,127,248,92
2022-02-16,EF,Finland,484,118,92,1,366,141,133,274,91
2022-02-17,EF,Finland,455,113,94,1,342,125,123,248,93
2022-02-18,EF,Finland,520,123,112,0,397,140,145,285,112
2022-02-19,EF,Finland,442,74,72,0,368,148,148,296,72
2022-02-20,EF,Finland,493,116,81,2,377,146,150,296,79
2022-02-21,EF,Finland,453,105,106,0,348,123,119,242,106
2022-02-22,EF,Finland,477,107,96,1,370,141,133,274,95
2022-02-23,EF,Finland,486,118,103,3,368,129,136,265,100
2022-02-24,EF,Finland,462,100,100,0,362,131,131,262,100
2022-02-25,EF,Finland,490,117,98,0,373,137,138,275,98
2022-02-26,EF,Finland,472,102,70,0,370,147,153,300,70
2022-02-27,EF,Finland,605,237,81,0,368,139,148,287,81
2022-02-28,EF,Finland,474,141,108,0,333,114,111,225,108
2022-03-01,EF,Finland,500,127,112,3,373,132,129,261,109
2022-03-02,EF,Finland,516,123,115,4,393,139,139,278,111
2022-03-03,EF,Finland,473,110,112,4,363,125,126,251,108
2022-03-04,EF,Finland,550,141,135,0,409,137,137,274,135
2022-03-05,EF,Finland,447,92,62,0,355,149,144,293,62
2022-03-06,EF,Finland,497,131,87,0,366,140,139,279,87
2022-03-07,EF,Finland,474,129,99,0,345,124,122,246,99
2022-03-08,EF,Finland,483,121,107,0,362,129,126,255,107
2022-03-09,EF,Finland,497,130,113,0,367,125,129,254,113
2022-03-10,EF,Finland,534,124,131,1,410,144,135,279,130
2022-03-11,EF,Finland,516,136,111,1,380,129,140,269,110
2022-03-12,EF,Finland,426,86,67,0,340,136,137,273,67
2022-03-13,EF,Finland,506,143,87,0,363,139,137,276,87
2022-03-14,EF,Finland,489,120,113,1,369,134,122,256,112
2022-03-15,EF,Finland,443,79,107,0,364,127,130,257,107
2022-03-16,EF,Finland,498,119,127,5,379,127,125,252,122
2022-03-17,EF,Finland,500,126,123,2,374,121,130,251,121
2022-03-18,EF,Finland,514,135,115,0,379,132,132,264,115
2022-03-19,EF,Finland,428,71,74,1,357,141,142,283,73
2022-03-20,EF,Finland,491,135,83,0,356,137,136,273,83
2022-03-21,EF,Finland,472,107,109,1,365,132,124,256,108
2022-03-22,EF,Finland,464,87,118,1,377,125,134,259,117
2022-03-23,EF,Finland,453,110,106,2,343,120,117,237,104
2022-03-24,EF,Finland,482,120,128,0,362,121,113,234,128
2022-03-25,EF,Finland,497,115,111,0,382,131,140,271,111
2022-03-26,EF,Finland,423,83,69,0,340,133,138,271,69
2022-03-27,EF,Finland,498,122,90,0,376,145,141,286,90
2022-03-28,EF,Finland,542,121,108,1,421,157,156,313,107
2022-03-29,EF,Finland,507,93,106,1,414,153,155,308,105
2022-03-30,EF,Finland,548,114,107,1,434,165,162,327,106
2022-03-31,EF,Finland,529,112,114,1,417,150,153,303,113
2022-04-01,EF,Finland,575,143,120,1,432,156,156,312,119
2022-04-02,EF,Finland,393,72,48,0,321,135,138,273,48
2022-04-03,EF,Finland,479,119,71,0,360,141,148,289,71
2022-04-04,EF,Finland,556,126,108,0,430,160,162,322,108
2022-04-05,EF,Finland,479,96,106,2,383,141,136,277,104
2022-04-06,EF,Finland,566,133,118,0,433,158,157,315,118
2022-04-07,EF,Finland,601,126,134,0,475,171,170,341,134
2022-04-08,EF,Finland,591,137,118,2,454,171,165,336,116
2022-04-09,EF,Finland,432,89,57,1,343,144,142,286,56
2022-04-10,EF,Finland,490,130,68,0,360,143,149,292,68
2022-04-11,EF,Finland,550,123,106,2,427,160,161,321,104
2022-04-12,EF,Finland,524,94,113,2,430,158,159,317,111
2022-04-13,EF,Finland,552,133,107,1,419,157,155,312,106
2022-04-14,EF,Finland,555,113,123,0,442,162,157,319,123
2022-04-15,EF,Finland,506,124,77,0,382,151,154,305,77
2022-04-16,EF,Finland,403,80,49,0,323,138,136,274,49
2022-04-17,EF,Finland,477,139,60,0,338,137,141,278,60
2022-04-18,EF,Finland,499,122,77,0,377,150,150,300,77
2022-04-19,EF,Finland,567,112,126,1,455,164,165,329,125
2022-04-20,EF,Finland,567,139,105,0,428,161,162,323,105
2022-04-21,EF,Finland,582,134,114,0,448,168,166,334,114
2022-04-22,EF,Finland,573,132,107,0,441,167,167,334,107
2022-04-23,EF,Finland,406,81,44,0,325,139,142,281,44
2022-04-24,EF,Finland,529,147,65,0,382,156,161,317,65
2022-04-25,EF,Finland,542,124,102,0,418,161,155,316,102
2022-04-26,EF,Finland,525,107,97,0,418,160,161,321,97
2022-04-27,EF,Finland,587,146,111,0,441,167,163,330,111
2022-04-28,EF,Finland,576,145,110,0,431,160,161,321,110
2022-04-29,EF,Finland,622,165,107,0,457,177,173,350,107
2022-04-30,EF,Finland,423,112,40,0,311,135,136,271,40
2022-05-01,EF,Finland,549,157,65,0,392,161,166,327,65
2022-05-02,EF,Finland,621,143,115,0,478,181,182,363,115
2022-05-03,EF,Finland,592,145,104,0,447,175,168,343,104
2022-05-04,EF,Finland,629,160,127,1,469,169,173,342,126
2022-05-05,EF,Finland,643,152,119,0,491,187,185,372,119
2022-05-06,EF,Finland,675,175,122,0,500,188,190,378,122
2022-05-07,EF,Finland,456,111,44,0,345,150,151,301,44
2022-05-08,EF,Finland,557,154,65,0,403,167,171,338,65
2022-05-09,EF,Finland,648,169,120,1,479,182,177,359,119
2022-05-10,EF,Finland,632,154,125,3,478,177,176,353,122
2022-05-11,EF,Finland,649,176,123,0,473,173,177,350,123
2022-05-12,EF,Finland,634,141,125,1,493,183,185,368,124
2022-05-13,EF,Finland,655,146,127,1,509,193,189,382,126
2022-05-14,EF,Finland,452,94,55,1,358,154,149,303,54
2022-05-15,EF,Finland,566,148,73,1,418,170,175,345,72
2022-05-16,EF,Finland,621,126,115,0,495,188,192,380,115
2022-05-17,EF,Finland,580,114,110,1,466,182,174,356,109
2022-05-18,EF,Finland,655,160,134,3,495,179,182,361,131
2022-05-19,EF,Finland,684,153,128,3,531,202,201,403,125
2022-05-20,EF,Finland,653,175,120,1,478,178,180,358,119
2022-05-21,EF,Finland,460,97,48,3,363,159,156,315,45
2022-05-22,EF,Finland,576,165,72,3,411,170,169,339,69
2022-05-23,EF,Finland,658,164,120,3,494,190,184,374,117
2022-05-24,EF,Finland,577,126,102,3,451,172,177,349,99
2022-05-25,EF,Finland,655,169,115,4,486,187,184,371,111
2022-05-26,EF,Finland,587,150,63,0,437,188,186,374,63
2022-05-27,EF,Finland,618,162,110,0,456,170,176,346,110
2022-05-28,EF,Finland,466,108,50,0,358,154,154,308,50
2022-05-29,EF,Finland,583,165,69,0,418,171,178,349,69
2022-05-30,EF,Finland,664,170,109,0,494,196,189,385,109
2022-05-31,EF,Finland,604,144,112,0,460,176,172,348,112
2022-06-01,EF,Finland,639,174,107,0,465,180,178,358,107
2022-06-02,EF,Finland,661,174,111,1,487,187,189,376,110
2022-06-03,EF,Finland,652,183,111,0,469,181,177,358,111
2022-06-04,EF,Finland,483,119,50,0,364,157,157,314,50
2022-06-05,EF,Finland,571,169,66,1,402,166,170,336,65
2022-06-06,EF,Finland,652,184,112,5,468,177,179,356,107
2022-06-07,EF,Finland,632,163,121,5,469,173,175,348,116
2022-06-08,EF,Finland,659,189,117,6,470,177,176,353,111
2022-06-09,EF,Finland,684,181,128,4,503,189,186,375,124
2022-06-10,EF,Finland,673,201,121,2,472,174,177,351,119
2022-06-11,EF,Finland,509,138,53,2,371,160,158,318,51
2022-06-12,EF,Finland,577,179,66,1,398,164,168,332,65
2022-06-13,EF,Finland,689,201,119,0,488,185,184,369,119
2022-06-14,EF,Finland,634,173,113,0,461,174,174,348,113
2022-06-15,EF,Finland,659,184,108,3,475,183,184,367,105
2022-06-16,EF,Finland,683,182,108,1,501,197,196,393,107
2022-06-17,EF,Finland,647,179,108,0,468,178,182,360,108
2022-06-18,EF,Finland,501,135,48,0,366,157,161,318,48
2022-06-19,EF,Finland,612,186,86,0,426,170,170,340,86
2022-06-20,EF,Finland,643,165,108,1,478,186,184,370,107
2022-06-21,EF,Finland,628,163,107,1,465,181,177,358,106
2022-06-22,EF,Finland,621,172,89,0,449,179,181,360,89
2022-06-23,EF,Finland,621,170,87,0,451,186,178,364,87
2022-06-24,EF,Finland,572,178,54,2,394,170,170,340,52
2022-06-25,EF,Finland,479,135,40,4,344,150,154,304,36
2022-06-26,EF,Finland,564,172,52,0,392,168,172,340,52
2022-06-27,EF,Finland,615,166,87,3,449,182,180,362,84
2022-06-28,EF,Finland,596,165,84,2,431,176,171,347,82
2022-06-29,EF,Finland,613,180,79,1,433,175,179,354,78
2022-06-30,EF,Finland,615,159,93,3,456,180,183,363,90
2022-07-01,EF,Finland,668,187,97,1,481,196,188,384,96
2022-07-02,EF,Finland,521,139,47,0,382,169,166,335,47
2022-07-03,EF,Finland,575,182,60,0,393,163,170,333,60
2022-07-04,EF,Finland,598,173,78,2,425,174,173,347,76
2022-07-05,EF,Finland,553,157,71,0,396,163,162,325,71
2022-07-06,EF,Finland,611,180,83,0,431,173,175,348,83
2022-07-07,EF,Finland,591,154,86,0,437,178,173,351,86
2022-07-08,EF,Finland,623,168,85,0,455,185,185,370,85
2022-07-09,EF,Finland,511,140,49,0,371,160,162,322,49
2022-07-10,EF,Finland,581,180,58,0,401,171,172,343,58
2022-07-11,EF,Finland,605,171,82,0,434,175,177,352,82
2022-07-12,EF,Finland,578,178,76,0,400,165,159,324,76
2022-07-13,EF,Finland,611,187,77,1,424,170,177,347,76
2022-07-14,EF,Finland,612,174,82,1,438,180,176,356,81
2022-07-15,EF,Finland,619,169,95,0,450,179,176,355,95
2022-07-16,EF,Finland,512,140,46,0,372,162,164,326,46
2022-07-17,EF,Finland,578,176,54,0,402,174,174,348,54
2022-07-18,EF,Finland,579,156,77,0,423,172,174,346,77
2022-07-19,EF,Finland,571,164,70,0,407,170,167,337,70
2022-07-20,EF,Finland,591,177,71,0,414,170,173,343,71
2022-07-21,EF,Finland,615,181,79,2,434,179,176,355,77
2022-07-22,EF,Finland,630,182,83,0,448,182,183,365,83
2022-07-23,EF,Finland,508,151,42,0,357,158,157,315,42
2022-07-24,EF,Finland,570,189,56,0,381,161,164,325,56
2022-07-25,EF,Finland,610,174,86,0,436,173,177,350,86
2022-07-26,EF,Finland,590,163,90,4,427,170,167,337,86
2022-07-27,EF,Finland,606,184,92,2,422,164,166,330,90
2022-07-28,EF,Finland,621,174,93,0,447,174,180,354,93
2022-07-29,EF,Finland,647,182,99,0,465,185,181,366,99
2022-07-30,EF,Finland,514,147,54,0,367,160,153,313,54
2022-07-31,EF,Finland,576,184,57,0,392,167,168,335,57
2022-08-01,EF,Finland,623,172,108,1,451,171,172,343,107
2022-08-02,EF,Finland,602,178,86,1,424,170,168,338,85
2022-08-03,EF,Finland,608,180,94,3,428,162,172,334,91
2022-08-04,EF,Finland,651,184,90,2,467,192,185,377,88
2022-08-05,EF,Finland,646,183,100,4,463,181,182,363,96
2022-08-06,EF,Finland,496,148,39,4,348,155,154,309,35
2022-08-07,EF,Finland,585,197,50,3,388,167,171,338,47
2022-08-08,EF,Finland,630,182,86,1,448,182,180,362,85
2022-08-09,EF,Finland,624,176,95,5,448,172,181,353,90
2022-08-10,EF,Finland,622,185,94,0,437,166,177,343,94
2022-08-11,EF,Finland,666,183,99,2,483,204,180,384,97
2022-08-12,EF,Finland,650,181,103,2,469,180,186,366,101
2022-08-13,EF,Finland,493,147,33,1,346,156,157,313,32
2022-08-14,EF,Finland,589,191,48,1,398,176,174,350,47
2022-08-15,EF,Finland,662,187,95,2,475,191,189,380,93
2022-08-16,EF,Finland,589,182,74,1,407,168,165,333,73
2022-08-17,EF,Finland,612,187,79,4,425,174,172,346,75
2022-08-18,EF,Finland,619,183,82,0,436,176,178,354,82
2022-08-19,EF,Finland,672,205,98,6,467,188,181,369,92
2022-08-20,EF,Finland,477,139,34,0,338,153,151,304,34
2022-08-21,EF,Finland,565,190,46,1,375,166,163,329,45
2022-08-22,EF,Finland,657,200,90,1,457,180,187,367,89
2022-08-23,EF,Finland,623,197,76,1,426,176,174,350,75
2022-08-24,EF,Finland,651,200,87,2,451,184,180,364,85
2022-08-25,EF,Finland,649,190,91,0,459,182,186,368,91
2022-08-26,EF,Finland,678,208,88,1,470,193,189,382,87
2022-08-27,EF,Finland,520,165,40,0,355,157,158,315,40
2022-08-28,EF,Finland,581,189,52,0,392,170,170,340,52
2022-08-29,EF,Finland,657,197,80,0,460,187,193,380,80
2022-08-30,EF,Finland,630,197,89,0,433,174,170,344,89
2022-08-31,EF,Finland,671,213,87,1,458,183,188,371,86
2022-09-01,EF,Finland,659,189,90,0,470,192,188,380,90
2022-09-02,EF,Finland,666,200,90,0,466,188,188,376,90
2022-09-03,EF,Finland,518,152,43,0,366,160,163,323,43
2022-09-04,EF,Finland,625,206,55,0,419,182,182,364,55
2022-09-05,EF,Finland,677,213,91,0,464,187,186,373,91
2022-09-06,EF,Finland,606,181,80,0,425,173,172,345,80
2022-09-07,EF,Finland,656,194,84,0,462,189,189,378,84
2022-09-08,EF,Finland,675,187,110,1,488,186,192,378,109
2022-09-09,EF,Finland,687,209,93,1,478,195,190,385,92
2022-09-10,EF,Finland,526,155,47,0,371,160,164,324,47
2022-09-11,EF,Finland,604,189,57,1,415,177,181,358,56
2022-09-12,EF,Finland,661,192,94,1,469,187,188,375,93
2022-09-13,EF,Finland,631,179,90,0,452,183,179,362,90
2022-09-14,EF,Finland,657,201,82,3,456,188,186,374,79
2022-09-15,EF,Finland,658,187,96,0,471,189,186,375,96
2022-09-16,EF,Finland,664,200,89,0,464,190,185,375,89
2022-09-17,EF,Finland,513,140,51,1,373,159,163,322,50
2022-09-18,EF,Finland,597,195,64,1,402,169,169,338,63
2022-09-19,EF,Finland,665,186,100,0,479,185,194,379,100
2022-09-20,EF,Finland,626,184,83,0,442,179,180,359,83
2022-09-21,EF,Finland,649,191,88,0,458,191,179,370,88
2022-09-22,EF,Finland,662,180,100,1,482,191,191,382,99
2022-09-23,EF,Finland,693,201,106,1,492,193,193,386,105
2022-09-24,EF,Finland,506,134,49,1,372,162,161,323,48
2022-09-25,EF,Finland,586,188,56,0,398,170,172,342,56
2022-09-26,EF,Finland,679,193,103,3,486,193,190,383,100
2022-09-27,EF,Finland,631,177,89,3,454,180,185,365,86
2022-09-28,EF,Finland,647,184,88,0,463,184,191,375,88
2022-09-29,EF,Finland,658,186,92,0,472,193,187,380,92
2022-09-30,EF,Finland,659,193,95,0,466,186,185,371,95
2022-10-01,EF,Finland,490,132,44,0,358,158,156,314,44
2022-10-02,EF,Finland,588,186,52,0,402,174,176,350,52
2022-10-03,EF,Finland,626,181,92,0,445,177,176,353,92
2022-10-04,EF,Finland,592,154,86,1,438,170,182,352,85
2022-10-05,EF,Finland,624,171,83,2,453,183,187,370,81
2022-10-06,EF,Finland,620,162,81,0,458,192,185,377,81
2022-10-07,EF,Finland,618,174,68,1,444,187,189,376,67
2022-10-08,EF,Finland,476,124,37,0,352,158,157,315,37
2022-10-09,EF,Finland,552,160,53,0,392,168,171,339,53
2022-10-10,EF,Finland,616,170,94,2,446,173,179,352,92
2022-10-11,EF,Finland,579,160,79,1,419,172,168,340,78
2022-10-12,EF,Finland,650,163,96,0,487,194,197,391,96
2022-10-13,EF,Finland,622,160,87,1,462,187,188,375,86
2022-10-14,EF,Finland,674,165,92,0,509,209,208,417,92
2022-10-15,EF,Finland,479,110,37,0,369,169,163,332,37
2022-10-16,EF,Finland,569,164,51,0,405,177,177,354,51
2022-10-17,EF,Finland,631,159,96,1,472,186,190,376,95
2022-10-18,EF,Finland,589,153,84,0,436,176,176,352,84
2022-10-19,EF,Finland,621,153,85,1,468,191,192,383,84
2022-10-20,EF,Finland,637,161,101,0,476,190,185,375,101
2022-10-21,EF,Finland,654,162,94,0,492,199,199,398,94
2022-10-22,EF,Finland,480,112,46,2,368,160,162,322,44
2022-10-23,EF,Finland,568,153,59,0,415,178,178,356,59
2022-10-24,EF,Finland,608,154,87,1,454,183,184,367,86
2022-10-25,EF,Finland,574,151,78,0,423,173,172,345,78
2022-10-26,EF,Finland,615,164,85,1,451,184,182,366,84
2022-10-27,EF,Finland,629,163,94,0,466,185,187,372,94
2022-10-28,EF,Finland,640,165,84,1,475,196,195,391,83
2022-10-29,EF,Finland,477,115,45,1,362,158,159,317,44
2022-10-30,EF,Finland,523,147,57,1,376,158,161,319,56
2022-10-31,EF,Finland,584,135,113,0,449,167,169,336,113
2022-11-01,EF,Finland,530,127,89,0,403,154,160,314,89
2022-11-02,EF,Finland,558,136,90,1,422,170,162,332,89
2022-11-03,EF,Finland,548,137,96,0,411,158,157,315,96
2022-11-04,EF,Finland,616,152,111,1,464,175,178,353,110
2022-11-05,EF,Finland,429,106,52,1,323,134,137,271,51
2022-11-06,EF,Finland,532,139,66,0,393,166,161,327,66
2022-11-07,EF,Finland,594,148,109,1,446,168,169,337,108
2022-11-08,EF,Finland,534,131,94,1,403,152,157,309,93
2022-11-09,EF,Finland,601,158,98,1,443,173,172,345,97
2022-11-10,EF,Finland,596,143,120,9,453,170,163,333,111
2022-11-11,EF,Finland,612,146,112,1,466,176,178,354,111
2022-11-12,EF,Finland,412,97,55,0,315,129,131,260,55
2022-11-13,EF,Finland,539,155,66,0,384,158,160,318,66
2022-11-14,EF,Finland,593,151,96,1,442,173,173,346,95
2022-11-15,EF,Finland,564,139,101,1,425,155,169,324,100
2022-11-16,EF,Finland,615,159,112,2,456,175,169,344,110
2022-11-17,EF,Finland,586,138,104,0,448,174,170,344,104
2022-11-18,EF,Finland,626,152,112,1,474,182,180,362,111
2022-11-19,EF,Finland,438,101,58,0,337,139,140,279,58
2022-11-20,EF,Finland,495,144,64,0,351,143,144,287,64
2022-11-21,EF,Finland,514,146,80,0,368,148,140,288,80
2022-11-22,EF,Finland,539,121,102,0,418,159,157,316,102
2022-11-23,EF,Finland,570,139,97,1,431,165,169,334,96
2022-11-24,EF,Finland,572,128,98,0,444,174,172,346,98
2022-11-25,EF,Finland,608,149,105,0,459,176,178,354,105
2022-11-26,EF,Finland,428,95,59,0,333,138,136,274,59
2022-11-27,EF,Finland,572,149,79,2,423,172,172,344,77
2022-11-28,EF,Finland,619,148,111,0,471,182,178,360,111
2022-11-29,EF,Finland,539,118,105,0,421,157,159,316,105
2022-11-30,EF,Finland,619,127,110,1,492,191,191,382,109
2022-12-01,EF,Finland,624,142,125,3,482,178,179,357,122
2022-12-02,EF,Finland,661,145,129,0,516,193,194,387,129
2022-12-03,EF,Finland,476,87,68,0,389,161,160,321,68
2022-12-04,EF,Finland,612,130,86,1,482,195,201,396,85
2022-12-05,EF,Finland,642,145,106,0,497,198,193,391,106
2022-12-06,EF,Finland,517,112,68,0,405,166,171,337,68
2022-12-07,EF,Finland,705,143,129,3,562,217,216,433,126
2022-12-08,EF,Finland,645,134,132,1,511,197,182,379,131
2022-12-09,EF,Finland,670,147,134,0,523,189,200,389,134
2022-12-10,EF,Finland,487,108,68,0,379,157,154,311,68
2022-12-11,EF,Finland,665,146,97,1,519,209,213,422,96
2022-12-12,EF,Finland,621,117,122,2,504,190,192,382,120
2022-12-13,EF,Finland,590,130,112,0,460,177,171,348,112
2022-12-14,EF,Finland,683,128,133,2,555,207,215,422,131
2022-12-15,EF,Finland,619,137,126,0,482,180,176,356,126
2022-12-16,EF,Finland,676,139,135,1,537,195,207,402,134
2022-12-17,EF,Finland,530,96,79,2,434,178,177,355,77
2022-12-18,EF,Finland,691,157,92,0,534,221,221,442,92
2022-12-19,EF,Finland,660,140,125,1,520,198,197,395,124
2022-12-20,EF,Finland,616,131,116,2,485,184,185,369,114
2022-12-21,EF,Finland,622,122,111,0,500,196,193,389,111
2022-12-22,EF,Finland,695,134,127,0,561,219,215,434,127
2022-12-23,EF,Finland,689,146,127,2,543,209,207,416,125
2022-12-24,EF,Finland,385,99,42,0,286,122,122,244,42
2022-12-25,EF,Finland,378,98,48,0,280,118,114,232,48
2022-12-26,EF,Finland,609,138,80,0,471,196,195,391,80
2022-12-27,EF,Finland,566,121,83,0,445,181,181,362,83
2022-01-01,LF,France,5447,3065,455,1,2382,969,958,1927,454
2022-01-02,LF,France,7188,3774,842,1,3414,1279,1293,2572,841
2022-01-03,LF,France,6681,3463,915,14,3218,1147,1156,2303,901
2022-01-04,LF,France,5824,3044,825,14,2780,971,984,1955,811
2022-01-05,LF,France,5414,2858,812,22,2556,871,873,1744,790
2022-01-06,LF,France,5498,2864,817,19,2634,912,905,1817,798
2022-01-07,LF,France,5968,3161,835,25,2807,1007,965,1972,810
2022-01-08,LF,France,5758,3550,399,4,2208,899,910,1809,395
2022-01-09,LF,France,6306,3659,525,6,2647,1076,1046,2122,519
2022-01-10,LF,France,5144,2580,855,24,2564,847,862,1709,831
2022-01-11,LF,France,4376,1997,892,26,2379,731,756,1487,866
2022-01-12,LF,France,4402,2036,896,35,2366,738,732,1470,861
2022-01-13,LF,France,4513,2076,897,33,2437,761,779,1540,864
2022-01-14,LF,France,5344,2565,948,32,2779,935,896,1831,916
2022-01-15,LF,France,4531,2662,433,13,1869,703,733,1436,420
2022-01-16,LF,France,4995,2760,537,4,2235,857,841,1698,533
2022-01-17,LF,France,4774,2228,920,24,2546,798,828,1626,896
2022-01-18,LF,France,3997,1802,822,33,2195,686,687,1373,789
2022-01-19,LF,France,4224,1829,938,27,2395,721,736,1457,911
2022-01-20,LF,France,4551,2018,967,34,2533,785,781,1566,933
2022-01-21,LF,France,5334,2504,962,30,2830,928,940,1868,932
2022-01-22,LF,France,4639,2662,443,17,1977,754,780,1534,426
2022-01-23,LF,France,5084,2755,556,4,2329,895,878,1773,552
2022-01-24,LF,France,4699,2168,972,22,2531,768,791,1559,950
2022-01-25,LF,France,3799,1715,761,28,2084,668,655,1323,733
2022-01-26,LF,France,4262,1889,914,23,2373,741,718,1459,891
2022-01-27,LF,France,4438,2069,861,28,2369,760,748,1508,833
2022-01-28,LF,France,5339,2567,964,25,2772,912,896,1808,939
2022-01-29,LF,France,4669,2738,431,9,1931,737,763,1500,422
2022-01-30,LF,France,5323,2915,593,4,2408,927,888,1815,589
2022-01-31,LF,France,4672,2269,856,14,2403,763,784,1547,842
2022-02-01,LF,France,4426,2093,844,25,2333,740,749,1489,819
2022-02-02,LF,France,4580,2195,912,28,2385,728,745,1473,884
2022-02-03,LF,France,4992,2348,957,19,2644,848,839,1687,938
2022-02-04,LF,France,5726,2784,1007,22,2942,982,953,1935,985
2022-02-05,LF,France,5339,3117,532,11,2222,849,841,1690,521
2022-02-06,LF,France,5580,3114,573,3,2466,940,953,1893,570
2022-02-07,LF,France,5536,2657,984,18,2879,938,957,1895,966
2022-02-08,LF,France,4849,2223,974,17,2626,839,813,1652,957
2022-02-09,LF,France,5033,2356,951,24,2677,857,869,1726,927
2022-02-10,LF,France,5676,2706,1029,21,2970,969,972,1941,1008
2022-02-11,LF,France,6732,3388,1031,21,3344,1169,1144,2313,1010
2022-02-12,LF,France,6411,3686,563,11,2725,1064,1098,2162,552
2022-02-13,LF,France,6244,3408,627,7,2836,1109,1100,2209,620
2022-02-14,LF,France,5798,2883,840,17,2915,1031,1044,2075,823
2022-02-15,LF,France,5096,2428,843,22,2668,918,907,1825,821
2022-02-16,LF,France,5246,2482,887,16,2764,938,939,1877,871
2022-02-17,LF,France,5819,2780,976,26,3039,1031,1032,2063,950
2022-02-18,LF,France,6211,3004,989,20,3207,1110,1108,2218,969
2022-02-19,LF,France,6811,3847,606,8,2964,1178,1180,2358,598
2022-02-20,LF,France,6791,3725,629,4,3066,1229,1208,2437,625
2022-02-21,LF,France,5916,2975,832,15,2941,1035,1074,2109,817
2022-02-22,LF,France,5450,2534,965,31,2916,978,973,1951,934
2022-02-23,LF,France,5642,2706,984,28,2936,971,981,1952,956
2022-02-24,LF,France,6092,2931,1038,22,3161,1061,1062,2123,1016
2022-02-25,LF,France,6975,3474,1045,23,3501,1253,1203,2456,1022
2022-02-26,LF,France,6682,3753,604,9,2929,1140,1185,2325,595
2022-02-27,LF,France,6942,3768,675,6,3174,1245,1254,2499,669
2022-02-28,LF,France,6446,3169,1011,25,3277,1112,1154,2266,986
2022-03-01,LF,France,5804,2774,1008,52,3030,1008,1014,2022,956
2022-03-02,LF,France,5910,2832,996,50,3078,1046,1036,2082,946
2022-03-03,LF,France,6369,3103,1064,64,3266,1107,1095,2202,1000
2022-03-04,LF,France,7126,3568,1097,54,3558,1231,1230,2461,1043
2022-03-05,LF,France,6724,3852,559,15,2872,1148,1165,2313,544
2022-03-06,LF,France,6985,3831,695,12,3154,1238,1221,2459,683
2022-03-07,LF,France,6441,3192,986,28,3249,1118,1145,2263,958
2022-03-08,LF,France,5904,2877,998,46,3027,1021,1008,2029,952
2022-03-09,LF,France,6046,2867,1082,56,3179,1055,1042,2097,1026
2022-03-10,LF,France,6546,3174,1128,80,3372,1102,1142,2244,1048
2022-03-11,LF,France,6969,3496,972,54,3473,1279,1222,2501,918
2022-03-12,LF,France,6494,3742,520,19,2752,1098,1134,2232,501
2022-03-13,LF,France,6763,3728,618,11,3035,1207,1210,2417,607
2022-03-14,LF,France,6649,3228,1088,37,3421,1151,1182,2333,1051
2022-03-15,LF,France,6069,2869,1082,38,3200,1044,1074,2118,1044
2022-03-16,LF,France,6178,2886,1126,50,3292,1087,1079,2166,1076
2022-03-17,LF,France,6554,3142,1126,41,3412,1152,1134,2286,1085
2022-03-18,LF,France,7172,3519,1087,30,3653,1301,1265,2566,1057
2022-03-19,LF,France,6622,3846,543,10,2776,1091,1142,2233,533
2022-03-20,LF,France,7064,3828,734,13,3236,1274,1228,2502,721
2022-03-21,LF,France,6570,3230,1022,52,3340,1154,1164,2318,970
2022-03-22,LF,France,5990,2867,1076,55,3123,1024,1023,2047,1021
2022-03-23,LF,France,6118,2908,1028,46,3210,1077,1105,2182,982
2022-03-24,LF,France,6538,3167,1108,44,3371,1141,1122,2263,1064
2022-03-25,LF,France,7300,3609,1106,53,3691,1306,1279,2585,1053
2022-03-26,LF,France,6665,3863,509,14,2802,1141,1152,2293,495
2022-03-27,LF,France,7742,4439,714,5,3303,1309,1280,2589,709
2022-03-28,LF,France,7566,4003,1009,44,3563,1266,1288,2554,965
2022-03-29,LF,France,7315,3802,1071,65,3513,1227,1215,2442,1006
2022-03-30,LF,France,7206,3741,1073,40,3465,1186,1206,2392,1033
2022-03-31,LF,France,7636,4065,1014,40,3571,1271,1286,2557,974
2022-04-01,LF,France,8062,4459,872,22,3603,1369,1362,2731,850
2022-04-02,LF,France,7783,4800,496,12,2983,1244,1243,2487,484
2022-04-03,LF,France,7999,4711,653,8,3288,1320,1315,2635,645
2022-04-04,LF,France,7872,4286,984,24,3586,1288,1314,2602,960
2022-04-05,LF,France,7328,3904,993,31,3424,1204,1227,2431,962
2022-04-06,LF,France,7560,4023,1042,21,3537,1254,1241,2495,1021
2022-04-07,LF,France,7888,4236,983,20,3652,1331,1338,2669,963
2022-04-08,LF,France,8526,4637,992,27,3889,1450,1447,2897,965
2022-04-09,LF,France,8452,5069,598,18,3383,1404,1381,2785,580
2022-04-10,LF,France,8330,4798,753,9,3532,1394,1385,2779,744
2022-04-11,LF,France,7956,4214,1076,33,3742,1319,1347,2666,1043
2022-04-12,LF,France,7738,4170,1003,35,3568,1282,1283,2565,968
2022-04-13,LF,France,8126,4314,1093,67,3812,1356,1363,2719,1026
2022-04-14,LF,France,8805,4591,1213,39,4214,1473,1528,3001,1174
2022-04-15,LF,France,8829,4646,1234,34,4183,1485,1464,2949,1200
2022-04-16,LF,France,8545,4983,725,19,3562,1423,1414,2837,706
2022-04-17,LF,France,8111,4611,672,13,3500,1429,1399,2828,659
2022-04-18,LF,France,8537,4757,874,15,3780,1439,1467,2906,859
2022-04-19,LF,France,8155,4305,1032,34,3850,1408,1410,2818,998
2022-04-20,LF,France,7869,4208,1003,24,3661,1330,1328,2658,979
2022-04-21,LF,France,8344,4435,1069,38,3909,1414,1426,2840,1031
2022-04-22,LF,France,8779,4558,1125,40,4221,1553,1543,3096,1085
2022-04-23,LF,France,8393,4888,633,10,3505,1441,1431,2872,623
2022-04-24,LF,France,8577,4812,763,12,3765,1502,1500,3002,751
2022-04-25,LF,France,8296,4337,1054,59,3959,1443,1462,2905,995
2022-04-26,LF,France,8023,4138,1070,46,3885,1408,1407,2815,1024
2022-04-27,LF,France,7983,4105,1055,39,3878,1417,1406,2823,1016
2022-04-28,LF,France,8522,4434,1140,41,4088,1467,1481,2948,1099
2022-04-29,LF,France,9007,4663,1155,27,4344,1577,1612,3189,1128
2022-04-30,LF,France,8541,4905,732,16,3636,1466,1438,2904,716
2022-05-01,LF,France,8806,5014,807,16,3792,1500,1485,2985,791
2022-05-02,LF,France,8690,4609,1136,32,4081,1459,1486,2945,1104
2022-05-03,LF,France,8270,4400,1023,30,3870,1427,1420,2847,993
2022-05-04,LF,France,8415,4527,1063,81,3888,1402,1423,2825,982
2022-05-05,LF,France,8826,4671,1154,43,4155,1496,1505,3001,1111
2022-05-06,LF,France,9282,4939,1131,26,4343,1590,1622,3212,1105
2022-05-07,LF,France,8876,5195,741,11,3681,1466,1474,2940,730
2022-05-08,LF,France,9055,5145,864,7,3910,1548,1498,3046,857
2022-05-09,LF,France,8699,4646,1055,39,4053,1481,1517,2998,1016
2022-05-10,LF,France,8287,4429,1043,38,3858,1400,1415,2815,1005
2022-05-11,LF,France,8449,4551,1066,37,3898,1418,1414,2832,1029
2022-05-12,LF,France,9036,4721,1208,61,4315,1533,1574,3107,1147
2022-05-13,LF,France,9295,4895,1228,44,4400,1568,1604,3172,1184
2022-05-14,LF,France,8838,5228,714,22,3610,1466,1430,2896,692
2022-05-15,LF,France,8989,5144,788,18,3845,1546,1511,3057,770
2022-05-16,LF,France,8999,4763,1181,41,4236,1516,1539,3055,1140
2022-05-17,LF,France,8535,4623,1091,56,3912,1408,1413,2821,1035
2022-05-18,LF,France,8708,4657,1147,43,4051,1447,1457,2904,1104
2022-05-19,LF,France,9428,5062,1240,61,4366,1550,1576,3126,1179
2022-05-20,LF,France,9456,5003,1209,46,4453,1616,1628,3244,1163
2022-05-21,LF,France,9117,5397,712,18,3720,1502,1506,3008,694
2022-05-22,LF,France,9346,5374,791,6,3972,1605,1576,3181,785
2022-05-23,LF,France,9084,4907,1112,18,4177,1518,1547,3065,1094
2022-05-24,LF,France,8900,4746,1135,38,4154,1496,1523,3019,1097
2022-05-25,LF,France,9540,4886,1286,23,4654,1675,1693,3368,1263
2022-05-26,LF,France,9547,5214,931,19,4333,1675,1727,3402,912
2022-05-27,LF,France,9574,5227,838,17,4347,1714,1795,3509,821
2022-05-28,LF,France,9744,5529,759,20,4215,1668,1788,3456,739
2022-05-29,LF,France,10421,5465,1128,13,4956,2009,1819,3828,1115
2022-05-30,LF,France,9926,4961,1276,32,4965,1890,1799,3689,1244
2022-05-31,LF,France,9192,4892,1158,29,4300,1563,1579,3142,1129
2022-06-01,LF,France,9376,4989,1174,44,4387,1597,1616,3213,1130
2022-06-02,LF,France,9641,4998,1228,41,4643,1673,1742,3415,1187
2022-06-03,LF,France,10076,5277,1268,33,4799,1740,1791,3531,1235
2022-06-04,LF,France,9523,5600,748,6,3923,1591,1584,3175,742
2022-06-05,LF,France,9519,5474,720,14,4045,1702,1623,3325,706
2022-06-06,LF,France,9929,5417,1034,24,4512,1742,1736,3478,1010
2022-06-07,LF,France,9538,5117,1223,45,4421,1606,1592,3198,1178
2022-06-08,LF,France,9264,4866,1243,45,4398,1556,1599,3155,1198
2022-06-09,LF,France,9652,5158,1258,49,4494,1612,1624,3236,1209
2022-06-10,LF,France,10121,5317,1321,52,4804,1733,1750,3483,1269
2022-06-11,LF,France,9628,5690,766,12,3938,1595,1577,3172,754
2022-06-12,LF,France,9649,5461,855,21,4188,1693,1640,3333,834
2022-06-13,LF,France,9714,5052,1297,34,4662,1664,1701,3365,1263
2022-06-14,LF,France,9495,5057,1099,38,4438,1658,1681,3339,1061
2022-06-15,LF,France,9555,5075,1201,30,4480,1640,1639,3279,1171
2022-06-16,LF,France,9839,5249,1278,33,4590,1649,1663,3312,1245
2022-06-17,LF,France,10237,5429,1310,51,4808,1734,1764,3498,1259
2022-06-18,LF,France,9690,5783,773,16,3907,1567,1567,3134,757
2022-06-19,LF,France,9901,5701,848,10,4200,1702,1650,3352,838
2022-06-20,LF,France,9872,5288,1192,17,4584,1692,1700,3392,1175
2022-06-21,LF,France,9700,5205,1141,45,4495,1670,1684,3354,1096
2022-06-22,LF,France,9555,5188,1135,52,4367,1606,1626,3232,1083
2022-06-23,LF,France,9932,5298,1191,40,4634,1724,1719,3443,1151
2022-06-24,LF,France,10169,5440,1197,33,4729,1773,1759,3532,1164
2022-06-25,LF,France,9126,5433,688,13,3693,1495,1510,3005,675
2022-06-26,LF,France,9397,5411,793,13,3986,1612,1581,3193,780
2022-06-27,LF,France,10022,5445,1113,29,4577,1722,1742,3464,1084
2022-06-28,LF,France,9897,5409,1143,31,4488,1654,1691,3345,1112
2022-06-29,LF,France,9926,5363,1229,39,4563,1683,1651,3334,1190
2022-06-30,LF,France,10116,5506,1192,31,4610,1699,1719,3418,1161
2022-07-01,LF,France,10739,5763,1318,26,4976,1826,1832,3658,1292
2022-07-02,LF,France,10118,5934,801,11,4184,1688,1695,3383,790
2022-07-03,LF,France,10188,5755,893,10,4433,1765,1775,3540,883
2022-07-04,LF,France,10373,5612,1180,38,4761,1790,1791,3581,1142
2022-07-05,LF,France,10094,5430,1169,39,4664,1745,1750,3495,1130
2022-07-06,LF,France,10138,5397,1172,49,4741,1778,1791,3569,1123
2022-07-07,LF,France,10435,5534,1200,32,4901,1862,1839,3701,1168
2022-07-08,LF,France,10656,5742,1187,34,4914,1863,1864,3727,1153
2022-07-09,LF,France,10558,6152,848,13,4406,1777,1781,3558,835
2022-07-10,LF,France,10260,5806,871,15,4454,1780,1803,3583,856
2022-07-11,LF,France,10284,5547,1066,22,4737,1814,1857,3671,1044
2022-07-12,LF,France,10127,5525,1055,34,4602,1797,1750,3547,1021
2022-07-13,LF,France,10050,5452,1096,34,4598,1732,1770,3502,1062
2022-07-14,LF,France,9729,5541,742,21,4188,1749,1697,3446,721
2022-07-15,LF,France,10184,5656,915,24,4528,1797,1816,3613,891
2022-07-16,LF,France,10306,6048,750,9,4258,1753,1755,3508,741
2022-07-17,LF,France,10096,5708,911,20,4388,1728,1749,3477,891
2022-07-18,LF,France,10364,5577,1109,40,4787,1838,1840,3678,1069
2022-07-19,LF,France,9981,5382,1043,37,4599,1791,1765,3556,1006
2022-07-20,LF,France,10060,5492,1029,32,4568,1767,1772,3539,997
2022-07-21,LF,France,10373,5589,1143,33,4784,1805,1836,3641,1110
2022-07-22,LF,France,10549,5706,1152,28,4843,1838,1853,3691,1124
2022-07-23,LF,France,10566,6111,862,12,4455,1794,1799,3593,850
2022-07-24,LF,France,10261,5858,877,13,4403,1776,1750,3526,864
2022-07-25,LF,France,10234,5551,1063,34,4683,1803,1817,3620,1029
2022-07-26,LF,France,9885,5402,1035,47,4483,1736,1712,3448,988
2022-07-27,LF,France,9741,5323,1025,34,4418,1675,1718,3393,991
2022-07-28,LF,France,10301,5549,1118,64,4752,1813,1821,3634,1054
2022-07-29,LF,France,10554,5773,1079,38,4781,1862,1840,3702,1041
2022-07-30,LF,France,10742,6239,808,11,4503,1858,1837,3695,797
2022-07-31,LF,France,10397,6045,805,14,4352,1790,1757,3547,791
2022-08-01,LF,France,10219,5687,962,42,4532,1769,1801,3570,920
2022-08-02,LF,France,9737,5500,832,30,4237,1700,1705,3405,802
2022-08-03,LF,France,9633,5382,850,31,4251,1711,1690,3401,819
2022-08-04,LF,France,9816,5515,837,21,4301,1730,1734,3464,816
2022-08-05,LF,France,10085,5657,888,16,4428,1744,1796,3540,872
2022-08-06,LF,France,10482,6192,777,12,4290,1765,1748,3513,765
2022-08-07,LF,France,10160,5987,751,13,4173,1723,1699,3422,738
2022-08-08,LF,France,9890,5559,894,21,4331,1714,1723,3437,873
2022-08-09,LF,France,9712,5505,829,25,4207,1694,1684,3378,804
2022-08-10,LF,France,9691,5490,872,34,4201,1672,1657,3329,838
2022-08-11,LF,France,9783,5528,873,41,4255,1676,1706,3382,832
2022-08-12,LF,France,10151,5669,946,16,4482,1759,1777,3536,930
2022-08-13,LF,France,10409,6147,810,10,4262,1726,1726,3452,800
2022-08-14,LF,France,9926,5867,699,5,4059,1692,1668,3360,694
2022-08-15,LF,France,9661,5493,773,8,4168,1691,1704,3395,765
2022-08-16,LF,France,9490,5312,804,34,4178,1696,1678,3374,770
2022-08-17,LF,France,9151,5071,829,31,4080,1620,1631,3251,798
2022-08-18,LF,France,9628,5410,868,32,4218,1670,1680,3350,836
2022-08-19,LF,France,10104,5678,961,31,4426,1727,1738,3465,930
2022-08-20,LF,France,10564,6246,816,17,4318,1737,1765,3502,799
2022-08-21,LF,France,10113,5871,834,4,4242,1706,1702,3408,830
2022-08-22,LF,France,9978,5476,1024,30,4502,1726,1752,3478,994
2022-08-23,LF,France,9743,5318,1017,45,4425,1696,1712,3408,972
2022-08-24,LF,France,9894,5442,1052,36,4452,1705,1695,3400,1016
2022-08-25,LF,France,10060,5489,1033,32,4571,1764,1774,3538,1001
2022-08-26,LF,France,10226,5650,1043,25,4576,1769,1764,3533,1018
2022-08-27,LF,France,10286,6010,841,25,4276,1704,1731,3435,816
2022-08-28,LF,France,10213,5904,861,5,4309,1743,1705,3448,856
2022-08-29,LF,France,10057,5569,1014,24,4488,1725,1749,3474,990
2022-08-30,LF,France,9927,5380,1003,41,4547,1765,1779,3544,962
2022-08-31,LF,France,10048,5435,1109,33,4613,1769,1735,3504,1076
2022-09-01,LF,France,10033,5532,982,43,4501,1753,1766,3519,939
2022-09-02,LF,France,9980,5597,958,34,4383,1711,1714,3425,924
2022-09-03,LF,France,10060,6057,748,13,4003,1629,1626,3255,735
2022-09-04,LF,France,10009,5863,774,5,4146,1690,1682,3372,769
2022-09-05,LF,France,9884,5425,1060,51,4459,1689,1710,3399,1009
2022-09-06,LF,France,9688,5342,1077,54,4346,1629,1640,3269,1023
2022-09-07,LF,France,9658,5301,1056,45,4357,1659,1642,3301,1011
2022-09-08,LF,France,9885,5357,1145,46,4528,1667,1716,3383,1099
2022-09-09,LF,France,10126,5507,1179,35,4619,1715,1725,3440,1144
2022-09-10,LF,France,9833,5879,744,14,3954,1617,1593,3210,730
2022-09-11,LF,France,10036,5820,829,8,4216,1701,1686,3387,821
2022-09-12,LF,France,9745,5276,1134,36,4469,1661,1674,3335,1098
2022-09-13,LF,France,9490,5224,1084,34,4266,1587,1595,3182,1050
2022-09-14,LF,France,9535,5176,1105,34,4359,1643,1611,3254,1071
2022-09-15,LF,France,10114,5482,1226,49,4632,1686,1720,3406,1177
2022-09-16,LF,France,6638,4230,475,25,2408,959,974,1933,450
2022-09-17,LF,France,10059,5883,767,20,4176,1695,1714,3409,747
2022-09-18,LF,France,9888,5770,819,4,4118,1668,1631,3299,815
2022-09-19,LF,France,9680,5205,1194,34,4475,1637,1644,3281,1160
2022-09-20,LF,France,9471,5174,1152,55,4297,1587,1558,3145,1097
2022-09-21,LF,France,9454,5161,1133,32,4293,1575,1585,3160,1101
2022-09-22,LF,France,9762,5307,1219,24,4455,1605,1631,3236,1195
2022-09-23,LF,France,10032,5409,1216,42,4623,1699,1708,3407,1174
2022-09-24,LF,France,9228,5651,585,18,3577,1502,1490,2992,567
2022-09-25,LF,France,9581,5636,752,6,3945,1614,1579,3193,746
2022-09-26,LF,France,9572,5259,1071,19,4313,1602,1640,3242,1052
2022-09-27,LF,France,9283,4990,1107,35,4293,1569,1617,3186,1072
2022-09-28,LF,France,9372,4983,1136,33,4389,1627,1626,3253,1103
2022-09-29,LF,France,8598,4404,1044,49,4194,1569,1581,3150,995
2022-09-30,LF,France,10217,5439,1235,35,4778,1746,1797,3543,1200
2022-10-01,LF,France,9323,5574,672,15,3749,1546,1531,3077,657
2022-10-02,LF,France,9563,5453,815,10,4110,1680,1615,3295,805
2022-10-03,LF,France,9547,5140,1195,67,4407,1620,1592,3212,1128
2022-10-04,LF,France,8947,4866,1118,32,4081,1492,1471,2963,1086
2022-10-05,LF,France,8951,4853,1135,38,4098,1482,1481,2963,1097
2022-10-06,LF,France,9366,5042,1179,60,4324,1570,1575,3145,1119
2022-10-07,LF,France,9653,5252,1184,44,4401,1600,1617,3217,1140
2022-10-08,LF,France,9074,5559,591,16,3515,1471,1453,2924,575
2022-10-09,LF,France,9229,5402,740,6,3827,1568,1519,3087,734
2022-10-10,LF,France,9227,5035,1126,53,4192,1528,1538,3066,1073
2022-10-11,LF,France,9043,4877,1187,41,4166,1486,1493,2979,1146
2022-10-12,LF,France,9087,4869,1154,52,4218,1530,1534,3064,1102
2022-10-13,LF,France,9332,5021,1198,57,4311,1553,1560,3113,1141
2022-10-14,LF,France,9592,5300,1101,37,4292,1598,1593,3191,1064
2022-10-15,LF,France,9179,5602,626,17,3577,1475,1476,2951,609
2022-10-16,LF,France,9352,5517,736,7,3835,1554,1545,3099,729
2022-10-17,LF,France,9063,4850,1160,41,4213,1514,1539,3053,1119
2022-10-18,LF,France,8865,4761,1095,49,4104,1497,1512,3009,1046
2022-10-19,LF,France,8925,4724,1153,44,4201,1520,1528,3048,1109
2022-10-20,LF,France,9189,4950,1145,56,4239,1559,1535,3094,1089
2022-10-21,LF,France,8845,4729,1067,24,4116,1514,1535,3049,1043
2022-10-22,LF,France,9345,5611,687,16,3734,1532,1515,3047,671
2022-10-23,LF,France,8950,5237,676,4,3713,1548,1489,3037,672
2022-10-24,LF,France,8936,4894,984,25,4042,1514,1544,3058,959
2022-10-25,LF,France,8832,4784,1032,44,4048,1510,1506,3016,988
2022-10-26,LF,France,8895,4786,1049,47,4109,1531,1529,3060,1002
2022-10-27,LF,France,9179,4980,1088,59,4199,1550,1561,3111,1029
2022-10-28,LF,France,9506,5207,1060,27,4299,1617,1622,3239,1033
2022-10-29,LF,France,9170,5547,616,11,3623,1508,1499,3007,605
2022-10-30,LF,France,8299,4875,602,4,3424,1426,1396,2822,598
2022-10-31,LF,France,7828,4289,781,20,3539,1375,1383,2758,761
2022-11-01,LF,France,6962,3792,644,5,3170,1254,1272,2526,639
2022-11-02,LF,France,7114,3577,947,22,3537,1309,1281,2590,925
2022-11-03,LF,France,7388,3811,906,24,3577,1333,1338,2671,882
2022-11-04,LF,France,8016,4168,928,23,3848,1447,1473,2920,905
2022-11-05,LF,France,7413,4300,590,15,3113,1269,1254,2523,575
2022-11-06,LF,France,7852,4345,657,2,3507,1434,1416,2850,655
2022-11-07,LF,France,7621,3871,1039,28,3750,1341,1370,2711,1011
2022-11-08,LF,France,6737,3252,1039,36,3485,1212,1234,2446,1003
2022-11-09,LF,France,6465,3129,939,16,3336,1197,1200,2397,923
2022-11-10,LF,France,7335,3620,1091,26,3715,1307,1317,2624,1065
2022-11-11,LF,France,7563,4054,733,18,3509,1395,1381,2776,715
2022-11-12,LF,France,6595,3825,468,15,2770,1153,1149,2302,453
2022-11-13,LF,France,7395,4153,634,12,3242,1334,1274,2608,622
2022-11-14,LF,France,7283,3721,989,14,3562,1264,1309,2573,975
2022-11-15,LF,France,6348,3129,940,29,3219,1140,1139,2279,911
2022-11-16,LF,France,6499,3195,1045,33,3304,1123,1136,2259,1012
2022-11-17,LF,France,6928,3456,1038,46,3472,1211,1223,2434,992
2022-11-18,LF,France,7671,3941,1018,44,3730,1368,1344,2712,974
2022-11-19,LF,France,6552,3809,502,13,2743,1127,1114,2241,489
2022-11-20,LF,France,7017,3968,563,5,3049,1249,1237,2486,558
2022-11-21,LF,France,7026,3602,950,41,3424,1213,1261,2474,909
2022-11-22,LF,France,6192,3098,878,40,3094,1125,1091,2216,838
2022-11-23,LF,France,6154,3050,917,29,3104,1102,1085,2187,888
2022-11-24,LF,France,6876,3432,1074,58,3444,1173,1197,2370,1016
2022-11-25,LF,France,7510,3865,996,34,3645,1329,1320,2649,962
2022-11-26,LF,France,6273,3624,465,14,2649,1092,1092,2184,451
2022-11-27,LF,France,6905,3889,555,3,3016,1240,1221,2461,552
2022-11-28,LF,France,6907,3525,952,17,3382,1195,1235,2430,935
2022-11-29,LF,France,6146,3014,965,25,3132,1087,1080,2167,940
2022-11-30,LF,France,6457,3153,1042,42,3304,1134,1128,2262,1000
2022-12-01,LF,France,6841,3351,1083,36,3490,1196,1211,2407,1047
2022-12-02,LF,France,7450,3760,1021,26,3690,1327,1342,2669,995
2022-12-03,LF,France,6284,3707,410,14,2577,1097,1070,2167,396
2022-12-04,LF,France,6925,3849,585,3,3076,1261,1230,2491,582
2022-12-05,LF,France,7027,3602,950,24,3425,1220,1255,2475,926
2022-12-06,LF,France,6367,3151,938,36,3216,1148,1130,2278,902
2022-12-07,LF,France,6646,3241,1039,37,3405,1180,1186,2366,1002
2022-12-08,LF,France,6977,3483,973,39,3494,1264,1257,2521,934
2022-12-09,LF,France,7378,3643,1022,46,3735,1351,1362,2713,976
2022-12-10,LF,France,6571,3826,442,11,2745,1159,1144,2303,431
2022-12-11,LF,France,6909,3785,597,8,3124,1250,1277,2527,589
2022-12-12,LF,France,7031,3451,1069,57,3580,1253,1258,2511,1012
2022-12-13,LF,France,6662,3204,998,39,3458,1219,1241,2460,959
2022-12-14,LF,France,6357,3209,889,33,3148,1148,1111,2259,856
2022-12-15,LF,France,7228,3546,1013,47,3682,1318,1351,2669,966
2022-12-16,LF,France,7948,3928,1136,40,4020,1444,1440,2884,1096
2022-12-17,LF,France,7360,4075,568,8,3285,1377,1340,2717,560
2022-12-18,LF,France,7216,3941,622,6,3275,1324,1329,2653,616
2022-12-19,LF,France,7661,3868,973,32,3793,1397,1423,2820,941
2022-12-20,LF,France,7260,3682,876,23,3578,1360,1342,2702,853
2022-12-21,LF,France,6991,3508,818,26,3483,1337,1328,2665,792
2022-12-22,LF,France,7634,3984,876,27,3650,1387,1387,2774,849
2022-12-23,LF,France,8016,4238,819,10,3778,1484,1475,2959,809
2022-12-24,LF,France,6338,3561,401,10,2777,1192,1184,2376,391
2022-12-25,LF,France,4567,2276,392,3,2291,949,950,1899,389
2022-12-26,LF,France,7337,3837,788,11,3500,1364,1348,2712,777
2022-12-27,LF,France,7132,3817,693,7,3315,1309,1313,2622,686
2022-01-01,UG,Georgia,181,107,0,0,74,37,37,74,0
2022-01-02,UG,Georgia,258,157,0,0,101,50,51,101,0
2022-01-03,UG,Georgia,245,153,2,0,92,47,43,90,2
2022-01-04,UG,Georgia,211,119,0,0,92,45,47,92,0
2022-01-05,UG,Georgia,219,129,2,0,90,44,44,88,2
2022-01-06,UG,Georgia,205,131,0,0,74,34,40,74,0
2022-01-07,UG,Georgia,234,138,2,0,96,48,46,94,2
2022-01-08,UG,Georgia,222,134,1,0,88,45,42,87,1
2022-01-09,UG,Georgia,239,147,0,0,92,47,45,92,0
2022-01-10,UG,Georgia,212,144,2,0,68,32,34,66,2
2022-01-11,UG,Georgia,199,121,0,0,78,40,38,78,0
2022-01-12,UG,Georgia,197,114,2,0,83,39,42,81,2
2022-01-13,UG,Georgia,222,133,0,0,89,45,44,89,0
2022-01-14,UG,Georgia,226,134,2,0,92,44,46,90,2
2022-01-15,UG,Georgia,211,134,0,0,77,38,39,77,0
2022-01-16,UG,Georgia,201,116,0,0,85,41,44,85,0
2022-01-17,UG,Georgia,204,131,2,0,73,38,33,71,2
2022-01-18,UG,Georgia,171,100,0,0,71,37,34,71,0
2022-01-19,UG,Georgia,196,119,2,0,77,36,39,75,2
2022-01-20,UG,Georgia,190,110,0,0,80,40,40,80,0
2022-01-21,UG,Georgia,214,120,2,0,94,46,46,92,2
2022-01-22,UG,Georgia,208,129,0,0,79,39,40,79,0
2022-01-23,UG,Georgia,191,115,0,0,76,39,37,76,0
2022-01-24,UG,Georgia,179,118,3,1,61,31,27,58,2
2022-01-25,UG,Georgia,135,71,0,0,64,30,34,64,0
2022-01-26,UG,Georgia,165,86,2,0,79,38,39,77,2
2022-01-27,UG,Georgia,200,114,0,0,86,43,43,86,0
2022-01-28,UG,Georgia,185,102,2,0,83,41,40,81,2
2022-01-29,UG,Georgia,218,131,2,0,87,43,42,85,2
2022-01-30,UG,Georgia,211,128,0,0,83,42,41,83,0
2022-01-31,UG,Georgia,182,118,2,0,64,30,32,62,2
2022-02-01,UG,Georgia,176,106,0,0,70,37,33,70,0
2022-02-02,UG,Georgia,184,111,2,0,73,32,39,71,2
2022-02-03,UG,Georgia,188,105,0,0,83,41,42,83,0
2022-02-04,UG,Georgia,193,106,2,0,87,42,43,85,2
2022-02-05,UG,Georgia,196,117,0,0,79,41,38,79,0
2022-02-06,UG,Georgia,197,114,0,0,83,41,42,83,0
2022-02-07,UG,Georgia,178,116,2,0,62,31,29,60,2
2022-02-08,UG,Georgia,151,87,0,0,64,32,32,64,0
2022-02-09,UG,Georgia,178,108,2,0,70,33,35,68,2
2022-02-10,UG,Georgia,167,98,0,0,69,36,33,69,0
2022-02-11,UG,Georgia,205,115,2,0,90,43,45,88,2
2022-02-12,UG,Georgia,204,122,2,2,82,41,39,80,0
2022-02-13,UG,Georgia,206,121,0,0,85,42,43,85,0
2022-02-14,UG,Georgia,179,121,2,0,58,28,28,56,2
2022-02-15,UG,Georgia,170,98,0,0,72,36,36,72,0
2022-02-16,UG,Georgia,184,113,2,0,71,34,35,69,2
2022-02-17,UG,Georgia,192,113,1,1,79,40,38,78,0
2022-02-18,UG,Georgia,214,123,2,0,91,43,46,89,2
2022-02-19,UG,Georgia,206,123,0,0,83,41,42,83,0
2022-02-20,UG,Georgia,220,127,0,0,93,46,47,93,0
2022-02-21,UG,Georgia,186,117,2,0,69,35,32,67,2
2022-02-22,UG,Georgia,188,114,0,0,74,38,36,74,0
2022-02-23,UG,Georgia,203,126,2,0,77,36,39,75,2
2022-02-24,UG,Georgia,239,153,1,1,86,42,43,85,0
2022-02-25,UG,Georgia,271,185,2,0,86,44,40,84,2
2022-02-26,UG,Georgia,337,246,0,0,91,44,47,91,0
2022-02-27,UG,Georgia,335,236,1,0,99,48,50,98,1
2022-02-28,UG,Georgia,310,242,2,0,68,35,31,66,2
2022-03-01,UG,Georgia,291,219,0,0,72,35,37,72,0
2022-03-02,UG,Georgia,305,214,2,0,91,44,45,89,2
2022-03-03,UG,Georgia,326,229,0,0,97,49,48,97,0
2022-03-04,UG,Georgia,370,255,2,0,115,54,59,113,2
2022-03-05,UG,Georgia,380,281,0,0,99,49,50,99,0
2022-03-06,UG,Georgia,356,249,0,0,107,53,54,107,0
2022-03-07,UG,Georgia,347,256,2,0,91,46,43,89,2
2022-03-08,UG,Georgia,301,208,0,0,93,47,46,93,0
2022-03-09,UG,Georgia,303,206,2,0,97,48,47,95,2
2022-03-10,UG,Georgia,298,202,0,0,96,47,49,96,0
2022-03-11,UG,Georgia,281,181,4,2,100,50,46,96,2
2022-03-12,UG,Georgia,305,215,0,0,90,43,47,90,0
2022-03-13,UG,Georgia,254,161,1,0,93,44,48,92,1
2022-03-14,UG,Georgia,251,188,0,0,63,33,30,63,0
2022-03-15,UG,Georgia,260,184,0,0,76,38,38,76,0
2022-03-16,UG,Georgia,295,202,0,0,93,47,46,93,0
2022-03-17,UG,Georgia,296,185,3,1,111,49,59,108,2
2022-03-18,UG,Georgia,291,196,0,0,95,50,45,95,0
2022-03-19,UG,Georgia,306,218,0,0,88,45,43,88,0
2022-03-20,UG,Georgia,309,216,0,0,93,47,46,93,0
2022-03-21,UG,Georgia,278,202,0,0,76,40,36,76,0
2022-03-22,UG,Georgia,281,194,0,0,87,42,45,87,0
2022-03-23,UG,Georgia,295,209,0,0,86,43,43,86,0
2022-03-24,UG,Georgia,329,229,0,0,100,48,52,100,0
2022-03-25,UG,Georgia,287,199,0,0,88,44,44,88,0
2022-03-26,UG,Georgia,322,226,0,0,96,48,48,96,0
2022-03-27,UG,Georgia,316,218,0,0,98,50,48,98,0
2022-03-28,UG,Georgia,290,196,0,0,94,48,46,94,0
2022-03-29,UG,Georgia,296,203,0,0,93,45,48,93,0
2022-03-30,UG,Georgia,312,206,0,0,106,51,55,106,0
2022-03-31,UG,Georgia,320,212,1,0,108,55,52,107,1
2022-04-01,UG,Georgia,310,215,2,1,95,48,45,93,1
2022-04-02,UG,Georgia,303,216,0,0,87,44,43,87,0
2022-04-03,UG,Georgia,310,211,2,0,99,46,51,97,2
2022-04-04,UG,Georgia,290,212,0,0,78,40,38,78,0
2022-04-05,UG,Georgia,284,189,1,0,95,48,46,94,1
2022-04-06,UG,Georgia,291,212,0,0,79,38,41,79,0
2022-04-07,UG,Georgia,304,210,0,0,94,48,46,94,0
2022-04-08,UG,Georgia,288,204,0,0,84,41,43,84,0
2022-04-09,UG,Georgia,292,211,0,0,81,41,40,81,0
2022-04-10,UG,Georgia,309,214,0,0,95,46,49,95,0
2022-04-11,UG,Georgia,270,194,2,0,76,36,38,74,2
2022-04-12,UG,Georgia,279,197,0,0,82,42,40,82,0
2022-04-13,UG,Georgia,285,211,2,0,74,35,37,72,2
2022-04-14,UG,Georgia,345,239,0,0,106,52,54,106,0
2022-04-15,UG,Georgia,310,221,2,0,89,46,41,87,2
2022-04-16,UG,Georgia,293,208,0,0,85,42,43,85,0
2022-04-17,UG,Georgia,313,211,2,0,102,49,51,100,2
2022-04-18,UG,Georgia,263,192,2,0,71,37,32,69,2
2022-04-19,UG,Georgia,298,207,2,0,91,45,44,89,2
2022-04-20,UG,Georgia,267,197,2,0,70,33,35,68,2
2022-04-21,UG,Georgia,323,227,0,0,96,47,49,96,0
2022-04-22,UG,Georgia,315,215,3,1,100,48,49,97,2
2022-04-23,UG,Georgia,322,231,0,0,91,46,45,91,0
2022-04-24,UG,Georgia,329,220,3,1,109,52,54,106,2
2022-04-25,UG,Georgia,276,197,2,0,79,40,37,77,2
2022-04-26,UG,Georgia,296,204,0,0,92,47,45,92,0
2022-04-27,UG,Georgia,299,212,2,0,87,40,45,85,2
2022-04-28,UG,Georgia,346,244,2,1,102,51,49,100,1
2022-04-29,UG,Georgia,334,232,3,0,102,50,49,99,3
2022-04-30,UG,Georgia,383,252,7,1,131,61,63,124,6
2022-05-01,UG,Georgia,379,242,2,0,137,67,68,135,2
2022-05-02,UG,Georgia,304,197,2,0,107,52,53,105,2
2022-05-03,UG,Georgia,320,216,1,0,104,52,51,103,1
2022-05-04,UG,Georgia,320,212,2,0,108,54,52,106,2
2022-05-05,UG,Georgia,341,222,0,0,119,59,60,119,0
2022-05-06,UG,Georgia,325,219,2,0,106,50,54,104,2
2022-05-07,UG,Georgia,323,215,0,0,108,55,53,108,0
2022-05-08,UG,Georgia,335,230,0,0,105,54,51,105,0
2022-05-09,UG,Georgia,318,217,2,0,101,49,50,99,2
2022-05-10,UG,Georgia,320,218,0,0,102,53,49,102,0
2022-05-11,UG,Georgia,329,236,2,0,93,42,49,91,2
2022-05-12,UG,Georgia,368,252,0,0,116,59,57,116,0
2022-05-13,UG,Georgia,324,227,2,0,97,48,47,95,2
2022-05-14,UG,Georgia,329,235,0,0,94,47,47,94,0
2022-05-15,UG,Georgia,358,249,2,0,109,52,55,107,2
2022-05-16,UG,Georgia,326,213,3,1,113,56,54,110,2
2022-05-17,UG,Georgia,327,220,1,0,107,55,51,106,1
2022-05-18,UG,Georgia,340,247,0,0,93,43,50,93,0
2022-05-19,UG,Georgia,371,256,2,1,115,58,55,113,1
2022-05-20,UG,Georgia,318,224,4,1,94,45,45,90,3
2022-05-21,UG,Georgia,341,238,1,0,103,52,50,102,1
2022-05-22,UG,Georgia,359,249,3,1,110,53,54,107,2
2022-05-23,UG,Georgia,361,249,2,0,112,57,53,110,2
2022-05-24,UG,Georgia,329,217,0,0,112,55,57,112,0
2022-05-25,UG,Georgia,348,247,1,0,101,50,50,100,1
2022-05-26,UG,Georgia,382,265,3,0,117,56,58,114,3
2022-05-27,UG,Georgia,323,231,5,0,92,41,46,87,5
2022-05-28,UG,Georgia,347,254,0,0,93,47,46,93,0
2022-05-29,UG,Georgia,388,272,2,0,116,57,57,114,2
2022-05-30,UG,Georgia,365,266,2,0,99,47,50,97,2
2022-05-31,UG,Georgia,341,234,0,0,107,54,53,107,0
2022-06-01,UG,Georgia,367,272,2,0,95,49,44,93,2
2022-06-02,UG,Georgia,375,267,0,0,108,53,55,108,0
2022-06-03,UG,Georgia,364,258,2,0,106,53,51,104,2
2022-06-04,UG,Georgia,388,268,2,0,120,58,60,118,2
2022-06-05,UG,Georgia,377,270,2,0,107,53,52,105,2
2022-06-06,UG,Georgia,376,271,2,0,105,52,51,103,2
2022-06-07,UG,Georgia,341,227,4,0,114,56,54,110,4
2022-06-08,UG,Georgia,368,274,2,0,94,45,47,92,2
2022-06-09,UG,Georgia,403,287,1,0,116,56,59,115,1
2022-06-10,UG,Georgia,399,280,4,0,119,58,57,115,4
2022-06-11,UG,Georgia,395,280,0,0,115,59,56,115,0
2022-06-12,UG,Georgia,432,310,4,0,122,56,62,118,4
2022-06-13,UG,Georgia,378,280,3,0,98,50,45,95,3
2022-06-14,UG,Georgia,379,265,1,0,114,57,56,113,1
2022-06-15,UG,Georgia,399,285,4,1,114,53,57,110,3
2022-06-16,UG,Georgia,420,310,0,0,110,57,53,110,0
2022-06-17,UG,Georgia,381,272,2,0,109,51,56,107,2
2022-06-18,UG,Georgia,413,298,2,0,115,58,55,113,2
2022-06-19,UG,Georgia,413,294,4,0,119,55,60,115,4
2022-06-20,UG,Georgia,419,322,2,0,97,49,46,95,2
2022-06-21,UG,Georgia,415,291,0,0,124,61,63,124,0
2022-06-22,UG,Georgia,426,320,1,0,106,52,53,105,1
2022-06-23,UG,Georgia,439,311,0,0,128,64,64,128,0
2022-06-24,UG,Georgia,419,306,4,0,113,56,53,109,4
2022-06-25,UG,Georgia,441,312,0,0,129,66,63,129,0
2022-06-26,UG,Georgia,443,325,0,0,118,56,62,118,0
2022-06-27,UG,Georgia,425,319,2,0,106,54,50,104,2
2022-06-28,UG,Georgia,415,283,1,0,132,66,65,131,1
2022-06-29,UG,Georgia,423,323,2,0,100,49,49,98,2
2022-06-30,UG,Georgia,465,329,0,0,136,69,67,136,0
2022-07-01,UG,Georgia,434,314,2,0,120,58,60,118,2
2022-07-02,UG,Georgia,470,329,2,0,141,70,69,139,2
2022-07-03,UG,Georgia,469,337,2,0,132,64,66,130,2
2022-07-04,UG,Georgia,472,345,2,0,127,60,65,125,2
2022-07-05,UG,Georgia,450,296,2,0,154,79,73,152,2
2022-07-06,UG,Georgia,454,325,2,0,129,63,64,127,2
2022-07-07,UG,Georgia,456,308,0,0,148,74,74,148,0
2022-07-08,UG,Georgia,471,329,3,0,142,69,70,139,3
2022-07-09,UG,Georgia,511,352,5,2,159,78,76,154,3
2022-07-10,UG,Georgia,480,344,3,1,136,65,68,133,2
2022-07-11,UG,Georgia,461,320,6,0,141,69,66,135,6
2022-07-12,UG,Georgia,477,311,2,0,166,82,82,164,2
2022-07-13,UG,Georgia,491,345,4,0,146,68,74,142,4
2022-07-14,UG,Georgia,487,331,4,0,156,76,76,152,4
2022-07-15,UG,Georgia,478,345,4,0,133,66,63,129,4
2022-07-16,UG,Georgia,475,331,2,0,144,73,69,142,2
2022-07-17,UG,Georgia,492,355,4,0,137,63,70,133,4
2022-07-18,UG,Georgia,474,334,5,1,140,68,67,135,4
2022-07-19,UG,Georgia,483,326,4,1,157,77,76,153,3
2022-07-20,UG,Georgia,476,347,3,0,129,64,62,126,3
2022-07-21,UG,Georgia,520,345,7,0,175,81,87,168,7
2022-07-22,UG,Georgia,467,342,3,0,125,63,59,122,3
2022-07-23,UG,Georgia,493,348,6,0,145,70,69,139,6
2022-07-24,UG,Georgia,468,330,2,0,138,68,68,136,2
2022-07-25,UG,Georgia,468,329,6,0,139,66,67,133,6
2022-07-26,UG,Georgia,495,332,3,1,163,80,80,160,2
2022-07-27,UG,Georgia,470,336,3,0,134,66,65,131,3
2022-07-28,UG,Georgia,505,359,2,0,146,71,73,144,2
2022-07-29,UG,Georgia,478,341,2,0,137,69,66,135,2
2022-07-30,UG,Georgia,506,364,2,0,142,71,69,140,2
2022-07-31,UG,Georgia,494,355,2,0,139,67,70,137,2
2022-08-01,UG,Georgia,497,359,2,0,138,68,68,136,2
2022-08-02,UG,Georgia,486,334,2,0,152,78,72,150,2
2022-08-03,UG,Georgia,494,363,2,0,131,63,66,129,2
2022-08-04,UG,Georgia,523,353,3,0,170,81,86,167,3
2022-08-05,UG,Georgia,489,346,2,0,143,71,70,141,2
2022-08-06,UG,Georgia,502,356,2,0,146,73,71,144,2
2022-08-07,UG,Georgia,499,349,2,0,150,74,74,148,2
2022-08-08,UG,Georgia,480,345,2,0,135,67,66,133,2
2022-08-09,UG,Georgia,501,342,2,0,159,79,78,157,2
2022-08-10,UG,Georgia,492,364,4,1,128,62,62,124,3
2022-08-11,UG,Georgia,521,354,6,0,167,81,80,161,6
2022-08-12,UG,Georgia,488,346,2,0,142,71,69,140,2
2022-08-13,UG,Georgia,498,352,4,1,146,71,71,142,3
2022-08-14,UG,Georgia,504,359,2,0,145,69,74,143,2
2022-08-15,UG,Georgia,473,324,5,0,149,73,71,144,5
2022-08-16,UG,Georgia,518,354,2,0,164,82,80,162,2
2022-08-17,UG,Georgia,488,352,2,0,136,68,66,134,2
2022-08-18,UG,Georgia,534,354,4,0,180,86,90,176,4
2022-08-19,UG,Georgia,499,349,2,0,150,76,72,148,2
2022-08-20,UG,Georgia,518,370,2,0,148,74,72,146,2
2022-08-21,UG,Georgia,525,368,4,0,157,73,80,153,4
2022-08-22,UG,Georgia,482,339,2,0,143,71,70,141,2
2022-08-23,UG,Georgia,503,345,2,0,158,81,75,156,2
2022-08-24,UG,Georgia,504,361,7,0,143,65,71,136,7
2022-08-25,UG,Georgia,527,362,3,0,165,81,81,162,3
2022-08-26,UG,Georgia,531,366,2,0,165,83,80,163,2
2022-08-27,UG,Georgia,533,384,3,0,149,73,73,146,3
2022-08-28,UG,Georgia,544,388,2,0,156,74,80,154,2
2022-08-29,UG,Georgia,498,342,5,0,156,78,73,151,5
2022-08-30,UG,Georgia,522,358,2,0,164,80,82,162,2
2022-08-31,UG,Georgia,512,373,3,1,139,67,69,136,2
2022-09-01,UG,Georgia,563,402,2,0,161,81,78,159,2
2022-09-02,UG,Georgia,505,368,2,0,137,69,66,135,2
2022-09-03,UG,Georgia,543,399,7,1,144,68,69,137,6
2022-09-04,UG,Georgia,526,389,3,0,137,66,68,134,3
2022-09-05,UG,Georgia,469,344,2,0,125,60,63,123,2
2022-09-06,UG,Georgia,532,379,2,0,153,77,74,151,2
2022-09-07,UG,Georgia,503,382,2,0,121,60,59,119,2
2022-09-08,UG,Georgia,534,368,2,0,166,80,84,164,2
2022-09-09,UG,Georgia,505,363,4,0,142,68,70,138,4
2022-09-10,UG,Georgia,552,412,3,0,140,68,69,137,3
2022-09-11,UG,Georgia,518,370,3,0,148,73,72,145,3
2022-09-12,UG,Georgia,483,356,2,0,127,65,60,125,2
2022-09-13,UG,Georgia,667,510,3,1,157,77,77,154,2
2022-09-14,UG,Georgia,603,484,4,0,119,55,60,115,4
2022-09-15,UG,Georgia,628,459,2,0,169,83,84,167,2
2022-09-16,UG,Georgia,563,432,3,0,131,66,62,128,3
2022-09-17,UG,Georgia,584,451,2,0,133,67,64,131,2
2022-09-18,UG,Georgia,587,448,4,0,139,64,71,135,4
2022-09-19,UG,Georgia,540,421,3,0,119,58,58,116,3
2022-09-20,UG,Georgia,552,420,2,0,132,66,64,130,2
2022-09-21,UG,Georgia,548,427,3,0,121,60,58,118,3
2022-09-22,UG,Georgia,587,441,3,0,146,71,72,143,3
2022-09-23,UG,Georgia,568,442,3,0,126,62,61,123,3
2022-09-24,UG,Georgia,594,457,3,0,137,69,65,134,3
2022-09-25,UG,Georgia,591,470,2,0,121,59,60,119,2
2022-09-26,UG,Georgia,523,415,2,0,108,52,54,106,2
2022-09-27,UG,Georgia,587,457,3,0,130,66,61,127,3
2022-09-28,UG,Georgia,556,451,3,1,105,51,51,102,2
2022-09-29,UG,Georgia,605,453,4,2,152,71,77,148,2
2022-09-30,UG,Georgia,580,452,4,1,128,65,59,124,3
2022-10-01,UG,Georgia,590,474,2,0,116,57,57,114,2
2022-10-02,UG,Georgia,592,469,3,0,123,59,61,120,3
2022-10-03,UG,Georgia,499,394,3,0,105,51,51,102,3
2022-10-04,UG,Georgia,529,417,3,0,112,55,54,109,3
2022-10-05,UG,Georgia,528,422,3,1,106,50,53,103,2
2022-10-06,UG,Georgia,542,395,2,0,147,71,74,145,2
2022-10-07,UG,Georgia,519,406,3,0,113,55,55,110,3
2022-10-08,UG,Georgia,570,436,2,0,134,65,67,132,2
2022-10-09,UG,Georgia,556,436,2,0,120,61,57,118,2
2022-10-10,UG,Georgia,494,389,2,0,105,53,50,103,2
2022-10-11,UG,Georgia,524,409,2,0,115,57,56,113,2
2022-10-12,UG,Georgia,546,437,2,0,109,51,56,107,2
2022-10-13,UG,Georgia,565,429,3,0,136,65,68,133,3
2022-10-14,UG,Georgia,537,424,2,0,113,59,52,111,2
2022-10-15,UG,Georgia,555,433,2,0,122,60,60,120,2
2022-10-16,UG,Georgia,555,443,2,0,112,54,56,110,2
2022-10-17,UG,Georgia,471,367,4,0,104,50,50,100,4
2022-10-18,UG,Georgia,520,397,2,0,123,64,57,121,2
2022-10-19,UG,Georgia,508,414,2,0,94,41,51,92,2
2022-10-20,UG,Georgia,553,414,2,0,139,68,69,137,2
2022-10-21,UG,Georgia,504,395,2,0,109,56,51,107,2
2022-10-22,UG,Georgia,537,429,2,0,108,52,54,106,2
2022-10-23,UG,Georgia,519,412,2,0,107,53,52,105,2
2022-10-24,UG,Georgia,467,369,2,0,98,49,47,96,2
2022-10-25,UG,Georgia,504,383,2,0,121,60,59,119,2
2022-10-26,UG,Georgia,467,373,3,1,94,45,46,91,2
2022-10-27,UG,Georgia,511,392,2,0,119,58,59,117,2
2022-10-28,UG,Georgia,502,396,3,1,106,50,53,103,2
2022-10-29,UG,Georgia,527,420,2,0,107,55,50,105,2
2022-10-30,UG,Georgia,489,386,2,0,103,49,52,101,2
2022-10-31,UG,Georgia,443,358,2,0,85,43,40,83,2
2022-11-01,UG,Georgia,457,353,2,0,104,49,53,102,2
2022-11-02,UG,Georgia,445,360,2,0,85,41,42,83,2
2022-11-03,UG,Georgia,448,324,2,0,124,61,61,122,2
2022-11-04,UG,Georgia,432,333,2,0,99,49,48,97,2
2022-11-05,UG,Georgia,464,360,2,0,104,51,51,102,2
2022-11-06,UG,Georgia,469,355,3,1,114,57,54,111,2
2022-11-07,UG,Georgia,458,360,2,0,98,47,49,96,2
2022-11-08,UG,Georgia,447,342,2,0,105,51,52,103,2
2022-11-09,UG,Georgia,454,363,2,0,91,43,46,89,2
2022-11-10,UG,Georgia,449,330,0,0,119,59,60,119,0
2022-11-11,UG,Georgia,436,330,4,0,106,52,50,102,4
2022-11-12,UG,Georgia,478,374,2,0,104,50,52,102,2
2022-11-13,UG,Georgia,485,376,2,0,109,56,51,107,2
2022-11-14,UG,Georgia,464,364,2,0,100,48,50,98,2
2022-11-15,UG,Georgia,442,342,2,0,100,49,49,98,2
2022-11-16,UG,Georgia,443,351,2,0,92,45,45,90,2
2022-11-17,UG,Georgia,457,339,3,0,118,58,57,115,3
2022-11-18,UG,Georgia,446,341,2,0,105,48,55,103,2
2022-11-19,UG,Georgia,464,368,4,0,96,48,44,92,4
2022-11-20,UG,Georgia,459,347,2,0,112,56,54,110,2
2022-11-21,UG,Georgia,424,335,4,2,89,44,41,85,2
2022-11-22,UG,Georgia,446,350,2,1,96,45,49,94,1
2022-11-23,UG,Georgia,441,354,4,1,87,42,41,83,3
2022-11-24,UG,Georgia,457,344,4,2,113,54,55,109,2
2022-11-25,UG,Georgia,444,336,4,2,108,51,53,104,2
2022-11-26,UG,Georgia,472,371,2,0,101,49,50,99,2
2022-11-27,UG,Georgia,485,373,4,0,112,56,52,108,4
2022-11-28,UG,Georgia,442,347,4,0,95,45,46,91,4
2022-11-29,UG,Georgia,459,355,4,0,104,50,50,100,4
2022-11-30,UG,Georgia,462,360,2,0,102,50,50,100,2
2022-12-01,UG,Georgia,463,324,2,0,139,68,69,137,2
2022-12-02,UG,Georgia,462,352,2,0,110,54,54,108,2
2022-12-03,UG,Georgia,482,375,1,0,107,55,51,106,1
2022-12-04,UG,Georgia,488,344,2,0,144,69,73,142,2
2022-12-05,UG,Georgia,432,333,2,0,99,49,48,97,2
2022-12-06,UG,Georgia,414,318,2,0,96,48,46,94,2
2022-12-07,UG,Georgia,430,353,2,0,77,37,38,75,2
2022-12-08,UG,Georgia,440,324,1,1,116,55,60,115,0
2022-12-09,UG,Georgia,475,361,4,2,114,54,56,110,2
2022-12-10,UG,Georgia,475,373,4,2,102,50,48,98,2
2022-12-11,UG,Georgia,438,342,1,0,96,49,46,95,1
2022-12-12,UG,Georgia,441,347,0,0,94,43,51,94,0
2022-12-13,UG,Georgia,441,340,2,0,101,50,49,99,2
2022-12-14,UG,Georgia,435,348,2,1,87,44,41,85,1
2022-12-15,UG,Georgia,461,346,2,0,115,57,56,113,2
2022-12-16,UG,Georgia,469,339,2,0,130,65,63,128,2
2022-12-17,UG,Georgia,464,354,3,0,110,53,54,107,3
2022-12-18,UG,Georgia,487,371,1,0,116,55,60,115,1
2022-12-19,UG,Georgia,434,340,2,0,94,47,45,92,2
2022-12-20,UG,Georgia,468,351,2,0,117,57,58,115,2
2022-12-21,UG,Georgia,369,270,3,0,99,47,49,96,3
2022-12-22,UG,Georgia,451,338,2,0,113,54,57,111,2
2022-12-23,UG,Georgia,469,360,2,0,109,55,52,107,2
2022-12-24,UG,Georgia,479,365,2,0,114,56,56,112,2
2022-12-25,UG,Georgia,449,334,2,0,115,56,57,113,2
2022-12-26,UG,Georgia,448,336,2,0,112,56,54,110,2
2022-12-27,UG,Georgia,452,333,2,1,119,59,58,117,1
2022-01-01,ED,Germany,4589,2217,184,5,2372,1122,1066,2188,179
2022-01-02,ED,Germany,6631,3105,370,5,3526,1569,1587,3156,365
2022-01-03,ED,Germany,6288,2862,382,16,3426,1522,1522,3044,366
2022-01-04,ED,Germany,5552,2408,375,19,3144,1374,1395,2769,356
2022-01-05,ED,Germany,5527,2436,361,23,3091,1364,1366,2730,338
2022-01-06,ED,Germany,5596,2423,477,24,3173,1344,1352,2696,453
2022-01-07,ED,Germany,6158,2793,359,18,3365,1515,1491,3006,341
2022-01-08,ED,Germany,5789,2727,302,11,3062,1388,1372,2760,291
2022-01-09,ED,Germany,6280,2979,330,5,3301,1473,1498,2971,325
2022-01-10,ED,Germany,5308,2234,413,10,3074,1303,1358,2661,403
2022-01-11,ED,Germany,4643,1892,467,21,2751,1158,1126,2284,446
2022-01-12,ED,Germany,4570,1866,451,27,2704,1118,1135,2253,424
2022-01-13,ED,Germany,4629,1854,491,31,2775,1154,1130,2284,460
2022-01-14,ED,Germany,5265,2167,462,23,3098,1325,1311,2636,439
2022-01-15,ED,Germany,4615,2142,292,16,2473,1096,1085,2181,276
2022-01-16,ED,Germany,4895,2265,314,5,2630,1146,1170,2316,309
2022-01-17,ED,Germany,4616,1920,401,13,2696,1127,1168,2295,388
2022-01-18,ED,Germany,4185,1671,462,23,2514,1026,1026,2052,439
2022-01-19,ED,Germany,4361,1742,524,29,2619,1046,1049,2095,495
2022-01-20,ED,Germany,4520,1785,495,23,2735,1125,1115,2240,472
2022-01-21,ED,Germany,5238,2184,491,21,3054,1292,1271,2563,470
2022-01-22,ED,Germany,4449,2140,245,6,2309,1036,1028,2064,239
2022-01-23,ED,Germany,4942,2287,396,13,2655,1122,1137,2259,383
2022-01-24,ED,Germany,4527,1893,470,14,2634,1052,1112,2164,456
2022-01-25,ED,Germany,3878,1517,470,34,2361,947,944,1891,436
2022-01-26,ED,Germany,4281,1776,441,16,2505,1039,1025,2064,425
2022-01-27,ED,Germany,4532,1830,501,20,2702,1111,1090,2201,481
2022-01-28,ED,Germany,5354,2186,567,24,3168,1305,1296,2601,543
2022-01-29,ED,Germany,4544,2144,254,14,2400,1077,1069,2146,240
2022-01-30,ED,Germany,4833,2167,369,7,2666,1149,1148,2297,362
2022-01-31,ED,Germany,4502,1877,389,12,2625,1093,1143,2236,377
2022-02-01,ED,Germany,4395,1786,401,13,2609,1114,1094,2208,388
2022-02-02,ED,Germany,4613,1837,550,33,2776,1105,1121,2226,517
2022-02-03,ED,Germany,4909,1981,572,32,2928,1185,1171,2356,540
2022-02-04,ED,Germany,5563,2293,538,18,3270,1378,1354,2732,520
2022-02-05,ED,Germany,5074,2357,427,18,2717,1150,1140,2290,409
2022-02-06,ED,Germany,5158,2431,303,3,2727,1193,1231,2424,300
2022-02-07,ED,Germany,4981,2062,498,22,2919,1192,1229,2421,476
2022-02-08,ED,Germany,4532,1802,535,39,2730,1100,1095,2195,496
2022-02-09,ED,Germany,4941,1940,633,38,3001,1196,1172,2368,595
2022-02-10,ED,Germany,5266,2164,594,17,3102,1249,1259,2508,577
2022-02-11,ED,Germany,6021,2530,541,19,3491,1508,1442,2950,522
2022-02-12,ED,Germany,5682,2690,497,20,2992,1263,1232,2495,477
2022-02-13,ED,Germany,5599,2563,466,21,3036,1257,1313,2570,445
2022-02-14,ED,Germany,5274,2264,487,13,3010,1248,1275,2523,474
2022-02-15,ED,Germany,4800,1938,554,25,2862,1142,1166,2308,529
2022-02-16,ED,Germany,4903,2018,468,28,2885,1211,1206,2417,440
2022-02-17,ED,Germany,4858,2113,313,4,2745,1210,1222,2432,309
2022-02-18,ED,Germany,5575,2372,405,27,3203,1411,1387,2798,378
2022-02-19,ED,Germany,5710,2844,276,12,2866,1317,1273,2590,264
2022-02-20,ED,Germany,5673,2656,288,6,3017,1357,1372,2729,282
2022-02-21,ED,Germany,5218,2253,412,8,2965,1251,1302,2553,404
2022-02-22,ED,Germany,4951,2051,540,37,2900,1188,1172,2360,503
2022-02-23,ED,Germany,5345,2108,672,51,3237,1290,1275,2565,621
2022-02-24,ED,Germany,5573,2290,578,24,3283,1357,1348,2705,554
2022-02-25,ED,Germany,6133,2664,478,30,3469,1503,1488,2991,448
2022-02-26,ED,Germany,5883,2829,432,33,3054,1325,1297,2622,399
2022-02-27,ED,Germany,6003,2725,462,24,3278,1402,1414,2816,438
2022-02-28,ED,Germany,5783,2374,591,26,3409,1392,1426,2818,565
2022-03-01,ED,Germany,5403,2123,594,32,3280,1336,1350,2686,562
2022-03-02,ED,Germany,5596,2254,607,33,3342,1381,1354,2735,574
2022-03-03,ED,Germany,5802,2358,646,32,3444,1398,1400,2798,614
2022-03-04,ED,Germany,6617,2733,635,27,3884,1638,1611,3249,608
2022-03-05,ED,Germany,5905,2743,447,27,3162,1373,1342,2715,420
2022-03-06,ED,Germany,6229,2811,463,23,3418,1471,1484,2955,440
2022-03-07,ED,Germany,6024,2535,552,23,3489,1450,1487,2937,529
2022-03-08,ED,Germany,5419,2203,590,35,3216,1301,1325,2626,555
2022-03-09,ED,Germany,5746,2294,642,35,3452,1405,1405,2810,607
2022-03-10,ED,Germany,5965,2386,668,29,3579,1459,1452,2911,639
2022-03-11,ED,Germany,6573,2698,620,29,3875,1651,1604,3255,591
2022-03-12,ED,Germany,5703,2600,415,29,3103,1339,1349,2688,386
2022-03-13,ED,Germany,6151,2771,455,15,3380,1462,1463,2925,440
2022-03-14,ED,Germany,5972,2595,581,44,3377,1374,1422,2796,537
2022-03-15,ED,Germany,5336,2195,539,32,3141,1321,1281,2602,507
2022-03-16,ED,Germany,5824,2307,658,34,3517,1421,1438,2859,624
2022-03-17,ED,Germany,6002,2422,662,40,3580,1473,1445,2918,622
2022-03-18,ED,Germany,6850,2820,713,35,4030,1641,1676,3317,678
2022-03-19,ED,Germany,5851,2703,412,23,3148,1394,1342,2736,389
2022-03-20,ED,Germany,6298,2816,449,16,3482,1496,1537,3033,433
2022-03-21,ED,Germany,6252,2626,617,34,3626,1493,1516,3009,583
2022-03-22,ED,Germany,5262,2234,532,42,3028,1235,1261,2496,490
2022-03-23,ED,Germany,6035,2434,672,42,3601,1492,1437,2929,630
2022-03-24,ED,Germany,6233,2467,688,43,3766,1538,1540,3078,645
2022-03-25,ED,Germany,6886,2861,658,34,4025,1693,1674,3367,624
2022-03-26,ED,Germany,5920,2652,450,17,3268,1420,1398,2818,433
2022-03-27,ED,Germany,7032,3195,485,13,3837,1666,1686,3352,472
2022-03-28,ED,Germany,7195,3091,733,46,4104,1654,1717,3371,687
2022-03-29,ED,Germany,6568,2711,694,39,3857,1594,1569,3163,655
2022-03-30,ED,Germany,6917,2887,696,29,4030,1661,1673,3334,667
2022-03-31,ED,Germany,7168,2986,648,27,4182,1793,1741,3534,621
2022-04-01,ED,Germany,7541,3191,573,15,4350,1874,1903,3777,558
2022-04-02,ED,Germany,6607,3021,406,22,3586,1602,1578,3180,384
2022-04-03,ED,Germany,7257,3241,474,14,4016,1770,1772,3542,460
2022-04-04,ED,Germany,7181,3054,591,25,4127,1738,1798,3536,566
2022-04-05,ED,Germany,6781,2879,613,31,3902,1637,1652,3289,582
2022-04-06,ED,Germany,7381,3143,735,51,4238,1775,1728,3503,684
2022-04-07,ED,Germany,7511,3209,566,19,4302,1862,1874,3736,547
2022-04-08,ED,Germany,8233,3435,679,35,4798,2061,2058,4119,644
2022-04-09,ED,Germany,7385,3326,380,16,4059,1855,1824,3679,364
2022-04-10,ED,Germany,7871,3527,463,15,4344,1942,1939,3881,448
2022-04-11,ED,Germany,7843,3304,738,60,4539,1897,1904,3801,678
2022-04-12,ED,Germany,7361,3036,745,45,4325,1790,1790,3580,700
2022-04-13,ED,Germany,7939,3279,777,39,4660,1965,1918,3883,738
2022-04-14,ED,Germany,8069,3360,663,37,4709,2042,2004,4046,626
2022-04-15,ED,Germany,7801,3386,524,17,4415,1945,1946,3891,507
2022-04-16,ED,Germany,7086,3226,434,25,3860,1714,1712,3426,409
2022-04-17,ED,Germany,7405,3448,381,17,3957,1779,1797,3576,364
2022-04-18,ED,Germany,7704,3487,507,19,4217,1825,1885,3710,488
2022-04-19,ED,Germany,7554,3136,687,33,4418,1868,1863,3731,654
2022-04-20,ED,Germany,7799,3262,678,28,4537,1937,1922,3859,650
2022-04-21,ED,Germany,7974,3351,664,26,4623,1973,1986,3959,638
2022-04-22,ED,Germany,8321,3434,697,25,4887,2081,2109,4190,672
2022-04-23,ED,Germany,7402,3207,512,16,4195,1846,1837,3683,496
2022-04-24,ED,Germany,8051,3564,503,17,4487,1962,2022,3984,486
2022-04-25,ED,Germany,8069,3392,753,33,4677,1944,1980,3924,720
2022-04-26,ED,Germany,7658,3149,732,34,4509,1861,1916,3777,698
2022-04-27,ED,Germany,8094,3337,862,36,4757,1960,1935,3895,826
2022-04-28,ED,Germany,8564,3543,897,33,5021,2073,2051,4124,864
2022-04-29,ED,Germany,8755,3554,862,36,5201,2183,2156,4339,826
2022-04-30,ED,Germany,7439,3296,499,15,4143,1852,1792,3644,484
2022-05-01,ED,Germany,8158,3706,516,12,4452,1963,1973,3936,504
2022-05-02,ED,Germany,8284,3531,734,34,4753,1991,2028,4019,700
2022-05-03,ED,Germany,7974,3401,748,37,4573,1910,1915,3825,711
2022-05-04,ED,Germany,8139,3396,806,23,4743,1977,1960,3937,783
2022-05-05,ED,Germany,8471,3483,820,31,4988,2104,2064,4168,789
2022-05-06,ED,Germany,8855,3656,807,28,5199,2202,2190,4392,779
2022-05-07,ED,Germany,7706,3477,515,15,4229,1878,1836,3714,500
2022-05-08,ED,Germany,8379,3780,551,18,4599,2014,2034,4048,533
2022-05-09,ED,Germany,8352,3531,725,42,4821,2024,2072,4096,683
2022-05-10,ED,Germany,7984,3348,782,40,4636,1921,1933,3854,742
2022-05-11,ED,Germany,8250,3417,799,31,4833,2026,2008,4034,768
2022-05-12,ED,Germany,8598,3530,850,42,5068,2125,2093,4218,808
2022-05-13,ED,Germany,8861,3649,806,29,5212,2219,2187,4406,777
2022-05-14,ED,Germany,7970,3564,558,12,4406,1924,1924,3848,546
2022-05-15,ED,Germany,8583,3820,628,14,4763,2039,2096,4135,614
2022-05-16,ED,Germany,8284,3444,689,26,4840,2064,2087,4151,663
2022-05-17,ED,Germany,8130,3346,854,29,4784,1973,1957,3930,825
2022-05-18,ED,Germany,8419,3458,815,22,4961,2096,2050,4146,793
2022-05-19,ED,Germany,8575,3530,784,24,5045,2114,2147,4261,760
2022-05-20,ED,Germany,8687,3620,657,23,5067,2221,2189,4410,634
2022-05-21,ED,Germany,8020,3596,499,20,4424,1970,1955,3925,479
2022-05-22,ED,Germany,8636,3868,571,8,4768,2075,2122,4197,563
2022-05-23,ED,Germany,8381,3583,658,27,4798,2060,2080,4140,631
2022-05-24,ED,Germany,8368,3563,748,28,4805,2034,2023,4057,720
2022-05-25,ED,Germany,9130,3771,840,41,5359,2286,2233,4519,799
2022-05-26,ED,Germany,8593,3843,537,16,4750,2155,2058,4213,521
2022-05-27,ED,Germany,8486,3761,530,19,4725,2113,2082,4195,511
2022-05-28,ED,Germany,7979,3644,437,14,4335,1955,1943,3898,423
2022-05-29,ED,Germany,8955,4049,542,10,4906,2119,2245,4364,532
2022-05-30,ED,Germany,9094,3822,815,43,5272,2209,2248,4457,772
2022-05-31,ED,Germany,8571,3530,770,21,5041,2132,2139,4271,749
2022-06-01,ED,Germany,8935,3757,784,27,5178,2220,2174,4394,757
2022-06-02,ED,Germany,8984,3703,810,36,5281,2233,2238,4471,774
2022-06-03,ED,Germany,9398,3930,742,20,5468,2383,2343,4726,722
2022-06-04,ED,Germany,8319,3699,482,17,4620,2094,2044,4138,465
2022-06-05,ED,Germany,8190,3794,362,12,4396,2021,2013,4034,350
2022-06-06,ED,Germany,8781,3906,560,16,4875,2100,2215,4315,544
2022-06-07,ED,Germany,8711,3605,764,31,5106,2171,2171,4342,733
2022-06-08,ED,Germany,8796,3722,748,38,5074,2174,2152,4326,710
2022-06-09,ED,Germany,9066,3841,758,24,5225,2228,2239,4467,734
2022-06-10,ED,Germany,9350,3950,730,29,5400,2357,2313,4670,701
2022-06-11,ED,Germany,8317,3686,507,19,4631,2070,2054,4124,488
2022-06-12,ED,Germany,8864,4028,521,12,4836,2140,2175,4315,509
2022-06-13,ED,Germany,9003,3847,727,46,5156,2204,2225,4429,681
2022-06-14,ED,Germany,8917,3770,770,44,5147,2187,2190,4377,726
2022-06-15,ED,Germany,9168,3822,814,43,5346,2268,2264,4532,771
2022-06-16,ED,Germany,8894,3819,661,29,5075,2245,2169,4414,632
2022-06-17,ED,Germany,9078,3919,622,19,5159,2277,2260,4537,603
2022-06-18,ED,Germany,8294,3694,467,21,4600,2057,2076,4133,446
2022-06-19,ED,Germany,8973,4018,510,16,4955,2164,2281,4445,494
2022-06-20,ED,Germany,8849,3690,665,18,5159,2230,2264,4494,647
2022-06-21,ED,Germany,8977,3796,824,37,5181,2179,2178,4357,787
2022-06-22,ED,Germany,9030,3878,743,31,5152,2221,2188,4409,712
2022-06-23,ED,Germany,9231,3936,794,25,5295,2248,2253,4501,769
2022-06-24,ED,Germany,8854,3834,577,20,5020,2239,2204,4443,557
2022-06-25,ED,Germany,8334,3852,491,14,4482,1996,1995,3991,477
2022-06-26,ED,Germany,8809,4080,446,12,4729,2132,2151,4283,434
2022-06-27,ED,Germany,9013,3831,692,37,5182,2216,2274,4490,655
2022-06-28,ED,Germany,9065,3931,738,29,5134,2211,2185,4396,709
2022-06-29,ED,Germany,9141,3990,691,38,5151,2236,2224,4460,653
2022-06-30,ED,Germany,8978,3863,706,40,5115,2218,2191,4409,666
2022-07-01,ED,Germany,9014,3930,583,25,5084,2252,2249,4501,558
2022-07-02,ED,Germany,8273,3841,387,13,4432,2048,1997,4045,374
2022-07-03,ED,Germany,8741,3999,443,12,4742,2129,2170,4299,431
2022-07-04,ED,Germany,8815,3871,590,32,4944,2165,2189,4354,558
2022-07-05,ED,Germany,8704,3789,650,25,4915,2138,2127,4265,625
2022-07-06,ED,Germany,9122,3981,736,27,5141,2215,2190,4405,709
2022-07-07,ED,Germany,9296,4046,726,31,5250,2262,2262,4524,695
2022-07-08,ED,Germany,9307,3982,665,22,5325,2362,2298,4660,643
2022-07-09,ED,Germany,8405,3783,417,9,4622,2097,2108,4205,408
2022-07-10,ED,Germany,8680,4006,445,15,4674,2109,2120,4229,430
2022-07-11,ED,Germany,8916,3891,622,27,5025,2181,2222,4403,595
2022-07-12,ED,Germany,8789,3853,627,40,4936,2141,2168,4309,587
2022-07-13,ED,Germany,8898,3878,630,40,5020,2208,2182,4390,590
2022-07-14,ED,Germany,8844,3820,647,37,5024,2193,2184,4377,610
2022-07-15,ED,Germany,9185,3934,621,32,5251,2328,2302,4630,589
2022-07-16,ED,Germany,8330,3795,366,15,4535,2102,2067,4169,351
2022-07-17,ED,Germany,8539,3929,438,17,4610,2074,2098,4172,421
2022-07-18,ED,Germany,8850,3868,633,31,4982,2152,2197,4349,602
2022-07-19,ED,Germany,8680,3833,654,49,4847,2101,2092,4193,605
2022-07-20,ED,Germany,8760,3874,623,33,4886,2131,2132,4263,590
2022-07-21,ED,Germany,8801,3870,589,26,4931,2187,2155,4342,563
2022-07-22,ED,Germany,9078,3927,614,26,5151,2279,2258,4537,588
2022-07-23,ED,Germany,8236,3745,369,13,4491,2078,2044,4122,356
2022-07-24,ED,Germany,8617,3938,431,14,4679,2111,2137,4248,417
2022-07-25,ED,Germany,8783,3851,581,38,4932,2156,2195,4351,543
2022-07-26,ED,Germany,8755,3825,652,31,4930,2136,2142,4278,621
2022-07-27,ED,Germany,7812,3883,522,33,3929,1713,1694,3407,489
2022-07-28,ED,Germany,8876,3853,655,36,5023,2193,2175,4368,619
2022-07-29,ED,Germany,9005,3834,597,15,5171,2285,2289,4574,582
2022-07-30,ED,Germany,8532,3862,443,14,4670,2127,2100,4227,429
2022-07-31,ED,Germany,8767,3992,476,13,4775,2138,2161,4299,463
2022-08-01,ED,Germany,8733,3756,578,22,4977,2179,2220,4399,556
2022-08-02,ED,Germany,8804,3793,659,30,5011,2183,2169,4352,629
2022-08-03,ED,Germany,8890,3903,636,23,4987,2175,2176,4351,613
2022-08-04,ED,Germany,8754,3785,616,32,4969,2180,2173,4353,584
2022-08-05,ED,Germany,8908,3763,562,13,5145,2308,2275,4583,549
2022-08-06,ED,Germany,8366,3774,425,9,4592,2084,2083,4167,416
2022-08-07,ED,Germany,8634,3934,438,7,4700,2121,2141,4262,431
2022-08-08,ED,Germany,8816,3834,624,25,4982,2160,2198,4358,599
2022-08-09,ED,Germany,8627,3746,580,18,4881,2153,2148,4301,562
2022-08-10,ED,Germany,8833,3870,677,25,4963,2164,2122,4286,652
2022-08-11,ED,Germany,8806,3816,627,31,4990,2183,2180,4363,596
2022-08-12,ED,Germany,9064,3943,585,31,5121,2263,2273,4536,554
2022-08-13,ED,Germany,8504,3921,433,10,4583,2084,2066,4150,423
2022-08-14,ED,Germany,8671,4006,458,10,4665,2092,2115,4207,448
2022-08-15,ED,Germany,8528,3735,532,11,4793,2110,2151,4261,521
2022-08-16,ED,Germany,8603,3665,648,24,4938,2148,2142,4290,624
2022-08-17,ED,Germany,8797,3827,685,24,4970,2136,2149,4285,661
2022-08-18,ED,Germany,8798,3747,678,39,5051,2210,2163,4373,639
2022-08-19,ED,Germany,8889,3737,646,34,5152,2262,2244,4506,612
2022-08-20,ED,Germany,8152,3607,444,14,4545,2057,2044,4101,430
2022-08-21,ED,Germany,8649,3857,491,12,4792,2137,2164,4301,479
2022-08-22,ED,Germany,8862,3825,659,28,5037,2167,2211,4378,631
2022-08-23,ED,Germany,8679,3641,724,41,5038,2156,2158,4314,683
2022-08-24,ED,Germany,8977,3845,746,38,5132,2193,2193,4386,708
2022-08-25,ED,Germany,8907,3775,729,37,5132,2222,2181,4403,692
2022-08-26,ED,Germany,8757,3666,607,26,5091,2241,2243,4484,581
2022-08-27,ED,Germany,8240,3703,421,14,4537,2071,2045,4116,407
2022-08-28,ED,Germany,8682,3900,480,9,4782,2140,2162,4302,471
2022-08-29,ED,Germany,8822,3712,703,30,5110,2186,2221,4407,673
2022-08-30,ED,Germany,8757,3771,675,27,4986,2157,2154,4311,648
2022-08-31,ED,Germany,9026,3883,750,43,5143,2191,2202,4393,707
2022-09-01,ED,Germany,9084,3878,635,19,5206,2306,2265,4571,616
2022-09-02,ED,Germany,8461,3983,510,24,4478,1967,2001,3968,486
2022-09-03,ED,Germany,8245,3746,379,9,4499,2083,2037,4120,370
2022-09-04,ED,Germany,8798,3949,470,5,4849,2176,2203,4379,465
2022-09-05,ED,Germany,9006,3883,624,30,5123,2222,2277,4499,594
2022-09-06,ED,Germany,8755,3747,664,25,5008,2175,2169,4344,639
2022-09-07,ED,Germany,9120,3897,710,26,5223,2260,2253,4513,684
2022-09-08,ED,Germany,9064,3853,633,18,5211,2295,2283,4578,615
2022-09-09,ED,Germany,9211,3907,648,24,5304,2323,2333,4656,624
2022-09-10,ED,Germany,8268,3720,428,9,4548,2071,2049,4120,419
2022-09-11,ED,Germany,8900,4027,505,13,4873,2179,2189,4368,492
2022-09-12,ED,Germany,8866,3738,684,29,5128,2208,2236,4444,655
2022-09-13,ED,Germany,8648,3598,736,37,5050,2159,2155,4314,699
2022-09-14,ED,Germany,8891,3716,740,37,5175,2218,2217,4435,703
2022-09-15,ED,Germany,9100,3743,780,32,5357,2275,2302,4577,748
2022-09-16,ED,Germany,9057,3970,716,36,5087,2194,2177,4371,680
2022-09-17,ED,Germany,8257,3835,380,8,4422,2037,2005,4042,372
2022-09-18,ED,Germany,8700,3924,438,8,4776,2153,2185,4338,430
2022-09-19,ED,Germany,8709,3653,674,29,5056,2169,2213,4382,645
2022-09-20,ED,Germany,8707,3600,742,37,5107,2187,2178,4365,705
2022-09-21,ED,Germany,9015,3725,761,37,5290,2273,2256,4529,724
2022-09-22,ED,Germany,9147,3784,786,36,5363,2294,2283,4577,750
2022-09-23,ED,Germany,9210,3840,736,38,5370,2305,2329,4634,698
2022-09-24,ED,Germany,8102,3680,448,16,4422,2004,1970,3974,432
2022-09-25,ED,Germany,8660,3859,531,10,4801,2138,2132,4270,521
2022-09-26,ED,Germany,8722,3671,644,34,5051,2184,2223,4407,610
2022-09-27,ED,Germany,8575,3577,707,22,4998,2144,2147,4291,685
2022-09-28,ED,Germany,8799,3656,733,21,5143,2192,2218,4410,712
2022-09-29,ED,Germany,9116,3951,770,41,5165,2208,2187,4395,729
2022-09-30,ED,Germany,9253,3837,694,30,5416,2382,2340,4722,664
2022-10-01,ED,Germany,8026,3526,406,17,4500,2080,2014,4094,389
2022-10-02,ED,Germany,8455,3796,423,6,4659,2120,2116,4236,417
2022-10-03,ED,Germany,8507,3546,577,11,4961,2129,2255,4384,566
2022-10-04,ED,Germany,8370,3385,691,26,4985,2154,2140,4294,665
2022-10-05,ED,Germany,8515,3384,724,36,5131,2217,2190,4407,688
2022-10-06,ED,Germany,8343,3441,694,29,4902,2117,2091,4208,665
2022-10-07,ED,Germany,8881,3654,681,27,5227,2279,2267,4546,654
2022-10-08,ED,Germany,7948,3420,436,6,4528,2047,2045,4092,430
2022-10-09,ED,Germany,8576,3742,524,10,4834,2145,2165,4310,514
2022-10-10,ED,Germany,8421,3461,652,13,4960,2136,2172,4308,639
2022-10-11,ED,Germany,8199,3309,728,25,4890,2090,2072,4162,703
2022-10-12,ED,Germany,8599,3508,740,20,5091,2174,2177,4351,720
2022-10-13,ED,Germany,8600,3489,732,34,5111,2190,2189,4379,698
2022-10-14,ED,Germany,8811,3533,666,23,5278,2303,2309,4612,643
2022-10-15,ED,Germany,7907,3411,484,10,4496,2032,1980,4012,474
2022-10-16,ED,Germany,8527,3664,513,15,4863,2162,2188,4350,498
2022-10-17,ED,Germany,8213,3493,622,23,4720,2031,2067,4098,599
2022-10-18,ED,Germany,7864,3334,581,34,4530,1985,1964,3949,547
2022-10-19,ED,Germany,7960,3307,637,27,4653,2007,2009,4016,610
2022-10-20,ED,Germany,8482,3416,713,32,5066,2163,2190,4353,681
2022-10-21,ED,Germany,8369,3406,643,37,4963,2164,2156,4320,606
2022-10-22,ED,Germany,7987,3561,452,12,4426,2004,1970,3974,440
2022-10-23,ED,Germany,8257,3564,516,14,4693,2095,2082,4177,502
2022-10-24,ED,Germany,8239,3449,672,27,4790,2039,2079,4118,645
2022-10-25,ED,Germany,8165,3318,768,33,4847,2038,2041,4079,735
2022-10-26,ED,Germany,8415,3373,847,43,5042,2118,2077,4195,804
2022-10-27,ED,Germany,8432,3426,763,44,5006,2114,2129,4243,719
2022-10-28,ED,Germany,8716,3550,736,37,5166,2240,2190,4430,699
2022-10-29,ED,Germany,7841,3428,446,11,4413,1995,1972,3967,435
2022-10-30,ED,Germany,7792,3432,516,8,4360,1928,1916,3844,508
2022-10-31,ED,Germany,7506,3217,560,19,4289,1843,1886,3729,541
2022-11-01,ED,Germany,6758,2763,550,16,3995,1732,1713,3445,534
2022-11-02,ED,Germany,7082,2811,708,33,4271,1776,1787,3563,675
2022-11-03,ED,Germany,7250,2896,729,25,4354,1809,1816,3625,704
2022-11-04,ED,Germany,7742,3144,685,32,4598,1957,1956,3913,653
2022-11-05,ED,Germany,6560,2815,446,9,3745,1649,1650,3299,437
2022-11-06,ED,Germany,7229,3133,507,6,4096,1790,1799,3589,501
2022-11-07,ED,Germany,7148,2959,639,21,4189,1787,1763,3550,618
2022-11-08,ED,Germany,6588,2545,709,38,4043,1647,1687,3334,671
2022-11-09,ED,Germany,6720,2529,799,40,4191,1704,1688,3392,759
2022-11-10,ED,Germany,7024,2773,738,31,4251,1752,1761,3513,707
2022-11-11,ED,Germany,7384,2996,699,29,4388,1849,1840,3689,670
2022-11-12,ED,Germany,5927,2567,435,11,3360,1467,1458,2925,424
2022-11-13,ED,Germany,6858,2960,498,8,3898,1686,1714,3400,490
2022-11-14,ED,Germany,6994,2858,677,28,4136,1733,1726,3459,649
2022-11-15,ED,Germany,6407,2487,703,39,3920,1611,1606,3217,664
2022-11-16,ED,Germany,6629,2593,679,30,4036,1684,1673,3357,649
2022-11-17,ED,Germany,6873,2657,698,34,4216,1769,1749,3518,664
2022-11-18,ED,Germany,7257,2961,626,31,4296,1837,1833,3670,595
2022-11-19,ED,Germany,5809,2563,375,17,3246,1440,1431,2871,358
2022-11-20,ED,Germany,6560,2886,442,12,3674,1614,1618,3232,430
2022-11-21,ED,Germany,6710,2753,619,19,3957,1670,1668,3338,600
2022-11-22,ED,Germany,6248,2438,679,27,3810,1567,1564,3131,652
2022-11-23,ED,Germany,6442,2508,764,31,3934,1585,1585,3170,733
2022-11-24,ED,Germany,6739,2681,710,31,4058,1684,1664,3348,679
2022-11-25,ED,Germany,7327,3016,652,31,4311,1824,1835,3659,621
2022-11-26,ED,Germany,5768,2518,410,11,3250,1422,1418,2840,399
2022-11-27,ED,Germany,6552,2927,447,11,3625,1593,1585,3178,436
2022-11-28,ED,Germany,6749,2782,615,30,3967,1665,1687,3352,585
2022-11-29,ED,Germany,6134,2442,597,26,3692,1543,1552,3095,571
2022-11-30,ED,Germany,6405,2509,640,23,3896,1620,1636,3256,617
2022-12-01,ED,Germany,6818,2744,682,22,4074,1705,1687,3392,660
2022-12-02,ED,Germany,7103,3009,573,19,4094,1747,1774,3521,554
2022-12-03,ED,Germany,5685,2539,364,9,3146,1409,1373,2782,355
2022-12-04,ED,Germany,6535,2980,406,5,3555,1582,1567,3149,401
2022-12-05,ED,Germany,6598,2868,507,10,3730,1608,1615,3223,497
2022-12-06,ED,Germany,6122,2542,550,26,3580,1508,1522,3030,524
2022-12-07,ED,Germany,6537,2642,705,30,3895,1597,1593,3190,675
2022-12-08,ED,Germany,6680,2732,646,21,3948,1675,1627,3302,625
2022-12-09,ED,Germany,7000,2918,587,21,4082,1744,1751,3495,566
2022-12-10,ED,Germany,5728,2562,337,8,3166,1417,1412,2829,329
2022-12-11,ED,Germany,6254,2866,389,10,3388,1487,1512,2999,379
2022-12-12,ED,Germany,6609,2800,617,29,3809,1591,1601,3192,588
2022-12-13,ED,Germany,6244,2530,653,27,3714,1540,1521,3061,626
2022-12-14,ED,Germany,6013,2585,523,25,3428,1424,1481,2905,498
2022-12-15,ED,Germany,6564,2820,573,21,3744,1593,1578,3171,552
2022-12-16,ED,Germany,6808,2965,480,17,3843,1706,1657,3363,463
2022-12-17,ED,Germany,6022,2875,281,8,3147,1428,1438,2866,273
2022-12-18,ED,Germany,6387,3035,346,11,3352,1500,1506,3006,335
2022-12-19,ED,Germany,6445,2991,356,11,3454,1539,1559,3098,345
2022-12-20,ED,Germany,6541,2768,536,34,3773,1630,1607,3237,502
2022-12-21,ED,Germany,6487,2581,518,22,3906,1701,1687,3388,496
2022-12-22,ED,Germany,7013,2991,481,19,4022,1764,1777,3541,462
2022-12-23,ED,Germany,7192,3142,432,15,4050,1811,1807,3618,417
2022-12-24,ED,Germany,5217,2522,213,4,2695,1208,1274,2482,209
2022-12-25,ED,Germany,4359,1954,184,2,2405,1131,1090,2221,182
2022-12-26,ED,Germany,5807,2789,255,3,3018,1395,1368,2763,252
2022-12-27,ED,Germany,6082,2727,424,21,3355,1477,1454,2931,403
2022-01-01,LG,Greece,1256,893,139,0,363,110,114,224,139
2022-01-02,LG,Greece,1560,969,235,1,591,180,176,356,234
2022-01-03,LG,Greece,1424,801,247,9,623,190,186,376,238
2022-01-04,LG,Greece,1272,733,242,19,539,147,150,297,223
2022-01-05,LG,Greece,1352,780,252,16,572,160,160,320,236
2022-01-06,LG,Greece,1327,799,217,1,528,155,156,311,216
2022-01-07,LG,Greece,1356,743,250,11,613,183,180,363,239
2022-01-08,LG,Greece,1448,901,235,5,547,152,160,312,230
2022-01-09,LG,Greece,1454,880,228,7,574,181,165,346,221
2022-01-10,LG,Greece,1175,625,229,15,550,159,162,321,214
2022-01-11,LG,Greece,993,579,199,10,414,101,114,215,189
2022-01-12,LG,Greece,1018,574,203,9,444,122,119,241,194
2022-01-13,LG,Greece,973,550,217,13,423,107,99,206,204
2022-01-14,LG,Greece,1145,640,228,9,505,136,141,277,219
2022-01-15,LG,Greece,1115,721,192,7,394,102,100,202,185
2022-01-16,LG,Greece,1219,732,221,5,487,136,130,266,216
2022-01-17,LG,Greece,1009,516,225,14,493,133,135,268,211
2022-01-18,LG,Greece,919,529,215,19,390,84,91,175,196
2022-01-19,LG,Greece,924,523,214,14,401,94,93,187,200
2022-01-20,LG,Greece,975,549,230,13,426,99,97,196,217
2022-01-21,LG,Greece,1114,609,218,7,505,143,144,287,211
2022-01-22,LG,Greece,1038,693,170,9,345,87,88,175,161
2022-01-23,LG,Greece,1093,664,183,2,429,123,123,246,181
2022-01-24,LG,Greece,735,473,101,9,262,73,88,161,92
2022-01-25,LG,Greece,627,445,75,10,182,59,48,107,65
2022-01-26,LG,Greece,861,510,176,15,351,89,86,175,161
2022-01-27,LG,Greece,978,553,222,11,425,100,103,203,211
2022-01-28,LG,Greece,1141,621,245,8,520,136,139,275,237
2022-01-29,LG,Greece,1036,680,180,5,356,90,86,176,175
2022-01-30,LG,Greece,1171,710,205,8,461,129,127,256,197
2022-01-31,LG,Greece,982,550,224,20,432,106,102,208,204
2022-02-01,LG,Greece,967,547,210,15,420,104,106,210,195
2022-02-02,LG,Greece,928,553,190,12,375,96,89,185,178
2022-02-03,LG,Greece,997,574,213,17,423,101,109,210,196
2022-02-04,LG,Greece,1136,631,231,15,505,136,138,274,216
2022-02-05,LG,Greece,1142,744,213,6,398,92,93,185,207
2022-02-06,LG,Greece,1211,729,216,4,482,138,128,266,212
2022-02-07,LG,Greece,1044,548,228,11,496,130,138,268,217
2022-02-08,LG,Greece,934,554,190,24,380,95,95,190,166
2022-02-09,LG,Greece,1059,599,247,31,460,104,109,213,216
2022-02-10,LG,Greece,1106,636,245,17,470,110,115,225,228
2022-02-11,LG,Greece,1232,657,270,12,575,153,152,305,258
2022-02-12,LG,Greece,1210,797,201,5,413,107,105,212,196
2022-02-13,LG,Greece,1286,769,227,5,517,149,141,290,222
2022-02-14,LG,Greece,1106,554,263,19,552,141,148,289,244
2022-02-15,LG,Greece,971,543,221,20,428,105,102,207,201
2022-02-16,LG,Greece,1090,618,244,23,472,115,113,228,221
2022-02-17,LG,Greece,1119,617,253,23,502,124,125,249,230
2022-02-18,LG,Greece,1288,712,256,14,576,157,163,320,242
2022-02-19,LG,Greece,1325,877,215,11,448,124,109,233,204
2022-02-20,LG,Greece,1388,865,228,11,523,148,147,295,217
2022-02-21,LG,Greece,1174,629,261,23,545,139,145,284,238
2022-02-22,LG,Greece,1057,633,217,20,424,104,103,207,197
2022-02-23,LG,Greece,1098,655,220,21,443,108,115,223,199
2022-02-24,LG,Greece,1166,689,248,14,477,116,113,229,234
2022-02-25,LG,Greece,1391,810,279,19,581,150,152,302,260
2022-02-26,LG,Greece,1376,913,226,7,463,118,119,237,219
2022-02-27,LG,Greece,1469,927,222,5,542,162,158,320,217
2022-02-28,LG,Greece,1225,683,251,17,542,144,147,291,234
2022-03-01,LG,Greece,1175,710,246,29,465,109,110,219,217
2022-03-02,LG,Greece,1268,762,259,13,506,121,126,247,246
2022-03-03,LG,Greece,1334,785,279,22,549,137,133,270,257
2022-03-04,LG,Greece,1460,840,254,15,620,183,183,366,239
2022-03-05,LG,Greece,1401,967,186,5,434,122,126,248,181
2022-03-06,LG,Greece,1426,928,193,5,498,156,149,305,188
2022-03-07,LG,Greece,1290,724,238,9,566,158,170,328,229
2022-03-08,LG,Greece,1221,745,231,24,476,121,124,245,207
2022-03-09,LG,Greece,1301,794,251,30,507,125,131,256,221
2022-03-10,LG,Greece,1310,806,245,20,504,133,126,259,225
2022-03-11,LG,Greece,1365,819,233,13,546,154,159,313,220
2022-03-12,LG,Greece,1361,933,196,6,428,117,115,232,190
2022-03-13,LG,Greece,1482,939,222,3,543,164,157,321,219
2022-03-14,LG,Greece,1330,799,240,15,531,145,146,291,225
2022-03-15,LG,Greece,1278,784,243,32,494,127,124,251,211
2022-03-16,LG,Greece,1351,831,240,30,520,141,139,280,210
2022-03-17,LG,Greece,1345,826,241,18,519,136,142,278,223
2022-03-18,LG,Greece,1419,823,250,16,596,169,177,346,234
2022-03-19,LG,Greece,1470,1003,197,7,467,136,134,270,190
2022-03-20,LG,Greece,1568,997,227,4,571,179,165,344,223
2022-03-21,LG,Greece,1361,776,244,19,585,161,180,341,225
2022-03-22,LG,Greece,1230,761,225,21,469,119,125,244,204
2022-03-23,LG,Greece,1394,856,252,31,538,143,143,286,221
2022-03-24,LG,Greece,1471,864,269,19,607,165,173,338,250
2022-03-25,LG,Greece,1405,873,194,3,532,170,168,338,191
2022-03-26,LG,Greece,1515,1054,189,8,461,137,135,272,181
2022-03-27,LG,Greece,1804,1086,230,5,718,242,246,488,225
2022-03-28,LG,Greece,1651,893,295,13,758,233,230,463,282
2022-03-29,LG,Greece,1551,874,260,23,677,209,208,417,237
2022-03-30,LG,Greece,1685,955,290,22,730,220,220,440,268
2022-03-31,LG,Greece,1625,940,270,19,685,204,211,415,251
2022-04-01,LG,Greece,1793,1009,278,25,784,256,250,506,253
2022-04-02,LG,Greece,1891,1138,242,5,753,257,254,511,237
2022-04-03,LG,Greece,1902,1106,241,3,796,282,273,555,238
2022-04-04,LG,Greece,1695,921,308,22,774,230,236,466,286
2022-04-05,LG,Greece,1603,899,266,22,704,223,215,438,244
2022-04-06,LG,Greece,1712,959,277,21,753,234,242,476,256
2022-04-07,LG,Greece,1660,933,279,18,727,226,222,448,261
2022-04-08,LG,Greece,2055,1136,315,21,919,304,300,604,294
2022-04-09,LG,Greece,2245,1323,223,5,922,352,347,699,218
2022-04-10,LG,Greece,2230,1273,248,6,957,355,354,709,242
2022-04-11,LG,Greece,1849,1021,318,14,828,253,257,510,304
2022-04-12,LG,Greece,1763,948,309,25,815,253,253,506,284
2022-04-13,LG,Greece,1903,1045,284,19,858,288,286,574,265
2022-04-14,LG,Greece,2006,1050,331,27,956,314,311,625,304
2022-04-15,LG,Greece,2149,1164,330,13,985,328,327,655,317
2022-04-16,LG,Greece,2405,1351,261,5,1054,393,400,793,256
2022-04-17,LG,Greece,2316,1275,264,13,1041,387,390,777,251
2022-04-18,LG,Greece,2118,1110,370,13,1008,323,315,638,357
2022-04-19,LG,Greece,1882,994,326,25,888,285,277,562,301
2022-04-20,LG,Greece,2018,1097,317,15,921,299,305,604,302
2022-04-21,LG,Greece,2055,1057,335,9,998,327,336,663,326
2022-04-22,LG,Greece,2150,1120,307,3,1030,360,363,723,304
2022-04-23,LG,Greece,2509,1357,259,4,1152,434,459,893,255
2022-04-24,LG,Greece,2367,1277,189,3,1090,460,441,901,186
2022-04-25,LG,Greece,2091,1086,327,0,1005,340,338,678,327
2022-04-26,LG,Greece,2009,1025,328,8,984,327,329,656,320
2022-04-27,LG,Greece,2064,1084,312,12,980,337,331,668,300
2022-04-28,LG,Greece,2105,1091,338,16,1014,345,331,676,322
2022-04-29,LG,Greece,2268,1171,340,11,1097,371,386,757,329
2022-04-30,LG,Greece,2631,1365,286,7,1266,486,494,980,279
2022-05-01,LG,Greece,2683,1295,282,4,1388,558,548,1106,278
2022-05-02,LG,Greece,2276,1100,320,1,1176,425,431,856,319
2022-05-03,LG,Greece,2300,1123,318,12,1177,432,427,859,306
2022-05-04,LG,Greece,2233,1106,309,20,1127,409,409,818,289
2022-05-05,LG,Greece,2291,1112,347,24,1179,416,416,832,323
2022-05-06,LG,Greece,2567,1233,342,9,1334,491,501,992,333
2022-05-07,LG,Greece,2868,1410,273,12,1458,589,596,1185,261
2022-05-08,LG,Greece,2804,1336,298,8,1468,587,583,1170,290
2022-05-09,LG,Greece,2332,1088,364,15,1244,438,442,880,349
2022-05-10,LG,Greece,2308,1119,343,23,1189,425,421,846,320
2022-05-11,LG,Greece,2301,1144,316,14,1157,419,422,841,302
2022-05-12,LG,Greece,2350,1121,367,25,1229,425,437,862,342
2022-05-13,LG,Greece,2490,1101,360,17,1389,518,511,1029,343
2022-05-14,LG,Greece,2799,1304,280,13,1495,604,611,1215,267
2022-05-15,LG,Greece,2909,1347,297,3,1562,631,634,1265,294
2022-05-16,LG,Greece,2386,1092,369,14,1294,465,460,925,355
2022-05-17,LG,Greece,2361,1107,354,17,1254,446,454,900,337
2022-05-18,LG,Greece,2431,1185,338,12,1246,453,455,908,326
2022-05-19,LG,Greece,2414,1089,354,19,1325,489,482,971,335
2022-05-20,LG,Greece,2682,1165,361,9,1517,589,567,1156,352
2022-05-21,LG,Greece,3038,1351,323,8,1687,675,689,1364,315
2022-05-22,LG,Greece,2994,1310,324,6,1684,687,673,1360,318
2022-05-23,LG,Greece,2492,1078,381,10,1414,517,516,1033,371
2022-05-24,LG,Greece,2607,1171,372,18,1436,526,538,1064,354
2022-05-25,LG,Greece,2735,1233,375,30,1502,561,566,1127,345
2022-05-26,LG,Greece,2772,1248,392,21,1524,568,564,1132,371
2022-05-27,LG,Greece,2847,1210,382,12,1637,625,630,1255,370
2022-05-28,LG,Greece,3214,1381,337,6,1833,740,756,1496,331
2022-05-29,LG,Greece,3222,1347,369,9,1875,762,744,1506,360
2022-05-30,LG,Greece,2755,1171,400,11,1584,589,595,1184,389
2022-05-31,LG,Greece,2700,1135,384,20,1565,596,585,1181,364
2022-06-01,LG,Greece,2919,1169,412,15,1750,666,672,1338,397
2022-06-02,LG,Greece,3016,1258,443,15,1758,654,661,1315,428
2022-06-03,LG,Greece,3160,1273,422,14,1887,727,738,1465,408
2022-06-04,LG,Greece,3447,1401,365,7,2046,830,851,1681,358
2022-06-05,LG,Greece,3502,1466,411,6,2036,826,799,1625,405
2022-06-06,LG,Greece,3156,1308,455,16,1848,703,690,1393,439
2022-06-07,LG,Greece,3092,1284,430,33,1808,684,694,1378,397
2022-06-08,LG,Greece,3155,1331,442,23,1824,695,687,1382,419
2022-06-09,LG,Greece,3074,1268,457,30,1806,675,674,1349,427
2022-06-10,LG,Greece,3285,1307,433,5,1978,764,781,1545,428
2022-06-11,LG,Greece,3564,1471,369,5,2093,865,859,1724,364
2022-06-12,LG,Greece,3460,1407,367,4,2053,847,839,1686,363
2022-06-13,LG,Greece,3205,1302,442,9,1903,731,730,1461,433
2022-06-14,LG,Greece,3251,1353,442,34,1898,724,732,1456,408
2022-06-15,LG,Greece,3271,1405,413,20,1866,723,730,1453,393
2022-06-16,LG,Greece,3249,1312,458,28,1937,740,739,1479,430
2022-06-17,LG,Greece,3429,1374,457,21,2055,795,803,1598,436
2022-06-18,LG,Greece,3732,1552,389,8,2180,895,896,1791,381
2022-06-19,LG,Greece,3761,1538,411,5,2223,912,900,1812,406
2022-06-20,LG,Greece,3349,1383,444,16,1966,754,768,1522,428
2022-06-21,LG,Greece,3410,1372,457,37,2038,795,786,1581,420
2022-06-22,LG,Greece,3395,1368,448,22,2027,792,787,1579,426
2022-06-23,LG,Greece,3307,1324,447,17,1983,766,770,1536,430
2022-06-24,LG,Greece,3549,1402,455,9,2147,839,853,1692,446
2022-06-25,LG,Greece,3820,1563,408,12,2257,926,923,1849,396
2022-06-26,LG,Greece,3841,1549,415,3,2292,940,937,1877,412
2022-06-27,LG,Greece,3456,1418,452,19,2038,797,789,1586,433
2022-06-28,LG,Greece,3599,1448,455,25,2151,853,843,1696,430
2022-06-29,LG,Greece,3593,1437,455,24,2156,842,859,1701,431
2022-06-30,LG,Greece,3522,1409,459,19,2113,825,829,1654,440
2022-07-01,LG,Greece,3857,1522,494,10,2335,920,921,1841,484
2022-07-02,LG,Greece,4105,1666,423,8,2439,1003,1013,2016,415
2022-07-03,LG,Greece,3962,1565,416,7,2397,999,982,1981,409
2022-07-04,LG,Greece,3715,1513,450,20,2202,880,872,1752,430
2022-07-05,LG,Greece,3779,1544,458,30,2235,885,892,1777,428
2022-07-06,LG,Greece,3882,1603,455,30,2279,906,918,1824,425
2022-07-07,LG,Greece,3809,1555,474,20,2254,890,890,1780,454
2022-07-08,LG,Greece,3956,1568,474,10,2388,949,965,1914,464
2022-07-09,LG,Greece,4139,1647,420,3,2492,1034,1038,2072,417
2022-07-10,LG,Greece,4065,1597,420,4,2468,1033,1015,2048,416
2022-07-11,LG,Greece,3788,1524,460,11,2264,904,900,1804,449
2022-07-12,LG,Greece,3835,1516,475,25,2319,924,920,1844,450
2022-07-13,LG,Greece,3852,1558,451,19,2294,914,929,1843,432
2022-07-14,LG,Greece,3790,1520,456,18,2270,908,906,1814,438
2022-07-15,LG,Greece,3938,1538,479,10,2400,966,955,1921,469
2022-07-16,LG,Greece,4247,1731,416,6,2516,1050,1050,2100,410
2022-07-17,LG,Greece,4048,1651,421,5,2397,987,989,1976,416
2022-07-18,LG,Greece,3875,1582,476,11,2293,909,908,1817,465
2022-07-19,LG,Greece,3887,1542,441,20,2345,959,945,1904,421
2022-07-20,LG,Greece,3990,1661,434,23,2329,940,955,1895,411
2022-07-21,LG,Greece,3856,1499,476,12,2357,947,934,1881,464
2022-07-22,LG,Greece,3968,1565,500,16,2403,947,956,1903,484
2022-07-23,LG,Greece,4288,1693,429,5,2595,1080,1086,2166,424
2022-07-24,LG,Greece,4181,1672,421,7,2509,1045,1043,2088,414
2022-07-25,LG,Greece,3919,1556,472,12,2363,955,936,1891,460
2022-07-26,LG,Greece,3921,1587,443,25,2334,940,951,1891,418
2022-07-27,LG,Greece,3980,1604,455,18,2376,965,956,1921,437
2022-07-28,LG,Greece,3849,1520,468,19,2329,929,932,1861,449
2022-07-29,LG,Greece,4046,1586,482,8,2460,983,995,1978,474
2022-07-30,LG,Greece,4311,1711,430,6,2600,1084,1086,2170,424
2022-07-31,LG,Greece,4377,1835,426,7,2542,1064,1052,2116,419
2022-08-01,LG,Greece,4043,1676,474,10,2367,938,955,1893,464
2022-08-02,LG,Greece,4050,1656,478,20,2394,969,947,1916,458
2022-08-03,LG,Greece,4014,1646,429,14,2368,967,972,1939,415
2022-08-04,LG,Greece,3887,1567,454,12,2320,933,933,1866,442
2022-08-05,LG,Greece,3957,1565,468,6,2392,954,970,1924,462
2022-08-06,LG,Greece,4314,1734,422,5,2580,1083,1075,2158,417
2022-08-07,LG,Greece,4183,1654,422,7,2529,1050,1057,2107,415
2022-08-08,LG,Greece,3876,1573,467,14,2303,923,913,1836,453
2022-08-09,LG,Greece,3941,1599,449,30,2342,954,939,1893,419
2022-08-10,LG,Greece,4023,1632,453,16,2391,963,975,1938,437
2022-08-11,LG,Greece,3837,1558,444,19,2279,924,911,1835,425
2022-08-12,LG,Greece,3978,1554,476,13,2424,962,986,1948,463
2022-08-13,LG,Greece,4261,1693,419,8,2568,1072,1077,2149,411
2022-08-14,LG,Greece,4190,1680,429,5,2510,1052,1029,2081,424
2022-08-15,LG,Greece,3765,1543,429,1,2222,899,894,1793,428
2022-08-16,LG,Greece,3871,1575,457,17,2296,922,917,1839,440
2022-08-17,LG,Greece,3901,1593,459,20,2308,919,930,1849,439
2022-08-18,LG,Greece,3809,1523,453,21,2286,920,913,1833,432
2022-08-19,LG,Greece,3909,1561,463,11,2348,933,952,1885,452
2022-08-20,LG,Greece,4347,1737,442,12,2610,1086,1082,2168,430
2022-08-21,LG,Greece,4148,1664,439,11,2484,1028,1017,2045,428
2022-08-22,LG,Greece,3817,1578,462,18,2239,891,886,1777,444
2022-08-23,LG,Greece,3960,1628,458,23,2332,940,934,1874,435
2022-08-24,LG,Greece,3902,1586,429,26,2316,944,943,1887,403
2022-08-25,LG,Greece,3897,1642,454,16,2255,896,905,1801,438
2022-08-26,LG,Greece,3923,1581,456,18,2342,941,945,1886,438
2022-08-27,LG,Greece,4245,1734,414,9,2511,1048,1049,2097,405
2022-08-28,LG,Greece,4178,1721,432,7,2457,1019,1006,2025,425
2022-08-29,LG,Greece,3784,1550,476,9,2234,882,876,1758,467
2022-08-30,LG,Greece,3782,1549,438,21,2233,895,900,1795,417
2022-08-31,LG,Greece,3821,1598,423,11,2223,905,895,1800,412
2022-09-01,LG,Greece,3600,1467,457,22,2133,833,843,1676,435
2022-09-02,LG,Greece,3806,1619,458,15,2187,862,867,1729,443
2022-09-03,LG,Greece,4057,1652,410,7,2405,999,996,1995,403
2022-09-04,LG,Greece,4033,1657,414,9,2376,989,973,1962,405
2022-09-05,LG,Greece,3498,1491,427,8,2007,788,792,1580,419
2022-09-06,LG,Greece,3466,1486,422,22,1980,783,775,1558,400
2022-09-07,LG,Greece,3488,1523,426,22,1965,765,774,1539,404
2022-09-08,LG,Greece,3400,1434,442,12,1966,757,767,1524,430
2022-09-09,LG,Greece,3532,1446,457,10,2086,809,820,1629,447
2022-09-10,LG,Greece,3888,1631,389,9,2257,936,932,1868,380
2022-09-11,LG,Greece,3805,1584,399,7,2221,922,900,1822,392
2022-09-12,LG,Greece,3365,1438,424,9,1927,757,746,1503,415
2022-09-13,LG,Greece,3347,1396,416,17,1951,768,767,1535,399
2022-09-14,LG,Greece,3360,1443,427,16,1917,744,746,1490,411
2022-09-15,LG,Greece,3387,1448,428,15,1939,750,761,1511,413
2022-09-16,LG,Greece,3353,1355,432,7,1998,773,793,1566,425
2022-09-17,LG,Greece,3785,1577,365,8,2208,921,922,1843,357
2022-09-18,LG,Greece,3687,1576,383,10,2111,871,857,1728,373
2022-09-19,LG,Greece,3277,1378,431,8,1899,745,723,1468,423
2022-09-20,LG,Greece,3228,1348,397,13,1880,747,736,1483,384
2022-09-21,LG,Greece,3225,1407,399,15,1818,699,720,1419,384
2022-09-22,LG,Greece,3158,1299,428,14,1859,717,714,1431,414
2022-09-23,LG,Greece,3343,1330,431,8,2013,780,802,1582,423
2022-09-24,LG,Greece,3647,1506,358,5,2141,896,887,1783,353
2022-09-25,LG,Greece,3532,1481,381,7,2051,840,830,1670,374
2022-09-26,LG,Greece,3040,1274,409,8,1766,681,676,1357,401
2022-09-27,LG,Greece,3040,1224,396,14,1816,712,708,1420,382
2022-09-28,LG,Greece,3108,1343,398,24,1765,676,691,1367,374
2022-09-29,LG,Greece,3041,1308,392,14,1733,673,668,1341,378
2022-09-30,LG,Greece,3254,1360,416,11,1894,740,738,1478,405
2022-10-01,LG,Greece,3569,1601,315,2,1968,827,826,1653,313
2022-10-02,LG,Greece,3420,1574,333,4,1846,762,751,1513,329
2022-10-03,LG,Greece,2989,1448,356,7,1541,597,588,1185,349
2022-10-04,LG,Greece,2677,1178,360,22,1499,566,573,1139,338
2022-10-05,LG,Greece,2631,1199,341,21,1432,549,542,1091,320
2022-10-06,LG,Greece,2779,1326,368,18,1453,540,545,1085,350
2022-10-07,LG,Greece,3049,1402,376,14,1647,642,629,1271,362
2022-10-08,LG,Greece,3328,1542,308,2,1786,734,744,1478,306
2022-10-09,LG,Greece,3172,1491,323,7,1681,681,677,1358,316
2022-10-10,LG,Greece,2742,1331,375,13,1411,519,517,1036,362
2022-10-11,LG,Greece,2718,1322,371,25,1396,513,512,1025,346
2022-10-12,LG,Greece,2784,1382,376,41,1402,518,508,1026,335
2022-10-13,LG,Greece,2638,1246,368,30,1392,511,513,1024,338
2022-10-14,LG,Greece,2792,1310,337,10,1482,570,575,1145,327
2022-10-15,LG,Greece,3121,1521,303,7,1600,639,658,1297,296
2022-10-16,LG,Greece,3199,1547,320,4,1652,673,659,1332,316
2022-10-17,LG,Greece,2541,1247,330,14,1294,483,481,964,316
2022-10-18,LG,Greece,2606,1320,331,13,1286,484,471,955,318
2022-10-19,LG,Greece,2651,1426,337,17,1225,439,449,888,320
2022-10-20,LG,Greece,2594,1339,343,16,1255,454,458,912,327
2022-10-21,LG,Greece,2737,1370,319,11,1367,524,524,1048,308
2022-10-22,LG,Greece,3159,1620,278,8,1539,628,633,1261,270
2022-10-23,LG,Greece,2994,1518,306,11,1476,588,582,1170,295
2022-10-24,LG,Greece,2535,1349,338,17,1186,427,421,848,321
2022-10-25,LG,Greece,2506,1315,322,25,1191,431,438,869,297
2022-10-26,LG,Greece,2610,1384,322,17,1226,455,449,904,305
2022-10-27,LG,Greece,2567,1374,324,20,1193,436,433,869,304
2022-10-28,LG,Greece,2497,1295,257,9,1202,471,474,945,248
2022-10-29,LG,Greece,3025,1600,251,9,1425,585,589,1174,242
2022-10-30,LG,Greece,2559,1438,270,6,1121,426,425,851,264
2022-10-31,LG,Greece,2198,1288,292,18,910,312,306,618,274
2022-11-01,LG,Greece,1904,1143,269,25,761,248,244,492,244
2022-11-02,LG,Greece,1910,1179,276,33,731,226,229,455,243
2022-11-03,LG,Greece,1921,1154,307,34,767,229,231,460,273
2022-11-04,LG,Greece,1928,1164,289,17,764,238,237,475,272
2022-11-05,LG,Greece,2155,1343,245,11,812,281,286,567,234
2022-11-06,LG,Greece,2172,1374,234,4,798,293,271,564,230
2022-11-07,LG,Greece,1754,1051,290,14,703,205,208,413,276
2022-11-08,LG,Greece,1586,1022,245,6,564,160,159,319,239
2022-11-09,LG,Greece,1603,1064,211,16,539,161,167,328,195
2022-11-10,LG,Greece,1712,1065,284,23,647,179,184,363,261
2022-11-11,LG,Greece,1744,1041,299,17,703,201,203,404,282
2022-11-12,LG,Greece,1772,1180,243,2,592,176,173,349,241
2022-11-13,LG,Greece,1842,1201,252,6,641,197,192,389,246
2022-11-14,LG,Greece,1714,1020,297,28,694,197,200,397,269
2022-11-15,LG,Greece,1546,964,277,28,582,153,152,305,249
2022-11-16,LG,Greece,1665,1052,291,39,613,161,161,322,252
2022-11-17,LG,Greece,1719,1067,280,21,652,183,189,372,259
2022-11-18,LG,Greece,1658,1012,272,12,646,191,183,374,260
2022-11-19,LG,Greece,1757,1197,249,12,560,154,157,311,237
2022-11-20,LG,Greece,1814,1185,241,3,629,198,190,388,238
2022-11-21,LG,Greece,1550,940,261,13,610,175,174,349,248
2022-11-22,LG,Greece,1401,868,253,13,533,137,143,280,240
2022-11-23,LG,Greece,1484,925,243,23,559,153,163,316,220
2022-11-24,LG,Greece,1621,996,268,16,625,183,174,357,252
2022-11-25,LG,Greece,1582,947,259,12,635,190,186,376,247
2022-11-26,LG,Greece,1627,1102,237,9,525,145,143,288,228
2022-11-27,LG,Greece,1746,1147,237,4,599,185,177,362,233
2022-11-28,LG,Greece,1508,903,263,23,605,172,170,342,240
2022-11-29,LG,Greece,1478,925,273,32,553,138,142,280,241
2022-11-30,LG,Greece,1517,989,241,13,528,141,146,287,228
2022-12-01,LG,Greece,1564,969,258,8,595,168,169,337,250
2022-12-02,LG,Greece,1606,982,268,15,624,175,181,356,253
2022-12-03,LG,Greece,1666,1133,241,9,533,146,146,292,232
2022-12-04,LG,Greece,1702,1120,235,5,582,176,171,347,230
2022-12-05,LG,Greece,1580,954,275,25,626,177,174,351,250
2022-12-06,LG,Greece,1486,953,262,28,533,135,136,271,234
2022-12-07,LG,Greece,1557,1001,244,9,556,156,156,312,235
2022-12-08,LG,Greece,1587,980,271,36,607,168,168,336,235
2022-12-09,LG,Greece,1615,981,272,20,634,179,183,362,252
2022-12-10,LG,Greece,1624,1105,227,2,519,149,143,292,225
2022-12-11,LG,Greece,1692,1104,240,9,588,174,174,348,231
2022-12-12,LG,Greece,1584,942,271,14,642,184,187,371,257
2022-12-13,LG,Greece,1575,991,267,30,584,158,159,317,237
2022-12-14,LG,Greece,1593,987,273,28,606,166,167,333,245
2022-12-15,LG,Greece,1689,1051,280,24,638,179,179,358,256
2022-12-16,LG,Greece,1676,1030,277,12,646,178,191,369,265
2022-12-17,LG,Greece,1760,1163,245,13,597,177,175,352,232
2022-12-18,LG,Greece,1846,1238,243,13,608,186,179,365,230
2022-12-19,LG,Greece,1728,1088,275,24,640,184,181,365,251
2022-12-20,LG,Greece,1690,1094,264,28,596,166,166,332,236
2022-12-21,LG,Greece,1682,1045,268,17,637,184,185,369,251
2022-12-22,LG,Greece,1868,1172,286,19,696,205,205,410,267
2022-12-23,LG,Greece,1846,1139,292,8,707,209,206,415,284
2022-12-24,LG,Greece,1666,1127,225,3,539,157,157,314,222
2022-12-25,LG,Greece,1416,1080,124,4,336,107,105,212,120
2022-12-26,LG,Greece,1637,1060,239,3,577,167,171,338,236
2022-12-27,LG,Greece,1663,1037,247,12,626,189,190,379,235
2022-01-01,LH,Hungary,1347,1159,0,0,188,93,95,188,0
2022-01-02,LH,Hungary,1753,1477,1,0,276,135,140,275,1
2022-01-03,LH,Hungary,1586,1345,0,0,241,123,118,241,0
2022-01-04,LH,Hungary,1462,1232,2,1,230,113,115,228,1
2022-01-05,LH,Hungary,1542,1299,8,2,243,116,119,235,6
2022-01-06,LH,Hungary,1485,1276,4,1,209,103,102,205,3
2022-01-07,LH,Hungary,1722,1450,6,5,272,135,131,266,1
2022-01-08,LH,Hungary,1657,1445,0,0,212,107,105,212,0
2022-01-09,LH,Hungary,1707,1460,0,0,247,121,126,247,0
2022-01-10,LH,Hungary,1404,1185,4,4,219,111,104,215,0
2022-01-11,LH,Hungary,1239,1047,3,0,192,93,96,189,3
2022-01-12,LH,Hungary,1211,1026,10,4,185,86,89,175,6
2022-01-13,LH,Hungary,1166,989,2,2,177,87,88,175,0
2022-01-14,LH,Hungary,1369,1135,4,1,234,114,116,230,3
2022-01-15,LH,Hungary,1299,1121,3,1,178,85,90,175,2
2022-01-16,LH,Hungary,1395,1164,4,3,231,112,115,227,1
2022-01-17,LH,Hungary,1185,977,3,0,208,106,99,205,3
2022-01-18,LH,Hungary,1075,900,5,2,175,86,84,170,3
2022-01-19,LH,Hungary,1070,888,4,3,182,90,88,178,1
2022-01-20,LH,Hungary,1166,970,3,1,196,94,99,193,2
2022-01-21,LH,Hungary,1320,1081,4,1,239,117,118,235,3
2022-01-22,LH,Hungary,1249,1078,5,2,171,86,80,166,3
2022-01-23,LH,Hungary,1345,1127,3,0,218,101,114,215,3
2022-01-24,LH,Hungary,1045,845,7,2,200,103,90,193,5
2022-01-25,LH,Hungary,933,768,1,1,165,79,85,164,0
2022-01-26,LH,Hungary,1038,850,2,1,188,93,93,186,1
2022-01-27,LH,Hungary,1146,960,3,0,186,95,88,183,3
2022-01-28,LH,Hungary,1347,1099,3,1,248,121,124,245,2
2022-01-29,LH,Hungary,1254,1097,1,1,157,80,76,156,0
2022-01-30,LH,Hungary,1311,1097,1,0,214,98,115,213,1
2022-01-31,LH,Hungary,1153,940,3,0,213,109,101,210,3
2022-02-01,LH,Hungary,1121,936,3,1,185,95,87,182,2
2022-02-02,LH,Hungary,1084,880,7,3,204,99,98,197,4
2022-02-03,LH,Hungary,1208,998,7,2,210,102,101,203,5
2022-02-04,LH,Hungary,1325,1071,3,1,254,125,126,251,2
2022-02-05,LH,Hungary,1299,1132,0,0,167,84,83,167,0
2022-02-06,LH,Hungary,1367,1132,1,0,235,115,119,234,1
2022-02-07,LH,Hungary,1176,936,1,0,240,120,119,239,1
2022-02-08,LH,Hungary,1098,917,2,2,181,89,90,179,0
2022-02-09,LH,Hungary,1116,911,4,1,205,103,98,201,3
2022-02-10,LH,Hungary,1235,1038,3,3,197,98,96,194,0
2022-02-11,LH,Hungary,1437,1184,2,0,253,124,127,251,2
2022-02-12,LH,Hungary,1422,1221,4,1,201,100,97,197,3
2022-02-13,LH,Hungary,1504,1249,2,0,255,123,130,253,2
2022-02-14,LH,Hungary,1371,1126,3,2,245,124,118,242,1
2022-02-15,LH,Hungary,1296,1097,2,0,199,100,97,197,2
2022-02-16,LH,Hungary,1252,1036,5,3,216,103,108,211,2
2022-02-17,LH,Hungary,1320,1097,4,1,223,112,107,219,3
2022-02-18,LH,Hungary,1433,1165,6,3,268,129,133,262,3
2022-02-19,LH,Hungary,1464,1287,1,0,177,90,86,176,1
2022-02-20,LH,Hungary,1528,1288,0,0,240,116,124,240,0
2022-02-21,LH,Hungary,1322,1098,0,0,224,115,109,224,0
2022-02-22,LH,Hungary,1275,1073,5,3,202,100,97,197,2
2022-02-23,LH,Hungary,1261,1029,2,1,232,113,117,230,1
2022-02-24,LH,Hungary,1504,1268,6,4,236,113,117,230,2
2022-02-25,LH,Hungary,1712,1426,4,0,286,143,139,282,4
2022-02-26,LH,Hungary,1649,1460,0,0,189,98,91,189,0
2022-02-27,LH,Hungary,1703,1473,3,0,230,109,118,227,3
2022-02-28,LH,Hungary,1563,1303,3,1,260,130,127,257,2
2022-03-01,LH,Hungary,1487,1266,3,0,221,106,112,218,3
2022-03-02,LH,Hungary,1580,1322,1,0,258,129,128,257,1
2022-03-03,LH,Hungary,1667,1428,3,2,239,117,119,236,1
2022-03-04,LH,Hungary,1841,1545,3,0,296,151,142,293,3
2022-03-05,LH,Hungary,1811,1597,0,0,214,109,105,214,0
2022-03-06,LH,Hungary,1872,1598,1,0,274,129,144,273,1
2022-03-07,LH,Hungary,1692,1433,7,1,259,129,123,252,6
2022-03-08,LH,Hungary,1538,1292,1,1,246,123,122,245,0
2022-03-09,LH,Hungary,1612,1342,5,1,270,132,133,265,4
2022-03-10,LH,Hungary,1608,1373,4,3,235,118,113,231,1
2022-03-11,LH,Hungary,1802,1511,2,0,291,138,151,289,2
2022-03-12,LH,Hungary,1658,1448,0,0,210,109,101,210,0
2022-03-13,LH,Hungary,1770,1532,0,0,238,117,121,238,0
2022-03-14,LH,Hungary,1574,1344,4,0,230,119,107,226,4
2022-03-15,LH,Hungary,1534,1334,1,0,200,97,102,199,1
2022-03-16,LH,Hungary,1611,1371,2,1,240,117,121,238,1
2022-03-17,LH,Hungary,1675,1454,3,3,221,112,106,218,0
2022-03-18,LH,Hungary,1872,1599,2,0,273,138,133,271,2
2022-03-19,LH,Hungary,1761,1540,2,0,221,110,109,219,2
2022-03-20,LH,Hungary,1835,1583,0,0,252,118,134,252,0
2022-03-21,LH,Hungary,1647,1392,2,0,255,127,126,253,2
2022-03-22,LH,Hungary,1490,1254,7,1,236,120,109,229,6
2022-03-23,LH,Hungary,1648,1397,4,2,251,123,124,247,2
2022-03-24,LH,Hungary,1704,1469,4,4,235,115,116,231,0
2022-03-25,LH,Hungary,1852,1562,3,1,290,147,140,287,2
2022-03-26,LH,Hungary,1856,1652,2,0,204,100,102,202,2
2022-03-27,LH,Hungary,1970,1687,3,0,283,139,141,280,3
2022-03-28,LH,Hungary,1876,1587,1,0,289,146,142,288,1
2022-03-29,LH,Hungary,1835,1580,2,1,255,124,129,253,1
2022-03-30,LH,Hungary,1929,1612,6,3,317,156,155,311,3
2022-03-31,LH,Hungary,1977,1698,5,1,279,140,134,274,4
2022-04-01,LH,Hungary,2117,1810,3,2,307,153,151,304,1
2022-04-02,LH,Hungary,2208,1991,4,0,217,103,110,213,4
2022-04-03,LH,Hungary,2211,1940,0,0,271,132,139,271,0
2022-04-04,LH,Hungary,2002,1702,1,0,300,152,147,299,1
2022-04-05,LH,Hungary,1984,1720,3,2,264,133,128,261,1
2022-04-06,LH,Hungary,2046,1740,3,1,306,151,152,303,2
2022-04-07,LH,Hungary,2125,1830,1,1,295,146,148,294,0
2022-04-08,LH,Hungary,2294,1967,1,0,327,162,164,326,1
2022-04-09,LH,Hungary,2326,2099,1,0,227,114,112,226,1
2022-04-10,LH,Hungary,2347,2051,1,0,296,145,150,295,1
2022-04-11,LH,Hungary,2181,1851,4,1,330,166,160,326,3
2022-04-12,LH,Hungary,2081,1792,2,1,289,143,144,287,1
2022-04-13,LH,Hungary,2130,1821,2,2,309,153,154,307,0
2022-04-14,LH,Hungary,2275,1952,7,3,323,159,157,316,4
2022-04-15,LH,Hungary,2356,2030,1,0,326,165,160,325,1
2022-04-16,LH,Hungary,2322,2097,0,0,225,109,116,225,0
2022-04-17,LH,Hungary,2363,2071,0,0,292,143,149,292,0
2022-04-18,LH,Hungary,2273,1969,0,0,304,152,152,304,0
2022-04-19,LH,Hungary,2236,1929,4,3,307,151,152,303,1
2022-04-20,LH,Hungary,2176,1869,6,3,307,152,149,301,3
2022-04-21,LH,Hungary,2184,1868,2,2,316,157,157,314,0
2022-04-22,LH,Hungary,2393,2071,1,0,322,159,162,321,1
2022-04-23,LH,Hungary,2436,2198,1,0,238,124,113,237,1
2022-04-24,LH,Hungary,2443,2167,0,0,276,134,142,276,0
2022-04-25,LH,Hungary,2258,1942,0,0,316,159,157,316,0
2022-04-26,LH,Hungary,2242,1949,2,1,293,147,144,291,1
2022-04-27,LH,Hungary,2272,1967,1,1,305,150,154,304,0
2022-04-28,LH,Hungary,2373,2060,1,0,313,155,157,312,1
2022-04-29,LH,Hungary,2507,2170,4,3,337,169,164,333,1
2022-04-30,LH,Hungary,2582,2336,2,0,246,119,125,244,2
2022-05-01,LH,Hungary,2661,2368,1,0,293,145,147,292,1
2022-05-02,LH,Hungary,2374,2052,3,3,322,160,159,319,0
2022-05-03,LH,Hungary,2371,2073,1,0,298,150,147,297,1
2022-05-04,LH,Hungary,2407,2067,6,4,340,163,171,334,2
2022-05-05,LH,Hungary,2463,2144,5,4,319,159,155,314,1
2022-05-06,LH,Hungary,2518,2178,8,4,340,169,163,332,4
2022-05-07,LH,Hungary,2594,2344,1,1,250,123,126,249,0
2022-05-08,LH,Hungary,2666,2355,1,1,311,156,154,310,0
2022-05-09,LH,Hungary,2398,2064,4,1,334,168,162,330,3
2022-05-10,LH,Hungary,2319,2025,3,1,294,144,147,291,2
2022-05-11,LH,Hungary,2271,1950,6,3,321,160,155,315,3
2022-05-12,LH,Hungary,2379,2059,4,3,320,157,159,316,1
2022-05-13,LH,Hungary,2580,2241,3,2,339,166,170,336,1
2022-05-14,LH,Hungary,2702,2442,3,2,260,127,130,257,1
2022-05-15,LH,Hungary,2667,2349,2,1,318,158,158,316,1
2022-05-16,LH,Hungary,2455,2118,3,1,337,169,165,334,2
2022-05-17,LH,Hungary,2317,2020,1,0,297,150,146,296,1
2022-05-18,LH,Hungary,2409,2077,3,2,332,165,164,329,1
2022-05-19,LH,Hungary,2472,2157,2,1,315,158,155,313,1
2022-05-20,LH,Hungary,2622,2287,3,1,335,168,164,332,2
2022-05-21,LH,Hungary,2790,2549,0,0,241,121,120,241,0
2022-05-22,LH,Hungary,2701,2403,2,0,298,144,152,296,2
2022-05-23,LH,Hungary,2506,2173,4,0,333,168,161,329,4
2022-05-24,LH,Hungary,2437,2137,0,0,300,147,153,300,0
2022-05-25,LH,Hungary,2563,2232,0,0,331,168,163,331,0
2022-05-26,LH,Hungary,2654,2350,6,4,304,147,151,298,2
2022-05-27,LH,Hungary,2751,2425,2,1,326,160,164,324,1
2022-05-28,LH,Hungary,2873,2620,2,0,253,130,121,251,2
2022-05-29,LH,Hungary,2873,2569,1,0,304,145,158,303,1
2022-05-30,LH,Hungary,2631,2298,5,2,333,162,166,328,3
2022-05-31,LH,Hungary,2637,2318,2,2,319,159,158,317,0
2022-06-01,LH,Hungary,2726,2385,2,0,341,174,165,339,2
2022-06-02,LH,Hungary,2828,2515,4,2,313,156,153,309,2
2022-06-03,LH,Hungary,2923,2561,0,0,362,183,179,362,0
2022-06-04,LH,Hungary,3073,2807,1,0,266,132,133,265,1
2022-06-05,LH,Hungary,3076,2761,3,3,315,152,160,312,0
2022-06-06,LH,Hungary,2768,2433,3,1,335,170,162,332,2
2022-06-07,LH,Hungary,2787,2460,1,0,327,160,166,326,1
2022-06-08,LH,Hungary,2832,2487,1,1,345,175,169,344,0
2022-06-09,LH,Hungary,2840,2518,7,2,322,154,161,315,5
2022-06-10,LH,Hungary,3088,2723,3,1,365,184,178,362,2
2022-06-11,LH,Hungary,3120,2857,0,0,263,132,131,263,0
2022-06-12,LH,Hungary,3146,2821,1,0,325,158,166,324,1
2022-06-13,LH,Hungary,2889,2519,0,0,370,189,181,370,0
2022-06-14,LH,Hungary,2876,2519,3,3,357,174,180,354,0
2022-06-15,LH,Hungary,2879,2512,7,4,367,185,175,360,3
2022-06-16,LH,Hungary,2981,2611,5,2,370,179,186,365,3
2022-06-17,LH,Hungary,3135,2741,5,3,394,194,195,389,2
2022-06-18,LH,Hungary,3162,2868,2,2,294,146,146,292,0
2022-06-19,LH,Hungary,3145,2791,2,0,354,177,175,352,2
2022-06-20,LH,Hungary,2953,2614,2,1,339,168,169,337,1
2022-06-21,LH,Hungary,3097,2729,3,1,368,179,186,365,2
2022-06-22,LH,Hungary,3036,2656,5,1,380,191,184,375,4
2022-06-23,LH,Hungary,3041,2697,5,1,344,173,166,339,4
2022-06-24,LH,Hungary,3174,2780,4,2,394,192,198,390,2
2022-06-25,LH,Hungary,3339,3022,2,0,317,158,157,315,2
2022-06-26,LH,Hungary,3393,3019,5,2,374,185,184,369,3
2022-06-27,LH,Hungary,3187,2823,3,1,364,182,179,361,2
2022-06-28,LH,Hungary,3193,2839,7,3,354,172,175,347,4
2022-06-29,LH,Hungary,3254,2880,5,5,374,181,188,369,0
2022-06-30,LH,Hungary,3216,2864,2,1,352,179,171,350,1
2022-07-01,LH,Hungary,3469,3108,5,2,361,180,176,356,3
2022-07-02,LH,Hungary,3483,3196,1,0,287,144,142,286,1
2022-07-03,LH,Hungary,3521,3170,0,0,351,176,175,351,0
2022-07-04,LH,Hungary,3356,3002,6,5,354,173,175,348,1
2022-07-05,LH,Hungary,3280,2937,6,5,343,165,172,337,1
2022-07-06,LH,Hungary,3282,2900,2,2,382,191,189,380,0
2022-07-07,LH,Hungary,3379,3020,4,3,359,178,177,355,1
2022-07-08,LH,Hungary,3484,3127,2,0,357,177,178,355,2
2022-07-09,LH,Hungary,3538,3245,0,0,293,148,145,293,0
2022-07-10,LH,Hungary,3510,3175,0,0,335,167,168,335,0
2022-07-11,LH,Hungary,3272,2928,4,1,344,165,175,340,3
2022-07-12,LH,Hungary,3352,3026,1,0,326,161,164,325,1
2022-07-13,LH,Hungary,3293,2922,4,3,371,188,179,367,1
2022-07-14,LH,Hungary,3349,3008,2,2,341,169,170,339,0
2022-07-15,LH,Hungary,3474,3103,1,1,371,188,182,370,0
2022-07-16,LH,Hungary,3553,3255,1,1,298,146,151,297,0
2022-07-17,LH,Hungary,3502,3162,0,0,340,168,172,340,0
2022-07-18,LH,Hungary,3278,2941,3,1,337,167,167,334,2
2022-07-19,LH,Hungary,3365,3015,2,1,350,169,179,348,1
2022-07-20,LH,Hungary,3482,3072,8,6,410,204,198,402,2
2022-07-21,LH,Hungary,3419,3065,7,5,354,177,170,347,2
2022-07-22,LH,Hungary,3512,3152,6,4,360,177,177,354,2
2022-07-23,LH,Hungary,3684,3381,2,0,303,151,150,301,2
2022-07-24,LH,Hungary,3605,3261,2,0,344,170,172,342,2
2022-07-25,LH,Hungary,3335,2991,4,4,344,170,170,340,0
2022-07-26,LH,Hungary,3347,3022,4,4,325,160,161,321,0
2022-07-27,LH,Hungary,3364,3010,7,7,354,175,172,347,0
2022-07-28,LH,Hungary,3478,3116,5,5,362,174,183,357,0
2022-07-29,LH,Hungary,3568,3207,3,2,361,176,182,358,1
2022-07-30,LH,Hungary,3577,3278,0,0,299,152,147,299,0
2022-07-31,LH,Hungary,3598,3215,0,0,383,194,189,383,0
2022-08-01,LH,Hungary,3316,2955,7,5,361,181,173,354,2
2022-08-02,LH,Hungary,3440,3107,7,4,333,164,162,326,3
2022-08-03,LH,Hungary,3459,3097,12,11,362,176,174,350,1
2022-08-04,LH,Hungary,3394,3061,5,4,333,166,162,328,1
2022-08-05,LH,Hungary,3567,3220,4,3,347,173,170,343,1
2022-08-06,LH,Hungary,3663,3386,0,0,277,134,143,277,0
2022-08-07,LH,Hungary,3657,3323,0,0,334,164,170,334,0
2022-08-08,LH,Hungary,3363,3025,4,4,338,171,163,334,0
2022-08-09,LH,Hungary,3371,3037,6,5,334,157,171,328,1
2022-08-10,LH,Hungary,3427,3059,5,3,368,185,178,363,2
2022-08-11,LH,Hungary,3402,3083,2,1,319,158,159,317,1
2022-08-12,LH,Hungary,3579,3220,5,2,359,181,173,354,3
2022-08-13,LH,Hungary,3660,3371,0,0,289,146,143,289,0
2022-08-14,LH,Hungary,3566,3217,4,1,349,168,177,345,3
2022-08-15,LH,Hungary,3278,2941,3,0,337,171,163,334,3
2022-08-16,LH,Hungary,3318,2998,3,2,320,157,160,317,1
2022-08-17,LH,Hungary,3366,3008,3,2,358,179,176,355,1
2022-08-18,LH,Hungary,3421,3092,4,3,329,164,161,325,1
2022-08-19,LH,Hungary,3495,3138,3,1,357,174,180,354,2
2022-08-20,LH,Hungary,3538,3258,0,0,280,140,140,280,0
2022-08-21,LH,Hungary,3538,3190,1,0,348,172,175,347,1
2022-08-22,LH,Hungary,3208,2876,4,0,332,168,160,328,4
2022-08-23,LH,Hungary,3280,2963,4,2,317,151,162,313,2
2022-08-24,LH,Hungary,3343,2991,0,0,352,179,173,352,0
2022-08-25,LH,Hungary,3315,2985,10,6,330,159,161,320,4
2022-08-26,LH,Hungary,3389,3039,6,2,350,175,169,344,4
2022-08-27,LH,Hungary,3758,3459,3,0,299,148,148,296,3
2022-08-28,LH,Hungary,3567,3231,0,0,336,164,172,336,0
2022-08-29,LH,Hungary,3193,2877,0,0,316,162,154,316,0
2022-08-30,LH,Hungary,3292,2958,2,2,334,163,169,332,0
2022-08-31,LH,Hungary,3346,2989,4,2,357,178,175,353,2
2022-09-01,LH,Hungary,3311,2987,5,3,324,159,160,319,2
2022-09-02,LH,Hungary,3378,3018,6,1,360,182,172,354,5
2022-09-03,LH,Hungary,3598,3327,0,0,271,135,136,271,0
2022-09-04,LH,Hungary,3545,3203,0,0,342,165,177,342,0
2022-09-05,LH,Hungary,3187,2848,3,2,339,170,166,336,1
2022-09-06,LH,Hungary,3154,2830,3,2,324,162,159,321,1
2022-09-07,LH,Hungary,3222,2854,2,1,368,182,184,366,1
2022-09-08,LH,Hungary,3244,2906,5,3,338,170,163,333,2
2022-09-09,LH,Hungary,3302,2939,4,0,363,182,177,359,4
2022-09-10,LH,Hungary,3587,3280,10,1,307,144,153,297,9
2022-09-11,LH,Hungary,3508,3152,10,2,356,170,176,346,8
2022-09-12,LH,Hungary,3042,2687,4,1,355,175,176,351,3
2022-09-13,LH,Hungary,2970,2625,4,3,345,169,172,341,1
2022-09-14,LH,Hungary,3139,2756,3,2,383,190,190,380,1
2022-09-15,LH,Hungary,3199,2854,5,2,345,171,169,340,3
2022-09-16,LH,Hungary,3307,2930,5,1,377,186,186,372,4
2022-09-17,LH,Hungary,3456,3155,2,1,301,150,149,299,1
2022-09-18,LH,Hungary,3363,3023,0,0,340,166,174,340,0
2022-09-19,LH,Hungary,3044,2704,3,1,340,171,166,337,2
2022-09-20,LH,Hungary,3015,2694,3,0,321,162,156,318,3
2022-09-21,LH,Hungary,3063,2712,3,1,351,172,176,348,2
2022-09-22,LH,Hungary,3098,2754,8,5,344,169,167,336,3
2022-09-23,LH,Hungary,3132,2767,1,1,365,183,181,364,0
2022-09-24,LH,Hungary,3320,3040,3,0,280,140,137,277,3
2022-09-25,LH,Hungary,3265,2925,2,1,340,166,172,338,1
2022-09-26,LH,Hungary,2958,2609,12,3,349,167,170,337,9
2022-09-27,LH,Hungary,2916,2591,10,3,325,155,160,315,7
2022-09-28,LH,Hungary,3009,2640,6,2,369,182,181,363,4
2022-09-29,LH,Hungary,3084,2753,3,1,331,168,160,328,2
2022-09-30,LH,Hungary,3116,2766,3,2,350,176,171,347,1
2022-10-01,LH,Hungary,3348,3081,0,0,267,136,131,267,0
2022-10-02,LH,Hungary,3249,2920,1,0,329,156,172,328,1
2022-10-03,LH,Hungary,2794,2478,2,2,316,155,159,314,0
2022-10-04,LH,Hungary,2770,2465,2,1,305,154,149,303,1
2022-10-05,LH,Hungary,2747,2441,4,4,306,151,151,302,0
2022-10-06,LH,Hungary,2799,2481,1,1,318,156,161,317,0
2022-10-07,LH,Hungary,2908,2572,3,0,336,168,165,333,3
2022-10-08,LH,Hungary,3083,2831,0,0,252,128,124,252,0
2022-10-09,LH,Hungary,3054,2746,1,0,308,151,156,307,1
2022-10-10,LH,Hungary,2703,2347,10,4,356,178,168,346,6
2022-10-11,LH,Hungary,2622,2318,5,2,304,150,149,299,3
2022-10-12,LH,Hungary,2723,2403,7,5,320,155,158,313,2
2022-10-13,LH,Hungary,2772,2463,7,3,309,154,148,302,4
2022-10-14,LH,Hungary,2955,2612,5,2,343,167,171,338,3
2022-10-15,LH,Hungary,3016,2748,2,0,268,136,130,266,2
2022-10-16,LH,Hungary,2985,2678,0,0,307,148,159,307,0
2022-10-17,LH,Hungary,2661,2335,4,1,326,163,159,322,3
2022-10-18,LH,Hungary,2626,2322,4,2,304,152,148,300,2
2022-10-19,LH,Hungary,2646,2324,5,2,322,155,162,317,3
2022-10-20,LH,Hungary,2726,2409,5,4,317,157,155,312,1
2022-10-21,LH,Hungary,2785,2473,2,1,312,159,151,310,1
2022-10-22,LH,Hungary,3011,2747,0,0,264,132,132,264,0
2022-10-23,LH,Hungary,2893,2584,1,0,309,154,154,308,1
2022-10-24,LH,Hungary,2661,2327,0,0,334,168,166,334,0
2022-10-25,LH,Hungary,2526,2236,0,0,290,142,148,290,0
2022-10-26,LH,Hungary,2682,2346,3,1,336,169,164,333,2
2022-10-27,LH,Hungary,2716,2408,4,1,308,152,152,304,3
2022-10-28,LH,Hungary,2815,2475,5,1,340,168,167,335,4
2022-10-29,LH,Hungary,2938,2667,1,0,271,134,136,270,1
2022-10-30,LH,Hungary,2721,2429,0,0,292,142,150,292,0
2022-10-31,LH,Hungary,2401,2114,0,0,287,146,141,287,0
2022-11-01,LH,Hungary,2199,1959,1,0,240,119,120,239,1
2022-11-02,LH,Hungary,2271,1979,5,2,292,140,147,287,3
2022-11-03,LH,Hungary,2319,2035,4,1,284,142,138,280,3
2022-11-04,LH,Hungary,2414,2085,6,3,329,163,160,323,3
2022-11-05,LH,Hungary,2388,2165,1,0,223,111,111,222,1
2022-11-06,LH,Hungary,2561,2238,2,1,323,153,168,321,1
2022-11-07,LH,Hungary,2228,1927,2,0,301,155,144,299,2
2022-11-08,LH,Hungary,2032,1782,2,1,250,120,128,248,1
2022-11-09,LH,Hungary,2089,1801,5,2,288,143,140,283,3
2022-11-10,LH,Hungary,2125,1855,6,2,270,133,131,264,4
2022-11-11,LH,Hungary,2214,1902,4,1,312,157,151,308,3
2022-11-12,LH,Hungary,2151,1930,0,0,221,110,111,221,0
2022-11-13,LH,Hungary,2298,2003,4,0,295,141,150,291,4
2022-11-14,LH,Hungary,2066,1780,0,0,286,147,139,286,0
2022-11-15,LH,Hungary,1989,1731,3,1,258,126,129,255,2
2022-11-16,LH,Hungary,1993,1718,3,0,275,135,137,272,3
2022-11-17,LH,Hungary,2123,1827,15,6,296,142,139,281,9
2022-11-18,LH,Hungary,2180,1863,2,0,317,157,158,315,2
2022-11-19,LH,Hungary,2122,1908,1,1,214,107,106,213,0
2022-11-20,LH,Hungary,2283,1982,1,0,301,144,156,300,1
2022-11-21,LH,Hungary,2013,1705,4,2,308,158,146,304,2
2022-11-22,LH,Hungary,1925,1671,5,3,254,122,127,249,2
2022-11-23,LH,Hungary,1940,1679,0,0,261,130,131,261,0
2022-11-24,LH,Hungary,2000,1724,5,2,276,133,138,271,3
2022-11-25,LH,Hungary,2156,1831,2,0,325,164,159,323,2
2022-11-26,LH,Hungary,2071,1868,0,0,203,103,100,203,0
2022-11-27,LH,Hungary,2236,1928,2,1,308,150,156,306,1
2022-11-28,LH,Hungary,2035,1734,5,2,301,152,144,296,3
2022-11-29,LH,Hungary,1884,1640,4,3,244,120,120,240,1
2022-11-30,LH,Hungary,2016,1738,4,1,278,138,136,274,3
2022-12-01,LH,Hungary,2042,1747,8,3,295,141,146,287,5
2022-12-02,LH,Hungary,2129,1819,6,3,310,152,152,304,3
2022-12-03,LH,Hungary,2063,1846,2,0,217,109,106,215,2
2022-12-04,LH,Hungary,2192,1893,3,1,299,145,151,296,2
2022-12-05,LH,Hungary,1979,1669,4,2,310,155,151,306,2
2022-12-06,LH,Hungary,1873,1622,3,0,251,122,126,248,3
2022-12-07,LH,Hungary,1943,1668,4,2,275,138,133,271,2
2022-12-08,LH,Hungary,2041,1734,4,3,307,152,151,303,1
2022-12-09,LH,Hungary,2170,1852,1,1,318,159,158,317,0
2022-12-10,LH,Hungary,2069,1846,1,1,223,112,110,222,0
2022-12-11,LH,Hungary,2103,1819,0,0,284,140,144,284,0
2022-12-12,LH,Hungary,1945,1629,1,0,316,161,154,315,1
2022-12-13,LH,Hungary,1952,1674,5,3,278,135,138,273,2
2022-12-14,LH,Hungary,1990,1712,3,0,278,140,135,275,3
2022-12-15,LH,Hungary,2172,1891,2,0,281,138,141,279,2
2022-12-16,LH,Hungary,2255,1940,0,0,315,158,157,315,0
2022-12-17,LH,Hungary,2232,2004,0,0,228,116,112,228,0
2022-12-18,LH,Hungary,2260,1962,2,1,298,145,151,296,1
2022-12-19,LH,Hungary,2131,1822,2,1,309,154,153,307,1
2022-12-20,LH,Hungary,2070,1806,3,2,264,129,132,261,1
2022-12-21,LH,Hungary,2014,1718,3,2,296,146,147,293,1
2022-12-22,LH,Hungary,2282,1993,2,2,289,143,144,287,0
2022-12-23,LH,Hungary,2374,2059,0,0,315,162,153,315,0
2022-12-24,LH,Hungary,2058,1875,0,0,183,89,94,183,0
2022-12-25,LH,Hungary,1782,1616,0,0,166,85,81,166,0
2022-12-26,LH,Hungary,2014,1758,0,0,256,129,127,256,0
2022-12-27,LH,Hungary,2059,1792,1,1,267,133,133,266,0
2022-01-01,EI,Ireland,854,407,9,1,447,219,219,438,8
2022-01-02,EI,Ireland,1158,546,10,2,612,299,303,602,8
2022-01-03,EI,Ireland,1120,536,10,2,584,286,288,574,8
2022-01-04,EI,Ireland,952,446,17,4,506,245,244,489,13
2022-01-05,EI,Ireland,1109,572,20,5,537,257,260,517,15
2022-01-06,EI,Ireland,984,477,16,4,507,248,243,491,12
2022-01-07,EI,Ireland,1028,442,16,4,586,283,287,570,12
2022-01-08,EI,Ireland,877,357,10,2,520,255,255,510,8
2022-01-09,EI,Ireland,1100,496,11,0,604,296,297,593,11
2022-01-10,EI,Ireland,917,513,19,7,404,192,193,385,12
2022-01-11,EI,Ireland,704,400,20,7,304,141,143,284,13
2022-01-12,EI,Ireland,752,427,21,7,325,155,149,304,14
2022-01-13,EI,Ireland,806,455,21,7,351,165,165,330,14
2022-01-14,EI,Ireland,967,534,23,10,433,203,207,410,13
2022-01-15,EI,Ireland,940,559,10,3,381,184,187,371,7
2022-01-16,EI,Ireland,1065,602,13,5,463,224,226,450,8
2022-01-17,EI,Ireland,753,354,23,12,399,193,183,376,11
2022-01-18,EI,Ireland,779,453,22,9,326,152,152,304,13
2022-01-19,EI,Ireland,772,456,20,7,316,146,150,296,13
2022-01-20,EI,Ireland,772,430,19,3,342,164,159,323,16
2022-01-21,EI,Ireland,938,487,18,6,451,216,217,433,12
2022-01-22,EI,Ireland,922,536,13,5,386,184,189,373,8
2022-01-23,EI,Ireland,965,518,9,3,447,221,217,438,6
2022-01-24,EI,Ireland,904,492,21,10,412,199,192,391,11
2022-01-25,EI,Ireland,721,412,19,9,309,146,144,290,10
2022-01-26,EI,Ireland,705,392,17,8,313,145,151,296,9
2022-01-27,EI,Ireland,772,401,16,9,371,180,175,355,7
2022-01-28,EI,Ireland,849,394,25,10,455,211,219,430,15
2022-01-29,EI,Ireland,749,370,15,9,379,179,185,364,6
2022-01-30,EI,Ireland,773,312,17,10,461,222,222,444,7
2022-01-31,EI,Ireland,754,350,17,9,404,194,193,387,8
2022-02-01,EI,Ireland,810,390,30,15,420,196,194,390,15
2022-02-02,EI,Ireland,820,394,20,10,426,207,199,406,10
2022-02-03,EI,Ireland,856,394,22,9,462,216,224,440,13
2022-02-04,EI,Ireland,958,381,22,10,577,274,281,555,12
2022-02-05,EI,Ireland,850,387,6,2,463,230,227,457,4
2022-02-06,EI,Ireland,1003,457,13,5,546,265,268,533,8
2022-02-07,EI,Ireland,934,438,15,5,496,246,235,481,10
2022-02-08,EI,Ireland,907,507,17,9,400,193,190,383,8
2022-02-09,EI,Ireland,881,455,13,5,426,203,210,413,8
2022-02-10,EI,Ireland,957,510,12,4,447,218,217,435,8
2022-02-11,EI,Ireland,1068,470,18,5,598,289,291,580,13
2022-02-12,EI,Ireland,952,442,16,9,510,247,247,494,7
2022-02-13,EI,Ireland,995,429,18,7,566,271,277,548,11
2022-02-14,EI,Ireland,893,366,24,9,527,254,249,503,15
2022-02-15,EI,Ireland,780,331,27,9,449,214,208,422,18
2022-02-16,EI,Ireland,806,376,6,0,430,210,214,424,6
2022-02-17,EI,Ireland,890,411,14,10,479,235,230,465,4
2022-02-18,EI,Ireland,883,384,8,1,499,239,252,491,7
2022-02-19,EI,Ireland,1041,488,8,1,553,276,269,545,7
2022-02-20,EI,Ireland,928,383,4,0,545,271,270,541,4
2022-02-21,EI,Ireland,953,431,14,4,522,254,254,508,10
2022-02-22,EI,Ireland,902,450,13,6,452,223,216,439,7
2022-02-23,EI,Ireland,844,377,9,2,467,227,231,458,7
2022-02-24,EI,Ireland,955,462,10,8,493,240,243,483,2
2022-02-25,EI,Ireland,1165,547,23,2,618,294,301,595,21
2022-02-26,EI,Ireland,998,483,12,2,515,253,250,503,10
2022-02-27,EI,Ireland,1003,432,14,4,571,278,279,557,10
2022-02-28,EI,Ireland,1085,511,28,6,574,279,267,546,22
2022-03-01,EI,Ireland,1079,558,32,9,521,244,245,489,23
2022-03-02,EI,Ireland,1055,510,27,5,545,257,261,518,22
2022-03-03,EI,Ireland,1057,497,26,6,560,271,263,534,20
2022-03-04,EI,Ireland,1178,529,35,6,649,300,314,614,29
2022-03-05,EI,Ireland,1143,586,11,3,557,275,271,546,8
2022-03-06,EI,Ireland,1170,572,12,2,598,289,297,586,10
2022-03-07,EI,Ireland,1205,614,18,5,591,288,285,573,13
2022-03-08,EI,Ireland,909,407,14,5,502,247,241,488,9
2022-03-09,EI,Ireland,918,380,21,5,538,261,256,517,16
2022-03-10,EI,Ireland,1175,615,28,7,560,268,264,532,21
2022-03-11,EI,Ireland,1119,475,27,6,644,309,308,617,21
2022-03-12,EI,Ireland,973,424,16,2,549,264,269,533,14
2022-03-13,EI,Ireland,1053,407,20,5,646,310,316,626,15
2022-03-14,EI,Ireland,1256,629,24,3,627,304,299,603,21
2022-03-15,EI,Ireland,1124,582,24,5,542,259,259,518,19
2022-03-16,EI,Ireland,1085,513,23,3,572,273,276,549,20
2022-03-17,EI,Ireland,1103,550,21,5,553,263,269,532,16
2022-03-18,EI,Ireland,1334,662,21,5,672,320,331,651,16
2022-03-19,EI,Ireland,1204,616,16,2,588,287,285,572,14
2022-03-20,EI,Ireland,1249,561,23,6,688,334,331,665,17
2022-03-21,EI,Ireland,1243,618,19,2,625,308,298,606,17
2022-03-22,EI,Ireland,1025,512,21,5,513,246,246,492,16
2022-03-23,EI,Ireland,1051,504,23,5,547,258,266,524,18
2022-03-24,EI,Ireland,1176,623,17,3,553,270,266,536,14
2022-03-25,EI,Ireland,1289,629,18,3,660,322,320,642,15
2022-03-26,EI,Ireland,1175,636,12,2,539,262,265,527,10
2022-03-27,EI,Ireland,1427,698,9,1,729,357,363,720,8
2022-03-28,EI,Ireland,1400,664,13,2,736,364,359,723,11
2022-03-29,EI,Ireland,1410,700,12,2,710,354,344,698,10
2022-03-30,EI,Ireland,1415,668,12,2,747,367,368,735,10
2022-03-31,EI,Ireland,1415,671,16,6,744,361,367,728,10
2022-04-01,EI,Ireland,1519,729,14,3,790,389,387,776,11
2022-04-02,EI,Ireland,1431,772,16,0,659,323,320,643,16
2022-04-03,EI,Ireland,1398,672,8,0,726,356,362,718,8
2022-04-04,EI,Ireland,1474,702,20,2,772,379,373,752,18
2022-04-05,EI,Ireland,1449,722,21,4,727,351,355,706,17
2022-04-06,EI,Ireland,1312,551,25,1,761,369,367,736,24
2022-04-07,EI,Ireland,1425,666,20,2,759,369,370,739,18
2022-04-08,EI,Ireland,1508,702,22,2,806,384,400,784,20
2022-04-09,EI,Ireland,1388,688,13,3,700,346,341,687,10
2022-04-10,EI,Ireland,1618,847,20,5,771,375,376,751,15
2022-04-11,EI,Ireland,1394,651,22,4,743,363,358,721,18
2022-04-12,EI,Ireland,1387,644,22,5,743,366,355,721,17
2022-04-13,EI,Ireland,1378,624,24,4,754,363,367,730,20
2022-04-14,EI,Ireland,1499,734,27,7,765,367,371,738,20
2022-04-15,EI,Ireland,1466,663,19,6,803,389,395,784,13
2022-04-16,EI,Ireland,1388,716,14,4,672,331,327,658,10
2022-04-17,EI,Ireland,1311,586,12,4,725,360,353,713,8
2022-04-18,EI,Ireland,1351,580,10,1,771,381,380,761,9
2022-04-19,EI,Ireland,1337,589,13,1,748,363,372,735,12
2022-04-20,EI,Ireland,1447,682,13,2,765,378,374,752,11
2022-04-21,EI,Ireland,1393,629,13,2,764,376,375,751,11
2022-04-22,EI,Ireland,1592,759,16,3,833,409,408,817,13
2022-04-23,EI,Ireland,1363,675,12,3,688,337,339,676,9
2022-04-24,EI,Ireland,1566,788,11,3,778,380,387,767,8
2022-04-25,EI,Ireland,1545,737,20,4,808,392,396,788,16
2022-04-26,EI,Ireland,1458,702,16,3,756,370,370,740,13
2022-04-27,EI,Ireland,1595,800,21,4,795,391,383,774,17
2022-04-28,EI,Ireland,1571,798,25,3,773,373,375,748,22
2022-04-29,EI,Ireland,1440,597,16,2,843,415,412,827,14
2022-04-30,EI,Ireland,1381,688,17,5,693,336,340,676,12
2022-05-01,EI,Ireland,1454,648,13,4,806,398,395,793,9
2022-05-02,EI,Ireland,1524,735,9,0,789,390,390,780,9
2022-05-03,EI,Ireland,1383,634,11,0,749,366,372,738,11
2022-05-04,EI,Ireland,1505,716,15,2,789,394,380,774,13
2022-05-05,EI,Ireland,1539,781,14,0,758,370,374,744,14
2022-05-06,EI,Ireland,1675,822,14,3,853,417,422,839,11
2022-05-07,EI,Ireland,1560,833,10,1,727,357,360,717,9
2022-05-08,EI,Ireland,1556,757,11,1,799,394,394,788,10
2022-05-09,EI,Ireland,1447,639,12,1,808,396,400,796,11
2022-05-10,EI,Ireland,1484,714,12,0,770,378,380,758,12
2022-05-11,EI,Ireland,1473,677,11,1,796,398,387,785,10
2022-05-12,EI,Ireland,1480,669,12,1,811,397,402,799,11
2022-05-13,EI,Ireland,1559,693,13,2,866,424,429,853,11
2022-05-14,EI,Ireland,1546,830,13,2,716,351,352,703,11
2022-05-15,EI,Ireland,1536,722,15,3,814,401,398,799,12
2022-05-16,EI,Ireland,1558,746,11,0,812,402,399,801,11
2022-05-17,EI,Ireland,1481,704,15,3,777,383,379,762,12
2022-05-18,EI,Ireland,1552,743,15,2,809,394,400,794,13
2022-05-19,EI,Ireland,1501,669,18,5,832,408,406,814,13
2022-05-20,EI,Ireland,1486,614,14,2,872,428,430,858,12
2022-05-21,EI,Ireland,1554,810,14,2,744,365,365,730,12
2022-05-22,EI,Ireland,1760,938,13,3,822,400,409,809,10
2022-05-23,EI,Ireland,1629,795,15,3,834,415,404,819,12
2022-05-24,EI,Ireland,1544,744,15,3,800,398,387,785,12
2022-05-25,EI,Ireland,1602,775,20,8,827,400,407,807,12
2022-05-26,EI,Ireland,1555,703,20,9,852,411,421,832,11
2022-05-27,EI,Ireland,1718,813,20,3,905,440,445,885,17
2022-05-28,EI,Ireland,1544,780,13,2,764,374,377,751,11
2022-05-29,EI,Ireland,1681,825,14,4,856,428,414,842,10
2022-05-30,EI,Ireland,1701,842,13,1,859,423,423,846,12
2022-05-31,EI,Ireland,1594,784,18,4,810,397,395,792,14
2022-06-01,EI,Ireland,1622,770,16,3,852,415,421,836,13
2022-06-02,EI,Ireland,1614,802,19,4,812,395,398,793,15
2022-06-03,EI,Ireland,1642,767,16,2,875,431,428,859,14
2022-06-04,EI,Ireland,1592,826,16,2,766,378,372,750,14
2022-06-05,EI,Ireland,1560,731,13,2,829,413,403,816,11
2022-06-06,EI,Ireland,1455,599,12,3,856,419,425,844,9
2022-06-07,EI,Ireland,1536,714,15,2,822,401,406,807,13
2022-06-08,EI,Ireland,1463,619,16,5,844,415,413,828,11
2022-06-09,EI,Ireland,1628,793,12,2,835,412,411,823,10
2022-06-10,EI,Ireland,1563,667,15,0,896,432,449,881,15
2022-06-11,EI,Ireland,1496,724,9,1,772,385,378,763,8
2022-06-12,EI,Ireland,1758,912,10,1,846,416,420,836,9
2022-06-13,EI,Ireland,1778,907,14,2,871,436,421,857,12
2022-06-14,EI,Ireland,1637,829,14,3,808,392,402,794,11
2022-06-15,EI,Ireland,1535,670,20,7,865,423,422,845,13
2022-06-16,EI,Ireland,1697,867,18,5,830,407,405,812,13
2022-06-17,EI,Ireland,1679,809,15,4,870,425,430,855,11
2022-06-18,EI,Ireland,1538,769,14,3,769,379,376,755,11
2022-06-19,EI,Ireland,1680,850,11,3,830,409,410,819,8
2022-06-20,EI,Ireland,1713,841,18,4,872,422,432,854,14
2022-06-21,EI,Ireland,1701,859,16,3,842,410,416,826,13
2022-06-22,EI,Ireland,1614,769,12,4,845,423,410,833,8
2022-06-23,EI,Ireland,1682,832,19,7,850,417,414,831,12
2022-06-24,EI,Ireland,1866,951,17,2,915,446,452,898,15
2022-06-25,EI,Ireland,1666,906,11,1,760,376,373,749,10
2022-06-26,EI,Ireland,1613,777,8,0,836,407,421,828,8
2022-06-27,EI,Ireland,1694,825,16,0,869,433,420,853,16
2022-06-28,EI,Ireland,1680,851,13,2,829,406,410,816,11
2022-06-29,EI,Ireland,1728,873,13,1,855,424,418,842,12
2022-06-30,EI,Ireland,1602,757,17,5,845,412,416,828,12
2022-07-01,EI,Ireland,1732,816,16,3,916,447,453,900,13
2022-07-02,EI,Ireland,1658,849,10,2,809,397,402,799,8
2022-07-03,EI,Ireland,1724,861,13,1,863,426,424,850,12
2022-07-04,EI,Ireland,1730,855,16,3,875,431,428,859,13
2022-07-05,EI,Ireland,1757,916,15,3,841,416,410,826,12
2022-07-06,EI,Ireland,1718,853,17,4,865,434,414,848,13
2022-07-07,EI,Ireland,1576,736,15,4,840,410,415,825,11
2022-07-08,EI,Ireland,1763,878,16,3,885,433,436,869,13
2022-07-09,EI,Ireland,1631,859,10,0,772,377,385,762,10
2022-07-10,EI,Ireland,1642,824,10,1,818,405,403,808,9
2022-07-11,EI,Ireland,1634,783,16,1,851,418,417,835,15
2022-07-12,EI,Ireland,1576,752,13,1,824,402,409,811,12
2022-07-13,EI,Ireland,1584,758,16,1,826,407,403,810,15
2022-07-14,EI,Ireland,1712,888,14,2,824,403,407,810,12
2022-07-15,EI,Ireland,1712,857,18,3,855,416,421,837,15
2022-07-16,EI,Ireland,1630,868,10,0,762,377,375,752,10
2022-07-17,EI,Ireland,1794,947,12,0,847,421,414,835,12
2022-07-18,EI,Ireland,1787,916,18,3,871,429,424,853,15
2022-07-19,EI,Ireland,1655,826,16,3,829,403,410,813,13
2022-07-20,EI,Ireland,1630,834,17,2,796,386,393,779,15
2022-07-21,EI,Ireland,1531,728,18,5,803,392,393,785,13
2022-07-22,EI,Ireland,1526,665,18,2,861,422,421,843,16
2022-07-23,EI,Ireland,1458,710,8,0,748,372,368,740,8
2022-07-24,EI,Ireland,1681,840,13,4,841,408,420,828,9
2022-07-25,EI,Ireland,1723,845,16,4,878,437,425,862,12
2022-07-26,EI,Ireland,1619,803,15,4,816,404,397,801,11
2022-07-27,EI,Ireland,1654,842,15,4,812,395,402,797,11
2022-07-28,EI,Ireland,1624,832,19,7,792,389,384,773,12
2022-07-29,EI,Ireland,1564,687,17,7,877,432,428,860,10
2022-07-30,EI,Ireland,1573,826,15,7,747,364,368,732,8
2022-07-31,EI,Ireland,1664,842,15,2,822,405,402,807,13
2022-08-01,EI,Ireland,1672,850,9,0,822,405,408,813,9
2022-08-02,EI,Ireland,1712,896,15,5,816,398,403,801,10
2022-08-03,EI,Ireland,1732,906,23,9,826,401,402,803,14
2022-08-04,EI,Ireland,1712,902,15,1,810,397,398,795,14
2022-08-05,EI,Ireland,1700,820,14,2,880,430,436,866,12
2022-08-06,EI,Ireland,1575,812,15,5,763,379,369,748,10
2022-08-07,EI,Ireland,1528,692,9,1,836,410,417,827,8
2022-08-08,EI,Ireland,1502,671,19,5,831,410,402,812,14
2022-08-09,EI,Ireland,1478,684,17,6,794,389,388,777,11
2022-08-10,EI,Ireland,1470,648,14,0,822,401,407,808,14
2022-08-11,EI,Ireland,1539,726,12,0,813,400,401,801,12
2022-08-12,EI,Ireland,1653,791,11,0,862,430,421,851,11
2022-08-13,EI,Ireland,1505,770,10,0,735,363,362,725,10
2022-08-14,EI,Ireland,1538,722,12,0,816,397,407,804,12
2022-08-15,EI,Ireland,1630,775,12,1,855,427,416,843,11
2022-08-16,EI,Ireland,1479,684,11,0,795,391,393,784,11
2022-08-17,EI,Ireland,1490,673,16,2,817,399,402,801,14
2022-08-18,EI,Ireland,1534,706,15,4,828,406,407,813,11
2022-08-19,EI,Ireland,1536,652,17,2,884,432,435,867,15
2022-08-20,EI,Ireland,1422,647,11,1,775,378,386,764,10
2022-08-21,EI,Ireland,1671,831,11,2,840,423,406,829,9
2022-08-22,EI,Ireland,1523,694,13,1,829,412,404,816,12
2022-08-23,EI,Ireland,1554,767,17,5,787,384,386,770,12
2022-08-24,EI,Ireland,1539,722,13,1,817,398,406,804,12
2022-08-25,EI,Ireland,1664,849,13,3,815,395,407,802,10
2022-08-26,EI,Ireland,1700,818,13,3,882,438,431,869,10
2022-08-27,EI,Ireland,1593,849,9,1,744,367,368,735,8
2022-08-28,EI,Ireland,1680,839,16,7,841,413,412,825,9
2022-08-29,EI,Ireland,1593,738,14,3,855,424,417,841,11
2022-08-30,EI,Ireland,1684,880,14,0,804,393,397,790,14
2022-08-31,EI,Ireland,1633,820,16,3,813,399,398,797,13
2022-09-01,EI,Ireland,1736,886,15,3,850,413,422,835,12
2022-09-02,EI,Ireland,1572,712,11,0,860,427,422,849,11
2022-09-03,EI,Ireland,1366,627,13,3,739,363,363,726,10
2022-09-04,EI,Ireland,1549,722,10,2,827,408,409,817,8
2022-09-05,EI,Ireland,1592,757,15,1,835,414,406,820,14
2022-09-06,EI,Ireland,1469,666,11,2,803,390,402,792,9
2022-09-07,EI,Ireland,1633,787,14,2,846,410,422,832,12
2022-09-08,EI,Ireland,1532,718,21,5,814,405,388,793,16
2022-09-09,EI,Ireland,1775,888,14,1,887,433,440,873,13
2022-09-10,EI,Ireland,1673,990,17,3,683,332,334,666,14
2022-09-11,EI,Ireland,1870,1005,12,0,865,432,421,853,12
2022-09-12,EI,Ireland,1828,957,17,4,871,426,428,854,13
2022-09-13,EI,Ireland,1614,811,11,1,803,395,397,792,10
2022-09-14,EI,Ireland,1697,859,12,1,838,408,418,826,11
2022-09-15,EI,Ireland,1695,871,13,0,824,408,403,811,13
2022-09-16,EI,Ireland,1838,998,15,4,840,407,418,825,11
2022-09-17,EI,Ireland,1590,835,14,3,755,375,366,741,11
2022-09-18,EI,Ireland,1717,870,10,1,847,426,411,837,9
2022-09-19,EI,Ireland,1667,830,13,2,837,412,412,824,11
2022-09-20,EI,Ireland,1682,897,18,3,785,381,386,767,15
2022-09-21,EI,Ireland,1679,870,18,2,809,399,392,791,16
2022-09-22,EI,Ireland,1779,934,17,1,845,411,417,828,16
2022-09-23,EI,Ireland,1810,936,15,4,874,430,429,859,11
2022-09-24,EI,Ireland,1587,865,10,1,722,354,358,712,9
2022-09-25,EI,Ireland,1392,566,14,3,826,403,409,812,11
2022-09-26,EI,Ireland,1641,780,18,3,861,420,423,843,15
2022-09-27,EI,Ireland,1579,785,20,3,794,388,386,774,17
2022-09-28,EI,Ireland,1415,580,16,4,835,408,411,819,12
2022-09-29,EI,Ireland,1359,551,14,3,808,403,391,794,11
2022-09-30,EI,Ireland,1477,598,13,2,879,428,438,866,11
2022-10-01,EI,Ireland,1290,599,10,1,691,345,336,681,9
2022-10-02,EI,Ireland,1602,760,15,2,842,405,422,827,13
2022-10-03,EI,Ireland,1739,908,14,2,831,416,401,817,12
2022-10-04,EI,Ireland,1453,684,12,1,769,380,377,757,11
2022-10-05,EI,Ireland,1418,631,15,2,787,388,384,772,13
2022-10-06,EI,Ireland,1555,756,15,3,799,389,395,784,12
2022-10-07,EI,Ireland,1659,792,18,4,867,423,426,849,14
2022-10-08,EI,Ireland,1511,788,11,3,723,362,350,712,8
2022-10-09,EI,Ireland,1484,663,13,1,821,399,409,808,12
2022-10-10,EI,Ireland,1631,795,20,5,836,409,407,816,15
2022-10-11,EI,Ireland,1503,730,16,3,773,381,376,757,13
2022-10-12,EI,Ireland,1454,673,19,8,781,380,382,762,11
2022-10-13,EI,Ireland,1450,645,21,5,805,395,389,784,16
2022-10-14,EI,Ireland,1501,654,17,6,847,413,417,830,11
2022-10-15,EI,Ireland,1308,602,9,0,706,348,349,697,9
2022-10-16,EI,Ireland,1541,735,12,2,806,396,398,794,10
2022-10-17,EI,Ireland,1582,764,13,2,818,401,404,805,11
2022-10-18,EI,Ireland,1542,784,19,9,758,376,363,739,10
2022-10-19,EI,Ireland,1631,878,23,2,753,361,369,730,21
2022-10-20,EI,Ireland,1665,825,27,14,840,404,409,813,13
2022-10-21,EI,Ireland,1513,691,14,2,822,407,401,808,12
2022-10-22,EI,Ireland,1465,767,13,3,698,346,339,685,10
2022-10-23,EI,Ireland,1490,712,19,9,778,374,385,759,10
2022-10-24,EI,Ireland,1518,706,20,7,812,396,396,792,13
2022-10-25,EI,Ireland,1538,785,21,10,753,364,368,732,11
2022-10-26,EI,Ireland,1520,734,19,8,786,388,379,767,11
2022-10-27,EI,Ireland,1589,808,15,4,781,380,386,766,11
2022-10-28,EI,Ireland,1524,670,16,6,854,420,418,838,10
2022-10-29,EI,Ireland,1514,817,12,4,697,347,338,685,8
2022-10-30,EI,Ireland,1424,642,13,2,782,381,388,769,11
2022-10-31,EI,Ireland,1365,638,14,6,727,357,356,713,8
2022-11-01,EI,Ireland,1222,537,24,11,685,329,332,661,13
2022-11-02,EI,Ireland,1241,544,14,0,697,339,344,683,14
2022-11-03,EI,Ireland,1306,556,19,2,750,366,365,731,17
2022-11-04,EI,Ireland,1415,583,27,10,832,402,403,805,17
2022-11-05,EI,Ireland,1338,665,15,5,673,331,327,658,10
2022-11-06,EI,Ireland,1458,671,14,6,787,384,389,773,8
2022-11-07,EI,Ireland,1396,656,14,3,740,361,365,726,11
2022-11-08,EI,Ireland,1158,529,19,8,629,305,305,610,11
2022-11-09,EI,Ireland,1138,481,19,5,657,318,320,638,14
2022-11-10,EI,Ireland,1370,716,10,1,654,321,323,644,9
2022-11-11,EI,Ireland,1504,725,15,0,779,383,381,764,15
2022-11-12,EI,Ireland,1317,679,10,2,638,313,315,628,8
2022-11-13,EI,Ireland,1367,621,12,4,746,367,367,734,8
2022-11-14,EI,Ireland,1194,482,19,6,712,346,347,693,13
2022-11-15,EI,Ireland,1056,401,23,8,655,318,314,632,15
2022-11-16,EI,Ireland,1102,430,25,11,672,321,326,647,14
2022-11-17,EI,Ireland,1218,549,20,5,669,325,324,649,15
2022-11-18,EI,Ireland,1276,496,18,7,780,379,383,762,11
2022-11-19,EI,Ireland,1064,452,17,9,612,301,294,595,8
2022-11-20,EI,Ireland,1097,350,15,7,747,365,367,732,8
2022-11-21,EI,Ireland,1216,513,17,6,703,348,338,686,11
2022-11-22,EI,Ireland,1187,569,27,13,618,296,295,591,14
2022-11-23,EI,Ireland,1074,444,14,4,630,305,311,616,10
2022-11-24,EI,Ireland,1098,439,19,9,659,319,321,640,10
2022-11-25,EI,Ireland,1324,540,19,4,784,385,380,765,15
2022-11-26,EI,Ireland,1159,553,10,1,606,299,297,596,9
2022-11-27,EI,Ireland,1318,586,18,9,732,354,360,714,9
2022-11-28,EI,Ireland,1356,639,21,9,717,348,348,696,12
2022-11-29,EI,Ireland,1410,775,30,13,635,304,301,605,17
2022-11-30,EI,Ireland,1225,567,17,4,658,321,320,641,13
2022-12-01,EI,Ireland,1428,735,27,16,693,332,334,666,11
2022-12-02,EI,Ireland,1518,738,13,3,780,384,383,767,10
2022-12-03,EI,Ireland,1299,676,18,8,623,303,302,605,10
2022-12-04,EI,Ireland,1433,700,15,7,733,354,364,718,8
2022-12-05,EI,Ireland,1361,634,20,8,727,355,352,707,12
2022-12-06,EI,Ireland,1316,701,15,6,615,298,302,600,9
2022-12-07,EI,Ireland,1265,604,18,7,661,324,319,643,11
2022-12-08,EI,Ireland,1317,638,19,3,679,330,330,660,16
2022-12-09,EI,Ireland,1222,632,9,2,590,285,296,581,7
2022-12-10,EI,Ireland,1226,643,10,1,583,295,278,573,9
2022-12-11,EI,Ireland,1252,601,9,0,651,322,320,642,9
2022-12-12,EI,Ireland,1242,647,7,1,595,295,293,588,6
2022-12-13,EI,Ireland,1265,639,15,4,626,299,312,611,11
2022-12-14,EI,Ireland,1298,647,15,3,651,322,314,636,12
2022-12-15,EI,Ireland,1310,645,12,2,665,327,326,653,10
2022-12-16,EI,Ireland,1451,702,13,3,749,363,373,736,10
2022-12-17,EI,Ireland,1348,675,15,1,673,325,333,658,14
2022-12-18,EI,Ireland,1367,607,10,1,760,378,372,750,9
2022-12-19,EI,Ireland,1361,588,13,0,773,384,376,760,13
2022-12-20,EI,Ireland,1312,597,17,4,715,347,351,698,13
2022-12-21,EI,Ireland,1309,553,11,1,756,371,374,745,10
2022-12-22,EI,Ireland,1391,622,18,8,769,378,373,751,10
2022-12-23,EI,Ireland,1373,563,13,1,810,400,397,797,12
2022-12-24,EI,Ireland,1004,496,8,0,508,247,253,500,8
2022-12-25,EI,Ireland,411,401,0,0,10,5,5,10,0
2022-12-26,EI,Ireland,1154,532,8,0,622,312,302,614,8
2022-12-27,EI,Ireland,1229,542,12,2,687,336,339,675,10
2022-01-01,LL,Israel,272,106,22,0,166,68,76,144,22
2022-01-02,LL,Israel,358,73,60,1,285,109,116,225,59
2022-01-03,LL,Israel,324,81,45,5,243,101,97,198,40
2022-01-04,LL,Israel,291,76,35,0,215,90,90,180,35
2022-01-05,LL,Israel,293,73,43,3,220,90,87,177,40
2022-01-06,LL,Israel,346,67,48,1,279,118,113,231,47
2022-01-07,LL,Israel,256,101,26,7,155,63,66,129,19
2022-01-08,LL,Israel,292,111,21,0,181,80,80,160,21
2022-01-09,LL,Israel,376,78,50,2,298,124,124,248,48
2022-01-10,LL,Israel,261,58,39,2,203,84,80,164,37
2022-01-11,LL,Israel,237,56,45,3,181,67,69,136,42
2022-01-12,LL,Israel,281,52,52,4,229,88,89,177,48
2022-01-13,LL,Israel,324,59,42,2,265,113,110,223,40
2022-01-14,LL,Israel,224,83,9,1,141,64,68,132,8
2022-01-15,LL,Israel,238,92,14,0,146,66,66,132,14
2022-01-16,LL,Israel,339,60,36,3,279,120,123,243,33
2022-01-17,LL,Israel,301,56,53,11,245,99,93,192,42
2022-01-18,LL,Israel,265,50,39,5,215,90,86,176,34
2022-01-19,LL,Israel,272,50,43,1,222,89,90,179,42
2022-01-20,LL,Israel,334,53,47,2,281,117,117,234,45
2022-01-21,LL,Israel,242,79,12,0,163,74,77,151,12
2022-01-22,LL,Israel,267,88,24,2,179,75,80,155,22
2022-01-23,LL,Israel,337,57,43,3,280,118,119,237,40
2022-01-24,LL,Israel,237,51,32,3,186,84,70,154,29
2022-01-25,LL,Israel,213,35,31,1,178,77,70,147,30
2022-01-26,LL,Israel,248,49,31,1,199,81,87,168,30
2022-01-27,LL,Israel,341,57,39,1,284,117,128,245,38
2022-01-28,LL,Israel,238,87,8,0,151,71,72,143,8
2022-01-29,LL,Israel,239,81,16,0,158,69,73,142,16
2022-01-30,LL,Israel,339,64,44,4,275,118,113,231,40
2022-01-31,LL,Israel,265,52,39,9,213,88,86,174,30
2022-02-01,LL,Israel,283,59,42,3,224,93,89,182,39
2022-02-02,LL,Israel,298,58,45,6,240,99,96,195,39
2022-02-03,LL,Israel,347,59,44,2,288,119,125,244,42
2022-02-04,LL,Israel,263,80,11,0,183,83,89,172,11
2022-02-05,LL,Israel,280,92,21,1,188,86,81,167,20
2022-02-06,LL,Israel,369,58,52,7,311,129,130,259,45
2022-02-07,LL,Israel,321,67,34,4,254,113,107,220,30
2022-02-08,LL,Israel,293,58,39,2,235,100,96,196,37
2022-02-09,LL,Israel,304,51,51,3,253,95,107,202,48
2022-02-10,LL,Israel,382,63,40,1,319,137,142,279,39
2022-02-11,LL,Israel,276,95,14,0,181,85,82,167,14
2022-02-12,LL,Israel,302,85,25,1,217,96,96,192,24
2022-02-13,LL,Israel,383,58,51,1,325,136,138,274,50
2022-02-14,LL,Israel,323,57,33,7,266,119,114,233,26
2022-02-15,LL,Israel,336,62,43,2,274,117,114,231,41
2022-02-16,LL,Israel,337,59,58,7,278,107,113,220,51
2022-02-17,LL,Israel,402,61,54,3,341,143,144,287,51
2022-02-18,LL,Israel,310,89,18,1,221,109,94,203,17
2022-02-19,LL,Israel,301,92,30,1,209,87,92,179,29
2022-02-20,LL,Israel,388,61,46,2,327,134,147,281,44
2022-02-21,LL,Israel,345,58,49,6,287,121,117,238,43
2022-02-22,LL,Israel,347,66,49,5,281,121,111,232,44
2022-02-23,LL,Israel,346,56,47,2,290,119,124,243,45
2022-02-24,LL,Israel,398,63,52,0,335,139,144,283,52
2022-02-25,LL,Israel,315,104,16,1,211,101,94,195,15
2022-02-26,LL,Israel,296,97,22,0,199,91,86,177,22
2022-02-27,LL,Israel,405,68,65,3,337,131,141,272,62
2022-02-28,LL,Israel,365,65,47,2,300,128,125,253,45
2022-03-01,LL,Israel,354,58,36,0,296,134,126,260,36
2022-03-02,LL,Israel,388,69,58,6,319,131,130,261,52
2022-03-03,LL,Israel,452,64,69,1,388,161,158,319,68
2022-03-04,LL,Israel,351,122,15,0,229,106,108,214,15
2022-03-05,LL,Israel,349,100,29,0,249,104,116,220,29
2022-03-06,LL,Israel,450,64,56,2,386,167,163,330,54
2022-03-07,LL,Israel,428,83,54,4,345,144,147,291,50
2022-03-08,LL,Israel,404,66,57,2,338,140,141,281,55
2022-03-09,LL,Israel,425,80,52,7,345,147,146,293,45
2022-03-10,LL,Israel,437,38,61,1,399,168,170,338,60
2022-03-11,LL,Israel,344,124,19,0,220,104,97,201,19
2022-03-12,LL,Israel,338,106,28,0,232,97,107,204,28
2022-03-13,LL,Israel,453,71,50,4,382,169,163,332,46
2022-03-14,LL,Israel,436,90,48,5,346,154,144,298,43
2022-03-15,LL,Israel,415,66,51,2,349,145,153,298,49
2022-03-16,LL,Israel,433,87,50,4,346,146,150,296,46
2022-03-17,LL,Israel,470,78,40,2,392,173,179,352,38
2022-03-18,LL,Israel,362,117,16,1,245,122,107,229,15
2022-03-19,LL,Israel,376,109,29,1,267,112,126,238,28
2022-03-20,LL,Israel,503,68,48,3,435,194,193,387,45
2022-03-21,LL,Israel,470,85,74,9,385,160,151,311,65
2022-03-22,LL,Israel,413,64,53,1,349,149,147,296,52
2022-03-23,LL,Israel,442,70,56,4,372,153,163,316,52
2022-03-24,LL,Israel,497,69,55,1,428,186,187,373,54
2022-03-25,LL,Israel,372,122,12,0,250,126,112,238,12
2022-03-26,LL,Israel,379,111,29,0,268,112,127,239,29
2022-03-27,LL,Israel,503,73,48,0,430,188,194,382,48
2022-03-28,LL,Israel,481,58,58,6,423,188,177,365,52
2022-03-29,LL,Israel,460,81,47,4,379,170,162,332,43
2022-03-30,LL,Israel,428,57,37,3,371,165,169,334,34
2022-03-31,LL,Israel,507,68,50,2,439,193,196,389,48
2022-04-01,LL,Israel,382,103,19,3,279,134,126,260,16
2022-04-02,LL,Israel,375,93,26,0,282,121,135,256,26
2022-04-03,LL,Israel,523,83,41,1,440,199,200,399,40
2022-04-04,LL,Israel,468,78,34,3,390,177,179,356,31
2022-04-05,LL,Israel,448,70,59,3,378,162,157,319,56
2022-04-06,LL,Israel,481,49,56,7,432,189,187,376,49
2022-04-07,LL,Israel,552,68,59,3,484,214,211,425,56
2022-04-08,LL,Israel,440,106,21,5,334,162,151,313,16
2022-04-09,LL,Israel,387,100,28,1,287,121,138,259,27
2022-04-10,LL,Israel,547,64,54,6,483,215,214,429,48
2022-04-11,LL,Israel,554,74,63,6,480,209,208,417,57
2022-04-12,LL,Israel,528,71,44,2,457,205,208,413,42
2022-04-13,LL,Israel,568,54,54,5,514,217,243,460,49
2022-04-14,LL,Israel,718,88,62,0,630,291,277,568,62
2022-04-15,LL,Israel,535,124,35,0,411,185,191,376,35
2022-04-16,LL,Israel,465,104,16,0,361,180,165,345,16
2022-04-17,LL,Israel,635,85,37,0,550,259,254,513,37
2022-04-18,LL,Israel,553,86,28,1,467,224,215,439,27
2022-04-19,LL,Israel,548,106,33,1,442,202,207,409,32
2022-04-20,LL,Israel,568,92,36,0,476,214,226,440,36
2022-04-21,LL,Israel,596,98,37,0,498,227,234,461,37
2022-04-22,LL,Israel,449,91,11,1,358,173,174,347,10
2022-04-23,LL,Israel,584,98,35,0,486,224,227,451,35
2022-04-24,LL,Israel,696,67,53,1,629,297,279,576,52
2022-04-25,LL,Israel,581,83,56,6,498,224,218,442,50
2022-04-26,LL,Israel,500,78,44,3,422,192,186,378,41
2022-04-27,LL,Israel,489,67,43,5,422,192,187,379,38
2022-04-28,LL,Israel,588,89,49,6,499,227,223,450,43
2022-04-29,LL,Israel,425,119,15,0,306,146,145,291,15
2022-04-30,LL,Israel,403,117,21,0,286,128,137,265,21
2022-05-01,LL,Israel,601,99,56,4,502,221,225,446,52
2022-05-02,LL,Israel,612,117,51,4,495,225,219,444,47
2022-05-03,LL,Israel,552,113,33,3,439,205,201,406,30
2022-05-04,LL,Israel,497,108,24,0,389,182,183,365,24
2022-05-05,LL,Israel,552,121,18,2,431,205,208,413,16
2022-05-06,LL,Israel,484,152,12,0,332,162,158,320,12
2022-05-07,LL,Israel,496,152,31,0,344,148,165,313,31
2022-05-08,LL,Israel,639,96,57,4,543,245,241,486,53
2022-05-09,LL,Israel,566,93,40,6,473,224,209,433,34
2022-05-10,LL,Israel,494,91,35,6,403,183,185,368,29
2022-05-11,LL,Israel,512,86,46,3,426,186,194,380,43
2022-05-12,LL,Israel,576,98,45,1,478,219,214,433,44
2022-05-13,LL,Israel,421,125,11,0,296,147,138,285,11
2022-05-14,LL,Israel,379,90,26,0,289,123,140,263,26
2022-05-15,LL,Israel,586,89,57,7,497,221,219,440,50
2022-05-16,LL,Israel,526,95,53,8,431,193,185,378,45
2022-05-17,LL,Israel,486,86,37,3,400,183,180,363,34
2022-05-18,LL,Israel,494,67,48,5,427,188,191,379,43
2022-05-19,LL,Israel,574,93,41,0,481,224,216,440,41
2022-05-20,LL,Israel,420,112,15,1,308,150,143,293,14
2022-05-21,LL,Israel,380,95,25,2,285,124,136,260,23
2022-05-22,LL,Israel,566,78,43,2,488,219,226,445,41
2022-05-23,LL,Israel,509,81,37,2,428,198,193,391,35
2022-05-24,LL,Israel,515,100,40,4,415,186,189,375,36
2022-05-25,LL,Israel,516,73,36,2,443,198,209,407,34
2022-05-26,LL,Israel,593,102,44,0,491,229,218,447,44
2022-05-27,LL,Israel,402,104,12,0,298,154,132,286,12
2022-05-28,LL,Israel,393,96,27,0,297,128,142,270,27
2022-05-29,LL,Israel,574,83,49,7,491,217,225,442,42
2022-05-30,LL,Israel,547,80,41,11,467,213,213,426,30
2022-05-31,LL,Israel,534,98,43,11,436,194,199,393,32
2022-06-01,LL,Israel,554,84,57,8,470,207,206,413,49
2022-06-02,LL,Israel,651,99,49,4,552,254,249,503,45
2022-06-03,LL,Israel,476,115,25,0,361,172,164,336,25
2022-06-04,LL,Israel,377,118,6,1,259,121,132,253,5
2022-06-05,LL,Israel,502,118,20,0,384,182,182,364,20
2022-06-06,LL,Israel,606,74,58,6,532,235,239,474,52
2022-06-07,LL,Israel,550,100,41,1,450,208,201,409,40
2022-06-08,LL,Israel,531,73,48,3,458,202,208,410,45
2022-06-09,LL,Israel,619,98,61,1,521,236,224,460,60
2022-06-10,LL,Israel,459,122,15,1,337,170,152,322,14
2022-06-11,LL,Israel,423,103,28,1,320,135,157,292,27
2022-06-12,LL,Israel,581,86,38,0,495,231,226,457,38
2022-06-13,LL,Israel,559,78,49,6,481,216,216,432,43
2022-06-14,LL,Israel,545,92,48,2,453,203,202,405,46
2022-06-15,LL,Israel,543,88,53,5,455,201,201,402,48
2022-06-16,LL,Israel,633,98,47,1,535,241,247,488,46
2022-06-17,LL,Israel,478,122,24,2,356,173,159,332,22
2022-06-18,LL,Israel,415,104,28,2,311,135,148,283,26
2022-06-19,LL,Israel,627,77,66,3,550,240,244,484,63
2022-06-20,LL,Israel,553,85,52,8,468,209,207,416,44
2022-06-21,LL,Israel,565,96,40,3,469,212,217,429,37
2022-06-22,LL,Israel,571,76,54,3,495,218,223,441,51
2022-06-23,LL,Israel,649,107,50,1,542,251,241,492,49
2022-06-24,LL,Israel,494,127,16,0,367,182,169,351,16
2022-06-25,LL,Israel,434,120,26,1,314,142,146,288,25
2022-06-26,LL,Israel,637,84,58,2,553,241,254,495,56
2022-06-27,LL,Israel,578,94,43,7,484,221,220,441,36
2022-06-28,LL,Israel,579,121,36,2,458,213,209,422,34
2022-06-29,LL,Israel,539,76,41,1,463,205,217,422,40
2022-06-30,LL,Israel,646,98,42,3,548,259,247,506,39
2022-07-01,LL,Israel,562,142,18,1,420,205,197,402,17
2022-07-02,LL,Israel,462,119,26,2,343,154,163,317,24
2022-07-03,LL,Israel,634,85,62,3,549,240,247,487,59
2022-07-04,LL,Israel,619,95,52,3,524,237,235,472,49
2022-07-05,LL,Israel,596,96,44,2,500,231,225,456,42
2022-07-06,LL,Israel,604,116,47,5,488,223,218,441,42
2022-07-07,LL,Israel,697,101,52,0,596,274,270,544,52
2022-07-08,LL,Israel,548,143,18,2,405,197,190,387,16
2022-07-09,LL,Israel,466,123,20,1,343,160,163,323,19
2022-07-10,LL,Israel,674,95,57,1,579,257,265,522,56
2022-07-11,LL,Israel,640,102,55,4,538,242,241,483,51
2022-07-12,LL,Israel,623,104,49,5,519,236,234,470,44
2022-07-13,LL,Israel,607,107,36,6,500,232,232,464,30
2022-07-14,LL,Israel,708,112,55,1,596,270,271,541,54
2022-07-15,LL,Israel,573,152,13,0,421,210,198,408,13
2022-07-16,LL,Israel,490,131,20,0,359,165,174,339,20
2022-07-17,LL,Israel,662,87,68,0,575,254,253,507,68
2022-07-18,LL,Israel,654,113,55,4,541,245,241,486,51
2022-07-19,LL,Israel,622,101,52,2,521,232,237,469,50
2022-07-20,LL,Israel,609,95,53,4,514,226,235,461,49
2022-07-21,LL,Israel,696,121,62,1,575,258,255,513,61
2022-07-22,LL,Israel,531,124,16,0,407,207,184,391,16
2022-07-23,LL,Israel,465,113,17,0,352,167,168,335,17
2022-07-24,LL,Israel,659,83,60,3,576,249,267,516,57
2022-07-25,LL,Israel,623,102,53,9,521,239,229,468,44
2022-07-26,LL,Israel,600,106,33,3,494,233,228,461,30
2022-07-27,LL,Israel,620,102,51,7,518,231,236,467,44
2022-07-28,LL,Israel,701,101,72,2,600,265,263,528,70
2022-07-29,LL,Israel,516,136,24,1,380,185,171,356,23
2022-07-30,LL,Israel,477,114,20,0,363,166,177,343,20
2022-07-31,LL,Israel,668,98,74,2,570,244,252,496,72
2022-08-01,LL,Israel,632,101,56,4,531,240,235,475,52
2022-08-02,LL,Israel,614,110,41,2,504,235,228,463,39
2022-08-03,LL,Israel,600,95,56,4,505,221,228,449,52
2022-08-04,LL,Israel,684,111,58,1,573,256,259,515,57
2022-08-05,LL,Israel,530,149,13,0,381,191,177,368,13
2022-08-06,LL,Israel,465,117,18,1,348,161,169,330,17
2022-08-07,LL,Israel,612,85,41,0,527,239,247,486,41
2022-08-08,LL,Israel,633,99,43,1,534,247,244,491,42
2022-08-09,LL,Israel,636,100,42,4,536,251,243,494,38
2022-08-10,LL,Israel,611,102,48,5,509,227,234,461,43
2022-08-11,LL,Israel,688,120,54,2,568,264,250,514,52
2022-08-12,LL,Israel,554,138,18,1,416,200,198,398,17
2022-08-13,LL,Israel,477,115,22,1,362,165,175,340,21
2022-08-14,LL,Israel,669,92,63,2,577,257,257,514,61
2022-08-15,LL,Israel,663,118,58,6,545,241,246,487,52
2022-08-16,LL,Israel,614,93,38,0,521,242,241,483,38
2022-08-17,LL,Israel,616,105,44,2,511,231,236,467,42
2022-08-18,LL,Israel,700,104,47,2,596,276,273,549,45
2022-08-19,LL,Israel,556,140,17,0,416,206,193,399,17
2022-08-20,LL,Israel,494,112,22,0,382,175,185,360,22
2022-08-21,LL,Israel,691,92,64,6,599,271,264,535,58
2022-08-22,LL,Israel,658,99,58,6,559,246,255,501,52
2022-08-23,LL,Israel,620,107,39,2,513,242,232,474,37
2022-08-24,LL,Israel,631,103,67,3,528,229,232,461,64
2022-08-25,LL,Israel,695,105,56,1,590,268,266,534,55
2022-08-26,LL,Israel,556,135,23,0,421,203,195,398,23
2022-08-27,LL,Israel,505,111,22,0,394,183,189,372,22
2022-08-28,LL,Israel,663,100,47,0,563,254,262,516,47
2022-08-29,LL,Israel,642,111,31,0,531,246,254,500,31
2022-08-30,LL,Israel,619,115,28,1,504,242,234,476,27
2022-08-31,LL,Israel,597,108,38,4,489,225,226,451,34
2022-09-01,LL,Israel,654,115,42,1,539,246,251,497,41
2022-09-02,LL,Israel,484,139,13,0,345,171,161,332,13
2022-09-03,LL,Israel,460,110,20,1,350,159,171,330,19
2022-09-04,LL,Israel,640,90,44,0,550,251,255,506,44
2022-09-05,LL,Israel,602,87,50,2,515,235,230,465,48
2022-09-06,LL,Israel,582,99,42,3,483,224,217,441,39
2022-09-07,LL,Israel,582,85,49,1,497,221,227,448,48
2022-09-08,LL,Israel,668,92,63,2,576,258,255,513,61
2022-09-09,LL,Israel,511,124,29,1,387,186,172,358,28
2022-09-10,LL,Israel,464,99,26,0,365,160,179,339,26
2022-09-11,LL,Israel,656,79,55,2,577,263,259,522,53
2022-09-12,LL,Israel,608,69,78,9,539,231,230,461,69
2022-09-13,LL,Israel,600,99,39,1,501,233,229,462,38
2022-09-14,LL,Israel,585,77,50,3,508,225,233,458,47
2022-09-15,LL,Israel,703,98,43,1,605,282,280,562,42
2022-09-16,LL,Israel,517,132,15,1,385,193,177,370,14
2022-09-17,LL,Israel,472,125,24,0,347,154,169,323,24
2022-09-18,LL,Israel,684,86,67,1,598,258,273,531,66
2022-09-19,LL,Israel,616,85,60,2,531,240,231,471,58
2022-09-20,LL,Israel,616,98,42,0,518,239,237,476,42
2022-09-21,LL,Israel,625,87,62,5,538,235,241,476,57
2022-09-22,LL,Israel,735,94,60,4,641,291,290,581,56
2022-09-23,LL,Israel,577,114,23,1,463,230,210,440,22
2022-09-24,LL,Israel,460,105,14,0,355,165,176,341,14
2022-09-25,LL,Israel,572,124,27,1,448,216,205,421,26
2022-09-26,LL,Israel,434,99,7,0,335,163,165,328,7
2022-09-27,LL,Israel,560,91,30,0,469,211,228,439,30
2022-09-28,LL,Israel,641,79,50,5,562,260,252,512,45
2022-09-29,LL,Israel,718,113,48,2,605,282,275,557,46
2022-09-30,LL,Israel,507,130,17,2,377,190,170,360,15
2022-10-01,LL,Israel,471,129,20,0,342,153,169,322,20
2022-10-02,LL,Israel,660,99,51,5,561,251,259,510,46
2022-10-03,LL,Israel,620,87,41,2,533,249,243,492,39
2022-10-04,LL,Israel,312,77,14,0,235,132,89,221,14
2022-10-05,LL,Israel,89,1,2,0,88,22,64,86,2
2022-10-06,LL,Israel,672,87,41,1,585,270,274,544,40
2022-10-07,LL,Israel,595,143,22,0,452,218,212,430,22
2022-10-08,LL,Israel,491,118,14,0,373,173,186,359,14
2022-10-09,LL,Israel,605,127,28,0,478,226,224,450,28
2022-10-10,LL,Israel,495,99,13,1,396,186,197,383,12
2022-10-11,LL,Israel,602,115,32,0,487,233,222,455,32
2022-10-12,LL,Israel,628,114,33,0,514,242,239,481,33
2022-10-13,LL,Israel,675,121,39,0,554,258,257,515,39
2022-10-14,LL,Israel,560,138,20,0,422,207,195,402,20
2022-10-15,LL,Israel,494,117,17,0,377,174,186,360,17
2022-10-16,LL,Israel,644,138,21,1,506,240,245,485,20
2022-10-17,LL,Israel,582,110,20,0,472,223,229,452,20
2022-10-18,LL,Israel,627,90,46,3,537,247,244,491,43
2022-10-19,LL,Israel,591,92,61,5,499,220,218,438,56
2022-10-20,LL,Israel,665,94,74,5,571,251,246,497,69
2022-10-21,LL,Israel,507,142,16,0,365,180,169,349,16
2022-10-22,LL,Israel,459,130,31,0,329,149,149,298,31
2022-10-23,LL,Israel,665,94,49,4,571,257,265,522,45
2022-10-24,LL,Israel,575,89,54,7,486,215,217,432,47
2022-10-25,LL,Israel,583,105,52,2,478,217,209,426,50
2022-10-26,LL,Israel,569,85,57,2,484,208,219,427,55
2022-10-27,LL,Israel,637,92,47,2,545,249,249,498,45
2022-10-28,LL,Israel,485,134,32,0,351,169,150,319,32
2022-10-29,LL,Israel,451,124,31,0,327,140,156,296,31
2022-10-30,LL,Israel,627,95,54,1,532,237,241,478,53
2022-10-31,LL,Israel,528,80,37,1,448,206,205,411,36
2022-11-01,LL,Israel,498,79,45,1,419,187,187,374,44
2022-11-02,LL,Israel,518,76,43,2,442,201,198,399,41
2022-11-03,LL,Israel,602,89,62,1,513,226,225,451,61
2022-11-04,LL,Israel,471,120,20,0,351,170,161,331,20
2022-11-05,LL,Israel,422,116,20,0,306,137,149,286,20
2022-11-06,LL,Israel,627,96,49,1,531,239,243,482,48
2022-11-07,LL,Israel,539,67,45,3,472,221,206,427,42
2022-11-08,LL,Israel,483,87,38,2,396,181,177,358,36
2022-11-09,LL,Israel,516,75,39,2,441,199,203,402,37
2022-11-10,LL,Israel,598,94,57,4,504,219,228,447,53
2022-11-11,LL,Israel,472,132,22,1,340,166,152,318,21
2022-11-12,LL,Israel,444,124,30,1,320,133,157,290,29
2022-11-13,LL,Israel,651,127,58,4,524,235,231,466,54
2022-11-14,LL,Israel,573,109,55,5,464,201,208,409,50
2022-11-15,LL,Israel,549,129,51,5,420,193,176,369,46
2022-11-16,LL,Israel,579,124,51,4,455,199,205,404,47
2022-11-17,LL,Israel,616,119,47,2,497,230,220,450,45
2022-11-18,LL,Israel,492,139,20,2,353,168,165,333,18
2022-11-19,LL,Israel,437,130,22,1,307,139,146,285,21
2022-11-20,LL,Israel,630,122,46,2,508,227,235,462,44
2022-11-21,LL,Israel,552,92,42,4,460,214,204,418,38
2022-11-22,LL,Israel,510,107,42,0,403,180,181,361,42
2022-11-23,LL,Israel,582,113,55,5,469,205,209,414,50
2022-11-24,LL,Israel,643,125,50,2,518,234,234,468,48
2022-11-25,LL,Israel,438,142,12,0,296,148,136,284,12
2022-11-26,LL,Israel,463,137,34,1,326,138,154,292,33
2022-11-27,LL,Israel,650,128,48,0,522,238,236,474,48
2022-11-28,LL,Israel,545,92,43,4,453,205,205,410,39
2022-11-29,LL,Israel,517,118,38,3,399,181,180,361,35
2022-11-30,LL,Israel,551,90,65,6,461,196,200,396,59
2022-12-01,LL,Israel,599,100,58,3,499,224,217,441,55
2022-12-02,LL,Israel,446,123,21,0,323,153,149,302,21
2022-12-03,LL,Israel,423,111,24,0,312,137,151,288,24
2022-12-04,LL,Israel,650,139,57,4,511,227,227,454,53
2022-12-05,LL,Israel,549,104,47,5,445,202,196,398,42
2022-12-06,LL,Israel,535,129,46,1,406,182,178,360,45
2022-12-07,LL,Israel,526,106,36,0,420,195,189,384,36
2022-12-08,LL,Israel,609,94,61,2,515,223,231,454,59
2022-12-09,LL,Israel,470,134,16,3,336,166,154,320,13
2022-12-10,LL,Israel,416,117,28,1,299,127,144,271,27
2022-12-11,LL,Israel,621,122,59,5,499,214,226,440,54
2022-12-12,LL,Israel,554,102,47,6,452,211,194,405,41
2022-12-13,LL,Israel,492,110,27,1,382,180,175,355,26
2022-12-14,LL,Israel,550,100,43,6,450,203,204,407,37
2022-12-15,LL,Israel,625,110,46,1,515,235,234,469,45
2022-12-16,LL,Israel,463,112,14,0,351,174,163,337,14
2022-12-17,LL,Israel,443,107,25,1,336,146,165,311,24
2022-12-18,LL,Israel,634,116,40,1,518,239,239,478,39
2022-12-19,LL,Israel,615,116,44,0,499,227,228,455,44
2022-12-20,LL,Israel,602,135,38,2,467,215,214,429,36
2022-12-21,LL,Israel,580,98,30,0,482,223,229,452,30
2022-12-22,LL,Israel,659,119,47,1,540,249,244,493,46
2022-12-23,LL,Israel,531,157,18,1,374,183,173,356,17
2022-12-24,LL,Israel,469,138,29,0,331,143,159,302,29
2022-12-25,LL,Israel,565,74,50,3,491,222,219,441,47
2022-12-26,LL,Israel,591,59,69,5,532,230,233,463,64
2022-12-27,LL,Israel,558,105,47,7,453,206,200,406,40
2022-01-01,LI,Italy,2992,1080,507,4,1912,701,704,1405,503
2022-01-02,LI,Italy,4057,1428,678,9,2629,979,972,1951,669
2022-01-03,LI,Italy,3888,1217,746,11,2671,965,960,1925,735
2022-01-04,LI,Italy,3344,1046,716,19,2298,795,787,1582,697
2022-01-05,LI,Italy,3262,975,725,35,2287,780,782,1562,690
2022-01-06,LI,Italy,3190,981,671,16,2209,776,762,1538,655
2022-01-07,LI,Italy,3653,1119,725,15,2534,882,927,1809,710
2022-01-08,LI,Italy,3443,1200,614,9,2243,814,815,1629,605
2022-01-09,LI,Italy,3852,1268,695,7,2584,943,946,1889,688
2022-01-10,LI,Italy,2952,865,675,16,2087,715,697,1412,659
2022-01-11,LI,Italy,2317,724,536,14,1593,530,527,1057,522
2022-01-12,LI,Italy,2346,758,571,17,1588,503,514,1017,554
2022-01-13,LI,Italy,2449,750,590,14,1699,556,553,1109,576
2022-01-14,LI,Italy,3029,927,647,17,2102,713,742,1455,630
2022-01-15,LI,Italy,2563,968,465,15,1595,573,557,1130,450
2022-01-16,LI,Italy,2881,985,564,17,1896,658,674,1332,547
2022-01-17,LI,Italy,2653,793,627,15,1860,629,604,1233,612
2022-01-18,LI,Italy,2249,714,534,25,1535,496,505,1001,509
2022-01-19,LI,Italy,2250,718,568,27,1532,485,479,964,541
2022-01-20,LI,Italy,2451,738,591,38,1713,562,560,1122,553
2022-01-21,LI,Italy,2926,883,624,14,2043,701,718,1419,610
2022-01-22,LI,Italy,2465,902,475,10,1563,549,539,1088,465
2022-01-23,LI,Italy,2854,948,569,14,1906,666,671,1337,555
2022-01-24,LI,Italy,2521,724,618,35,1797,594,585,1179,583
2022-01-25,LI,Italy,2115,597,526,26,1518,495,497,992,500
2022-01-26,LI,Italy,2210,713,536,24,1497,484,477,961,512
2022-01-27,LI,Italy,2375,725,555,30,1650,549,546,1095,525
2022-01-28,LI,Italy,2964,934,649,18,2030,670,711,1381,631
2022-01-29,LI,Italy,2477,905,462,13,1572,563,547,1110,449
2022-01-30,LI,Italy,2911,1032,575,12,1879,657,647,1304,563
2022-01-31,LI,Italy,2630,767,590,27,1863,636,637,1273,563
2022-02-01,LI,Italy,2412,686,541,22,1726,590,595,1185,519
2022-02-02,LI,Italy,2452,729,576,23,1723,574,573,1147,553
2022-02-03,LI,Italy,2680,781,608,33,1899,645,646,1291,575
2022-02-04,LI,Italy,3235,949,704,32,2286,775,807,1582,672
2022-02-05,LI,Italy,2737,971,470,6,1766,649,647,1296,464
2022-02-06,LI,Italy,3131,1073,579,7,2058,741,738,1479,572
2022-02-07,LI,Italy,2980,891,629,14,2089,732,728,1460,615
2022-02-08,LI,Italy,2529,741,547,31,1788,632,609,1241,516
2022-02-09,LI,Italy,2650,805,589,40,1845,615,641,1256,549
2022-02-10,LI,Italy,2892,881,608,40,2011,700,703,1403,568
2022-02-11,LI,Italy,3497,1013,715,34,2484,873,896,1769,681
2022-02-12,LI,Italy,3067,1060,508,15,2007,751,748,1499,493
2022-02-13,LI,Italy,3243,1077,586,12,2166,793,787,1580,574
2022-02-14,LI,Italy,3160,900,640,16,2260,807,813,1620,624
2022-02-15,LI,Italy,2724,802,586,18,1922,673,663,1336,568
2022-02-16,LI,Italy,2754,801,627,25,1953,655,671,1326,602
2022-02-17,LI,Italy,2940,860,637,33,2080,728,715,1443,604
2022-02-18,LI,Italy,3512,1104,745,23,2408,818,845,1663,722
2022-02-19,LI,Italy,3236,1169,528,26,2067,768,771,1539,502
2022-02-20,LI,Italy,3475,1224,629,24,2251,815,807,1622,605
2022-02-21,LI,Italy,3255,1013,671,22,2242,788,783,1571,649
2022-02-22,LI,Italy,2775,840,564,32,1935,680,691,1371,532
2022-02-23,LI,Italy,2896,878,641,45,2018,689,688,1377,596
2022-02-24,LI,Italy,3127,948,662,45,2179,755,762,1517,617
2022-02-25,LI,Italy,3667,1148,751,33,2519,873,895,1768,718
2022-02-26,LI,Italy,3274,1213,533,31,2061,768,760,1528,502
2022-02-27,LI,Italy,3525,1224,639,27,2301,837,825,1662,612
2022-02-28,LI,Italy,3385,1047,685,35,2338,837,816,1653,650
2022-03-01,LI,Italy,3051,903,640,44,2148,758,750,1508,596
2022-03-02,LI,Italy,3048,939,635,23,2109,728,746,1474,612
2022-03-03,LI,Italy,3333,994,705,34,2339,817,817,1634,671
2022-03-04,LI,Italy,3826,1174,773,26,2652,921,958,1879,747
2022-03-05,LI,Italy,3362,1201,552,22,2161,817,792,1609,530
2022-03-06,LI,Italy,3645,1239,640,18,2406,881,885,1766,622
2022-03-07,LI,Italy,3566,1056,737,28,2510,891,882,1773,709
2022-03-08,LI,Italy,3020,949,608,31,2071,735,728,1463,577
2022-03-09,LI,Italy,3185,966,653,26,2219,778,788,1566,627
2022-03-10,LI,Italy,3411,1002,741,26,2409,825,843,1668,715
2022-03-11,LI,Italy,3813,1146,757,26,2667,955,955,1910,731
2022-03-12,LI,Italy,3292,1192,527,11,2100,784,789,1573,516
2022-03-13,LI,Italy,3692,1249,646,12,2443,902,895,1797,634
2022-03-14,LI,Italy,3563,1152,684,24,2411,872,855,1727,660
2022-03-15,LI,Italy,3152,1023,620,24,2129,754,755,1509,596
2022-03-16,LI,Italy,3232,1004,668,26,2228,774,786,1560,642
2022-03-17,LI,Italy,3374,1055,689,17,2319,809,821,1630,672
2022-03-18,LI,Italy,3866,1219,740,24,2647,949,958,1907,716
2022-03-19,LI,Italy,3419,1235,531,13,2184,829,824,1653,518
2022-03-20,LI,Italy,3769,1299,643,13,2470,918,909,1827,630
2022-03-21,LI,Italy,3580,1087,719,23,2493,892,882,1774,696
2022-03-22,LI,Italy,3115,960,633,26,2155,768,754,1522,607
2022-03-23,LI,Italy,3273,1007,659,22,2266,797,810,1607,637
2022-03-24,LI,Italy,3504,1049,706,36,2455,866,883,1749,670
2022-03-25,LI,Italy,3911,1191,759,27,2720,969,992,1961,732
2022-03-26,LI,Italy,3449,1231,542,19,2218,856,820,1676,523
2022-03-27,LI,Italy,4425,1503,744,17,2922,1090,1088,2178,727
2022-03-28,LI,Italy,4327,1317,827,27,3010,1099,1084,2183,800
2022-03-29,LI,Italy,4027,1205,780,30,2822,1018,1024,2042,750
2022-03-30,LI,Italy,4035,1228,771,20,2807,1011,1025,2036,751
2022-03-31,LI,Italy,4262,1269,833,28,2993,1079,1081,2160,805
2022-04-01,LI,Italy,4599,1429,844,24,3170,1153,1173,2326,820
2022-04-02,LI,Italy,4365,1584,691,13,2781,1045,1045,2090,678
2022-04-03,LI,Italy,4662,1582,757,13,3080,1165,1158,2323,744
2022-04-04,LI,Italy,4455,1326,836,24,3129,1153,1140,2293,812
2022-04-05,LI,Italy,4180,1251,808,30,2929,1054,1067,2121,778
2022-04-06,LI,Italy,4310,1300,805,25,3010,1106,1099,2205,780
2022-04-07,LI,Italy,4480,1325,844,26,3155,1152,1159,2311,818
2022-04-08,LI,Italy,5004,1629,881,33,3375,1223,1271,2494,848
2022-04-09,LI,Italy,4811,1871,680,16,2940,1133,1127,2260,664
2022-04-10,LI,Italy,4916,1720,773,15,3196,1215,1208,2423,758
2022-04-11,LI,Italy,4610,1499,803,26,3111,1162,1146,2308,777
2022-04-12,LI,Italy,4520,1423,843,33,3097,1126,1128,2254,810
2022-04-13,LI,Italy,4820,1561,891,26,3259,1173,1195,2368,865
2022-04-14,LI,Italy,5154,1696,933,36,3458,1266,1259,2525,897
2022-04-15,LI,Italy,5199,1741,890,19,3458,1273,1295,2568,871
2022-04-16,LI,Italy,4907,1892,700,17,3015,1168,1147,2315,683
2022-04-17,LI,Italy,4708,1697,687,10,3011,1157,1167,2324,677
2022-04-18,LI,Italy,5047,1720,833,17,3327,1253,1241,2494,816
2022-04-19,LI,Italy,4827,1472,911,32,3355,1206,1238,2444,879
2022-04-20,LI,Italy,4822,1534,911,29,3288,1184,1193,2377,882
2022-04-21,LI,Italy,4828,1495,869,29,3333,1233,1231,2464,840
2022-04-22,LI,Italy,5182,1638,895,22,3544,1313,1336,2649,873
2022-04-23,LI,Italy,5126,1951,733,15,3175,1237,1205,2442,718
2022-04-24,LI,Italy,5207,1922,764,14,3285,1281,1240,2521,750
2022-04-25,LI,Italy,4926,1605,837,19,3321,1234,1250,2484,818
2022-04-26,LI,Italy,4619,1434,858,24,3185,1163,1164,2327,834
2022-04-27,LI,Italy,4702,1468,886,39,3234,1170,1178,2348,847
2022-04-28,LI,Italy,4979,1572,927,49,3407,1234,1246,2480,878
2022-04-29,LI,Italy,5346,1751,919,33,3595,1336,1340,2676,886
2022-04-30,LI,Italy,5118,2018,702,13,3100,1207,1191,2398,689
2022-05-01,LI,Italy,5303,1969,786,18,3334,1270,1278,2548,768
2022-05-02,LI,Italy,5107,1663,896,25,3444,1281,1267,2548,871
2022-05-03,LI,Italy,4892,1670,833,29,3222,1196,1193,2389,804
2022-05-04,LI,Italy,4933,1623,864,31,3310,1218,1228,2446,833
2022-05-05,LI,Italy,5093,1666,896,38,3427,1273,1258,2531,858
2022-05-06,LI,Italy,5569,1907,916,18,3662,1362,1384,2746,898
2022-05-07,LI,Italy,5444,2191,743,13,3253,1260,1250,2510,730
2022-05-08,LI,Italy,5515,2082,802,14,3433,1314,1317,2631,788
2022-05-09,LI,Italy,5166,1714,867,24,3452,1297,1288,2585,843
2022-05-10,LI,Italy,4860,1611,850,39,3249,1187,1212,2399,811
2022-05-11,LI,Italy,5145,1732,895,29,3413,1247,1271,2518,866
2022-05-12,LI,Italy,5379,1815,948,52,3564,1310,1306,2616,896
2022-05-13,LI,Italy,5581,1873,933,29,3708,1359,1416,2775,904
2022-05-14,LI,Italy,5392,2080,757,19,3312,1280,1275,2555,738
2022-05-15,LI,Italy,5624,2039,841,18,3585,1397,1347,2744,823
2022-05-16,LI,Italy,5458,1885,927,30,3573,1337,1309,2646,897
2022-05-17,LI,Italy,4914,1634,868,43,3280,1205,1207,2412,825
2022-05-18,LI,Italy,5106,1659,885,39,3447,1275,1287,2562,846
2022-05-19,LI,Italy,5364,1800,953,42,3564,1290,1321,2611,911
2022-05-20,LI,Italy,5663,2003,947,32,3660,1339,1374,2713,915
2022-05-21,LI,Italy,5663,2304,789,15,3359,1289,1281,2570,774
2022-05-22,LI,Italy,5784,2169,845,16,3615,1389,1381,2770,829
2022-05-23,LI,Italy,5525,1922,940,39,3603,1331,1332,2663,901
2022-05-24,LI,Italy,5134,1729,871,32,3405,1280,1254,2534,839
2022-05-25,LI,Italy,5672,2001,889,24,3671,1374,1408,2782,865
2022-05-26,LI,Italy,5766,2040,933,31,3726,1361,1432,2793,902
2022-05-27,LI,Italy,5932,2143,979,35,3789,1404,1406,2810,944
2022-05-28,LI,Italy,5909,2400,832,10,3509,1337,1340,2677,822
2022-05-29,LI,Italy,6397,2539,894,17,3858,1511,1453,2964,877
2022-05-30,LI,Italy,5895,2172,927,26,3723,1419,1377,2796,901
2022-05-31,LI,Italy,5487,1894,915,40,3593,1325,1353,2678,875
2022-06-01,LI,Italy,5758,1954,1000,35,3804,1410,1394,2804,965
2022-06-02,LI,Italy,5752,2087,884,13,3665,1392,1389,2781,871
2022-06-03,LI,Italy,6119,2270,897,18,3849,1440,1512,2952,879
2022-06-04,LI,Italy,6175,2447,900,9,3728,1401,1427,2828,891
2022-06-05,LI,Italy,6307,2389,974,13,3918,1477,1467,2944,961
2022-06-06,LI,Italy,6307,2264,991,27,4043,1553,1499,3052,964
2022-06-07,LI,Italy,5804,2024,953,29,3780,1414,1413,2827,924
2022-06-08,LI,Italy,5394,2122,790,25,3272,1232,1250,2482,765
2022-06-09,LI,Italy,5931,2030,995,30,3901,1459,1447,2906,965
2022-06-10,LI,Italy,6313,2174,996,22,4139,1552,1591,3143,974
2022-06-11,LI,Italy,6282,2476,920,15,3806,1442,1444,2886,905
2022-06-12,LI,Italy,6362,2396,948,12,3966,1515,1503,3018,936
2022-06-13,LI,Italy,6049,2122,977,21,3927,1482,1468,2950,956
2022-06-14,LI,Italy,5787,1976,965,38,3811,1416,1430,2846,927
2022-06-15,LI,Italy,6017,2103,1006,33,3914,1453,1455,2908,973
2022-06-16,LI,Italy,6057,2143,1004,30,3914,1443,1467,2910,974
2022-06-17,LI,Italy,6463,2310,1035,20,4153,1541,1577,3118,1015
2022-06-18,LI,Italy,6398,2553,937,11,3845,1454,1454,2908,926
2022-06-19,LI,Italy,6630,2562,995,14,4068,1567,1506,3073,981
2022-06-20,LI,Italy,6370,2363,983,16,4007,1524,1500,3024,967
2022-06-21,LI,Italy,5898,2066,964,26,3832,1421,1447,2868,938
2022-06-22,LI,Italy,6080,2185,978,18,3895,1468,1449,2917,960
2022-06-23,LI,Italy,6178,2260,1028,23,3918,1431,1459,2890,1005
2022-06-24,LI,Italy,6385,2353,1020,14,4032,1491,1521,3012,1006
2022-06-25,LI,Italy,6365,2636,899,10,3729,1416,1414,2830,889
2022-06-26,LI,Italy,6505,2522,1007,9,3983,1488,1488,2976,998
2022-06-27,LI,Italy,6460,2382,997,13,4078,1552,1529,3081,984
2022-06-28,LI,Italy,6114,2273,967,24,3841,1448,1426,2874,943
2022-06-29,LI,Italy,6417,2496,991,27,3921,1447,1483,2930,964
2022-06-30,LI,Italy,6473,2453,994,26,4020,1503,1523,3026,968
2022-07-01,LI,Italy,6897,2626,1045,17,4271,1593,1633,3226,1028
2022-07-02,LI,Italy,6838,2908,952,12,3930,1488,1490,2978,940
2022-07-03,LI,Italy,6835,2668,1006,18,4167,1601,1560,3161,988
2022-07-04,LI,Italy,6770,2554,1044,16,4216,1591,1581,3172,1028
2022-07-05,LI,Italy,6429,2463,987,20,3966,1484,1495,2979,967
2022-07-06,LI,Italy,6543,2516,1064,28,4027,1490,1473,2963,1036
2022-07-07,LI,Italy,6644,2524,1011,28,4120,1539,1570,3109,983
2022-07-08,LI,Italy,6838,2496,1087,22,4342,1613,1642,3255,1065
2022-07-09,LI,Italy,7055,2939,962,9,4116,1573,1581,3154,953
2022-07-10,LI,Italy,6911,2731,1027,10,4180,1593,1560,3153,1017
2022-07-11,LI,Italy,6622,2475,1016,18,4147,1569,1562,3131,998
2022-07-12,LI,Italy,6402,2422,996,22,3980,1500,1484,2984,974
2022-07-13,LI,Italy,6608,2536,1041,27,4072,1516,1515,3031,1014
2022-07-14,LI,Italy,6532,2473,1011,24,4059,1519,1529,3048,987
2022-07-15,LI,Italy,7000,2671,1073,21,4329,1592,1664,3256,1052
2022-07-16,LI,Italy,7133,2974,1013,13,4159,1579,1567,3146,1000
2022-07-17,LI,Italy,6235,2746,828,9,3489,1350,1311,2661,819
2022-07-18,LI,Italy,6800,2508,1051,24,4292,1621,1620,3241,1027
2022-07-19,LI,Italy,6473,2518,1026,26,3955,1469,1460,2929,1000
2022-07-20,LI,Italy,6738,2623,1068,25,4115,1515,1532,3047,1043
2022-07-21,LI,Italy,6886,2700,1054,31,4186,1570,1562,3132,1023
2022-07-22,LI,Italy,6791,2555,1063,20,4236,1558,1615,3173,1043
2022-07-23,LI,Italy,7157,3048,966,13,4109,1566,1577,3143,953
2022-07-24,LI,Italy,6948,2812,1033,13,4136,1574,1529,3103,1020
2022-07-25,LI,Italy,6831,2674,1009,30,4157,1578,1570,3148,979
2022-07-26,LI,Italy,6396,2497,1014,30,3899,1445,1440,2885,984
2022-07-27,LI,Italy,6537,2518,1061,36,4019,1469,1489,2958,1025
2022-07-28,LI,Italy,6714,2577,1003,27,4137,1560,1574,3134,976
2022-07-29,LI,Italy,6955,2683,1085,19,4272,1587,1600,3187,1066
2022-07-30,LI,Italy,7391,3163,976,6,4228,1619,1633,3252,970
2022-07-31,LI,Italy,7206,2880,1069,9,4326,1641,1616,3257,1060
2022-08-01,LI,Italy,6871,2662,1041,16,4209,1595,1573,3168,1025
2022-08-02,LI,Italy,6430,2499,985,17,3931,1478,1468,2946,968
2022-08-03,LI,Italy,6602,2528,1021,20,4074,1531,1522,3053,1001
2022-08-04,LI,Italy,6534,2519,970,22,4015,1519,1526,3045,948
2022-08-05,LI,Italy,6823,2645,1040,10,4178,1555,1583,3138,1030
2022-08-06,LI,Italy,7200,3021,1000,11,4179,1590,1589,3179,989
2022-08-07,LI,Italy,6885,2720,1009,8,4165,1605,1551,3156,1001
2022-08-08,LI,Italy,6656,2609,986,14,4047,1522,1539,3061,972
2022-08-09,LI,Italy,6379,2586,930,24,3793,1439,1424,2863,906
2022-08-10,LI,Italy,6564,2528,1024,23,4036,1500,1512,3012,1001
2022-08-11,LI,Italy,6370,2440,975,23,3930,1481,1474,2955,952
2022-08-12,LI,Italy,6671,2584,1003,17,4087,1531,1553,3084,986
2022-08-13,LI,Italy,7124,3015,980,7,4109,1561,1568,3129,973
2022-08-14,LI,Italy,6927,2885,1016,4,4042,1528,1498,3026,1012
2022-08-15,LI,Italy,6375,2569,896,9,3806,1466,1444,2910,887
2022-08-16,LI,Italy,6202,2419,943,12,3783,1430,1410,2840,931
2022-08-17,LI,Italy,6236,2407,985,22,3829,1423,1421,2844,963
2022-08-18,LI,Italy,6221,2405,907,18,3816,1450,1459,2909,889
2022-08-19,LI,Italy,6682,2624,991,22,4058,1507,1560,3067,969
2022-08-20,LI,Italy,7303,3222,996,12,4081,1546,1539,3085,984
2022-08-21,LI,Italy,7067,2959,1017,8,4108,1560,1531,3091,1009
2022-08-22,LI,Italy,6562,2570,990,18,3992,1502,1500,3002,972
2022-08-23,LI,Italy,6252,2502,936,18,3750,1404,1410,2814,918
2022-08-24,LI,Italy,6524,2565,987,18,3959,1485,1487,2972,969
2022-08-25,LI,Italy,6477,2529,962,28,3948,1492,1494,2986,934
2022-08-26,LI,Italy,6724,2625,1031,22,4099,1510,1558,3068,1009
2022-08-27,LI,Italy,6947,2919,987,12,4028,1526,1515,3041,975
2022-08-28,LI,Italy,7005,2849,1068,13,4156,1551,1537,3088,1055
2022-08-29,LI,Italy,6630,2566,1001,29,4064,1539,1524,3063,972
2022-08-30,LI,Italy,6267,2418,963,25,3849,1450,1436,2886,938
2022-08-31,LI,Italy,6473,2433,1081,30,4040,1466,1493,2959,1051
2022-09-01,LI,Italy,6481,2389,1001,18,4092,1539,1552,3091,983
2022-09-02,LI,Italy,6474,2301,1029,16,4173,1554,1590,3144,1013
2022-09-03,LI,Italy,6728,2727,983,15,4001,1503,1515,3018,968
2022-09-04,LI,Italy,6875,2655,1043,15,4220,1605,1572,3177,1028
2022-09-05,LI,Italy,6410,2311,987,17,4099,1571,1541,3112,970
2022-09-06,LI,Italy,6070,2192,952,40,3878,1457,1469,2926,912
2022-09-07,LI,Italy,6286,2269,1017,30,4017,1499,1501,3000,987
2022-09-08,LI,Italy,6263,2259,997,26,4004,1496,1511,3007,971
2022-09-09,LI,Italy,6498,2367,972,28,4131,1555,1604,3159,944
2022-09-10,LI,Italy,6573,2638,938,15,3935,1495,1502,2997,923
2022-09-11,LI,Italy,6806,2528,1026,19,4278,1654,1598,3252,1007
2022-09-12,LI,Italy,6097,2164,932,20,3933,1516,1485,3001,912
2022-09-13,LI,Italy,5983,2100,961,31,3883,1443,1479,2922,930
2022-09-14,LI,Italy,6116,2195,976,25,3921,1485,1460,2945,951
2022-09-15,LI,Italy,6398,2314,980,19,4084,1552,1552,3104,961
2022-09-16,LI,Italy,6071,2068,1020,22,4003,1469,1514,2983,998
2022-09-17,LI,Italy,6467,2652,915,14,3815,1460,1440,2900,901
2022-09-18,LI,Italy,6566,2417,1031,12,4149,1574,1544,3118,1019
2022-09-19,LI,Italy,6085,2116,993,24,3969,1498,1478,2976,969
2022-09-20,LI,Italy,5712,1976,921,32,3736,1408,1407,2815,889
2022-09-21,LI,Italy,5857,2043,949,23,3814,1418,1447,2865,926
2022-09-22,LI,Italy,5927,2018,963,28,3909,1463,1483,2946,935
2022-09-23,LI,Italy,6261,2151,991,28,4110,1534,1585,3119,963
2022-09-24,LI,Italy,6054,2388,883,11,3666,1388,1395,2783,872
2022-09-25,LI,Italy,6392,2341,968,11,4051,1564,1519,3083,957
2022-09-26,LI,Italy,5942,2086,927,19,3856,1483,1446,2929,908
2022-09-27,LI,Italy,5691,1970,923,29,3721,1413,1385,2798,894
2022-09-28,LI,Italy,5851,2077,950,35,3774,1404,1420,2824,915
2022-09-29,LI,Italy,5841,2090,939,23,3751,1399,1413,2812,916
2022-09-30,LI,Italy,6282,2288,980,17,3994,1498,1516,3014,963
2022-10-01,LI,Italy,6043,2574,809,10,3469,1330,1330,2660,799
2022-10-02,LI,Italy,6062,2255,899,7,3807,1461,1447,2908,892
2022-10-03,LI,Italy,5723,1982,913,34,3741,1430,1398,2828,879
2022-10-04,LI,Italy,5270,1737,891,39,3533,1316,1326,2642,852
2022-10-05,LI,Italy,5362,1804,904,41,3558,1332,1322,2654,863
2022-10-06,LI,Italy,5520,1911,938,41,3609,1328,1343,2671,897
2022-10-07,LI,Italy,5915,2043,950,26,3872,1440,1482,2922,924
2022-10-08,LI,Italy,5732,2285,784,17,3447,1333,1330,2663,767
2022-10-09,LI,Italy,5771,2076,852,9,3695,1438,1405,2843,843
2022-10-10,LI,Italy,5400,1744,892,15,3656,1385,1379,2764,877
2022-10-11,LI,Italy,5117,1668,855,42,3449,1306,1288,2594,813
2022-10-12,LI,Italy,5312,1795,872,38,3517,1321,1324,2645,834
2022-10-13,LI,Italy,5467,1842,916,36,3625,1350,1359,2709,880
2022-10-14,LI,Italy,5650,1959,902,27,3691,1379,1410,2789,875
2022-10-15,LI,Italy,5680,2286,767,17,3394,1318,1309,2627,750
2022-10-16,LI,Italy,5805,2154,836,14,3651,1408,1407,2815,822
2022-10-17,LI,Italy,5324,1776,894,34,3548,1344,1310,2654,860
2022-10-18,LI,Italy,5039,1645,855,45,3394,1262,1277,2539,810
2022-10-19,LI,Italy,5220,1776,863,44,3444,1293,1288,2581,819
2022-10-20,LI,Italy,5288,1771,894,40,3517,1327,1296,2623,854
2022-10-21,LI,Italy,3865,1981,437,14,1884,692,755,1447,423
2022-10-22,LI,Italy,5558,2170,737,19,3388,1343,1308,2651,718
2022-10-23,LI,Italy,5593,2084,794,8,3509,1348,1367,2715,786
2022-10-24,LI,Italy,5317,1756,923,34,3561,1332,1306,2638,889
2022-10-25,LI,Italy,4974,1634,824,36,3340,1254,1262,2516,788
2022-10-26,LI,Italy,5242,1828,857,31,3414,1274,1283,2557,826
2022-10-27,LI,Italy,5172,1712,874,26,3460,1289,1297,2586,848
2022-10-28,LI,Italy,5519,1900,884,20,3619,1355,1380,2735,864
2022-10-29,LI,Italy,5514,2195,750,12,3319,1299,1270,2569,738
2022-10-30,LI,Italy,4798,1770,703,12,3028,1183,1142,2325,691
2022-10-31,LI,Italy,4426,1507,704,8,2919,1113,1102,2215,696
2022-11-01,LI,Italy,3799,1292,585,7,2507,953,969,1922,578
2022-11-02,LI,Italy,3946,1284,696,36,2662,961,1005,1966,660
2022-11-03,LI,Italy,4072,1311,717,28,2761,1031,1013,2044,689
2022-11-04,LI,Italy,4477,1418,799,18,3059,1114,1146,2260,781
2022-11-05,LI,Italy,4017,1496,589,10,2521,977,955,1932,579
2022-11-06,LI,Italy,4453,1597,638,7,2856,1111,1107,2218,631
2022-11-07,LI,Italy,4255,1296,769,30,2959,1103,1087,2190,739
2022-11-08,LI,Italy,3584,1103,624,32,2481,930,927,1857,592
2022-11-09,LI,Italy,3534,1101,653,31,2433,886,894,1780,622
2022-11-10,LI,Italy,3818,1168,678,30,2650,981,991,1972,648
2022-11-11,LI,Italy,4297,1351,745,11,2946,1081,1120,2201,734
2022-11-12,LI,Italy,3720,1302,577,8,2418,923,918,1841,569
2022-11-13,LI,Italy,4218,1407,653,9,2811,1091,1067,2158,644
2022-11-14,LI,Italy,4122,1263,731,17,2859,1072,1056,2128,714
2022-11-15,LI,Italy,3488,1055,640,30,2433,902,891,1793,610
2022-11-16,LI,Italy,3525,1080,636,28,2445,891,918,1809,608
2022-11-17,LI,Italy,3799,1162,684,28,2637,978,975,1953,656
2022-11-18,LI,Italy,4210,1308,719,10,2902,1079,1104,2183,709
2022-11-19,LI,Italy,3621,1272,533,9,2349,922,894,1816,524
2022-11-20,LI,Italy,4016,1331,622,8,2685,1039,1024,2063,614
2022-11-21,LI,Italy,4019,1177,759,20,2842,1033,1050,2083,739
2022-11-22,LI,Italy,3376,1042,606,10,2334,866,862,1728,596
2022-11-23,LI,Italy,3469,1034,663,29,2435,890,882,1772,634
2022-11-24,LI,Italy,3703,1151,671,13,2552,932,949,1881,658
2022-11-25,LI,Italy,4191,1283,763,19,2908,1055,1090,2145,744
2022-11-26,LI,Italy,3479,1123,562,5,2356,911,883,1794,557
2022-11-27,LI,Italy,3955,1266,621,1,2689,1039,1029,2068,620
2022-11-28,LI,Italy,4001,1178,763,27,2823,1037,1023,2060,736
2022-11-29,LI,Italy,3359,989,640,22,2370,863,867,1730,618
2022-11-30,LI,Italy,3500,1068,668,26,2432,883,881,1764,642
2022-12-01,LI,Italy,3750,1170,708,28,2580,934,938,1872,680
2022-12-02,LI,Italy,4071,1307,731,14,2764,1015,1018,2033,717
2022-12-03,LI,Italy,3554,1215,563,3,2339,892,884,1776,560
2022-12-04,LI,Italy,3974,1282,644,6,2692,1011,1037,2048,638
2022-12-05,LI,Italy,3958,1123,743,22,2835,1051,1041,2092,721
2022-12-06,LI,Italy,3517,992,659,20,2525,935,931,1866,639
2022-12-07,LI,Italy,3654,1088,661,31,2566,955,950,1905,630
2022-12-08,LI,Italy,3592,1146,576,3,2446,944,926,1870,573
2022-12-09,LI,Italy,3992,1227,702,12,2765,1017,1046,2063,690
2022-12-10,LI,Italy,3631,1240,551,6,2391,924,916,1840,545
2022-12-11,LI,Italy,4140,1436,659,6,2704,1016,1029,2045,653
2022-12-12,LI,Italy,4002,1151,762,12,2851,1039,1050,2089,750
2022-12-13,LI,Italy,3566,1066,679,17,2500,935,886,1821,662
2022-12-14,LI,Italy,3569,1117,685,17,2452,873,894,1767,668
2022-12-15,LI,Italy,3822,1138,715,26,2684,986,983,1969,689
2022-12-16,LI,Italy,4322,1350,819,13,2972,1069,1084,2153,806
2022-12-17,LI,Italy,3881,1292,640,6,2589,969,980,1949,634
2022-12-18,LI,Italy,4159,1345,699,10,2814,1067,1048,2115,689
2022-12-19,LI,Italy,4439,1404,817,18,3035,1105,1113,2218,799
2022-12-20,LI,Italy,4022,1266,761,20,2756,995,1000,1995,741
2022-12-21,LI,Italy,4025,1150,826,12,2875,1022,1027,2049,814
2022-12-22,LI,Italy,4209,1296,785,23,2913,1061,1067,2128,762
2022-12-23,LI,Italy,4499,1386,805,17,3113,1150,1158,2308,788
2022-12-24,LI,Italy,3406,1216,550,4,2190,835,805,1640,546
2022-12-25,LI,Italy,2425,1065,287,2,1360,527,546,1073,285
2022-12-26,LI,Italy,3990,1309,635,4,2681,1026,1020,2046,631
2022-12-27,LI,Italy,3907,1218,726,13,2689,988,975,1963,713
2022-01-01,EV,Latvia,561,431,0,0,130,64,66,130,0
2022-01-02,EV,Latvia,737,564,0,0,173,89,84,173,0
2022-01-03,EV,Latvia,664,500,0,0,164,81,83,164,0
2022-01-04,EV,Latvia,593,468,0,0,125,61,64,125,0
2022-01-05,EV,Latvia,633,484,0,0,149,73,76,149,0
2022-01-06,EV,Latvia,596,451,1,0,145,73,71,144,1
2022-01-07,EV,Latvia,659,498,2,1,161,79,80,159,1
2022-01-08,EV,Latvia,647,506,1,1,141,69,71,140,0
2022-01-09,EV,Latvia,780,611,0,0,169,86,83,169,0
2022-01-10,EV,Latvia,621,480,1,1,141,65,75,140,0
2022-01-11,EV,Latvia,544,451,0,0,93,47,46,93,0
2022-01-12,EV,Latvia,566,458,0,0,108,55,53,108,0
2022-01-13,EV,Latvia,576,450,6,4,126,60,60,120,2
2022-01-14,EV,Latvia,594,465,0,0,129,66,63,129,0
2022-01-15,EV,Latvia,574,458,2,2,116,56,58,114,0
2022-01-16,EV,Latvia,616,480,0,0,136,67,69,136,0
2022-01-17,EV,Latvia,508,399,0,0,109,52,57,109,0
2022-01-18,EV,Latvia,496,390,6,6,106,50,50,100,0
2022-01-19,EV,Latvia,549,441,6,5,108,52,50,102,1
2022-01-20,EV,Latvia,487,392,0,0,95,46,49,95,0
2022-01-21,EV,Latvia,572,454,0,0,118,61,57,118,0
2022-01-22,EV,Latvia,560,447,0,0,113,56,57,113,0
2022-01-23,EV,Latvia,622,485,0,0,137,69,68,137,0
2022-01-24,EV,Latvia,517,408,0,0,109,54,55,109,0
2022-01-25,EV,Latvia,469,378,2,2,91,41,48,89,0
2022-01-26,EV,Latvia,531,446,0,0,85,43,42,85,0
2022-01-27,EV,Latvia,520,416,1,1,104,51,52,103,0
2022-01-28,EV,Latvia,557,447,0,0,110,59,51,110,0
2022-01-29,EV,Latvia,589,460,0,0,129,59,70,129,0
2022-01-30,EV,Latvia,588,455,1,1,133,70,62,132,0
2022-01-31,EV,Latvia,558,443,0,0,115,53,62,115,0
2022-02-01,EV,Latvia,471,390,2,2,81,37,42,79,0
2022-02-02,EV,Latvia,507,422,0,0,85,47,38,85,0
2022-02-03,EV,Latvia,509,408,4,4,101,47,50,97,0
2022-02-04,EV,Latvia,521,406,0,0,115,61,54,115,0
2022-02-05,EV,Latvia,528,421,0,0,107,53,54,107,0
2022-02-06,EV,Latvia,577,437,0,0,140,69,71,140,0
2022-02-07,EV,Latvia,475,361,4,4,114,56,54,110,0
2022-02-08,EV,Latvia,433,360,1,1,73,35,37,72,0
2022-02-09,EV,Latvia,496,404,11,11,92,43,38,81,0
2022-02-10,EV,Latvia,517,406,5,5,111,51,55,106,0
2022-02-11,EV,Latvia,553,415,3,3,138,71,64,135,0
2022-02-12,EV,Latvia,555,435,0,0,120,57,63,120,0
2022-02-13,EV,Latvia,592,440,1,1,152,77,74,151,0
2022-02-14,EV,Latvia,489,372,2,2,117,54,61,115,0
2022-02-15,EV,Latvia,456,366,8,8,90,42,40,82,0
2022-02-16,EV,Latvia,518,428,1,1,90,46,43,89,0
2022-02-17,EV,Latvia,507,396,0,0,111,55,56,111,0
2022-02-18,EV,Latvia,617,465,2,1,152,76,74,150,1
2022-02-19,EV,Latvia,624,495,0,0,129,64,65,129,0
2022-02-20,EV,Latvia,627,473,1,1,154,76,77,153,0
2022-02-21,EV,Latvia,511,385,0,0,126,62,64,126,0
2022-02-22,EV,Latvia,490,395,0,0,95,43,52,95,0
2022-02-23,EV,Latvia,530,420,3,3,110,56,51,107,0
2022-02-24,EV,Latvia,591,462,7,7,129,63,59,122,0
2022-02-25,EV,Latvia,604,460,1,1,144,74,69,143,0
2022-02-26,EV,Latvia,642,491,1,1,151,73,77,150,0
2022-02-27,EV,Latvia,455,311,1,1,144,72,71,143,0
2022-02-28,EV,Latvia,408,289,5,5,119,55,59,114,0
2022-03-01,EV,Latvia,404,302,3,3,102,51,48,99,0
2022-03-02,EV,Latvia,415,310,8,8,105,49,48,97,0
2022-03-03,EV,Latvia,410,302,5,5,108,51,52,103,0
2022-03-04,EV,Latvia,482,341,5,5,141,69,67,136,0
2022-03-05,EV,Latvia,461,331,2,2,130,63,65,128,0
2022-03-06,EV,Latvia,469,336,0,0,133,68,65,133,0
2022-03-07,EV,Latvia,432,302,4,4,130,59,67,126,0
2022-03-08,EV,Latvia,407,311,4,4,96,48,44,92,0
2022-03-09,EV,Latvia,397,297,5,5,100,49,46,95,0
2022-03-10,EV,Latvia,430,306,3,3,124,61,60,121,0
2022-03-11,EV,Latvia,452,316,4,4,136,68,64,132,0
2022-03-12,EV,Latvia,418,299,3,3,119,57,59,116,0
2022-03-13,EV,Latvia,439,306,1,1,133,69,63,132,0
2022-03-14,EV,Latvia,431,299,4,3,132,62,66,128,1
2022-03-15,EV,Latvia,373,274,3,3,99,47,49,96,0
2022-03-16,EV,Latvia,378,263,5,5,115,56,54,110,0
2022-03-17,EV,Latvia,388,273,7,7,115,54,54,108,0
2022-03-18,EV,Latvia,435,290,4,3,145,70,71,141,1
2022-03-19,EV,Latvia,386,273,0,0,113,54,59,113,0
2022-03-20,EV,Latvia,424,292,0,0,132,69,63,132,0
2022-03-21,EV,Latvia,377,248,3,3,129,61,65,126,0
2022-03-22,EV,Latvia,355,254,5,5,101,47,49,96,0
2022-03-23,EV,Latvia,374,256,4,4,118,58,56,114,0
2022-03-24,EV,Latvia,387,270,5,5,117,55,57,112,0
2022-03-25,EV,Latvia,411,267,3,3,144,71,70,141,0
2022-03-26,EV,Latvia,391,278,0,0,113,55,58,113,0
2022-03-27,EV,Latvia,410,266,1,1,144,76,67,143,0
2022-03-28,EV,Latvia,413,274,2,2,139,67,70,137,0
2022-03-29,EV,Latvia,368,248,3,3,120,59,58,117,0
2022-03-30,EV,Latvia,404,256,3,3,148,73,72,145,0
2022-03-31,EV,Latvia,417,264,3,3,153,77,73,150,0
2022-04-01,EV,Latvia,465,296,5,5,169,81,83,164,0
2022-04-02,EV,Latvia,386,262,0,0,124,61,63,124,0
2022-04-03,EV,Latvia,438,285,0,0,153,78,75,153,0
2022-04-04,EV,Latvia,415,268,0,0,147,71,76,147,0
2022-04-05,EV,Latvia,366,241,0,0,125,64,61,125,0
2022-04-06,EV,Latvia,424,275,4,4,149,72,73,145,0
2022-04-07,EV,Latvia,423,250,4,4,173,85,84,169,0
2022-04-08,EV,Latvia,461,289,0,0,172,88,84,172,0
2022-04-09,EV,Latvia,407,275,1,1,132,65,66,131,0
2022-04-10,EV,Latvia,415,267,0,0,148,75,73,148,0
2022-04-11,EV,Latvia,436,272,6,6,164,77,81,158,0
2022-04-12,EV,Latvia,412,270,5,4,142,69,68,137,1
2022-04-13,EV,Latvia,450,283,6,5,167,80,81,161,1
2022-04-14,EV,Latvia,453,289,2,2,164,83,79,162,0
2022-04-15,EV,Latvia,461,300,1,1,161,80,80,160,0
2022-04-16,EV,Latvia,417,293,1,1,124,61,62,123,0
2022-04-17,EV,Latvia,448,290,1,0,158,82,75,157,1
2022-04-18,EV,Latvia,467,305,0,0,162,78,84,162,0
2022-04-19,EV,Latvia,436,275,4,4,161,81,76,157,0
2022-04-20,EV,Latvia,420,258,2,2,162,80,80,160,0
2022-04-21,EV,Latvia,443,276,3,1,167,81,83,164,2
2022-04-22,EV,Latvia,493,326,2,2,167,83,82,165,0
2022-04-23,EV,Latvia,424,294,0,0,130,63,67,130,0
2022-04-24,EV,Latvia,459,308,0,0,151,77,74,151,0
2022-04-25,EV,Latvia,455,289,5,5,166,78,83,161,0
2022-04-26,EV,Latvia,449,285,3,3,164,80,81,161,0
2022-04-27,EV,Latvia,432,271,2,2,161,79,80,159,0
2022-04-28,EV,Latvia,485,305,3,3,180,90,87,177,0
2022-04-29,EV,Latvia,526,357,2,1,169,83,84,167,1
2022-04-30,EV,Latvia,448,318,0,0,130,65,65,130,0
2022-05-01,EV,Latvia,531,371,1,1,160,80,79,159,0
2022-05-02,EV,Latvia,503,335,2,2,168,81,85,166,0
2022-05-03,EV,Latvia,491,328,4,4,163,80,79,159,0
2022-05-04,EV,Latvia,471,320,0,0,151,78,73,151,0
2022-05-05,EV,Latvia,509,343,7,7,166,80,79,159,0
2022-05-06,EV,Latvia,559,386,2,2,173,85,86,171,0
2022-05-07,EV,Latvia,495,351,2,2,144,71,71,142,0
2022-05-08,EV,Latvia,519,356,1,1,163,81,81,162,0
2022-05-09,EV,Latvia,535,348,2,2,187,92,93,185,0
2022-05-10,EV,Latvia,523,355,5,3,168,82,81,163,2
2022-05-11,EV,Latvia,523,364,2,2,159,81,76,157,0
2022-05-12,EV,Latvia,514,347,1,1,167,86,80,166,0
2022-05-13,EV,Latvia,559,370,1,1,189,89,99,188,0
2022-05-14,EV,Latvia,483,331,3,1,152,73,76,149,2
2022-05-15,EV,Latvia,551,386,1,1,165,81,83,164,0
2022-05-16,EV,Latvia,513,336,5,5,177,88,84,172,0
2022-05-17,EV,Latvia,486,329,8,7,157,73,76,149,1
2022-05-18,EV,Latvia,500,344,6,5,156,76,74,150,1
2022-05-19,EV,Latvia,534,353,8,8,181,83,90,173,0
2022-05-20,EV,Latvia,537,350,5,5,187,93,89,182,0
2022-05-21,EV,Latvia,495,351,0,0,144,71,73,144,0
2022-05-22,EV,Latvia,534,367,4,4,167,82,81,163,0
2022-05-23,EV,Latvia,515,335,9,9,180,85,86,171,0
2022-05-24,EV,Latvia,495,337,7,7,158,77,74,151,0
2022-05-25,EV,Latvia,533,357,12,11,176,83,81,164,1
2022-05-26,EV,Latvia,531,350,6,6,181,86,89,175,0
2022-05-27,EV,Latvia,544,366,4,4,178,85,89,174,0
2022-05-28,EV,Latvia,489,343,3,3,146,72,71,143,0
2022-05-29,EV,Latvia,557,387,2,2,170,82,86,168,0
2022-05-30,EV,Latvia,539,356,3,3,183,95,85,180,0
2022-05-31,EV,Latvia,498,341,7,6,157,73,77,150,1
2022-06-01,EV,Latvia,542,372,3,3,170,82,85,167,0
2022-06-02,EV,Latvia,559,379,6,6,180,90,84,174,0
2022-06-03,EV,Latvia,594,400,5,5,194,93,96,189,0
2022-06-04,EV,Latvia,529,380,2,2,149,72,75,147,0
2022-06-05,EV,Latvia,584,418,0,0,166,84,82,166,0
2022-06-06,EV,Latvia,558,378,4,4,180,87,89,176,0
2022-06-07,EV,Latvia,552,390,4,3,162,80,78,158,1
2022-06-08,EV,Latvia,548,375,3,2,173,83,87,170,1
2022-06-09,EV,Latvia,578,392,3,3,186,95,88,183,0
2022-06-10,EV,Latvia,587,407,1,1,180,88,91,179,0
2022-06-11,EV,Latvia,542,387,4,4,155,74,77,151,0
2022-06-12,EV,Latvia,574,400,5,5,174,86,83,169,0
2022-06-13,EV,Latvia,561,388,1,1,173,86,86,172,0
2022-06-14,EV,Latvia,572,399,2,2,173,85,86,171,0
2022-06-15,EV,Latvia,559,377,4,4,182,87,91,178,0
2022-06-16,EV,Latvia,577,399,5,5,178,88,85,173,0
2022-06-17,EV,Latvia,581,396,4,4,185,88,93,181,0
2022-06-18,EV,Latvia,564,409,3,3,155,78,74,152,0
2022-06-19,EV,Latvia,590,414,0,0,176,89,87,176,0
2022-06-20,EV,Latvia,583,388,3,3,195,95,97,192,0
2022-06-21,EV,Latvia,591,423,5,5,168,85,78,163,0
2022-06-22,EV,Latvia,555,379,2,2,176,85,89,174,0
2022-06-23,EV,Latvia,569,401,1,1,168,85,82,167,0
2022-06-24,EV,Latvia,582,415,1,1,167,83,83,166,0
2022-06-25,EV,Latvia,521,380,0,0,141,72,69,141,0
2022-06-26,EV,Latvia,563,391,0,0,172,84,88,172,0
2022-06-27,EV,Latvia,585,396,6,6,189,89,94,183,0
2022-06-28,EV,Latvia,564,393,6,6,171,84,81,165,0
2022-06-29,EV,Latvia,549,377,5,5,172,84,83,167,0
2022-06-30,EV,Latvia,554,376,3,3,178,86,89,175,0
2022-07-01,EV,Latvia,583,405,3,3,178,86,89,175,0
2022-07-02,EV,Latvia,532,384,1,1,148,74,73,147,0
2022-07-03,EV,Latvia,563,386,2,2,177,87,88,175,0
2022-07-04,EV,Latvia,577,397,3,3,180,88,89,177,0
2022-07-05,EV,Latvia,555,378,3,3,177,86,88,174,0
2022-07-06,EV,Latvia,544,371,1,1,173,86,86,172,0
2022-07-07,EV,Latvia,549,374,3,3,175,84,88,172,0
2022-07-08,EV,Latvia,603,423,3,3,180,88,89,177,0
2022-07-09,EV,Latvia,547,394,4,1,153,77,72,149,3
2022-07-10,EV,Latvia,543,378,0,0,165,79,86,165,0
2022-07-11,EV,Latvia,557,384,0,0,173,90,83,173,0
2022-07-12,EV,Latvia,542,371,1,1,171,85,85,170,0
2022-07-13,EV,Latvia,562,391,2,2,171,84,85,169,0
2022-07-14,EV,Latvia,564,395,3,1,169,84,82,166,2
2022-07-15,EV,Latvia,599,415,2,2,184,90,92,182,0
2022-07-16,EV,Latvia,536,382,0,0,154,77,77,154,0
2022-07-17,EV,Latvia,567,394,0,0,173,87,86,173,0
2022-07-18,EV,Latvia,566,387,1,1,179,90,88,178,0
2022-07-19,EV,Latvia,540,379,1,1,161,82,78,160,0
2022-07-20,EV,Latvia,556,386,0,0,170,84,86,170,0
2022-07-21,EV,Latvia,563,386,1,1,177,87,89,176,0
2022-07-22,EV,Latvia,584,403,1,1,181,89,91,180,0
2022-07-23,EV,Latvia,523,381,0,0,142,74,68,142,0
2022-07-24,EV,Latvia,549,381,1,1,168,80,87,167,0
2022-07-25,EV,Latvia,551,375,3,3,176,89,84,173,0
2022-07-26,EV,Latvia,550,391,2,2,159,80,77,157,0
2022-07-27,EV,Latvia,533,370,2,2,163,81,80,161,0
2022-07-28,EV,Latvia,537,370,4,3,167,83,80,163,1
2022-07-29,EV,Latvia,594,414,1,1,180,89,90,179,0
2022-07-30,EV,Latvia,525,385,0,0,140,69,71,140,0
2022-07-31,EV,Latvia,543,377,1,1,166,83,82,165,0
2022-08-01,EV,Latvia,539,354,2,2,185,88,95,183,0
2022-08-02,EV,Latvia,572,395,3,3,177,90,84,174,0
2022-08-03,EV,Latvia,561,397,1,1,164,82,81,163,0
2022-08-04,EV,Latvia,556,394,0,0,162,81,81,162,0
2022-08-05,EV,Latvia,596,416,0,0,180,90,90,180,0
2022-08-06,EV,Latvia,518,382,0,0,136,69,67,136,0
2022-08-07,EV,Latvia,554,391,0,0,163,79,84,163,0
2022-08-08,EV,Latvia,554,377,1,1,177,89,87,176,0
2022-08-09,EV,Latvia,551,383,3,2,168,82,83,165,1
2022-08-10,EV,Latvia,567,388,3,3,179,90,86,176,0
2022-08-11,EV,Latvia,605,438,2,2,167,82,83,165,0
2022-08-12,EV,Latvia,619,434,1,1,185,93,91,184,0
2022-08-13,EV,Latvia,533,391,1,1,142,72,69,141,0
2022-08-14,EV,Latvia,556,389,0,0,167,83,84,167,0
2022-08-15,EV,Latvia,587,409,1,1,178,87,90,177,0
2022-08-16,EV,Latvia,540,381,0,0,159,81,78,159,0
2022-08-17,EV,Latvia,540,376,1,1,164,78,85,163,0
2022-08-18,EV,Latvia,564,393,1,1,171,87,83,170,0
2022-08-19,EV,Latvia,589,409,0,0,180,92,88,180,0
2022-08-20,EV,Latvia,528,381,0,0,147,73,74,147,0
2022-08-21,EV,Latvia,575,406,0,0,169,83,86,169,0
2022-08-22,EV,Latvia,564,388,0,0,176,89,87,176,0
2022-08-23,EV,Latvia,547,384,1,1,163,81,81,162,0
2022-08-24,EV,Latvia,562,394,3,3,168,85,80,165,0
2022-08-25,EV,Latvia,579,400,4,4,179,89,86,175,0
2022-08-26,EV,Latvia,612,430,4,4,182,88,90,178,0
2022-08-27,EV,Latvia,545,404,2,2,141,70,69,139,0
2022-08-28,EV,Latvia,570,410,1,1,160,78,81,159,0
2022-08-29,EV,Latvia,544,364,3,3,180,88,89,177,0
2022-08-30,EV,Latvia,554,390,5,5,164,80,79,159,0
2022-08-31,EV,Latvia,574,409,6,6,165,79,80,159,0
2022-09-01,EV,Latvia,595,421,2,2,174,85,87,172,0
2022-09-02,EV,Latvia,599,422,3,3,177,86,88,174,0
2022-09-03,EV,Latvia,540,396,2,2,144,73,69,142,0
2022-09-04,EV,Latvia,559,386,2,2,173,87,84,171,0
2022-09-05,EV,Latvia,550,384,5,5,166,79,82,161,0
2022-09-06,EV,Latvia,545,381,4,4,164,81,79,160,0
2022-09-07,EV,Latvia,588,408,2,2,180,88,90,178,0
2022-09-08,EV,Latvia,582,401,4,4,181,89,88,177,0
2022-09-09,EV,Latvia,609,426,0,0,183,92,91,183,0
2022-09-10,EV,Latvia,546,400,2,2,146,72,72,144,0
2022-09-11,EV,Latvia,563,390,3,3,173,84,86,170,0
2022-09-12,EV,Latvia,556,381,3,3,175,87,85,172,0
2022-09-13,EV,Latvia,575,400,5,3,175,86,84,170,2
2022-09-14,EV,Latvia,570,396,5,5,174,84,85,169,0
2022-09-15,EV,Latvia,571,395,5,4,176,85,86,171,1
2022-09-16,EV,Latvia,625,436,4,4,189,96,89,185,0
2022-09-17,EV,Latvia,555,408,1,1,147,72,74,146,0
2022-09-18,EV,Latvia,584,412,3,3,172,83,86,169,0
2022-09-19,EV,Latvia,560,395,0,0,165,84,81,165,0
2022-09-20,EV,Latvia,574,413,1,1,161,80,80,160,0
2022-09-21,EV,Latvia,583,409,2,2,174,85,87,172,0
2022-09-22,EV,Latvia,579,402,3,3,177,87,87,174,0
2022-09-23,EV,Latvia,629,439,3,1,190,94,93,187,2
2022-09-24,EV,Latvia,573,419,2,2,154,77,75,152,0
2022-09-25,EV,Latvia,568,395,1,1,173,85,87,172,0
2022-09-26,EV,Latvia,576,393,1,1,183,91,91,182,0
2022-09-27,EV,Latvia,549,389,4,4,160,80,76,156,0
2022-09-28,EV,Latvia,568,404,4,3,164,79,81,160,1
2022-09-29,EV,Latvia,551,384,1,1,167,83,83,166,0
2022-09-30,EV,Latvia,584,395,5,4,189,92,92,184,1
2022-10-01,EV,Latvia,545,388,2,2,157,78,77,155,0
2022-10-02,EV,Latvia,558,387,0,0,171,84,87,171,0
2022-10-03,EV,Latvia,500,340,4,4,160,77,79,156,0
2022-10-04,EV,Latvia,517,361,2,2,156,78,76,154,0
2022-10-05,EV,Latvia,557,391,1,1,166,82,83,165,0
2022-10-06,EV,Latvia,546,371,3,3,175,85,87,172,0
2022-10-07,EV,Latvia,547,374,4,4,173,88,81,169,0
2022-10-08,EV,Latvia,508,365,3,3,143,67,73,140,0
2022-10-09,EV,Latvia,519,347,1,1,172,86,85,171,0
2022-10-10,EV,Latvia,488,327,2,2,161,77,82,159,0
2022-10-11,EV,Latvia,506,345,3,3,161,82,76,158,0
2022-10-12,EV,Latvia,527,361,2,2,166,82,82,164,0
2022-10-13,EV,Latvia,531,364,3,3,167,82,82,164,0
2022-10-14,EV,Latvia,601,419,3,3,182,89,90,179,0
2022-10-15,EV,Latvia,527,378,1,1,149,75,73,148,0
2022-10-16,EV,Latvia,537,372,2,2,165,81,82,163,0
2022-10-17,EV,Latvia,540,364,4,4,176,84,88,172,0
2022-10-18,EV,Latvia,494,332,0,0,162,83,79,162,0
2022-10-19,EV,Latvia,513,342,2,2,171,85,84,169,0
2022-10-20,EV,Latvia,539,369,0,0,170,82,88,170,0
2022-10-21,EV,Latvia,587,395,1,1,192,97,94,191,0
2022-10-22,EV,Latvia,528,376,0,0,152,77,75,152,0
2022-10-23,EV,Latvia,524,357,1,1,167,83,83,166,0
2022-10-24,EV,Latvia,502,335,1,1,167,83,83,166,0
2022-10-25,EV,Latvia,503,341,1,0,162,82,79,161,1
2022-10-26,EV,Latvia,534,354,5,5,180,87,88,175,0
2022-10-27,EV,Latvia,518,356,1,1,162,78,83,161,0
2022-10-28,EV,Latvia,575,395,2,2,180,90,88,178,0
2022-10-29,EV,Latvia,512,352,0,0,160,80,80,160,0
2022-10-30,EV,Latvia,492,321,1,1,171,82,88,170,0
2022-10-31,EV,Latvia,443,277,0,0,166,82,84,166,0
2022-11-01,EV,Latvia,424,276,3,3,148,72,73,145,0
2022-11-02,EV,Latvia,430,289,0,0,141,69,72,141,0
2022-11-03,EV,Latvia,451,302,3,1,149,71,75,146,2
2022-11-04,EV,Latvia,496,331,0,0,165,86,79,165,0
2022-11-05,EV,Latvia,425,296,0,0,129,64,65,129,0
2022-11-06,EV,Latvia,467,304,0,0,163,80,83,163,0
2022-11-07,EV,Latvia,447,271,1,1,176,87,88,175,0
2022-11-08,EV,Latvia,411,278,0,0,133,68,65,133,0
2022-11-09,EV,Latvia,411,280,3,1,131,63,65,128,2
2022-11-10,EV,Latvia,410,266,2,0,144,71,71,142,2
2022-11-11,EV,Latvia,474,317,0,0,157,79,78,157,0
2022-11-12,EV,Latvia,441,312,1,0,129,61,67,128,1
2022-11-13,EV,Latvia,477,324,0,0,153,80,73,153,0
2022-11-14,EV,Latvia,444,277,1,1,167,83,83,166,0
2022-11-15,EV,Latvia,392,263,1,1,129,63,65,128,0
2022-11-16,EV,Latvia,421,282,1,1,139,70,68,138,0
2022-11-17,EV,Latvia,411,260,0,0,151,79,72,151,0
2022-11-18,EV,Latvia,460,300,2,2,160,78,80,158,0
2022-11-19,EV,Latvia,394,271,0,0,123,59,64,123,0
2022-11-20,EV,Latvia,419,268,0,0,151,75,76,151,0
2022-11-21,EV,Latvia,376,212,3,3,164,81,80,161,0
2022-11-22,EV,Latvia,369,241,3,3,128,61,64,125,0
2022-11-23,EV,Latvia,402,261,3,3,141,70,68,138,0
2022-11-24,EV,Latvia,409,271,3,3,138,66,69,135,0
2022-11-25,EV,Latvia,462,292,4,4,170,86,80,166,0
2022-11-26,EV,Latvia,405,282,0,0,123,59,64,123,0
2022-11-27,EV,Latvia,451,295,0,0,156,79,77,156,0
2022-11-28,EV,Latvia,416,246,3,3,170,84,83,167,0
2022-11-29,EV,Latvia,392,260,1,1,132,65,66,131,0
2022-11-30,EV,Latvia,396,261,3,3,135,66,66,132,0
2022-12-01,EV,Latvia,416,265,4,4,151,71,76,147,0
2022-12-02,EV,Latvia,445,272,3,3,173,87,83,170,0
2022-12-03,EV,Latvia,402,283,0,0,119,58,61,119,0
2022-12-04,EV,Latvia,447,290,0,0,157,78,79,157,0
2022-12-05,EV,Latvia,427,251,0,0,176,88,88,176,0
2022-12-06,EV,Latvia,389,259,0,0,130,67,63,130,0
2022-12-07,EV,Latvia,399,269,0,0,130,66,64,130,0
2022-12-08,EV,Latvia,413,268,0,0,145,69,76,145,0
2022-12-09,EV,Latvia,464,295,0,0,169,87,82,169,0
2022-12-10,EV,Latvia,394,269,1,1,125,60,64,124,0
2022-12-11,EV,Latvia,412,263,0,0,149,74,75,149,0
2022-12-12,EV,Latvia,347,223,0,0,124,62,62,124,0
2022-12-13,EV,Latvia,405,265,1,1,140,72,67,139,0
2022-12-14,EV,Latvia,393,252,1,1,141,70,70,140,0
2022-12-15,EV,Latvia,421,273,2,2,148,74,72,146,0
2022-12-16,EV,Latvia,468,296,1,1,172,82,89,171,0
2022-12-17,EV,Latvia,418,272,0,0,146,75,71,146,0
2022-12-18,EV,Latvia,460,303,2,2,157,77,78,155,0
2022-12-19,EV,Latvia,464,272,1,1,192,95,96,191,0
2022-12-20,EV,Latvia,414,263,1,1,151,76,74,150,0
2022-12-21,EV,Latvia,418,268,1,1,150,77,72,149,0
2022-12-22,EV,Latvia,428,266,0,0,162,81,81,162,0
2022-12-23,EV,Latvia,460,292,3,3,168,84,81,165,0
2022-12-24,EV,Latvia,360,248,0,0,112,54,58,112,0
2022-12-25,EV,Latvia,331,221,0,0,110,56,54,110,0
2022-12-26,EV,Latvia,413,254,0,0,159,78,81,159,0
2022-12-27,EV,Latvia,402,251,3,3,151,73,75,148,0
2022-01-01,EY,Lithuania,572,456,3,1,116,57,56,113,2
2022-01-02,EY,Lithuania,766,634,2,1,132,63,67,130,1
2022-01-03,EY,Lithuania,679,560,0,0,119,60,59,119,0
2022-01-04,EY,Lithuania,606,471,4,4,135,64,67,131,0
2022-01-05,EY,Lithuania,647,526,5,5,121,60,56,116,0
2022-01-06,EY,Lithuania,621,498,3,3,123,58,62,120,0
2022-01-07,EY,Lithuania,674,552,4,4,122,58,60,118,0
2022-01-08,EY,Lithuania,697,573,1,1,124,64,59,123,0
2022-01-09,EY,Lithuania,777,650,1,1,127,59,67,126,0
2022-01-10,EY,Lithuania,641,537,3,3,104,53,48,101,0
2022-01-11,EY,Lithuania,569,453,8,7,116,53,55,108,1
2022-01-12,EY,Lithuania,576,482,5,5,94,43,46,89,0
2022-01-13,EY,Lithuania,573,464,2,2,109,55,52,107,0
2022-01-14,EY,Lithuania,596,493,0,0,103,50,53,103,0
2022-01-15,EY,Lithuania,604,499,1,1,105,54,50,104,0
2022-01-16,EY,Lithuania,619,526,1,1,93,44,48,92,0
2022-01-17,EY,Lithuania,516,424,3,1,92,46,43,89,2
2022-01-18,EY,Lithuania,492,389,7,7,103,47,49,96,0
2022-01-19,EY,Lithuania,536,460,2,2,76,37,37,74,0
2022-01-20,EY,Lithuania,525,421,2,2,104,48,54,102,0
2022-01-21,EY,Lithuania,592,474,0,0,118,63,55,118,0
2022-01-22,EY,Lithuania,591,488,2,2,103,52,49,101,0
2022-01-23,EY,Lithuania,587,493,2,2,94,46,46,92,0
2022-01-24,EY,Lithuania,490,404,1,1,86,41,44,85,0
2022-01-25,EY,Lithuania,475,380,4,4,95,46,45,91,0
2022-01-26,EY,Lithuania,555,476,2,2,79,38,39,77,0
2022-01-27,EY,Lithuania,515,427,3,3,88,42,43,85,0
2022-01-28,EY,Lithuania,571,467,5,5,104,49,50,99,0
2022-01-29,EY,Lithuania,611,507,2,2,104,52,50,102,0
2022-01-30,EY,Lithuania,566,473,1,1,93,43,49,92,0
2022-01-31,EY,Lithuania,562,468,0,0,94,47,47,94,0
2022-02-01,EY,Lithuania,518,391,6,6,127,60,61,121,0
2022-02-02,EY,Lithuania,510,423,6,6,87,40,41,81,0
2022-02-03,EY,Lithuania,578,462,8,7,116,53,55,108,1
2022-02-04,EY,Lithuania,552,443,2,2,109,55,52,107,0
2022-02-05,EY,Lithuania,578,458,2,1,120,61,57,118,1
2022-02-06,EY,Lithuania,573,479,4,3,94,44,46,90,1
2022-02-07,EY,Lithuania,496,389,5,5,107,50,52,102,0
2022-02-08,EY,Lithuania,474,352,8,5,122,54,60,114,3
2022-02-09,EY,Lithuania,503,400,9,7,103,51,43,94,2
2022-02-10,EY,Lithuania,543,427,9,7,116,55,52,107,2
2022-02-11,EY,Lithuania,593,466,3,2,127,61,63,124,1
2022-02-12,EY,Lithuania,592,464,7,6,128,63,58,121,1
2022-02-13,EY,Lithuania,590,489,3,3,101,48,50,98,0
2022-02-14,EY,Lithuania,486,381,3,3,105,52,50,102,0
2022-02-15,EY,Lithuania,490,369,6,5,121,58,57,115,1
2022-02-16,EY,Lithuania,501,426,4,3,75,36,35,71,1
2022-02-17,EY,Lithuania,534,433,1,1,101,49,51,100,0
2022-02-18,EY,Lithuania,598,471,7,6,127,56,64,120,1
2022-02-19,EY,Lithuania,674,543,2,2,131,68,61,129,0
2022-02-20,EY,Lithuania,626,528,1,1,98,46,51,97,0
2022-02-21,EY,Lithuania,526,419,4,3,107,51,52,103,1
2022-02-22,EY,Lithuania,517,397,6,5,120,58,56,114,1
2022-02-23,EY,Lithuania,532,429,3,3,103,50,50,100,0
2022-02-24,EY,Lithuania,639,530,3,3,109,53,53,106,0
2022-02-25,EY,Lithuania,683,557,3,3,126,61,62,123,0
2022-02-26,EY,Lithuania,628,501,4,4,127,64,59,123,0
2022-02-27,EY,Lithuania,378,275,4,3,103,46,53,99,1
2022-02-28,EY,Lithuania,356,240,6,3,116,57,53,110,3
2022-03-01,EY,Lithuania,344,228,8,7,116,54,54,108,1
2022-03-02,EY,Lithuania,338,235,9,9,103,44,50,94,0
2022-03-03,EY,Lithuania,382,263,10,8,119,55,54,109,2
2022-03-04,EY,Lithuania,407,273,4,3,134,65,65,130,1
2022-03-05,EY,Lithuania,376,251,2,2,125,63,60,123,0
2022-03-06,EY,Lithuania,372,267,4,3,105,48,53,101,1
2022-03-07,EY,Lithuania,345,231,3,3,114,55,56,111,0
2022-03-08,EY,Lithuania,342,215,6,4,127,61,60,121,2
2022-03-09,EY,Lithuania,319,227,5,4,92,44,43,87,1
2022-03-10,EY,Lithuania,351,239,7,5,112,53,52,105,2
2022-03-11,EY,Lithuania,378,248,8,6,130,62,60,122,2
2022-03-12,EY,Lithuania,335,218,6,5,117,57,54,111,1
2022-03-13,EY,Lithuania,342,238,4,3,104,48,52,100,1
2022-03-14,EY,Lithuania,355,228,4,3,127,61,62,123,1
2022-03-15,EY,Lithuania,305,183,2,1,122,61,59,120,1
2022-03-16,EY,Lithuania,310,208,5,5,102,49,48,97,0
2022-03-17,EY,Lithuania,318,199,7,7,119,57,55,112,0
2022-03-18,EY,Lithuania,373,239,10,8,134,63,61,124,2
2022-03-19,EY,Lithuania,306,195,3,3,111,54,54,108,0
2022-03-20,EY,Lithuania,338,222,6,4,116,53,57,110,2
2022-03-21,EY,Lithuania,324,199,7,5,125,57,61,118,2
2022-03-22,EY,Lithuania,316,184,7,5,132,63,62,125,2
2022-03-23,EY,Lithuania,312,199,7,4,113,56,50,106,3
2022-03-24,EY,Lithuania,327,213,5,5,114,52,57,109,0
2022-03-25,EY,Lithuania,352,218,5,2,134,65,64,129,3
2022-03-26,EY,Lithuania,337,205,6,5,132,67,59,126,1
2022-03-27,EY,Lithuania,341,212,5,3,129,60,64,124,2
2022-03-28,EY,Lithuania,357,216,3,3,141,68,70,138,0
2022-03-29,EY,Lithuania,349,216,6,5,133,61,66,127,1
2022-03-30,EY,Lithuania,367,227,12,11,140,61,67,128,1
2022-03-31,EY,Lithuania,386,229,6,6,157,77,74,151,0
2022-04-01,EY,Lithuania,397,234,4,4,163,82,77,159,0
2022-04-02,EY,Lithuania,376,230,3,3,146,73,70,143,0
2022-04-03,EY,Lithuania,371,231,4,3,140,67,69,136,1
2022-04-04,EY,Lithuania,354,221,8,7,133,62,63,125,1
2022-04-05,EY,Lithuania,355,213,9,8,142,70,63,133,1
2022-04-06,EY,Lithuania,358,219,7,6,139,64,68,132,1
2022-04-07,EY,Lithuania,374,228,9,7,146,67,70,137,2
2022-04-08,EY,Lithuania,408,252,6,5,156,74,76,150,1
2022-04-09,EY,Lithuania,385,238,3,3,147,73,71,144,0
2022-04-10,EY,Lithuania,360,220,3,1,140,70,67,137,2
2022-04-11,EY,Lithuania,380,237,12,10,143,65,66,131,2
2022-04-12,EY,Lithuania,398,239,9,8,159,74,76,150,1
2022-04-13,EY,Lithuania,406,247,10,10,159,77,72,149,0
2022-04-14,EY,Lithuania,398,244,9,7,154,71,74,145,2
2022-04-15,EY,Lithuania,430,277,4,4,153,74,75,149,0
2022-04-16,EY,Lithuania,390,249,4,4,141,69,68,137,0
2022-04-17,EY,Lithuania,383,249,5,5,134,64,65,129,0
2022-04-18,EY,Lithuania,405,266,7,7,139,67,65,132,0
2022-04-19,EY,Lithuania,413,254,12,10,159,75,72,147,2
2022-04-20,EY,Lithuania,390,235,8,6,155,74,73,147,2
2022-04-21,EY,Lithuania,395,238,5,4,157,75,77,152,1
2022-04-22,EY,Lithuania,421,259,5,4,162,78,79,157,1
2022-04-23,EY,Lithuania,415,269,4,4,146,72,70,142,0
2022-04-24,EY,Lithuania,409,265,3,3,144,69,72,141,0
2022-04-25,EY,Lithuania,411,262,5,4,149,71,73,144,1
2022-04-26,EY,Lithuania,449,274,9,8,175,84,82,166,1
2022-04-27,EY,Lithuania,411,255,12,8,156,69,75,144,4
2022-04-28,EY,Lithuania,452,280,11,8,172,83,78,161,3
2022-04-29,EY,Lithuania,496,339,8,8,157,73,76,149,0
2022-04-30,EY,Lithuania,470,314,1,1,156,79,76,155,0
2022-05-01,EY,Lithuania,493,338,3,2,155,73,79,152,1
2022-05-02,EY,Lithuania,456,306,7,7,150,71,72,143,0
2022-05-03,EY,Lithuania,492,321,8,7,171,81,82,163,1
2022-05-04,EY,Lithuania,452,295,10,8,157,73,74,147,2
2022-05-05,EY,Lithuania,490,320,11,7,170,82,77,159,4
2022-05-06,EY,Lithuania,509,346,10,9,163,75,78,153,1
2022-05-07,EY,Lithuania,502,333,3,1,169,85,81,166,2
2022-05-08,EY,Lithuania,480,333,3,3,147,71,73,144,0
2022-05-09,EY,Lithuania,509,351,11,10,158,72,75,147,1
2022-05-10,EY,Lithuania,535,346,8,8,189,89,92,181,0
2022-05-11,EY,Lithuania,494,337,8,5,157,76,73,149,3
2022-05-12,EY,Lithuania,493,311,7,5,182,87,88,175,2
2022-05-13,EY,Lithuania,516,345,10,7,171,81,80,161,3
2022-05-14,EY,Lithuania,488,329,5,4,159,76,78,154,1
2022-05-15,EY,Lithuania,485,339,2,1,146,72,72,144,1
2022-05-16,EY,Lithuania,481,327,4,4,154,75,75,150,0
2022-05-17,EY,Lithuania,482,311,7,5,171,84,80,164,2
2022-05-18,EY,Lithuania,462,308,10,9,154,70,74,144,1
2022-05-19,EY,Lithuania,527,358,7,6,169,82,80,162,1
2022-05-20,EY,Lithuania,516,352,4,3,164,81,79,160,1
2022-05-21,EY,Lithuania,490,331,2,2,159,79,78,157,0
2022-05-22,EY,Lithuania,513,354,5,4,159,75,79,154,1
2022-05-23,EY,Lithuania,504,340,7,5,164,80,77,157,2
2022-05-24,EY,Lithuania,500,331,6,6,169,78,85,163,0
2022-05-25,EY,Lithuania,489,328,9,9,161,78,74,152,0
2022-05-26,EY,Lithuania,522,347,5,3,175,86,84,170,2
2022-05-27,EY,Lithuania,531,370,6,5,161,76,79,155,1
2022-05-28,EY,Lithuania,521,357,1,0,164,80,83,163,1
2022-05-29,EY,Lithuania,538,381,2,1,157,79,76,155,1
2022-05-30,EY,Lithuania,522,362,3,3,160,78,79,157,0
2022-05-31,EY,Lithuania,533,355,6,5,178,89,83,172,1
2022-06-01,EY,Lithuania,521,350,6,6,171,83,82,165,0
2022-06-02,EY,Lithuania,541,373,8,8,168,81,79,160,0
2022-06-03,EY,Lithuania,579,405,7,7,174,84,83,167,0
2022-06-04,EY,Lithuania,551,389,3,3,162,79,80,159,0
2022-06-05,EY,Lithuania,574,408,4,2,166,82,80,162,2
2022-06-06,EY,Lithuania,547,378,9,8,169,78,82,160,1
2022-06-07,EY,Lithuania,559,376,10,9,183,86,87,173,1
2022-06-08,EY,Lithuania,530,363,10,7,167,81,76,157,3
2022-06-09,EY,Lithuania,582,407,12,8,175,78,85,163,4
2022-06-10,EY,Lithuania,590,406,9,5,184,89,86,175,4
2022-06-11,EY,Lithuania,566,418,0,0,148,74,74,148,0
2022-06-12,EY,Lithuania,535,378,9,8,157,73,75,148,1
2022-06-13,EY,Lithuania,541,381,5,5,160,77,78,155,0
2022-06-14,EY,Lithuania,571,395,3,3,176,85,88,173,0
2022-06-15,EY,Lithuania,558,394,7,7,164,80,77,157,0
2022-06-16,EY,Lithuania,576,405,11,9,171,79,81,160,2
2022-06-17,EY,Lithuania,592,416,6,6,176,85,85,170,0
2022-06-18,EY,Lithuania,578,420,2,2,158,80,76,156,0
2022-06-19,EY,Lithuania,575,418,1,1,157,76,80,156,0
2022-06-20,EY,Lithuania,575,404,7,4,171,84,80,164,3
2022-06-21,EY,Lithuania,589,413,8,8,176,88,80,168,0
2022-06-22,EY,Lithuania,553,396,12,9,157,71,74,145,3
2022-06-23,EY,Lithuania,564,394,6,6,170,81,83,164,0
2022-06-24,EY,Lithuania,574,414,3,2,160,79,78,157,1
2022-06-25,EY,Lithuania,557,402,7,6,155,75,73,148,1
2022-06-26,EY,Lithuania,544,392,6,5,152,72,74,146,1
2022-06-27,EY,Lithuania,575,406,7,7,169,83,79,162,0
2022-06-28,EY,Lithuania,571,402,6,6,169,80,83,163,0
2022-06-29,EY,Lithuania,513,368,5,4,145,69,71,140,1
2022-06-30,EY,Lithuania,554,399,3,3,155,76,76,152,0
2022-07-01,EY,Lithuania,600,424,7,7,176,86,83,169,0
2022-07-02,EY,Lithuania,550,404,4,3,146,72,70,142,1
2022-07-03,EY,Lithuania,567,407,7,5,160,75,78,153,2
2022-07-04,EY,Lithuania,545,380,9,7,165,80,76,156,2
2022-07-05,EY,Lithuania,557,388,9,8,169,79,81,160,1
2022-07-06,EY,Lithuania,520,376,6,5,144,71,67,138,1
2022-07-07,EY,Lithuania,555,399,11,10,156,73,72,145,1
2022-07-08,EY,Lithuania,590,422,7,6,168,80,81,161,1
2022-07-09,EY,Lithuania,567,419,4,2,148,72,72,144,2
2022-07-10,EY,Lithuania,567,417,4,3,150,73,73,146,1
2022-07-11,EY,Lithuania,545,381,7,6,164,79,78,157,1
2022-07-12,EY,Lithuania,565,408,4,3,157,78,75,153,1
2022-07-13,EY,Lithuania,536,389,6,6,147,70,71,141,0
2022-07-14,EY,Lithuania,550,393,10,9,157,72,75,147,1
2022-07-15,EY,Lithuania,611,442,7,6,169,79,83,162,1
2022-07-16,EY,Lithuania,584,432,2,2,152,79,71,150,0
2022-07-17,EY,Lithuania,564,420,6,2,144,70,68,138,4
2022-07-18,EY,Lithuania,567,405,6,6,162,77,79,156,0
2022-07-19,EY,Lithuania,584,415,6,6,169,82,81,163,0
2022-07-20,EY,Lithuania,535,396,8,8,139,66,65,131,0
2022-07-21,EY,Lithuania,571,408,13,12,163,73,77,150,1
2022-07-22,EY,Lithuania,598,430,12,12,168,77,79,156,0
2022-07-23,EY,Lithuania,572,426,3,3,146,68,75,143,0
2022-07-24,EY,Lithuania,558,411,4,4,147,74,69,143,0
2022-07-25,EY,Lithuania,566,408,5,5,158,75,78,153,0
2022-07-26,EY,Lithuania,587,417,10,10,170,80,80,160,0
2022-07-27,EY,Lithuania,556,401,11,9,155,73,71,144,2
2022-07-28,EY,Lithuania,566,406,10,8,160,75,75,150,2
2022-07-29,EY,Lithuania,600,432,8,6,168,79,81,160,2
2022-07-30,EY,Lithuania,561,422,4,3,139,67,68,135,1
2022-07-31,EY,Lithuania,569,429,4,2,140,69,67,136,2
2022-08-01,EY,Lithuania,575,408,5,5,167,83,79,162,0
2022-08-02,EY,Lithuania,600,432,7,6,168,81,80,161,1
2022-08-03,EY,Lithuania,560,412,9,8,148,69,70,139,1
2022-08-04,EY,Lithuania,562,406,8,6,156,75,73,148,2
2022-08-05,EY,Lithuania,598,439,7,7,159,77,75,152,0
2022-08-06,EY,Lithuania,560,417,6,4,143,68,69,137,2
2022-08-07,EY,Lithuania,560,414,3,2,146,72,71,143,1
2022-08-08,EY,Lithuania,560,404,3,3,156,77,76,153,0
2022-08-09,EY,Lithuania,588,425,8,6,163,77,78,155,2
2022-08-10,EY,Lithuania,559,404,10,7,155,70,75,145,3
2022-08-11,EY,Lithuania,581,417,8,8,164,81,75,156,0
2022-08-12,EY,Lithuania,616,454,7,7,162,77,78,155,0
2022-08-13,EY,Lithuania,571,431,2,1,140,68,70,138,1
2022-08-14,EY,Lithuania,571,418,4,4,153,74,75,149,0
2022-08-15,EY,Lithuania,588,423,7,7,165,82,76,158,0
2022-08-16,EY,Lithuania,587,411,10,10,176,83,83,166,0
2022-08-17,EY,Lithuania,552,396,9,8,156,72,75,147,1
2022-08-18,EY,Lithuania,570,403,12,12,167,76,79,155,0
2022-08-19,EY,Lithuania,616,440,11,10,176,84,81,165,1
2022-08-20,EY,Lithuania,583,422,7,7,161,75,79,154,0
2022-08-21,EY,Lithuania,581,434,3,1,147,73,71,144,2
2022-08-22,EY,Lithuania,586,419,7,6,167,79,81,160,1
2022-08-23,EY,Lithuania,590,416,9,9,174,82,83,165,0
2022-08-24,EY,Lithuania,559,397,12,12,162,76,74,150,0
2022-08-25,EY,Lithuania,570,400,10,9,170,81,79,160,1
2022-08-26,EY,Lithuania,618,444,8,8,174,83,83,166,0
2022-08-27,EY,Lithuania,583,432,4,2,151,74,73,147,2
2022-08-28,EY,Lithuania,588,425,7,3,163,76,80,156,4
2022-08-29,EY,Lithuania,582,398,11,8,184,88,85,173,3
2022-08-30,EY,Lithuania,608,424,9,6,184,86,89,175,3
2022-08-31,EY,Lithuania,570,408,9,8,162,76,77,153,1
2022-09-01,EY,Lithuania,595,429,9,9,166,80,77,157,0
2022-09-02,EY,Lithuania,620,460,9,5,160,76,75,151,4
2022-09-03,EY,Lithuania,589,441,4,3,148,72,72,144,1
2022-09-04,EY,Lithuania,580,431,1,0,149,75,73,148,1
2022-09-05,EY,Lithuania,565,401,9,7,164,78,77,155,2
2022-09-06,EY,Lithuania,585,422,9,9,163,76,78,154,0
2022-09-07,EY,Lithuania,591,427,16,13,164,74,74,148,3
2022-09-08,EY,Lithuania,596,430,8,8,166,79,79,158,0
2022-09-09,EY,Lithuania,624,458,6,5,166,79,81,160,1
2022-09-10,EY,Lithuania,589,434,3,1,155,79,73,152,2
2022-09-11,EY,Lithuania,580,432,5,3,148,69,74,143,2
2022-09-12,EY,Lithuania,563,400,5,5,163,79,79,158,0
2022-09-13,EY,Lithuania,612,436,9,7,176,83,84,167,2
2022-09-14,EY,Lithuania,590,427,5,4,163,79,79,158,1
2022-09-15,EY,Lithuania,590,418,7,7,172,82,83,165,0
2022-09-16,EY,Lithuania,628,460,8,7,168,80,80,160,1
2022-09-17,EY,Lithuania,602,433,5,4,169,83,81,164,1
2022-09-18,EY,Lithuania,600,441,2,1,159,80,77,157,1
2022-09-19,EY,Lithuania,570,398,11,10,172,78,83,161,1
2022-09-20,EY,Lithuania,616,444,11,10,172,81,80,161,1
2022-09-21,EY,Lithuania,576,424,5,5,152,73,74,147,0
2022-09-22,EY,Lithuania,603,437,7,7,166,79,80,159,0
2022-09-23,EY,Lithuania,632,469,10,10,163,77,76,153,0
2022-09-24,EY,Lithuania,609,450,6,3,159,80,73,153,3
2022-09-25,EY,Lithuania,581,438,2,2,143,68,73,141,0
2022-09-26,EY,Lithuania,588,418,12,9,170,80,78,158,3
2022-09-27,EY,Lithuania,610,440,8,6,170,81,81,162,2
2022-09-28,EY,Lithuania,577,426,4,4,151,75,72,147,0
2022-09-29,EY,Lithuania,577,411,6,5,166,80,80,160,1
2022-09-30,EY,Lithuania,613,453,4,4,160,79,77,156,0
2022-10-01,EY,Lithuania,596,431,2,2,165,82,81,163,0
2022-10-02,EY,Lithuania,555,406,3,3,149,71,75,146,0
2022-10-03,EY,Lithuania,534,379,5,4,155,74,76,150,1
2022-10-04,EY,Lithuania,566,406,4,4,160,78,78,156,0
2022-10-05,EY,Lithuania,542,391,8,8,151,70,73,143,0
2022-10-06,EY,Lithuania,558,397,6,5,161,78,77,155,1
2022-10-07,EY,Lithuania,577,417,5,4,160,77,78,155,1
2022-10-08,EY,Lithuania,560,404,1,1,156,79,76,155,0
2022-10-09,EY,Lithuania,531,388,1,1,143,71,71,142,0
2022-10-10,EY,Lithuania,510,364,8,6,146,69,69,138,2
2022-10-11,EY,Lithuania,555,395,7,7,160,75,78,153,0
2022-10-12,EY,Lithuania,527,383,6,6,144,70,68,138,0
2022-10-13,EY,Lithuania,544,378,5,5,166,79,82,161,0
2022-10-14,EY,Lithuania,598,431,10,10,167,80,77,157,0
2022-10-15,EY,Lithuania,558,403,3,2,155,77,75,152,1
2022-10-16,EY,Lithuania,536,391,3,2,145,71,71,142,1
2022-10-17,EY,Lithuania,533,375,7,5,158,75,76,151,2
2022-10-18,EY,Lithuania,558,396,4,4,162,78,80,158,0
2022-10-19,EY,Lithuania,530,374,8,6,156,73,75,148,2
2022-10-20,EY,Lithuania,535,372,11,10,163,78,74,152,1
2022-10-21,EY,Lithuania,589,426,8,5,163,76,79,155,3
2022-10-22,EY,Lithuania,557,404,3,2,153,75,75,150,1
2022-10-23,EY,Lithuania,523,385,3,1,138,68,67,135,2
2022-10-24,EY,Lithuania,511,355,4,4,156,73,79,152,0
2022-10-25,EY,Lithuania,525,368,6,5,157,76,75,151,1
2022-10-26,EY,Lithuania,509,350,9,6,159,76,74,150,3
2022-10-27,EY,Lithuania,504,352,6,6,152,75,71,146,0
2022-10-28,EY,Lithuania,552,391,8,6,161,76,77,153,2
2022-10-29,EY,Lithuania,558,385,2,2,173,88,83,171,0
2022-10-30,EY,Lithuania,478,334,2,2,144,70,72,142,0
2022-10-31,EY,Lithuania,445,307,6,6,138,64,68,132,0
2022-11-01,EY,Lithuania,410,291,3,3,119,57,59,116,0
2022-11-02,EY,Lithuania,403,287,3,3,116,54,59,113,0
2022-11-03,EY,Lithuania,447,318,8,8,129,60,61,121,0
2022-11-04,EY,Lithuania,476,312,8,6,164,78,78,156,2
2022-11-05,EY,Lithuania,439,300,6,2,139,68,65,133,4
2022-11-06,EY,Lithuania,463,313,3,1,150,74,73,147,2
2022-11-07,EY,Lithuania,443,303,2,2,140,70,68,138,0
2022-11-08,EY,Lithuania,409,269,14,12,140,61,65,126,2
2022-11-09,EY,Lithuania,396,275,10,7,121,55,56,111,3
2022-11-10,EY,Lithuania,398,283,7,4,115,55,53,108,3
2022-11-11,EY,Lithuania,431,283,6,4,148,72,70,142,2
2022-11-12,EY,Lithuania,421,296,5,5,125,60,60,120,0
2022-11-13,EY,Lithuania,433,310,4,2,123,59,60,119,2
2022-11-14,EY,Lithuania,417,294,1,1,123,60,62,122,0
2022-11-15,EY,Lithuania,400,268,12,7,132,62,58,120,5
2022-11-16,EY,Lithuania,378,277,4,4,101,49,48,97,0
2022-11-17,EY,Lithuania,410,283,7,6,127,60,60,120,1
2022-11-18,EY,Lithuania,422,283,5,5,139,67,67,134,0
2022-11-19,EY,Lithuania,396,286,2,2,110,56,52,108,0
2022-11-20,EY,Lithuania,408,283,3,0,125,60,62,122,3
2022-11-21,EY,Lithuania,392,258,6,5,134,63,65,128,1
2022-11-22,EY,Lithuania,360,231,8,7,129,60,61,121,1
2022-11-23,EY,Lithuania,353,247,2,2,106,53,51,104,0
2022-11-24,EY,Lithuania,381,264,6,5,117,54,57,111,1
2022-11-25,EY,Lithuania,405,272,2,1,133,67,64,131,1
2022-11-26,EY,Lithuania,367,259,3,1,108,53,52,105,2
2022-11-27,EY,Lithuania,407,281,3,0,126,62,61,123,3
2022-11-28,EY,Lithuania,399,269,4,4,130,62,64,126,0
2022-11-29,EY,Lithuania,368,246,6,5,122,57,59,116,1
2022-11-30,EY,Lithuania,356,252,5,5,104,51,48,99,0
2022-12-01,EY,Lithuania,368,253,3,3,115,57,55,112,0
2022-12-02,EY,Lithuania,403,266,2,2,137,68,67,135,0
2022-12-03,EY,Lithuania,380,259,3,2,121,61,57,118,1
2022-12-04,EY,Lithuania,396,268,1,0,128,60,67,127,1
2022-12-05,EY,Lithuania,395,268,2,1,127,63,62,125,1
2022-12-06,EY,Lithuania,368,245,0,0,123,59,64,123,0
2022-12-07,EY,Lithuania,351,250,1,0,101,50,50,100,1
2022-12-08,EY,Lithuania,371,259,4,4,112,53,55,108,0
2022-12-09,EY,Lithuania,400,273,0,0,127,65,62,127,0
2022-12-10,EY,Lithuania,353,251,5,5,102,49,48,97,0
2022-12-11,EY,Lithuania,367,265,0,0,102,54,48,102,0
2022-12-12,EY,Lithuania,354,222,1,0,132,60,71,131,1
2022-12-13,EY,Lithuania,382,255,1,0,127,64,62,126,1
2022-12-14,EY,Lithuania,353,246,8,7,107,53,46,99,1
2022-12-15,EY,Lithuania,388,276,9,7,112,51,52,103,2
2022-12-16,EY,Lithuania,435,291,4,2,144,71,69,140,2
2022-12-17,EY,Lithuania,387,273,1,1,114,58,55,113,0
2022-12-18,EY,Lithuania,406,279,4,2,127,61,62,123,2
2022-12-19,EY,Lithuania,425,286,8,7,139,65,66,131,1
2022-12-20,EY,Lithuania,392,255,0,0,137,70,67,137,0
2022-12-21,EY,Lithuania,374,263,6,5,111,52,53,105,1
2022-12-22,EY,Lithuania,388,289,1,1,99,50,48,98,0
2022-12-23,EY,Lithuania,447,293,6,4,154,73,75,148,2
2022-12-24,EY,Lithuania,340,245,2,2,95,48,45,93,0
2022-12-25,EY,Lithuania,300,241,4,4,59,27,28,55,0
2022-12-26,EY,Lithuania,381,282,3,3,99,52,44,96,0
2022-12-27,EY,Lithuania,400,272,7,7,128,59,62,121,0
2022-01-01,LM,Malta,212,121,0,0,91,46,45,91,0
2022-01-02,LM,Malta,247,125,0,0,122,61,61,122,0
2022-01-03,LM,Malta,239,108,1,1,131,64,66,130,0
2022-01-04,LM,Malta,211,112,0,0,99,48,51,99,0
2022-01-05,LM,Malta,220,126,0,0,94,48,46,94,0
2022-01-06,LM,Malta,195,113,1,1,82,40,41,81,0
2022-01-07,LM,Malta,216,103,0,0,113,55,58,113,0
2022-01-08,LM,Malta,208,101,2,2,107,53,52,105,0
2022-01-09,LM,Malta,233,117,1,1,116,55,60,115,0
2022-01-10,LM,Malta,174,115,0,0,59,29,30,59,0
2022-01-11,LM,Malta,163,106,3,3,57,25,29,54,0
2022-01-12,LM,Malta,157,97,0,0,60,31,29,60,0
2022-01-13,LM,Malta,138,91,2,2,47,24,21,45,0
2022-01-14,LM,Malta,157,93,0,0,64,32,32,64,0
2022-01-15,LM,Malta,189,123,0,0,66,34,32,66,0
2022-01-16,LM,Malta,180,120,1,1,60,29,30,59,0
2022-01-17,LM,Malta,164,106,3,3,58,27,28,55,0
2022-01-18,LM,Malta,163,108,3,3,55,25,27,52,0
2022-01-19,LM,Malta,158,98,3,3,60,29,28,57,0
2022-01-20,LM,Malta,156,107,2,2,49,23,24,47,0
2022-01-21,LM,Malta,169,106,3,3,63,30,30,60,0
2022-01-22,LM,Malta,174,111,3,3,63,31,29,60,0
2022-01-23,LM,Malta,163,110,0,0,53,26,27,53,0
2022-01-24,LM,Malta,145,98,3,3,47,22,22,44,0
2022-01-25,LM,Malta,123,81,1,1,42,19,22,41,0
2022-01-26,LM,Malta,145,80,0,0,65,30,35,65,0
2022-01-27,LM,Malta,146,104,2,2,42,23,17,40,0
2022-01-28,LM,Malta,169,110,1,1,59,30,28,58,0
2022-01-29,LM,Malta,141,96,0,0,45,23,22,45,0
2022-01-30,LM,Malta,176,124,0,0,52,26,26,52,0
2022-01-31,LM,Malta,163,110,0,0,53,26,27,53,0
2022-02-01,LM,Malta,169,110,0,0,59,30,29,59,0
2022-02-02,LM,Malta,172,101,0,0,71,35,36,71,0
2022-02-03,LM,Malta,161,105,0,0,56,28,28,56,0
2022-02-04,LM,Malta,173,93,0,0,80,39,41,80,0
2022-02-05,LM,Malta,163,97,0,0,66,34,32,66,0
2022-02-06,LM,Malta,170,102,1,1,68,33,34,67,0
2022-02-07,LM,Malta,201,128,1,1,73,35,37,72,0
2022-02-08,LM,Malta,176,106,1,1,70,33,36,69,0
2022-02-09,LM,Malta,184,111,1,1,73,34,38,72,0
2022-02-10,LM,Malta,200,114,2,2,86,45,39,84,0
2022-02-11,LM,Malta,196,119,2,2,77,39,36,75,0
2022-02-12,LM,Malta,190,110,1,1,80,41,38,79,0
2022-02-13,LM,Malta,201,123,1,1,78,37,40,77,0
2022-02-14,LM,Malta,196,120,2,2,76,35,39,74,0
2022-02-15,LM,Malta,176,110,2,2,66,31,33,64,0
2022-02-16,LM,Malta,180,96,0,0,84,43,41,84,0
2022-02-17,LM,Malta,160,91,1,1,69,33,35,68,0
2022-02-18,LM,Malta,231,127,3,3,104,50,51,101,0
2022-02-19,LM,Malta,210,125,4,4,85,41,40,81,0
2022-02-20,LM,Malta,193,122,1,1,71,36,34,70,0
2022-02-21,LM,Malta,193,113,1,1,80,40,39,79,0
2022-02-22,LM,Malta,184,117,1,1,67,33,33,66,0
2022-02-23,LM,Malta,185,112,3,3,73,35,35,70,0
2022-02-24,LM,Malta,194,101,4,4,93,45,44,89,0
2022-02-25,LM,Malta,205,110,3,3,95,44,48,92,0
2022-02-26,LM,Malta,211,122,1,1,89,46,42,88,0
2022-02-27,LM,Malta,231,146,1,1,85,41,43,84,0
2022-02-28,LM,Malta,214,134,2,2,80,41,37,78,0
2022-03-01,LM,Malta,202,131,1,1,71,35,35,70,0
2022-03-02,LM,Malta,231,137,1,1,94,47,46,93,0
2022-03-03,LM,Malta,228,134,2,2,94,42,50,92,0
2022-03-04,LM,Malta,235,128,1,1,107,57,49,106,0
2022-03-05,LM,Malta,224,135,0,0,89,42,47,89,0
2022-03-06,LM,Malta,241,140,1,1,101,49,51,100,0
2022-03-07,LM,Malta,241,129,1,1,112,57,54,111,0
2022-03-08,LM,Malta,218,136,1,1,82,39,42,81,0
2022-03-09,LM,Malta,234,134,0,0,100,51,49,100,0
2022-03-10,LM,Malta,229,136,0,0,93,47,46,93,0
2022-03-11,LM,Malta,224,125,1,1,99,50,48,98,0
2022-03-12,LM,Malta,223,115,1,1,108,54,53,107,0
2022-03-13,LM,Malta,245,138,0,0,107,52,55,107,0
2022-03-14,LM,Malta,239,135,0,0,104,52,52,104,0
2022-03-15,LM,Malta,209,122,2,2,87,42,43,85,0
2022-03-16,LM,Malta,201,107,1,1,94,50,43,93,0
2022-03-17,LM,Malta,208,114,1,1,94,43,50,93,0
2022-03-18,LM,Malta,221,112,1,1,109,55,53,108,0
2022-03-19,LM,Malta,221,113,0,0,108,54,54,108,0
2022-03-20,LM,Malta,235,128,0,0,107,52,55,107,0
2022-03-21,LM,Malta,269,162,1,1,107,54,52,106,0
2022-03-22,LM,Malta,240,147,2,2,93,42,49,91,0
2022-03-23,LM,Malta,238,136,3,3,102,50,49,99,0
2022-03-24,LM,Malta,250,156,4,4,94,46,44,90,0
2022-03-25,LM,Malta,264,143,5,5,121,55,61,116,0
2022-03-26,LM,Malta,239,126,1,1,113,56,56,112,0
2022-03-27,LM,Malta,285,147,0,0,138,74,64,138,0
2022-03-28,LM,Malta,291,146,0,0,145,69,76,145,0
2022-03-29,LM,Malta,268,145,4,4,123,61,58,119,0
2022-03-30,LM,Malta,266,121,2,2,145,72,71,143,0
2022-03-31,LM,Malta,281,127,0,0,154,75,79,154,0
2022-04-01,LM,Malta,290,146,1,1,144,72,71,143,0
2022-04-02,LM,Malta,289,146,1,1,143,71,71,142,0
2022-04-03,LM,Malta,284,144,3,3,140,70,67,137,0
2022-04-04,LM,Malta,262,126,0,0,136,70,66,136,0
2022-04-05,LM,Malta,237,120,1,1,117,55,61,116,0
2022-04-06,LM,Malta,266,124,2,2,142,72,68,140,0
2022-04-07,LM,Malta,272,117,1,1,155,77,77,154,0
2022-04-08,LM,Malta,289,126,3,3,163,79,81,160,0
2022-04-09,LM,Malta,275,126,3,3,149,74,72,146,0
2022-04-10,LM,Malta,268,134,1,1,134,65,68,133,0
2022-04-11,LM,Malta,255,115,5,5,140,71,64,135,0
2022-04-12,LM,Malta,256,125,2,2,131,64,65,129,0
2022-04-13,LM,Malta,305,151,0,0,154,74,80,154,0
2022-04-14,LM,Malta,291,128,1,1,163,82,80,162,0
2022-04-15,LM,Malta,281,131,0,0,150,75,75,150,0
2022-04-16,LM,Malta,268,126,0,0,142,70,72,142,0
2022-04-17,LM,Malta,310,163,1,1,147,72,74,146,0
2022-04-18,LM,Malta,282,134,0,0,148,78,70,148,0
2022-04-19,LM,Malta,273,137,2,2,136,64,70,134,0
2022-04-20,LM,Malta,275,130,2,2,145,72,71,143,0
2022-04-21,LM,Malta,305,138,0,0,167,81,86,167,0
2022-04-22,LM,Malta,298,142,2,2,156,79,75,154,0
2022-04-23,LM,Malta,289,140,2,2,149,73,74,147,0
2022-04-24,LM,Malta,281,145,0,0,136,66,70,136,0
2022-04-25,LM,Malta,288,131,2,2,157,79,76,155,0
2022-04-26,LM,Malta,236,106,1,1,130,65,64,129,0
2022-04-27,LM,Malta,246,102,0,0,144,71,73,144,0
2022-04-28,LM,Malta,301,138,0,0,163,85,78,163,0
2022-04-29,LM,Malta,272,122,1,1,150,75,74,149,0
2022-04-30,LM,Malta,277,126,1,1,151,74,76,150,0
2022-05-01,LM,Malta,276,142,0,0,134,64,70,134,0
2022-05-02,LM,Malta,282,138,0,0,144,73,71,144,0
2022-05-03,LM,Malta,257,139,2,2,118,57,59,116,0
2022-05-04,LM,Malta,271,119,3,3,152,74,75,149,0
2022-05-05,LM,Malta,284,130,0,0,154,77,77,154,0
2022-05-06,LM,Malta,276,125,0,0,151,77,74,151,0
2022-05-07,LM,Malta,285,140,0,0,145,72,73,145,0
2022-05-08,LM,Malta,302,155,0,0,147,71,76,147,0
2022-05-09,LM,Malta,279,139,0,0,140,72,68,140,0
2022-05-10,LM,Malta,257,127,0,0,130,67,63,130,0
2022-05-11,LM,Malta,284,131,1,1,153,75,77,152,0
2022-05-12,LM,Malta,293,129,1,1,164,79,84,163,0
2022-05-13,LM,Malta,270,120,1,1,150,74,75,149,0
2022-05-14,LM,Malta,285,141,2,2,144,71,71,142,0
2022-05-15,LM,Malta,307,155,1,1,152,77,74,151,0
2022-05-16,LM,Malta,274,129,1,1,145,73,71,144,0
2022-05-17,LM,Malta,257,131,1,1,126,60,65,125,0
2022-05-18,LM,Malta,267,117,2,2,150,76,72,148,0
2022-05-19,LM,Malta,281,129,1,1,152,77,74,151,0
2022-05-20,LM,Malta,280,126,2,2,154,72,80,152,0
2022-05-21,LM,Malta,274,129,0,0,145,75,70,145,0
2022-05-22,LM,Malta,283,143,1,1,140,69,70,139,0
2022-05-23,LM,Malta,281,137,2,2,144,72,70,142,0
2022-05-24,LM,Malta,243,120,1,1,123,61,61,122,0
2022-05-25,LM,Malta,275,125,1,1,150,74,75,149,0
2022-05-26,LM,Malta,287,127,0,0,160,83,77,160,0
2022-05-27,LM,Malta,263,116,0,0,147,71,76,147,0
2022-05-28,LM,Malta,280,131,1,1,149,73,75,148,0
2022-05-29,LM,Malta,304,148,1,1,156,78,77,155,0
2022-05-30,LM,Malta,295,142,1,1,153,77,75,152,0
2022-05-31,LM,Malta,237,115,2,2,122,59,61,120,0
2022-06-01,LM,Malta,287,126,1,1,161,78,82,160,0
2022-06-02,LM,Malta,311,136,3,3,175,84,88,172,0
2022-06-03,LM,Malta,280,117,1,1,163,83,79,162,0
2022-06-04,LM,Malta,297,151,1,1,146,73,72,145,0
2022-06-05,LM,Malta,317,157,1,1,160,78,81,159,0
2022-06-06,LM,Malta,285,136,1,1,149,77,71,148,0
2022-06-07,LM,Malta,268,135,1,1,133,65,67,132,0
2022-06-08,LM,Malta,284,120,1,1,164,86,77,163,0
2022-06-09,LM,Malta,318,151,2,2,167,82,83,165,0
2022-06-10,LM,Malta,310,147,1,1,163,76,86,162,0
2022-06-11,LM,Malta,312,156,1,1,156,79,76,155,0
2022-06-12,LM,Malta,309,163,0,0,146,77,69,146,0
2022-06-13,LM,Malta,274,121,2,2,153,74,77,151,0
2022-06-14,LM,Malta,267,143,0,0,124,63,61,124,0
2022-06-15,LM,Malta,282,125,1,1,157,77,79,156,0
2022-06-16,LM,Malta,300,135,0,0,165,81,84,165,0
2022-06-17,LM,Malta,319,163,0,0,156,79,77,156,0
2022-06-18,LM,Malta,314,157,0,0,157,78,79,157,0
2022-06-19,LM,Malta,354,188,0,0,166,84,82,166,0
2022-06-20,LM,Malta,315,158,0,0,157,79,78,157,0
2022-06-21,LM,Malta,302,162,2,2,140,68,70,138,0
2022-06-22,LM,Malta,308,142,1,1,166,83,82,165,0
2022-06-23,LM,Malta,365,196,3,3,169,80,86,166,0
2022-06-24,LM,Malta,340,166,1,1,174,85,88,173,0
2022-06-25,LM,Malta,333,188,0,0,145,72,73,145,0
2022-06-26,LM,Malta,361,203,1,1,158,81,76,157,0
2022-06-27,LM,Malta,324,160,2,2,164,84,78,162,0
2022-06-28,LM,Malta,288,154,0,0,134,66,68,134,0
2022-06-29,LM,Malta,319,151,1,1,168,85,82,167,0
2022-06-30,LM,Malta,349,172,1,1,177,89,87,176,0
2022-07-01,LM,Malta,332,157,2,2,175,85,88,173,0
2022-07-02,LM,Malta,346,181,1,1,165,81,83,164,0
2022-07-03,LM,Malta,366,194,1,1,172,86,85,171,0
2022-07-04,LM,Malta,318,156,2,2,162,80,80,160,0
2022-07-05,LM,Malta,289,147,1,1,142,72,69,141,0
2022-07-06,LM,Malta,349,177,2,2,172,84,86,170,0
2022-07-07,LM,Malta,359,180,2,2,179,88,89,177,0
2022-07-08,LM,Malta,330,154,1,1,176,88,87,175,0
2022-07-09,LM,Malta,311,154,0,0,157,77,80,157,0
2022-07-10,LM,Malta,344,177,1,1,167,83,83,166,0
2022-07-11,LM,Malta,325,152,1,1,173,89,83,172,0
2022-07-12,LM,Malta,295,151,1,1,144,70,73,143,0
2022-07-13,LM,Malta,336,156,1,1,180,91,88,179,0
2022-07-14,LM,Malta,364,184,3,3,180,86,91,177,0
2022-07-15,LM,Malta,370,184,1,1,186,96,89,185,0
2022-07-16,LM,Malta,361,189,1,1,172,82,89,171,0
2022-07-17,LM,Malta,348,196,1,1,152,80,71,151,0
2022-07-18,LM,Malta,337,167,1,1,170,81,88,169,0
2022-07-19,LM,Malta,304,163,2,2,141,68,71,139,0
2022-07-20,LM,Malta,354,170,1,1,184,92,91,183,0
2022-07-21,LM,Malta,362,175,2,2,187,91,94,185,0
2022-07-22,LM,Malta,342,164,0,0,178,88,90,178,0
2022-07-23,LM,Malta,363,202,1,1,161,79,81,160,0
2022-07-24,LM,Malta,383,202,0,0,181,90,91,181,0
2022-07-25,LM,Malta,358,186,0,0,172,87,85,172,0
2022-07-26,LM,Malta,323,176,1,1,147,72,74,146,0
2022-07-27,LM,Malta,365,174,1,1,191,96,94,190,0
2022-07-28,LM,Malta,345,177,0,0,168,82,86,168,0
2022-07-29,LM,Malta,329,158,0,0,171,87,84,171,0
2022-07-30,LM,Malta,350,187,0,0,163,82,81,163,0
2022-07-31,LM,Malta,362,199,2,2,163,77,84,161,0
2022-08-01,LM,Malta,320,161,2,2,159,81,76,157,0
2022-08-02,LM,Malta,307,171,1,1,136,67,68,135,0
2022-08-03,LM,Malta,348,169,1,1,179,89,89,178,0
2022-08-04,LM,Malta,341,174,1,1,167,85,81,166,0
2022-08-05,LM,Malta,325,158,1,1,167,84,82,166,0
2022-08-06,LM,Malta,333,178,2,2,155,78,75,153,0
2022-08-07,LM,Malta,363,198,2,2,165,80,83,163,0
2022-08-08,LM,Malta,329,157,1,1,172,86,85,171,0
2022-08-09,LM,Malta,286,142,2,2,144,71,71,142,0
2022-08-10,LM,Malta,352,172,1,1,180,89,90,179,0
2022-08-11,LM,Malta,338,168,1,1,170,84,85,169,0
2022-08-12,LM,Malta,320,156,0,0,164,82,82,164,0
2022-08-13,LM,Malta,356,197,2,2,159,79,78,157,0
2022-08-14,LM,Malta,368,197,2,2,171,87,82,169,0
2022-08-15,LM,Malta,335,175,1,1,160,77,82,159,0
2022-08-16,LM,Malta,290,154,2,2,136,66,68,134,0
2022-08-17,LM,Malta,343,159,2,2,184,91,91,182,0
2022-08-18,LM,Malta,364,195,1,1,169,87,81,168,0
2022-08-19,LM,Malta,353,171,2,2,182,88,92,180,0
2022-08-20,LM,Malta,341,185,3,3,156,77,76,153,0
2022-08-21,LM,Malta,373,206,0,0,167,84,83,167,0
2022-08-22,LM,Malta,331,173,0,0,158,78,80,158,0
2022-08-23,LM,Malta,318,176,2,2,142,72,68,140,0
2022-08-24,LM,Malta,343,164,2,2,179,88,89,177,0
2022-08-25,LM,Malta,372,200,1,1,172,84,87,171,0
2022-08-26,LM,Malta,326,162,2,2,164,82,80,162,0
2022-08-27,LM,Malta,348,190,1,1,158,77,80,157,0
2022-08-28,LM,Malta,396,234,1,1,162,80,81,161,0
2022-08-29,LM,Malta,354,198,3,3,156,78,75,153,0
2022-08-30,LM,Malta,289,149,2,2,140,68,70,138,0
2022-08-31,LM,Malta,350,171,2,2,179,88,89,177,0
2022-09-01,LM,Malta,358,185,1,1,173,80,92,172,0
2022-09-02,LM,Malta,329,172,2,2,157,80,75,155,0
2022-09-03,LM,Malta,331,184,1,1,147,72,74,146,0
2022-09-04,LM,Malta,387,222,2,2,165,81,82,163,0
2022-09-05,LM,Malta,337,176,1,1,161,80,80,160,0
2022-09-06,LM,Malta,279,144,0,0,135,67,68,135,0
2022-09-07,LM,Malta,329,161,1,1,168,85,82,167,0
2022-09-08,LM,Malta,356,176,3,3,180,87,90,177,0
2022-09-09,LM,Malta,299,145,1,1,154,78,75,153,0
2022-09-10,LM,Malta,349,192,1,1,157,78,78,156,0
2022-09-11,LM,Malta,355,189,1,1,166,82,83,165,0
2022-09-12,LM,Malta,325,155,2,2,170,82,86,168,0
2022-09-13,LM,Malta,290,146,1,1,144,68,75,143,0
2022-09-14,LM,Malta,339,160,0,0,179,90,89,179,0
2022-09-15,LM,Malta,352,178,1,1,174,86,87,173,0
2022-09-16,LM,Malta,331,179,0,0,152,79,73,152,0
2022-09-17,LM,Malta,339,180,0,0,159,82,77,159,0
2022-09-18,LM,Malta,368,200,1,1,168,80,87,167,0
2022-09-19,LM,Malta,318,160,1,1,158,78,79,157,0
2022-09-20,LM,Malta,281,133,1,1,148,74,73,147,0
2022-09-21,LM,Malta,287,119,3,3,168,84,81,165,0
2022-09-22,LM,Malta,307,143,1,1,164,81,82,163,0
2022-09-23,LM,Malta,293,128,2,2,165,82,81,163,0
2022-09-24,LM,Malta,315,156,1,1,159,79,79,158,0
2022-09-25,LM,Malta,342,185,0,0,157,78,79,157,0
2022-09-26,LM,Malta,308,161,2,2,147,72,73,145,0
2022-09-27,LM,Malta,273,134,1,1,139,68,70,138,0
2022-09-28,LM,Malta,309,140,3,3,169,83,83,166,0
2022-09-29,LM,Malta,352,178,3,3,174,86,85,171,0
2022-09-30,LM,Malta,335,159,2,2,176,85,89,174,0
2022-10-01,LM,Malta,321,173,0,0,148,73,75,148,0
2022-10-02,LM,Malta,349,201,0,0,148,72,76,148,0
2022-10-03,LM,Malta,328,178,1,1,150,77,72,149,0
2022-10-04,LM,Malta,280,144,3,3,136,65,68,133,0
2022-10-05,LM,Malta,314,154,1,1,160,78,81,159,0
2022-10-06,LM,Malta,332,153,2,2,179,88,89,177,0
2022-10-07,LM,Malta,312,154,1,1,158,82,75,157,0
2022-10-08,LM,Malta,331,186,2,2,145,73,70,143,0
2022-10-09,LM,Malta,343,190,1,1,153,75,77,152,0
2022-10-10,LM,Malta,294,152,2,2,142,72,68,140,0
2022-10-11,LM,Malta,265,139,3,3,126,62,61,123,0
2022-10-12,LM,Malta,307,156,3,3,151,73,75,148,0
2022-10-13,LM,Malta,303,142,1,1,161,79,81,160,0
2022-10-14,LM,Malta,328,176,1,1,152,77,74,151,0
2022-10-15,LM,Malta,303,162,0,0,141,71,70,141,0
2022-10-16,LM,Malta,308,152,1,1,156,77,78,155,0
2022-10-17,LM,Malta,284,151,2,2,133,65,66,131,0
2022-10-18,LM,Malta,270,135,2,2,135,69,64,133,0
2022-10-19,LM,Malta,311,163,2,2,148,68,78,146,0
2022-10-20,LM,Malta,295,142,0,0,153,79,74,153,0
2022-10-21,LM,Malta,287,157,2,2,130,64,64,128,0
2022-10-22,LM,Malta,309,160,0,0,149,74,75,149,0
2022-10-23,LM,Malta,322,167,1,1,155,77,77,154,0
2022-10-24,LM,Malta,291,144,3,3,147,72,72,144,0
2022-10-25,LM,Malta,259,129,1,1,130,66,63,129,0
2022-10-26,LM,Malta,297,137,4,4,160,75,81,156,0
2022-10-27,LM,Malta,310,146,3,3,164,80,81,161,0
2022-10-28,LM,Malta,297,148,3,3,149,75,71,146,0
2022-10-29,LM,Malta,284,144,3,3,140,67,70,137,0
2022-10-30,LM,Malta,283,147,0,0,136,65,71,136,0
2022-10-31,LM,Malta,297,155,5,5,142,70,67,137,0
2022-11-01,LM,Malta,229,125,2,2,104,51,51,102,0
2022-11-02,LM,Malta,222,124,5,5,98,46,47,93,0
2022-11-03,LM,Malta,266,135,3,3,131,63,65,128,0
2022-11-04,LM,Malta,256,127,3,3,129,64,62,126,0
2022-11-05,LM,Malta,284,154,0,0,130,67,63,130,0
2022-11-06,LM,Malta,274,148,0,0,126,62,64,126,0
2022-11-07,LM,Malta,258,125,2,2,133,65,66,131,0
2022-11-08,LM,Malta,215,117,2,2,98,46,50,96,0
2022-11-09,LM,Malta,215,119,3,3,96,48,45,93,0
2022-11-10,LM,Malta,264,140,0,0,124,65,59,124,0
2022-11-11,LM,Malta,257,125,3,3,132,65,64,129,0
2022-11-12,LM,Malta,274,141,1,1,133,66,66,132,0
2022-11-13,LM,Malta,280,150,1,1,130,63,66,129,0
2022-11-14,LM,Malta,286,136,2,2,150,68,80,148,0
2022-11-15,LM,Malta,237,122,3,3,115,57,55,112,0
2022-11-16,LM,Malta,229,119,3,3,110,54,53,107,0
2022-11-17,LM,Malta,288,149,1,1,139,70,68,138,0
2022-11-18,LM,Malta,281,144,2,2,137,68,67,135,0
2022-11-19,LM,Malta,269,150,2,2,119,58,59,117,0
2022-11-20,LM,Malta,288,159,0,0,129,66,63,129,0
2022-11-21,LM,Malta,280,161,0,0,119,61,58,119,0
2022-11-22,LM,Malta,216,128,1,1,88,43,44,87,0
2022-11-23,LM,Malta,236,136,1,1,100,47,52,99,0
2022-11-24,LM,Malta,229,110,3,3,119,60,56,116,0
2022-11-25,LM,Malta,243,118,1,1,125,64,60,124,0
2022-11-26,LM,Malta,225,118,0,0,107,54,53,107,0
2022-11-27,LM,Malta,269,139,0,0,130,62,68,130,0
2022-11-28,LM,Malta,276,138,5,5,138,66,67,133,0
2022-11-29,LM,Malta,244,156,2,2,88,44,42,86,0
2022-11-30,LM,Malta,258,171,1,1,87,43,43,86,0
2022-12-01,LM,Malta,268,151,1,1,117,57,59,116,0
2022-12-02,LM,Malta,280,150,2,2,130,65,63,128,0
2022-12-03,LM,Malta,266,152,1,1,114,56,57,113,0
2022-12-04,LM,Malta,275,149,0,0,126,62,64,126,0
2022-12-05,LM,Malta,262,145,2,2,117,59,56,115,0
2022-12-06,LM,Malta,219,128,5,5,91,42,44,86,0
2022-12-07,LM,Malta,245,144,2,2,101,50,49,99,0
2022-12-08,LM,Malta,279,146,2,2,133,66,65,131,0
2022-12-09,LM,Malta,261,138,1,1,123,62,60,122,0
2022-12-10,LM,Malta,283,159,0,0,124,60,64,124,0
2022-12-11,LM,Malta,287,159,0,0,128,66,62,128,0
2022-12-12,LM,Malta,286,167,1,1,119,58,60,118,0
2022-12-13,LM,Malta,265,163,1,1,102,49,52,101,0
2022-12-14,LM,Malta,251,158,2,2,93,44,47,91,0
2022-12-15,LM,Malta,291,170,2,2,121,59,60,119,0
2022-12-16,LM,Malta,294,166,2,2,128,66,60,126,0
2022-12-17,LM,Malta,289,166,3,3,123,60,60,120,0
2022-12-18,LM,Malta,342,208,3,3,134,65,66,131,0
2022-12-19,LM,Malta,307,175,2,2,132,69,61,130,0
2022-12-20,LM,Malta,263,150,4,4,113,54,55,109,0
2022-12-21,LM,Malta,228,125,3,3,103,48,52,100,0
2022-12-22,LM,Malta,267,132,1,1,135,66,68,134,0
2022-12-23,LM,Malta,261,137,3,3,124,62,59,121,0
2022-12-24,LM,Malta,236,149,0,0,87,44,43,87,0
2022-12-25,LM,Malta,194,164,0,0,30,15,15,30,0
2022-12-26,LM,Malta,259,144,1,1,115,56,58,114,0
2022-12-27,LM,Malta,249,140,1,1,109,53,55,108,0
2022-01-01,LU,Moldova,71,35,0,0,36,17,19,36,0
2022-01-02,LU,Moldova,116,47,0,0,69,36,33,69,0
2022-01-03,LU,Moldova,110,50,0,0,60,30,30,60,0
2022-01-04,LU,Moldova,94,46,0,0,48,23,25,48,0
2022-01-05,LU,Moldova,94,44,0,0,50,26,24,50,0
2022-01-06,LU,Moldova,86,31,0,0,55,26,29,55,0
2022-01-07,LU,Moldova,100,31,0,0,69,35,34,69,0
2022-01-08,LU,Moldova,119,66,0,0,53,26,27,53,0
2022-01-09,LU,Moldova,116,48,0,0,68,34,34,68,0
2022-01-10,LU,Moldova,100,45,0,0,55,28,27,55,0
2022-01-11,LU,Moldova,68,22,0,0,46,23,23,46,0
2022-01-12,LU,Moldova,70,29,0,0,41,22,19,41,0
2022-01-13,LU,Moldova,84,37,0,0,47,22,25,47,0
2022-01-14,LU,Moldova,93,37,0,0,56,28,28,56,0
2022-01-15,LU,Moldova,84,36,0,0,48,21,27,48,0
2022-01-16,LU,Moldova,89,29,0,0,60,31,29,60,0
2022-01-17,LU,Moldova,90,46,0,0,44,22,22,44,0
2022-01-18,LU,Moldova,73,28,1,0,45,21,23,44,1
2022-01-19,LU,Moldova,60,31,0,0,29,16,13,29,0
2022-01-20,LU,Moldova,73,29,0,0,44,22,22,44,0
2022-01-21,LU,Moldova,96,35,0,0,61,31,30,61,0
2022-01-22,LU,Moldova,75,40,0,0,35,17,18,35,0
2022-01-23,LU,Moldova,78,28,0,0,50,26,24,50,0
2022-01-24,LU,Moldova,81,45,0,0,36,17,19,36,0
2022-01-25,LU,Moldova,54,24,0,0,30,15,15,30,0
2022-01-26,LU,Moldova,66,36,0,0,30,16,14,30,0
2022-01-27,LU,Moldova,67,30,0,0,37,17,20,37,0
2022-01-28,LU,Moldova,82,29,0,0,53,27,26,53,0
2022-01-29,LU,Moldova,76,41,0,0,35,17,18,35,0
2022-01-30,LU,Moldova,75,31,0,0,44,23,21,44,0
2022-01-31,LU,Moldova,82,45,0,0,37,17,20,37,0
2022-02-01,LU,Moldova,73,39,0,0,34,17,17,34,0
2022-02-02,LU,Moldova,59,29,0,0,30,16,14,30,0
2022-02-03,LU,Moldova,66,30,0,0,36,17,19,36,0
2022-02-04,LU,Moldova,84,33,0,0,51,26,25,51,0
2022-02-05,LU,Moldova,84,49,0,0,35,17,18,35,0
2022-02-06,LU,Moldova,72,31,0,0,41,21,20,41,0
2022-02-07,LU,Moldova,81,38,0,0,43,20,23,43,0
2022-02-08,LU,Moldova,58,26,0,0,32,16,16,32,0
2022-02-09,LU,Moldova,63,38,0,0,25,14,11,25,0
2022-02-10,LU,Moldova,64,27,0,0,37,17,20,37,0
2022-02-11,LU,Moldova,95,37,0,0,58,30,28,58,0
2022-02-12,LU,Moldova,76,40,0,0,36,17,19,36,0
2022-02-13,LU,Moldova,74,30,0,0,44,21,23,44,0
2022-02-14,LU,Moldova,90,48,0,0,42,21,21,42,0
2022-02-15,LU,Moldova,54,26,0,0,28,14,14,28,0
2022-02-16,LU,Moldova,68,31,0,0,37,17,20,37,0
2022-02-17,LU,Moldova,66,26,1,1,40,18,21,39,0
2022-02-18,LU,Moldova,90,32,0,0,58,33,25,58,0
2022-02-19,LU,Moldova,71,35,0,0,36,16,20,36,0
2022-02-20,LU,Moldova,72,23,0,0,49,25,24,49,0
2022-02-21,LU,Moldova,80,37,0,0,43,21,22,43,0
2022-02-22,LU,Moldova,67,30,0,0,37,18,19,37,0
2022-02-23,LU,Moldova,68,37,0,0,31,17,14,31,0
2022-02-24,LU,Moldova,21,6,0,0,15,5,10,15,0
2022-02-25,LU,Moldova,12,1,0,0,11,8,3,11,0
2022-02-26,LU,Moldova,6,1,0,0,5,4,1,5,0
2022-02-27,LU,Moldova,3,0,0,0,3,2,1,3,0
2022-02-28,LU,Moldova,9,0,0,0,9,4,5,9,0
2022-03-01,LU,Moldova,6,0,0,0,6,3,3,6,0
2022-03-02,LU,Moldova,6,0,0,0,6,3,3,6,0
2022-03-03,LU,Moldova,7,0,0,0,7,3,4,7,0
2022-03-04,LU,Moldova,6,1,0,0,5,3,2,5,0
2022-03-05,LU,Moldova,5,0,0,0,5,3,2,5,0
2022-03-06,LU,Moldova,3,0,0,0,3,2,1,3,0
2022-03-07,LU,Moldova,7,1,0,0,6,3,3,6,0
2022-03-08,LU,Moldova,8,0,0,0,8,4,4,8,0
2022-03-09,LU,Moldova,7,0,0,0,7,3,4,7,0
2022-03-10,LU,Moldova,8,0,0,0,8,4,4,8,0
2022-03-11,LU,Moldova,12,0,0,0,12,6,6,12,0
2022-03-12,LU,Moldova,4,0,1,0,4,2,1,3,1
2022-03-13,LU,Moldova,6,0,1,0,6,3,2,5,1
2022-03-14,LU,Moldova,12,0,0,0,12,5,7,12,0
2022-03-15,LU,Moldova,10,0,0,0,10,5,5,10,0
2022-03-16,LU,Moldova,16,0,0,0,16,9,7,16,0
2022-03-17,LU,Moldova,9,0,0,0,9,5,4,9,0
2022-03-18,LU,Moldova,6,1,0,0,5,2,3,5,0
2022-03-19,LU,Moldova,2,0,0,0,2,1,1,2,0
2022-03-20,LU,Moldova,6,1,0,0,5,3,2,5,0
2022-03-21,LU,Moldova,12,0,0,0,12,6,6,12,0
2022-03-22,LU,Moldova,13,1,0,0,12,6,6,12,0
2022-03-23,LU,Moldova,10,0,0,0,10,5,5,10,0
2022-03-24,LU,Moldova,15,0,0,0,15,8,7,15,0
2022-03-25,LU,Moldova,12,-1,0,0,13,6,7,13,0
2022-03-26,LU,Moldova,7,1,0,0,6,3,3,6,0
2022-03-27,LU,Moldova,17,0,0,0,17,9,8,17,0
2022-03-28,LU,Moldova,9,1,0,0,8,4,4,8,0
2022-03-29,LU,Moldova,4,0,0,0,4,2,2,4,0
2022-03-30,LU,Moldova,19,-1,0,0,20,10,10,20,0
2022-03-31,LU,Moldova,28,0,0,0,28,13,15,28,0
2022-04-01,LU,Moldova,28,1,0,0,27,14,13,27,0
2022-04-02,LU,Moldova,18,1,0,0,17,9,8,17,0
2022-04-03,LU,Moldova,25,-2,0,0,27,13,14,27,0
2022-04-04,LU,Moldova,22,2,0,0,20,10,10,20,0
2022-04-05,LU,Moldova,16,0,0,0,16,7,9,16,0
2022-04-06,LU,Moldova,20,1,0,0,19,11,8,19,0
2022-04-07,LU,Moldova,43,0,0,0,43,21,22,43,0
2022-04-08,LU,Moldova,33,-1,0,0,34,17,17,34,0
2022-04-09,LU,Moldova,27,1,0,0,26,13,13,26,0
2022-04-10,LU,Moldova,26,-1,0,0,27,13,14,27,0
2022-04-11,LU,Moldova,28,2,0,0,26,14,12,26,0
2022-04-12,LU,Moldova,21,-1,0,0,22,10,12,22,0
2022-04-13,LU,Moldova,25,-1,0,0,26,13,13,26,0
2022-04-14,LU,Moldova,32,1,0,0,31,15,16,31,0
2022-04-15,LU,Moldova,44,0,0,0,44,23,21,44,0
2022-04-16,LU,Moldova,23,3,0,0,20,10,10,20,0
2022-04-17,LU,Moldova,33,0,0,0,33,16,17,33,0
2022-04-18,LU,Moldova,31,0,0,0,31,15,16,31,0
2022-04-19,LU,Moldova,19,-1,0,0,20,10,10,20,0
2022-04-20,LU,Moldova,31,1,0,0,30,16,14,30,0
2022-04-21,LU,Moldova,35,0,0,0,35,16,19,35,0
2022-04-22,LU,Moldova,41,-4,0,0,45,23,22,45,0
2022-04-23,LU,Moldova,31,5,0,0,26,13,13,26,0
2022-04-24,LU,Moldova,38,-1,0,0,39,20,19,39,0
2022-04-25,LU,Moldova,29,1,0,0,28,13,15,28,0
2022-04-26,LU,Moldova,25,-1,0,0,26,13,13,26,0
2022-04-27,LU,Moldova,39,-1,1,1,40,21,18,39,0
2022-04-28,LU,Moldova,36,2,0,0,34,17,17,34,0
2022-04-29,LU,Moldova,42,-2,0,0,44,22,22,44,0
2022-04-30,LU,Moldova,31,1,0,0,30,16,14,30,0
2022-05-01,LU,Moldova,45,0,0,0,45,22,23,45,0
2022-05-02,LU,Moldova,34,0,0,0,34,17,17,34,0
2022-05-03,LU,Moldova,36,-1,0,0,37,18,19,37,0
2022-05-04,LU,Moldova,40,2,0,0,38,19,19,38,0
2022-05-05,LU,Moldova,41,-1,0,0,42,21,21,42,0
2022-05-06,LU,Moldova,43,0,0,0,43,22,21,43,0
2022-05-07,LU,Moldova,41,1,0,0,40,20,20,40,0
2022-05-08,LU,Moldova,43,-1,0,0,44,21,23,44,0
2022-05-09,LU,Moldova,31,3,0,0,28,15,13,28,0
2022-05-10,LU,Moldova,37,-1,0,0,38,19,19,38,0
2022-05-11,LU,Moldova,27,-1,0,0,28,14,14,28,0
2022-05-12,LU,Moldova,39,1,1,1,38,18,19,37,0
2022-05-13,LU,Moldova,46,-1,0,0,47,24,23,47,0
2022-05-14,LU,Moldova,37,3,0,0,34,17,17,34,0
2022-05-15,LU,Moldova,40,-2,0,0,42,20,22,42,0
2022-05-16,LU,Moldova,27,2,0,0,25,13,12,25,0
2022-05-17,LU,Moldova,38,0,0,0,38,18,20,38,0
2022-05-18,LU,Moldova,31,-1,0,0,32,17,15,32,0
2022-05-19,LU,Moldova,35,0,0,0,35,17,18,35,0
2022-05-20,LU,Moldova,43,-2,0,0,45,23,22,45,0
2022-05-21,LU,Moldova,40,1,0,0,39,18,21,39,0
2022-05-22,LU,Moldova,38,1,0,0,37,19,18,37,0
2022-05-23,LU,Moldova,31,1,0,0,30,15,15,30,0
2022-05-24,LU,Moldova,38,0,0,0,38,19,19,38,0
2022-05-25,LU,Moldova,36,1,0,0,35,19,16,35,0
2022-05-26,LU,Moldova,40,0,0,0,40,19,21,40,0
2022-05-27,LU,Moldova,47,-3,0,0,50,24,26,50,0
2022-05-28,LU,Moldova,47,4,0,0,43,23,20,43,0
2022-05-29,LU,Moldova,47,0,0,0,47,22,25,47,0
2022-05-30,LU,Moldova,35,0,0,0,35,18,17,35,0
2022-05-31,LU,Moldova,57,0,1,1,57,28,28,56,0
2022-06-01,LU,Moldova,55,1,1,1,54,27,26,53,0
2022-06-02,LU,Moldova,46,-3,0,0,49,24,25,49,0
2022-06-03,LU,Moldova,57,1,0,0,56,28,28,56,0
2022-06-04,LU,Moldova,53,2,0,0,51,28,23,51,0
2022-06-05,LU,Moldova,44,-2,0,0,46,21,25,46,0
2022-06-06,LU,Moldova,57,2,0,0,55,27,28,55,0
2022-06-07,LU,Moldova,54,-1,0,0,55,28,27,55,0
2022-06-08,LU,Moldova,58,2,0,0,56,27,29,56,0
2022-06-09,LU,Moldova,52,1,1,1,51,26,24,50,0
2022-06-10,LU,Moldova,59,0,0,0,59,28,31,59,0
2022-06-11,LU,Moldova,55,1,0,0,54,29,25,54,0
2022-06-12,LU,Moldova,58,0,0,0,58,27,31,58,0
2022-06-13,LU,Moldova,42,1,1,1,41,20,20,40,0
2022-06-14,LU,Moldova,55,0,0,0,55,28,27,55,0
2022-06-15,LU,Moldova,70,2,0,0,68,34,34,68,0
2022-06-16,LU,Moldova,69,-1,1,1,70,36,33,69,0
2022-06-17,LU,Moldova,56,1,0,0,55,26,29,55,0
2022-06-18,LU,Moldova,63,-1,0,0,64,34,30,64,0
2022-06-19,LU,Moldova,70,-2,0,0,72,34,38,72,0
2022-06-20,LU,Moldova,62,2,0,0,60,30,30,60,0
2022-06-21,LU,Moldova,60,-2,0,0,62,30,32,62,0
2022-06-22,LU,Moldova,63,2,0,0,61,31,30,61,0
2022-06-23,LU,Moldova,64,-1,0,0,65,33,32,65,0
2022-06-24,LU,Moldova,58,-3,0,0,61,30,31,61,0
2022-06-25,LU,Moldova,71,6,1,1,65,34,30,64,0
2022-06-26,LU,Moldova,63,-1,0,0,64,31,33,64,0
2022-06-27,LU,Moldova,69,0,2,2,69,33,34,67,0
2022-06-28,LU,Moldova,59,-1,0,0,60,30,30,60,0
2022-06-29,LU,Moldova,72,1,0,0,71,35,36,71,0
2022-06-30,LU,Moldova,63,0,0,0,63,33,30,63,0
2022-07-01,LU,Moldova,65,-2,0,0,67,33,34,67,0
2022-07-02,LU,Moldova,66,1,0,0,65,33,32,65,0
2022-07-03,LU,Moldova,60,-1,0,0,61,30,31,61,0
2022-07-04,LU,Moldova,68,3,0,0,65,32,33,65,0
2022-07-05,LU,Moldova,64,-2,0,0,66,33,33,66,0
2022-07-06,LU,Moldova,67,-1,0,0,68,32,36,68,0
2022-07-07,LU,Moldova,62,2,0,0,60,31,29,60,0
2022-07-08,LU,Moldova,63,-4,0,0,67,33,34,67,0
2022-07-09,LU,Moldova,67,4,0,0,63,33,30,63,0
2022-07-10,LU,Moldova,68,-2,0,0,70,34,36,70,0
2022-07-11,LU,Moldova,63,3,0,0,60,31,29,60,0
2022-07-12,LU,Moldova,68,-2,0,0,70,35,35,70,0
2022-07-13,LU,Moldova,71,3,0,0,68,33,35,68,0
2022-07-14,LU,Moldova,61,0,0,0,61,30,31,61,0
2022-07-15,LU,Moldova,70,-3,0,0,73,37,36,73,0
2022-07-16,LU,Moldova,72,3,0,0,69,35,34,69,0
2022-07-17,LU,Moldova,69,1,0,0,68,34,34,68,0
2022-07-18,LU,Moldova,64,-1,0,0,65,32,33,65,0
2022-07-19,LU,Moldova,66,0,0,0,66,33,33,66,0
2022-07-20,LU,Moldova,66,-1,0,0,67,34,33,67,0
2022-07-21,LU,Moldova,67,2,0,0,65,33,32,65,0
2022-07-22,LU,Moldova,66,-2,0,0,68,33,35,68,0
2022-07-23,LU,Moldova,61,3,0,0,58,31,27,58,0
2022-07-24,LU,Moldova,55,-1,0,0,56,26,30,56,0
2022-07-25,LU,Moldova,71,2,0,0,69,36,33,69,0
2022-07-26,LU,Moldova,68,-3,0,0,71,34,37,71,0
2022-07-27,LU,Moldova,75,3,0,0,72,37,35,72,0
2022-07-28,LU,Moldova,64,-3,0,0,67,33,34,67,0
2022-07-29,LU,Moldova,65,0,0,0,65,33,32,65,0
2022-07-30,LU,Moldova,66,1,0,0,65,32,33,65,0
2022-07-31,LU,Moldova,63,2,0,0,61,30,31,61,0
2022-08-01,LU,Moldova,72,1,0,0,71,37,34,71,0
2022-08-02,LU,Moldova,73,-3,0,0,76,37,39,76,0
2022-08-03,LU,Moldova,72,3,0,0,69,33,36,69,0
2022-08-04,LU,Moldova,70,1,0,0,69,37,32,69,0
2022-08-05,LU,Moldova,67,-2,0,0,69,34,35,69,0
2022-08-06,LU,Moldova,69,0,0,0,69,35,34,69,0
2022-08-07,LU,Moldova,69,-1,0,0,70,34,36,70,0
2022-08-08,LU,Moldova,70,2,0,0,68,34,34,68,0
2022-08-09,LU,Moldova,69,-2,1,1,71,34,36,70,0
2022-08-10,LU,Moldova,76,2,1,1,74,37,36,73,0
2022-08-11,LU,Moldova,70,2,0,0,68,35,33,68,0
2022-08-12,LU,Moldova,72,-4,0,0,76,37,39,76,0
2022-08-13,LU,Moldova,77,1,0,0,76,38,38,76,0
2022-08-14,LU,Moldova,70,0,0,0,70,35,35,70,0
2022-08-15,LU,Moldova,63,1,0,0,62,32,30,62,0
2022-08-16,LU,Moldova,68,-3,2,2,71,34,35,69,0
2022-08-17,LU,Moldova,78,2,1,1,76,38,37,75,0
2022-08-18,LU,Moldova,75,0,0,0,75,38,37,75,0
2022-08-19,LU,Moldova,71,-2,0,0,73,34,39,73,0
2022-08-20,LU,Moldova,70,1,0,0,69,36,33,69,0
2022-08-21,LU,Moldova,69,1,0,0,68,33,35,68,0
2022-08-22,LU,Moldova,71,2,0,0,69,35,34,69,0
2022-08-23,LU,Moldova,67,-1,0,0,68,34,34,68,0
2022-08-24,LU,Moldova,76,-1,0,0,77,37,40,77,0
2022-08-25,LU,Moldova,72,4,0,0,68,37,31,68,0
2022-08-26,LU,Moldova,76,-3,0,0,79,38,41,79,0
2022-08-27,LU,Moldova,70,3,0,0,67,34,33,67,0
2022-08-28,LU,Moldova,70,-3,0,0,73,36,37,73,0
2022-08-29,LU,Moldova,71,3,0,0,68,37,31,68,0
2022-08-30,LU,Moldova,72,-1,0,0,73,34,39,73,0
2022-08-31,LU,Moldova,81,2,0,0,79,40,39,79,0
2022-09-01,LU,Moldova,71,0,0,0,71,35,36,71,0
2022-09-02,LU,Moldova,74,-3,0,0,77,37,40,77,0
2022-09-03,LU,Moldova,82,3,0,0,79,41,38,79,0
2022-09-04,LU,Moldova,74,-2,1,1,76,36,39,75,0
2022-09-05,LU,Moldova,75,3,1,1,72,36,35,71,0
2022-09-06,LU,Moldova,81,-2,0,0,83,40,43,83,0
2022-09-07,LU,Moldova,80,-1,0,0,81,41,40,81,0
2022-09-08,LU,Moldova,92,2,0,0,90,46,44,90,0
2022-09-09,LU,Moldova,79,-1,0,0,80,40,40,80,0
2022-09-10,LU,Moldova,84,2,0,0,82,41,41,82,0
2022-09-11,LU,Moldova,90,-3,0,0,93,46,47,93,0
2022-09-12,LU,Moldova,63,4,3,3,59,29,27,56,0
2022-09-13,LU,Moldova,75,0,0,0,75,34,41,75,0
2022-09-14,LU,Moldova,77,-1,0,0,78,39,39,78,0
2022-09-15,LU,Moldova,91,2,0,0,89,46,43,89,0
2022-09-16,LU,Moldova,85,-4,0,0,89,45,44,89,0
2022-09-17,LU,Moldova,85,4,0,0,81,41,40,81,0
2022-09-18,LU,Moldova,83,-1,0,0,84,41,43,84,0
2022-09-19,LU,Moldova,70,0,0,0,70,35,35,70,0
2022-09-20,LU,Moldova,87,1,0,0,86,42,44,86,0
2022-09-21,LU,Moldova,86,-2,0,0,88,43,45,88,0
2022-09-22,LU,Moldova,93,2,0,0,91,46,45,91,0
2022-09-23,LU,Moldova,81,-4,0,0,85,42,43,85,0
2022-09-24,LU,Moldova,89,3,0,0,86,43,43,86,0
2022-09-25,LU,Moldova,83,-1,0,0,84,42,42,84,0
2022-09-26,LU,Moldova,68,4,0,0,64,33,31,64,0
2022-09-27,LU,Moldova,76,-1,0,0,77,38,39,77,0
2022-09-28,LU,Moldova,97,-6,0,0,103,50,53,103,0
2022-09-29,LU,Moldova,111,5,0,0,106,56,50,106,0
2022-09-30,LU,Moldova,95,-3,0,0,98,50,48,98,0
2022-10-01,LU,Moldova,81,0,0,0,81,41,40,81,0
2022-10-02,LU,Moldova,84,0,0,0,84,42,42,84,0
2022-10-03,LU,Moldova,67,3,0,0,64,32,32,64,0
2022-10-04,LU,Moldova,69,0,0,0,69,35,34,69,0
2022-10-05,LU,Moldova,75,0,1,1,75,35,39,74,0
2022-10-06,LU,Moldova,76,1,1,1,75,39,35,74,0
2022-10-07,LU,Moldova,78,-3,0,0,81,38,43,81,0
2022-10-08,LU,Moldova,82,1,0,0,81,42,39,81,0
2022-10-09,LU,Moldova,70,1,0,0,69,34,35,69,0
2022-10-10,LU,Moldova,61,1,0,0,60,30,30,60,0
2022-10-11,LU,Moldova,71,0,0,0,71,36,35,71,0
2022-10-12,LU,Moldova,78,0,1,1,78,38,39,77,0
2022-10-13,LU,Moldova,72,1,0,0,71,37,34,71,0
2022-10-14,LU,Moldova,79,-4,0,0,83,40,43,83,0
2022-10-15,LU,Moldova,80,5,0,0,75,39,36,75,0
2022-10-16,LU,Moldova,80,-4,0,0,84,41,43,84,0
2022-10-17,LU,Moldova,67,4,0,0,63,32,31,63,0
2022-10-18,LU,Moldova,73,-1,0,0,74,35,39,74,0
2022-10-19,LU,Moldova,77,0,0,0,77,39,38,77,0
2022-10-20,LU,Moldova,79,1,0,0,78,41,37,78,0
2022-10-21,LU,Moldova,70,-4,1,1,74,35,38,73,0
2022-10-22,LU,Moldova,83,4,0,0,79,40,39,79,0
2022-10-23,LU,Moldova,78,-4,0,0,82,42,40,82,0
2022-10-24,LU,Moldova,69,6,0,0,63,31,32,63,0
2022-10-25,LU,Moldova,63,-1,0,0,64,30,34,64,0
2022-10-26,LU,Moldova,78,1,0,0,77,41,36,77,0
2022-10-27,LU,Moldova,72,0,0,0,72,36,36,72,0
2022-10-28,LU,Moldova,82,-2,1,1,84,39,44,83,0
2022-10-29,LU,Moldova,80,1,0,0,79,41,38,79,0
2022-10-30,LU,Moldova,82,-3,0,0,85,40,45,85,0
2022-10-31,LU,Moldova,67,1,0,0,66,35,31,66,0
2022-11-01,LU,Moldova,76,1,0,0,75,36,39,75,0
2022-11-02,LU,Moldova,76,-1,0,0,77,39,38,77,0
2022-11-03,LU,Moldova,77,0,0,0,77,40,37,77,0
2022-11-04,LU,Moldova,80,0,0,0,80,40,40,80,0
2022-11-05,LU,Moldova,75,2,0,0,73,36,37,73,0
2022-11-06,LU,Moldova,81,-3,0,0,84,43,41,84,0
2022-11-07,LU,Moldova,69,5,0,0,64,33,31,64,0
2022-11-08,LU,Moldova,69,-2,0,0,71,35,36,71,0
2022-11-09,LU,Moldova,66,-2,0,0,68,34,34,68,0
2022-11-10,LU,Moldova,74,0,0,0,74,36,38,74,0
2022-11-11,LU,Moldova,69,0,0,0,69,36,33,69,0
2022-11-12,LU,Moldova,68,3,0,0,65,32,33,65,0
2022-11-13,LU,Moldova,72,-4,0,0,76,37,39,76,0
2022-11-14,LU,Moldova,74,5,0,0,69,37,32,69,0
2022-11-15,LU,Moldova,66,1,0,0,65,31,34,65,0
2022-11-16,LU,Moldova,75,-4,0,0,79,38,41,79,0
2022-11-17,LU,Moldova,73,2,0,0,71,36,35,71,0
2022-11-18,LU,Moldova,70,-1,0,0,71,36,35,71,0
2022-11-19,LU,Moldova,75,4,0,0,71,34,37,71,0
2022-11-20,LU,Moldova,65,-3,0,0,68,36,32,68,0
2022-11-21,LU,Moldova,66,0,0,0,66,31,35,66,0
2022-11-22,LU,Moldova,65,2,0,0,63,33,30,63,0
2022-11-23,LU,Moldova,68,-2,0,0,70,34,36,70,0
2022-11-24,LU,Moldova,74,-1,0,0,75,37,38,75,0
2022-11-25,LU,Moldova,69,-1,0,0,70,35,35,70,0
2022-11-26,LU,Moldova,69,5,0,0,64,32,32,64,0
2022-11-27,LU,Moldova,66,-2,0,0,68,35,33,68,0
2022-11-28,LU,Moldova,64,1,0,0,63,31,32,63,0
2022-11-29,LU,Moldova,67,-1,0,0,68,33,35,68,0
2022-11-30,LU,Moldova,76,1,0,0,75,39,36,75,0
2022-12-01,LU,Moldova,73,0,0,0,73,35,38,73,0
2022-12-02,LU,Moldova,64,-2,0,0,66,33,33,66,0
2022-12-03,LU,Moldova,72,3,0,0,69,35,34,69,0
2022-12-04,LU,Moldova,67,-2,0,0,69,33,36,69,0
2022-12-05,LU,Moldova,53,3,0,0,50,27,23,50,0
2022-12-06,LU,Moldova,53,-1,0,0,54,25,29,54,0
2022-12-07,LU,Moldova,56,-1,0,0,57,28,29,57,0
2022-12-08,LU,Moldova,70,1,0,0,69,36,33,69,0
2022-12-09,LU,Moldova,54,-2,0,0,56,27,29,56,0
2022-12-10,LU,Moldova,63,3,1,1,60,29,30,59,0
2022-12-11,LU,Moldova,55,-2,0,0,57,29,28,57,0
2022-12-12,LU,Moldova,56,3,0,0,53,27,26,53,0
2022-12-13,LU,Moldova,52,1,0,0,51,25,26,51,0
2022-12-14,LU,Moldova,56,0,0,0,56,29,27,56,0
2022-12-15,LU,Moldova,67,-1,0,0,68,32,36,68,0
2022-12-16,LU,Moldova,60,0,0,0,60,31,29,60,0
2022-12-17,LU,Moldova,64,4,0,0,60,31,29,60,0
2022-12-18,LU,Moldova,61,-3,0,0,64,32,32,64,0
2022-12-19,LU,Moldova,65,4,0,0,61,32,29,61,0
2022-12-20,LU,Moldova,56,-2,0,0,58,27,31,58,0
2022-12-21,LU,Moldova,77,-5,0,0,82,43,39,82,0
2022-12-22,LU,Moldova,74,0,0,0,74,36,38,74,0
2022-12-23,LU,Moldova,66,1,0,0,65,32,33,65,0
2022-12-24,LU,Moldova,73,-1,0,0,74,38,36,74,0
2022-12-25,LU,Moldova,58,1,0,0,57,28,29,57,0
2022-12-26,LU,Moldova,55,1,0,0,54,27,27,54,0
2022-12-27,LU,Moldova,56,0,0,0,56,28,28,56,0
2022-01-01,GM,Morocco,1060,985,38,0,75,20,17,37,38
2022-01-02,GM,Morocco,1014,909,54,0,105,29,22,51,54
2022-01-03,GM,Morocco,866,789,40,0,77,19,18,37,40
2022-01-04,GM,Morocco,880,775,45,0,105,30,30,60,45
2022-01-05,GM,Morocco,800,705,40,2,95,26,29,55,38
2022-01-06,GM,Morocco,789,683,44,3,106,33,29,62,41
2022-01-07,GM,Morocco,838,705,65,3,133,33,35,68,62
2022-01-08,GM,Morocco,1204,1129,23,1,75,28,24,52,22
2022-01-09,GM,Morocco,984,873,48,0,111,31,32,63,48
2022-01-10,GM,Morocco,714,616,42,6,98,29,27,56,36
2022-01-11,GM,Morocco,646,555,35,1,91,27,29,56,34
2022-01-12,GM,Morocco,608,494,50,3,114,33,31,64,47
2022-01-13,GM,Morocco,583,491,39,1,92,26,27,53,38
2022-01-14,GM,Morocco,665,548,50,2,117,33,34,67,48
2022-01-15,GM,Morocco,918,844,31,0,74,21,22,43,31
2022-01-16,GM,Morocco,755,652,48,0,103,27,28,55,48
2022-01-17,GM,Morocco,581,481,46,3,100,28,26,54,43
2022-01-18,GM,Morocco,563,466,34,2,97,29,34,63,32
2022-01-19,GM,Morocco,566,454,44,0,112,36,32,68,44
2022-01-20,GM,Morocco,565,456,48,1,109,30,31,61,47
2022-01-21,GM,Morocco,642,519,50,2,123,38,35,73,48
2022-01-22,GM,Morocco,952,863,27,0,89,33,29,62,27
2022-01-23,GM,Morocco,735,638,37,1,97,29,31,60,36
2022-01-24,GM,Morocco,552,473,37,3,79,21,21,42,34
2022-01-25,GM,Morocco,552,450,45,2,102,28,29,57,43
2022-01-26,GM,Morocco,569,443,50,2,126,36,40,76,48
2022-01-27,GM,Morocco,569,456,56,0,113,32,25,57,56
2022-01-28,GM,Morocco,612,495,47,1,117,36,34,70,46
2022-01-29,GM,Morocco,898,816,25,0,82,29,28,57,25
2022-01-30,GM,Morocco,737,636,42,0,101,32,27,59,42
2022-01-31,GM,Morocco,562,453,48,1,109,30,31,61,47
2022-02-01,GM,Morocco,589,497,37,2,92,28,27,55,35
2022-02-02,GM,Morocco,567,474,52,2,93,21,20,41,50
2022-02-03,GM,Morocco,623,534,47,1,89,21,21,42,46
2022-02-04,GM,Morocco,649,566,48,1,83,18,17,35,47
2022-02-05,GM,Morocco,998,931,25,0,67,21,21,42,25
2022-02-06,GM,Morocco,786,712,44,0,74,16,14,30,44
2022-02-07,GM,Morocco,822,544,57,1,278,115,106,221,56
2022-02-08,GM,Morocco,810,520,58,2,290,113,119,232,56
2022-02-09,GM,Morocco,807,502,57,2,305,122,126,248,55
2022-02-10,GM,Morocco,918,580,67,2,338,139,132,271,65
2022-02-11,GM,Morocco,978,624,68,2,354,143,143,286,66
2022-02-12,GM,Morocco,1316,964,50,0,352,154,148,302,50
2022-02-13,GM,Morocco,1072,732,60,1,340,140,140,280,59
2022-02-14,GM,Morocco,877,549,50,7,328,132,146,278,43
2022-02-15,GM,Morocco,879,589,53,3,290,122,115,237,50
2022-02-16,GM,Morocco,782,486,59,2,296,116,121,237,57
2022-02-17,GM,Morocco,886,561,57,1,325,135,133,268,56
2022-02-18,GM,Morocco,1018,620,67,0,398,165,166,331,67
2022-02-19,GM,Morocco,1346,964,40,0,382,177,165,342,40
2022-02-20,GM,Morocco,1146,778,58,0,368,152,158,310,58
2022-02-21,GM,Morocco,943,576,55,4,367,154,158,312,51
2022-02-22,GM,Morocco,877,577,48,0,300,127,125,252,48
2022-02-23,GM,Morocco,851,523,64,5,328,131,133,264,59
2022-02-24,GM,Morocco,938,602,42,1,336,151,143,294,41
2022-02-25,GM,Morocco,1047,627,68,4,420,178,174,352,64
2022-02-26,GM,Morocco,1424,1033,49,0,391,173,169,342,49
2022-02-27,GM,Morocco,1149,769,57,0,380,160,163,323,57
2022-02-28,GM,Morocco,1014,612,70,8,402,163,169,332,62
2022-03-01,GM,Morocco,989,612,64,3,377,158,155,313,61
2022-03-02,GM,Morocco,921,558,61,5,363,150,152,302,56
2022-03-03,GM,Morocco,1058,662,65,6,396,168,163,331,59
2022-03-04,GM,Morocco,1131,666,59,3,465,199,207,406,56
2022-03-05,GM,Morocco,1521,1058,48,1,463,214,201,415,47
2022-03-06,GM,Morocco,1284,836,62,0,448,191,195,386,62
2022-03-07,GM,Morocco,1081,630,72,4,451,185,194,379,68
2022-03-08,GM,Morocco,1008,610,66,6,398,172,160,332,60
2022-03-09,GM,Morocco,919,538,60,2,381,160,161,321,58
2022-03-10,GM,Morocco,1058,654,64,3,404,172,168,340,61
2022-03-11,GM,Morocco,1115,628,71,4,487,205,211,416,67
2022-03-12,GM,Morocco,1468,1034,51,1,434,193,190,383,50
2022-03-13,GM,Morocco,1242,789,60,2,453,197,196,393,58
2022-03-14,GM,Morocco,968,546,52,1,422,183,187,370,51
2022-03-15,GM,Morocco,980,609,56,0,371,158,157,315,56
2022-03-16,GM,Morocco,940,577,53,1,363,152,158,310,52
2022-03-17,GM,Morocco,1024,654,48,0,370,165,157,322,48
2022-03-18,GM,Morocco,1121,655,68,1,466,198,200,398,67
2022-03-19,GM,Morocco,1493,1054,49,0,439,198,192,390,49
2022-03-20,GM,Morocco,1234,788,59,0,446,195,192,387,59
2022-03-21,GM,Morocco,1083,632,67,1,451,183,201,384,66
2022-03-22,GM,Morocco,986,601,67,2,385,164,154,318,65
2022-03-23,GM,Morocco,939,564,63,1,375,155,157,312,62
2022-03-24,GM,Morocco,1022,630,58,0,392,171,163,334,58
2022-03-25,GM,Morocco,1156,670,67,1,486,213,206,419,66
2022-03-26,GM,Morocco,1512,1038,55,0,474,207,212,419,55
2022-03-27,GM,Morocco,1256,745,59,1,511,224,228,452,58
2022-03-28,GM,Morocco,984,533,61,1,451,191,199,390,60
2022-03-29,GM,Morocco,1078,605,52,2,473,210,211,421,50
2022-03-30,GM,Morocco,1040,575,61,0,465,202,202,404,61
2022-03-31,GM,Morocco,1184,675,71,0,509,228,210,438,71
2022-04-01,GM,Morocco,1170,646,72,1,524,218,234,452,71
2022-04-02,GM,Morocco,1472,973,46,1,499,232,221,453,45
2022-04-03,GM,Morocco,1284,791,63,0,493,216,214,430,63
2022-04-04,GM,Morocco,1044,585,59,2,459,203,197,400,57
2022-04-05,GM,Morocco,1051,639,53,2,412,180,179,359,51
2022-04-06,GM,Morocco,978,594,53,4,384,161,170,331,49
2022-04-07,GM,Morocco,1143,722,52,5,421,186,183,369,47
2022-04-08,GM,Morocco,1202,711,75,2,491,208,208,416,73
2022-04-09,GM,Morocco,1517,1034,43,2,483,224,216,440,41
2022-04-10,GM,Morocco,1336,851,54,0,485,212,219,431,54
2022-04-11,GM,Morocco,1084,640,58,5,444,194,192,386,53
2022-04-12,GM,Morocco,1124,710,59,7,414,179,176,355,52
2022-04-13,GM,Morocco,1072,646,59,5,426,181,186,367,54
2022-04-14,GM,Morocco,1207,704,79,7,503,211,213,424,72
2022-04-15,GM,Morocco,1139,644,78,4,495,208,209,417,74
2022-04-16,GM,Morocco,1462,954,50,2,508,232,226,458,48
2022-04-17,GM,Morocco,1356,838,61,3,518,228,229,457,58
2022-04-18,GM,Morocco,1123,674,47,1,449,202,200,402,46
2022-04-19,GM,Morocco,1093,672,49,7,421,185,187,372,42
2022-04-20,GM,Morocco,1048,620,61,6,428,185,182,367,55
2022-04-21,GM,Morocco,1151,711,57,10,440,187,196,383,47
2022-04-22,GM,Morocco,1118,637,76,7,481,206,199,405,69
2022-04-23,GM,Morocco,1445,968,51,3,477,218,208,426,48
2022-04-24,GM,Morocco,1336,815,59,3,521,231,231,462,56
2022-04-25,GM,Morocco,1075,621,55,6,454,197,202,399,49
2022-04-26,GM,Morocco,1064,660,58,6,404,175,171,346,52
2022-04-27,GM,Morocco,1028,601,77,8,427,174,176,350,69
2022-04-28,GM,Morocco,1085,643,59,9,442,192,191,383,50
2022-04-29,GM,Morocco,1073,578,68,8,495,215,212,427,60
2022-04-30,GM,Morocco,1386,853,54,0,533,241,238,479,54
2022-05-01,GM,Morocco,1189,669,65,1,520,224,231,455,64
2022-05-02,GM,Morocco,1003,570,49,0,433,191,193,384,49
2022-05-03,GM,Morocco,1058,602,46,0,456,207,203,410,46
2022-05-04,GM,Morocco,1009,548,65,2,461,195,201,396,63
2022-05-05,GM,Morocco,1124,637,50,4,487,219,218,437,46
2022-05-06,GM,Morocco,1086,566,67,2,520,225,228,453,65
2022-05-07,GM,Morocco,1317,772,51,1,545,250,244,494,50
2022-05-08,GM,Morocco,1204,655,67,1,549,240,242,482,66
2022-05-09,GM,Morocco,1098,564,92,10,534,221,221,442,82
2022-05-10,GM,Morocco,1089,589,74,16,500,206,220,426,58
2022-05-11,GM,Morocco,1057,545,71,9,512,229,212,441,62
2022-05-12,GM,Morocco,1128,624,55,4,504,224,225,449,51
2022-05-13,GM,Morocco,1089,569,70,2,520,224,226,450,68
2022-05-14,GM,Morocco,1305,771,60,0,534,242,232,474,60
2022-05-15,GM,Morocco,1186,646,73,2,540,234,233,467,71
2022-05-16,GM,Morocco,1077,584,59,6,493,210,224,434,53
2022-05-17,GM,Morocco,1057,594,59,0,463,207,197,404,59
2022-05-18,GM,Morocco,1020,581,61,3,439,188,190,378,58
2022-05-19,GM,Morocco,1091,608,68,9,483,205,210,415,59
2022-05-20,GM,Morocco,1058,534,80,0,524,219,225,444,80
2022-05-21,GM,Morocco,1313,774,54,0,539,248,237,485,54
2022-05-22,GM,Morocco,1166,641,59,0,525,238,228,466,59
2022-05-23,GM,Morocco,1054,581,65,9,473,199,209,408,56
2022-05-24,GM,Morocco,1064,586,64,8,478,207,207,414,56
2022-05-25,GM,Morocco,1028,558,63,4,470,204,203,407,59
2022-05-26,GM,Morocco,1131,615,92,4,516,205,219,424,88
2022-05-27,GM,Morocco,1091,570,69,2,521,231,221,452,67
2022-05-28,GM,Morocco,1239,733,50,0,506,227,229,456,50
2022-05-29,GM,Morocco,1187,649,58,0,538,243,237,480,58
2022-05-30,GM,Morocco,1079,593,61,2,486,208,217,425,59
2022-05-31,GM,Morocco,1113,628,56,1,485,217,212,429,55
2022-06-01,GM,Morocco,1053,565,63,1,488,218,207,425,62
2022-06-02,GM,Morocco,1111,620,67,4,491,210,214,424,63
2022-06-03,GM,Morocco,1072,550,74,3,522,225,223,448,71
2022-06-04,GM,Morocco,1232,712,54,1,520,236,230,466,53
2022-06-05,GM,Morocco,1199,655,72,0,544,236,236,472,72
2022-06-06,GM,Morocco,1086,573,61,4,513,225,227,452,57
2022-06-07,GM,Morocco,1100,617,64,4,483,208,211,419,60
2022-06-08,GM,Morocco,1043,549,70,2,494,207,217,424,68
2022-06-09,GM,Morocco,1135,637,70,1,498,216,212,428,69
2022-06-10,GM,Morocco,1095,582,84,1,513,214,215,429,83
2022-06-11,GM,Morocco,1298,752,60,0,546,243,243,486,60
2022-06-12,GM,Morocco,1220,633,80,0,587,260,247,507,80
2022-06-13,GM,Morocco,1069,598,63,0,471,200,208,408,63
2022-06-14,GM,Morocco,1110,610,61,0,500,223,216,439,61
2022-06-15,GM,Morocco,1081,578,71,2,503,213,219,432,69
2022-06-16,GM,Morocco,1142,631,63,3,511,225,223,448,60
2022-06-17,GM,Morocco,1091,565,80,3,526,224,222,446,77
2022-06-18,GM,Morocco,1307,757,62,3,550,240,248,488,59
2022-06-19,GM,Morocco,1194,631,70,0,563,253,240,493,70
2022-06-20,GM,Morocco,1125,596,62,2,529,233,234,467,60
2022-06-21,GM,Morocco,1173,609,63,1,564,247,254,501,62
2022-06-22,GM,Morocco,1113,568,63,1,545,244,238,482,62
2022-06-23,GM,Morocco,1173,597,79,2,576,243,254,497,77
2022-06-24,GM,Morocco,1183,588,88,4,595,257,250,507,84
2022-06-25,GM,Morocco,1333,767,54,1,566,252,260,512,53
2022-06-26,GM,Morocco,1229,626,72,0,603,269,262,531,72
2022-06-27,GM,Morocco,1212,603,74,5,609,266,269,535,69
2022-06-28,GM,Morocco,1225,619,71,4,606,271,264,535,67
2022-06-29,GM,Morocco,1169,580,59,7,589,263,267,530,52
2022-06-30,GM,Morocco,1274,654,70,5,620,273,277,550,65
2022-07-01,GM,Morocco,1245,609,78,3,636,289,269,558,75
2022-07-02,GM,Morocco,1354,751,61,2,603,271,271,542,59
2022-07-03,GM,Morocco,1297,667,83,2,630,273,274,547,81
2022-07-04,GM,Morocco,1169,587,71,6,582,258,253,511,65
2022-07-05,GM,Morocco,1236,606,71,2,630,282,277,559,69
2022-07-06,GM,Morocco,1203,606,59,3,597,269,269,538,56
2022-07-07,GM,Morocco,1302,681,61,3,621,277,283,560,58
2022-07-08,GM,Morocco,1199,596,72,1,603,273,258,531,71
2022-07-09,GM,Morocco,1362,779,59,0,583,256,268,524,59
2022-07-10,GM,Morocco,1274,691,62,0,583,260,261,521,62
2022-07-11,GM,Morocco,1186,618,58,0,568,255,255,510,58
2022-07-12,GM,Morocco,1202,621,70,4,581,259,252,511,66
2022-07-13,GM,Morocco,1203,614,66,2,589,258,265,523,64
2022-07-14,GM,Morocco,1307,704,74,2,603,263,266,529,72
2022-07-15,GM,Morocco,1221,616,69,2,605,273,263,536,67
2022-07-16,GM,Morocco,1378,786,62,0,592,262,268,530,62
2022-07-17,GM,Morocco,1289,703,63,0,586,261,262,523,63
2022-07-18,GM,Morocco,1234,638,71,2,596,262,263,525,69
2022-07-19,GM,Morocco,1240,654,69,3,586,261,256,517,66
2022-07-20,GM,Morocco,1221,608,75,1,613,267,271,538,74
2022-07-21,GM,Morocco,1323,689,87,5,634,273,274,547,82
2022-07-22,GM,Morocco,1216,593,78,4,623,277,268,545,74
2022-07-23,GM,Morocco,1402,806,51,2,596,275,270,545,49
2022-07-24,GM,Morocco,1282,695,63,0,587,263,261,524,63
2022-07-25,GM,Morocco,1261,662,68,2,599,261,270,531,66
2022-07-26,GM,Morocco,1248,676,52,3,572,260,260,520,49
2022-07-27,GM,Morocco,1186,618,53,2,568,259,256,515,51
2022-07-28,GM,Morocco,1295,695,68,4,600,261,271,532,64
2022-07-29,GM,Morocco,1236,627,67,3,609,279,263,542,64
2022-07-30,GM,Morocco,1410,804,58,1,606,273,275,548,57
2022-07-31,GM,Morocco,1313,698,63,0,615,275,277,552,63
2022-08-01,GM,Morocco,1274,678,54,0,596,277,265,542,54
2022-08-02,GM,Morocco,1292,678,72,2,614,271,271,542,70
2022-08-03,GM,Morocco,1215,641,58,1,574,255,261,516,57
2022-08-04,GM,Morocco,1320,713,65,2,607,269,273,542,63
2022-08-05,GM,Morocco,1229,610,75,1,619,279,265,544,74
2022-08-06,GM,Morocco,1421,817,62,0,604,269,273,542,62
2022-08-07,GM,Morocco,1314,716,67,1,598,265,266,531,66
2022-08-08,GM,Morocco,1264,661,68,3,603,268,267,535,65
2022-08-09,GM,Morocco,1270,675,75,5,595,261,259,520,70
2022-08-10,GM,Morocco,1191,627,53,2,564,250,261,511,51
2022-08-11,GM,Morocco,1281,694,51,2,587,270,266,536,49
2022-08-12,GM,Morocco,1204,609,71,0,595,262,262,524,71
2022-08-13,GM,Morocco,1352,764,52,0,588,267,269,536,52
2022-08-14,GM,Morocco,1278,678,65,0,600,268,267,535,65
2022-08-15,GM,Morocco,1245,662,53,3,583,266,264,530,50
2022-08-16,GM,Morocco,1251,654,66,3,597,269,262,531,63
2022-08-17,GM,Morocco,1193,632,53,2,561,250,258,508,51
2022-08-18,GM,Morocco,1302,693,71,1,609,271,267,538,70
2022-08-19,GM,Morocco,1202,586,68,2,616,276,272,548,66
2022-08-20,GM,Morocco,1408,801,51,1,607,277,279,556,50
2022-08-21,GM,Morocco,1320,719,63,0,601,268,270,538,63
2022-08-22,GM,Morocco,1273,676,56,1,597,274,267,541,55
2022-08-23,GM,Morocco,1234,652,56,0,582,263,263,526,56
2022-08-24,GM,Morocco,1198,630,54,1,568,255,259,514,53
2022-08-25,GM,Morocco,1326,717,62,3,609,272,275,547,59
2022-08-26,GM,Morocco,1224,607,72,2,617,275,270,545,70
2022-08-27,GM,Morocco,1374,776,50,1,598,274,274,548,49
2022-08-28,GM,Morocco,1267,668,61,0,599,264,274,538,61
2022-08-29,GM,Morocco,1222,637,54,3,585,268,263,531,51
2022-08-30,GM,Morocco,1229,629,57,1,600,276,267,543,56
2022-08-31,GM,Morocco,1215,624,68,1,591,261,262,523,67
2022-09-01,GM,Morocco,1267,684,55,2,583,264,264,528,53
2022-09-02,GM,Morocco,1227,614,73,1,613,271,269,540,72
2022-09-03,GM,Morocco,1369,792,48,0,577,263,266,529,48
2022-09-04,GM,Morocco,1271,670,74,3,601,263,264,527,71
2022-09-05,GM,Morocco,1207,639,62,5,568,257,249,506,57
2022-09-06,GM,Morocco,1242,666,66,4,576,259,251,510,62
2022-09-07,GM,Morocco,1176,612,54,3,564,254,256,510,51
2022-09-08,GM,Morocco,1246,678,71,1,568,241,256,497,70
2022-09-09,GM,Morocco,1193,597,82,2,596,263,251,514,80
2022-09-10,GM,Morocco,1390,804,57,0,586,260,269,529,57
2022-09-11,GM,Morocco,1242,675,66,0,567,253,248,501,66
2022-09-12,GM,Morocco,1120,597,61,2,523,233,229,462,59
2022-09-13,GM,Morocco,1155,644,58,0,511,232,221,453,58
2022-09-14,GM,Morocco,1097,589,49,3,508,229,230,459,46
2022-09-15,GM,Morocco,1223,678,63,2,545,235,247,482,61
2022-09-16,GM,Morocco,1050,551,76,1,499,216,207,423,75
2022-09-17,GM,Morocco,1373,818,56,0,555,246,253,499,56
2022-09-18,GM,Morocco,1223,649,61,0,574,258,255,513,61
2022-09-19,GM,Morocco,1100,585,59,2,515,224,232,456,57
2022-09-20,GM,Morocco,1161,623,68,6,538,240,230,470,62
2022-09-21,GM,Morocco,1063,565,59,1,498,215,224,439,58
2022-09-22,GM,Morocco,1175,650,59,0,525,234,232,466,59
2022-09-23,GM,Morocco,1141,603,78,2,538,227,233,460,76
2022-09-24,GM,Morocco,1278,760,53,0,518,236,229,465,53
2022-09-25,GM,Morocco,1071,491,71,0,580,258,251,509,71
2022-09-26,GM,Morocco,1104,608,51,0,496,220,225,445,51
2022-09-27,GM,Morocco,1172,655,65,3,517,230,222,452,62
2022-09-28,GM,Morocco,1118,601,57,4,517,226,234,460,53
2022-09-29,GM,Morocco,1123,617,54,5,506,222,230,452,49
2022-09-30,GM,Morocco,1139,601,70,1,538,239,229,468,69
2022-10-01,GM,Morocco,1338,773,52,1,565,259,254,513,51
2022-10-02,GM,Morocco,1197,675,55,0,522,230,237,467,55
2022-10-03,GM,Morocco,1162,653,68,3,509,218,223,441,65
2022-10-04,GM,Morocco,1148,662,69,3,486,213,204,417,66
2022-10-05,GM,Morocco,1112,623,68,5,489,205,216,421,63
2022-10-06,GM,Morocco,1211,675,61,4,536,243,232,475,57
2022-10-07,GM,Morocco,1184,626,80,3,558,238,240,478,77
2022-10-08,GM,Morocco,1389,845,51,1,544,244,249,493,50
2022-10-09,GM,Morocco,1274,711,69,1,563,252,242,494,68
2022-10-10,GM,Morocco,1132,626,59,0,506,218,229,447,59
2022-10-11,GM,Morocco,1119,633,60,5,486,215,211,426,55
2022-10-12,GM,Morocco,1165,638,71,2,527,227,229,456,69
2022-10-13,GM,Morocco,1201,665,79,4,536,226,231,457,75
2022-10-14,GM,Morocco,1183,642,69,2,541,237,235,472,67
2022-10-15,GM,Morocco,1480,923,57,0,557,252,248,500,57
2022-10-16,GM,Morocco,1323,769,59,0,554,252,243,495,59
2022-10-17,GM,Morocco,1202,674,65,2,528,225,238,463,63
2022-10-18,GM,Morocco,1195,687,65,5,508,227,216,443,60
2022-10-19,GM,Morocco,1165,618,70,6,547,239,238,477,64
2022-10-20,GM,Morocco,1226,677,82,11,549,237,230,467,71
2022-10-21,GM,Morocco,1242,666,92,4,576,241,243,484,88
2022-10-22,GM,Morocco,1541,966,58,1,575,259,258,517,57
2022-10-23,GM,Morocco,1335,760,68,0,575,254,253,507,68
2022-10-24,GM,Morocco,1185,662,64,4,523,223,236,459,60
2022-10-25,GM,Morocco,1202,679,65,3,523,231,227,458,62
2022-10-26,GM,Morocco,1192,658,65,4,534,232,237,469,61
2022-10-27,GM,Morocco,1265,727,63,2,538,237,238,475,61
2022-10-28,GM,Morocco,1317,748,77,4,569,243,249,492,73
2022-10-29,GM,Morocco,1607,1002,67,1,605,272,266,538,66
2022-10-30,GM,Morocco,1494,927,71,2,567,250,246,496,69
2022-10-31,GM,Morocco,1311,745,65,6,566,250,251,501,59
2022-11-01,GM,Morocco,1291,773,70,4,518,225,223,448,66
2022-11-02,GM,Morocco,1171,701,63,3,470,208,199,407,60
2022-11-03,GM,Morocco,1275,767,69,3,508,218,221,439,66
2022-11-04,GM,Morocco,1422,820,79,2,602,261,262,523,77
2022-11-05,GM,Morocco,1679,1096,63,0,583,262,258,520,63
2022-11-06,GM,Morocco,1484,924,66,0,560,249,245,494,66
2022-11-07,GM,Morocco,1286,734,58,1,552,246,248,494,57
2022-11-08,GM,Morocco,1176,710,65,4,466,198,203,401,61
2022-11-09,GM,Morocco,1107,667,71,2,440,186,183,369,69
2022-11-10,GM,Morocco,1206,709,70,2,497,211,216,427,68
2022-11-11,GM,Morocco,1396,802,75,2,594,261,258,519,73
2022-11-12,GM,Morocco,1594,1047,53,1,547,251,243,494,52
2022-11-13,GM,Morocco,1411,863,63,0,548,247,238,485,63
2022-11-14,GM,Morocco,1270,740,58,0,530,234,238,472,58
2022-11-15,GM,Morocco,1125,683,71,2,442,183,188,371,69
2022-11-16,GM,Morocco,1065,644,70,3,421,182,169,351,67
2022-11-17,GM,Morocco,1208,717,67,0,491,207,217,424,67
2022-11-18,GM,Morocco,1369,794,70,0,575,252,253,505,70
2022-11-19,GM,Morocco,1550,1036,47,0,514,236,231,467,47
2022-11-20,GM,Morocco,1382,852,60,0,530,236,234,470,60
2022-11-21,GM,Morocco,1263,735,71,1,528,226,231,457,70
2022-11-22,GM,Morocco,1085,652,63,2,433,187,183,370,61
2022-11-23,GM,Morocco,1051,629,72,0,422,176,174,350,72
2022-11-24,GM,Morocco,1147,704,54,2,443,193,196,389,52
2022-11-25,GM,Morocco,1289,751,64,3,538,238,236,474,61
2022-11-26,GM,Morocco,1521,999,51,1,522,240,231,471,50
2022-11-27,GM,Morocco,1382,858,61,1,524,233,230,463,60
2022-11-28,GM,Morocco,1178,670,63,3,508,218,227,445,60
2022-11-29,GM,Morocco,1068,647,76,4,421,174,171,345,72
2022-11-30,GM,Morocco,1060,660,60,4,400,172,168,340,56
2022-12-01,GM,Morocco,1141,700,57,0,441,189,195,384,57
2022-12-02,GM,Morocco,1353,777,70,3,576,257,249,506,67
2022-12-03,GM,Morocco,1571,1058,49,0,513,232,232,464,49
2022-12-04,GM,Morocco,1371,833,59,0,538,241,238,479,59
2022-12-05,GM,Morocco,1214,712,49,1,502,227,226,453,48
2022-12-06,GM,Morocco,1146,733,54,2,413,178,181,359,52
2022-12-07,GM,Morocco,1080,651,61,1,429,176,192,368,60
2022-12-08,GM,Morocco,1193,713,67,1,480,212,201,413,66
2022-12-09,GM,Morocco,1328,739,76,2,589,259,254,513,74
2022-12-10,GM,Morocco,1570,1011,64,0,559,248,247,495,64
2022-12-11,GM,Morocco,1412,830,74,0,582,250,258,508,74
2022-12-12,GM,Morocco,1258,689,69,3,569,250,250,500,66
2022-12-13,GM,Morocco,1254,709,82,2,545,232,231,463,80
2022-12-14,GM,Morocco,1089,617,64,3,472,209,199,408,61
2022-12-15,GM,Morocco,1277,735,55,0,542,237,250,487,55
2022-12-16,GM,Morocco,1443,822,79,2,621,277,265,542,77
2022-12-17,GM,Morocco,1617,1010,57,0,607,275,275,550,57
2022-12-18,GM,Morocco,1469,868,71,1,601,261,269,530,70
2022-12-19,GM,Morocco,1421,794,74,6,627,278,275,553,68
2022-12-20,GM,Morocco,1367,815,64,5,552,240,248,488,59
2022-12-21,GM,Morocco,1310,753,73,2,557,247,237,484,71
2022-12-22,GM,Morocco,1484,886,72,3,598,263,263,526,69
2022-12-23,GM,Morocco,1500,855,72,3,645,290,283,573,69
2022-12-24,GM,Morocco,1570,1021,60,1,549,243,246,489,59
2022-12-25,GM,Morocco,1114,672,69,2,442,189,184,373,67
2022-12-26,GM,Morocco,1387,776,79,0,611,260,272,532,79
2022-12-27,GM,Morocco,1434,857,75,2,577,256,246,502,73
2022-01-01,EH,Netherlands,2043,1080,3,1,963,497,463,960,2
2022-01-02,EH,Netherlands,2735,1454,7,1,1281,630,644,1274,6
2022-01-03,EH,Netherlands,2700,1387,58,13,1313,634,621,1255,45
2022-01-04,EH,Netherlands,2426,1232,52,13,1194,574,568,1142,39
2022-01-05,EH,Netherlands,2481,1292,47,14,1189,569,573,1142,33
2022-01-06,EH,Netherlands,2394,1181,59,15,1213,578,576,1154,44
2022-01-07,EH,Netherlands,2653,1335,51,16,1318,632,635,1267,35
2022-01-08,EH,Netherlands,2471,1313,20,2,1158,569,569,1138,18
2022-01-09,EH,Netherlands,2636,1372,17,0,1264,619,628,1247,17
2022-01-10,EH,Netherlands,2166,1052,71,12,1114,526,517,1043,59
2022-01-11,EH,Netherlands,1875,842,68,15,1033,484,481,965,53
2022-01-12,EH,Netherlands,1826,897,29,3,929,451,449,900,26
2022-01-13,EH,Netherlands,1877,902,54,7,975,470,451,921,47
2022-01-14,EH,Netherlands,2150,1048,59,15,1102,512,531,1043,44
2022-01-15,EH,Netherlands,1918,995,16,8,923,452,455,907,8
2022-01-16,EH,Netherlands,2160,1067,26,5,1093,529,538,1067,21
2022-01-17,EH,Netherlands,1934,873,74,26,1061,496,491,987,48
2022-01-18,EH,Netherlands,1618,796,36,13,822,396,390,786,23
2022-01-19,EH,Netherlands,1782,835,64,20,947,441,442,883,44
2022-01-20,EH,Netherlands,1890,866,57,20,1024,491,476,967,37
2022-01-21,EH,Netherlands,2138,1022,61,17,1116,524,531,1055,44
2022-01-22,EH,Netherlands,1868,953,15,1,915,450,450,900,14
2022-01-23,EH,Netherlands,2143,1058,22,5,1085,530,533,1063,17
2022-01-24,EH,Netherlands,1917,884,41,8,1033,499,493,992,33
2022-01-25,EH,Netherlands,1619,779,60,20,840,384,396,780,40
2022-01-26,EH,Netherlands,1749,857,46,19,892,425,421,846,27
2022-01-27,EH,Netherlands,1849,844,71,14,1005,475,459,934,57
2022-01-28,EH,Netherlands,2094,978,49,10,1116,533,534,1067,39
2022-01-29,EH,Netherlands,1842,910,10,2,932,455,467,922,8
2022-01-30,EH,Netherlands,2099,980,15,0,1119,547,557,1104,15
2022-01-31,EH,Netherlands,1705,889,27,8,816,401,388,789,19
2022-02-01,EH,Netherlands,1834,894,50,11,940,450,440,890,39
2022-02-02,EH,Netherlands,1926,934,64,21,992,462,466,928,43
2022-02-03,EH,Netherlands,2004,957,62,16,1047,497,488,985,46
2022-02-04,EH,Netherlands,2269,1111,26,3,1158,563,569,1132,23
2022-02-05,EH,Netherlands,2147,1121,33,9,1026,495,498,993,24
2022-02-06,EH,Netherlands,2265,1154,9,5,1111,548,554,1102,4
2022-02-07,EH,Netherlands,2169,1056,50,11,1113,527,536,1063,39
2022-02-08,EH,Netherlands,1882,929,65,14,953,443,445,888,51
2022-02-09,EH,Netherlands,1982,990,60,14,992,465,467,932,46
2022-02-10,EH,Netherlands,2212,1075,77,16,1137,541,519,1060,61
2022-02-11,EH,Netherlands,2547,1273,57,19,1274,600,617,1217,38
2022-02-12,EH,Netherlands,2322,1237,47,16,1085,525,513,1038,31
2022-02-13,EH,Netherlands,2412,1231,22,5,1181,574,585,1159,17
2022-02-14,EH,Netherlands,2263,1130,43,12,1133,545,545,1090,31
2022-02-15,EH,Netherlands,1982,987,52,11,995,470,473,943,41
2022-02-16,EH,Netherlands,2069,1053,61,15,1016,473,482,955,46
2022-02-17,EH,Netherlands,2148,1009,43,3,1139,556,540,1096,40
2022-02-18,EH,Netherlands,2000,1156,15,2,844,407,422,829,13
2022-02-19,EH,Netherlands,2503,1305,18,5,1198,591,589,1180,13
2022-02-20,EH,Netherlands,2379,1304,10,2,1075,524,541,1065,8
2022-02-21,EH,Netherlands,2101,1119,28,1,982,483,471,954,27
2022-02-22,EH,Netherlands,2079,1033,58,15,1046,492,496,988,43
2022-02-23,EH,Netherlands,2204,1056,74,20,1148,541,533,1074,54
2022-02-24,EH,Netherlands,2359,1107,68,10,1252,592,592,1184,58
2022-02-25,EH,Netherlands,2689,1312,61,20,1377,656,660,1316,41
2022-02-26,EH,Netherlands,2434,1209,37,10,1225,588,600,1188,27
2022-02-27,EH,Netherlands,2641,1357,34,6,1284,618,632,1250,28
2022-02-28,EH,Netherlands,2474,1205,65,17,1269,606,598,1204,48
2022-03-01,EH,Netherlands,2219,1093,71,26,1126,531,524,1055,45
2022-03-02,EH,Netherlands,2367,1213,68,28,1154,542,544,1086,40
2022-03-03,EH,Netherlands,2419,1194,65,20,1225,584,576,1160,45
2022-03-04,EH,Netherlands,2755,1428,68,25,1327,625,634,1259,43
2022-03-05,EH,Netherlands,2409,1235,26,8,1174,568,580,1148,18
2022-03-06,EH,Netherlands,2673,1416,21,3,1257,614,622,1236,18
2022-03-07,EH,Netherlands,2544,1260,64,22,1284,615,605,1220,42
2022-03-08,EH,Netherlands,2243,1112,61,17,1131,530,540,1070,44
2022-03-09,EH,Netherlands,2346,1193,57,15,1153,551,545,1096,42
2022-03-10,EH,Netherlands,2497,1194,69,19,1303,629,605,1234,50
2022-03-11,EH,Netherlands,2764,1391,63,21,1373,655,655,1310,42
2022-03-12,EH,Netherlands,2380,1230,33,9,1150,552,565,1117,24
2022-03-13,EH,Netherlands,2649,1369,21,3,1280,623,636,1259,18
2022-03-14,EH,Netherlands,2581,1280,55,14,1301,625,621,1246,41
2022-03-15,EH,Netherlands,2289,1104,84,23,1185,547,554,1101,61
2022-03-16,EH,Netherlands,2421,1214,69,16,1207,568,570,1138,53
2022-03-17,EH,Netherlands,2444,1156,70,13,1288,621,597,1218,57
2022-03-18,EH,Netherlands,2886,1495,56,13,1391,676,659,1335,43
2022-03-19,EH,Netherlands,2454,1280,35,9,1174,566,573,1139,26
2022-03-20,EH,Netherlands,2716,1426,18,1,1290,626,646,1272,17
2022-03-21,EH,Netherlands,2674,1325,75,25,1349,634,640,1274,50
2022-03-22,EH,Netherlands,2341,1136,75,20,1205,564,566,1130,55
2022-03-23,EH,Netherlands,2540,1273,74,15,1267,590,603,1193,59
2022-03-24,EH,Netherlands,2563,1229,78,17,1334,643,613,1256,61
2022-03-25,EH,Netherlands,2892,1467,68,12,1425,674,683,1357,56
2022-03-26,EH,Netherlands,2442,1269,36,9,1173,565,572,1137,27
2022-03-27,EH,Netherlands,2866,1503,22,6,1363,667,674,1341,16
2022-03-28,EH,Netherlands,2983,1516,45,13,1467,710,712,1422,32
2022-03-29,EH,Netherlands,2824,1493,60,13,1331,634,637,1271,47
2022-03-30,EH,Netherlands,2892,1545,64,15,1347,640,643,1283,49
2022-03-31,EH,Netherlands,2855,1484,32,5,1371,671,668,1339,27
2022-04-01,EH,Netherlands,2999,1554,52,4,1445,701,692,1393,48
2022-04-02,EH,Netherlands,2770,1525,24,6,1245,618,603,1221,18
2022-04-03,EH,Netherlands,3009,1591,16,1,1418,696,706,1402,15
2022-04-04,EH,Netherlands,2985,1563,47,3,1422,685,690,1375,44
2022-04-05,EH,Netherlands,2833,1489,63,11,1344,641,640,1281,52
2022-04-06,EH,Netherlands,3026,1611,54,7,1415,692,669,1361,47
2022-04-07,EH,Netherlands,2956,1548,52,6,1408,676,680,1356,46
2022-04-08,EH,Netherlands,3210,1694,52,11,1516,743,721,1464,41
2022-04-09,EH,Netherlands,2787,1529,15,5,1258,616,627,1243,10
2022-04-10,EH,Netherlands,3088,1684,17,2,1404,689,698,1387,15
2022-04-11,EH,Netherlands,3075,1622,74,18,1453,698,681,1379,56
2022-04-12,EH,Netherlands,2983,1575,76,15,1408,656,676,1332,61
2022-04-13,EH,Netherlands,3092,1641,66,13,1451,695,690,1385,53
2022-04-14,EH,Netherlands,3155,1618,70,10,1537,733,734,1467,60
2022-04-15,EH,Netherlands,3110,1598,53,12,1512,733,726,1459,41
2022-04-16,EH,Netherlands,2775,1471,44,14,1304,632,628,1260,30
2022-04-17,EH,Netherlands,2973,1595,24,8,1378,676,678,1354,16
2022-04-18,EH,Netherlands,3086,1626,46,7,1460,699,715,1414,39
2022-04-19,EH,Netherlands,3020,1606,78,13,1414,665,671,1336,65
2022-04-20,EH,Netherlands,3040,1595,61,11,1445,696,688,1384,50
2022-04-21,EH,Netherlands,3120,1549,66,9,1571,750,755,1505,57
2022-04-22,EH,Netherlands,3197,1615,58,7,1582,769,755,1524,51
2022-04-23,EH,Netherlands,2793,1527,28,1,1266,617,621,1238,27
2022-04-24,EH,Netherlands,3182,1714,24,1,1468,719,725,1444,23
2022-04-25,EH,Netherlands,3227,1626,65,7,1601,775,761,1536,58
2022-04-26,EH,Netherlands,3109,1570,71,10,1539,725,743,1468,61
2022-04-27,EH,Netherlands,3226,1707,42,3,1519,747,730,1477,39
2022-04-28,EH,Netherlands,3312,1638,60,11,1674,805,809,1614,49
2022-04-29,EH,Netherlands,3350,1666,50,5,1684,815,819,1634,45
2022-04-30,EH,Netherlands,2956,1501,27,3,1455,708,720,1428,24
2022-05-01,EH,Netherlands,3241,1678,21,3,1563,770,772,1542,18
2022-05-02,EH,Netherlands,3392,1732,53,7,1660,805,802,1607,46
2022-05-03,EH,Netherlands,3320,1726,61,9,1594,768,765,1533,52
2022-05-04,EH,Netherlands,3396,1774,66,7,1622,786,770,1556,59
2022-05-05,EH,Netherlands,3440,1806,62,9,1634,785,787,1572,53
2022-05-06,EH,Netherlands,3445,1769,50,9,1676,812,814,1626,41
2022-05-07,EH,Netherlands,3135,1607,27,6,1528,748,753,1501,21
2022-05-08,EH,Netherlands,3335,1712,17,5,1623,792,814,1606,12
2022-05-09,EH,Netherlands,3397,1726,63,16,1671,806,802,1608,47
2022-05-10,EH,Netherlands,3212,1621,71,16,1591,756,764,1520,55
2022-05-11,EH,Netherlands,3373,1758,60,15,1615,785,770,1555,45
2022-05-12,EH,Netherlands,3339,1695,61,14,1644,798,785,1583,47
2022-05-13,EH,Netherlands,3471,1743,67,16,1728,832,829,1661,51
2022-05-14,EH,Netherlands,3150,1691,23,6,1459,725,711,1436,17
2022-05-15,EH,Netherlands,3329,1712,21,4,1617,784,812,1596,17
2022-05-16,EH,Netherlands,3409,1745,50,9,1664,804,810,1614,41
2022-05-17,EH,Netherlands,3278,1674,64,17,1604,766,774,1540,47
2022-05-18,EH,Netherlands,3382,1758,61,11,1624,793,770,1563,50
2022-05-19,EH,Netherlands,3390,1749,49,6,1641,800,792,1592,43
2022-05-20,EH,Netherlands,3399,1761,49,10,1638,796,793,1589,39
2022-05-21,EH,Netherlands,3060,1596,24,3,1464,719,721,1440,21
2022-05-22,EH,Netherlands,3335,1767,21,5,1568,770,777,1547,16
2022-05-23,EH,Netherlands,3318,1738,55,14,1580,762,763,1525,41
2022-05-24,EH,Netherlands,3289,1674,67,18,1615,771,777,1548,49
2022-05-25,EH,Netherlands,3532,1831,62,18,1701,827,812,1639,44
2022-05-26,EH,Netherlands,3429,1754,61,7,1675,807,807,1614,54
2022-05-27,EH,Netherlands,3499,1828,63,14,1671,808,800,1608,49
2022-05-28,EH,Netherlands,3133,1702,20,6,1431,703,708,1411,14
2022-05-29,EH,Netherlands,3430,1828,24,4,1602,774,804,1578,20
2022-05-30,EH,Netherlands,3541,1847,58,16,1694,819,817,1636,42
2022-05-31,EH,Netherlands,3371,1748,62,18,1623,779,782,1561,44
2022-06-01,EH,Netherlands,3555,1928,54,15,1627,797,776,1573,39
2022-06-02,EH,Netherlands,3512,1812,63,12,1700,823,814,1637,51
2022-06-03,EH,Netherlands,3571,1888,48,20,1683,819,816,1635,28
2022-06-04,EH,Netherlands,3124,1775,30,10,1349,654,665,1319,20
2022-06-05,EH,Netherlands,3372,1884,12,2,1488,736,740,1476,10
2022-06-06,EH,Netherlands,3493,1825,36,1,1668,805,827,1632,35
2022-06-07,EH,Netherlands,3442,1823,64,16,1619,772,783,1555,48
2022-06-08,EH,Netherlands,3612,1957,61,19,1655,802,792,1594,42
2022-06-09,EH,Netherlands,3543,1809,85,24,1734,828,821,1649,61
2022-06-10,EH,Netherlands,3574,1891,54,16,1683,813,816,1629,38
2022-06-11,EH,Netherlands,3146,1694,25,6,1452,714,713,1427,19
2022-06-12,EH,Netherlands,3451,1888,21,6,1563,764,778,1542,15
2022-06-13,EH,Netherlands,3539,1830,51,18,1709,832,826,1658,33
2022-06-14,EH,Netherlands,3475,1796,68,16,1679,812,799,1611,52
2022-06-15,EH,Netherlands,3677,2001,73,21,1676,803,800,1603,52
2022-06-16,EH,Netherlands,3575,1848,68,19,1727,830,829,1659,49
2022-06-17,EH,Netherlands,3535,1822,49,14,1713,833,831,1664,35
2022-06-18,EH,Netherlands,3139,1673,26,8,1466,723,717,1440,18
2022-06-19,EH,Netherlands,3450,1864,11,2,1586,781,794,1575,9
2022-06-20,EH,Netherlands,3553,1789,57,10,1764,852,855,1707,47
2022-06-21,EH,Netherlands,3522,1867,59,18,1655,802,794,1596,41
2022-06-22,EH,Netherlands,3583,1927,69,19,1656,796,791,1587,50
2022-06-23,EH,Netherlands,3643,1905,58,8,1738,837,843,1680,50
2022-06-24,EH,Netherlands,3619,1918,47,11,1701,823,831,1654,36
2022-06-25,EH,Netherlands,3235,1768,28,4,1467,729,710,1439,24
2022-06-26,EH,Netherlands,3492,1884,20,2,1608,792,796,1588,18
2022-06-27,EH,Netherlands,3467,1792,56,9,1675,809,810,1619,47
2022-06-28,EH,Netherlands,3556,1874,92,23,1682,798,792,1590,69
2022-06-29,EH,Netherlands,3579,1936,70,21,1643,792,781,1573,49
2022-06-30,EH,Netherlands,3449,1811,77,23,1638,775,786,1561,54
2022-07-01,EH,Netherlands,3580,1933,67,14,1647,777,803,1580,53
2022-07-02,EH,Netherlands,3173,1710,36,11,1463,719,708,1427,25
2022-07-03,EH,Netherlands,3392,1854,17,1,1538,758,763,1521,16
2022-07-04,EH,Netherlands,3510,1828,62,14,1682,815,805,1620,48
2022-07-05,EH,Netherlands,3429,1783,73,16,1646,786,787,1573,57
2022-07-06,EH,Netherlands,3663,2000,75,21,1663,794,794,1588,54
2022-07-07,EH,Netherlands,3638,1957,72,15,1681,806,803,1609,57
2022-07-08,EH,Netherlands,3576,1908,68,17,1668,802,798,1600,51
2022-07-09,EH,Netherlands,3238,1782,23,5,1456,725,708,1433,18
2022-07-10,EH,Netherlands,3385,1843,17,1,1542,762,763,1525,16
2022-07-11,EH,Netherlands,3503,1864,54,15,1639,792,793,1585,39
2022-07-12,EH,Netherlands,3387,1831,57,14,1556,750,749,1499,43
2022-07-13,EH,Netherlands,3487,1937,58,16,1550,744,748,1492,42
2022-07-14,EH,Netherlands,3418,1790,60,10,1628,781,787,1568,50
2022-07-15,EH,Netherlands,3485,1852,71,22,1633,777,785,1562,49
2022-07-16,EH,Netherlands,3209,1760,24,6,1449,715,710,1425,18
2022-07-17,EH,Netherlands,3301,1834,26,5,1467,720,721,1441,21
2022-07-18,EH,Netherlands,3437,1820,53,12,1617,787,777,1564,41
2022-07-19,EH,Netherlands,3432,1867,55,5,1565,750,760,1510,50
2022-07-20,EH,Netherlands,3474,1917,53,8,1557,752,752,1504,45
2022-07-21,EH,Netherlands,3432,1830,41,4,1602,786,775,1561,37
2022-07-22,EH,Netherlands,3519,1888,61,11,1631,780,790,1570,50
2022-07-23,EH,Netherlands,3205,1742,24,8,1463,727,712,1439,16
2022-07-24,EH,Netherlands,3286,1762,17,3,1524,748,759,1507,14
2022-07-25,EH,Netherlands,3403,1821,42,3,1582,777,763,1540,39
2022-07-26,EH,Netherlands,3417,1849,63,11,1568,739,766,1505,52
2022-07-27,EH,Netherlands,3322,1790,47,8,1532,747,738,1485,39
2022-07-28,EH,Netherlands,3412,1814,56,6,1598,775,767,1542,50
2022-07-29,EH,Netherlands,3383,1832,41,7,1551,752,758,1510,34
2022-07-30,EH,Netherlands,3147,1677,15,4,1470,731,724,1455,11
2022-07-31,EH,Netherlands,3297,1794,9,0,1503,743,751,1494,9
2022-08-01,EH,Netherlands,3375,1715,49,4,1660,812,799,1611,45
2022-08-02,EH,Netherlands,3399,1802,74,5,1597,756,767,1523,69
2022-08-03,EH,Netherlands,3475,1874,70,20,1601,768,763,1531,50
2022-08-04,EH,Netherlands,3397,1771,63,9,1626,781,782,1563,54
2022-08-05,EH,Netherlands,3406,1779,50,9,1627,783,794,1577,41
2022-08-06,EH,Netherlands,3195,1732,16,1,1463,727,720,1447,15
2022-08-07,EH,Netherlands,3325,1814,14,6,1511,748,749,1497,8
2022-08-08,EH,Netherlands,3384,1786,32,6,1598,787,779,1566,26
2022-08-09,EH,Netherlands,3377,1807,57,9,1570,759,754,1513,48
2022-08-10,EH,Netherlands,3487,1890,46,9,1597,773,778,1551,37
2022-08-11,EH,Netherlands,3458,1835,65,5,1623,771,787,1558,60
2022-08-12,EH,Netherlands,3403,1815,45,2,1588,776,767,1543,43
2022-08-13,EH,Netherlands,3181,1692,20,4,1489,732,737,1469,16
2022-08-14,EH,Netherlands,3326,1805,11,3,1521,754,756,1510,8
2022-08-15,EH,Netherlands,3411,1801,39,8,1610,790,781,1571,31
2022-08-16,EH,Netherlands,3374,1791,62,13,1583,760,761,1521,49
2022-08-17,EH,Netherlands,3376,1783,44,7,1593,768,781,1549,37
2022-08-18,EH,Netherlands,3514,1860,65,8,1654,803,786,1589,57
2022-08-19,EH,Netherlands,3471,1821,68,11,1650,792,790,1582,57
2022-08-20,EH,Netherlands,3118,1620,20,5,1498,736,742,1478,15
2022-08-21,EH,Netherlands,3332,1803,11,2,1529,753,765,1518,9
2022-08-22,EH,Netherlands,3479,1821,51,12,1658,802,805,1607,39
2022-08-23,EH,Netherlands,3348,1739,60,13,1609,777,772,1549,47
2022-08-24,EH,Netherlands,3560,1931,46,4,1629,796,787,1583,42
2022-08-25,EH,Netherlands,3472,1797,61,14,1675,802,812,1614,47
2022-08-26,EH,Netherlands,3499,1833,58,15,1666,805,803,1608,43
2022-08-27,EH,Netherlands,3258,1794,13,7,1464,721,730,1451,6
2022-08-28,EH,Netherlands,3317,1791,8,1,1526,761,757,1518,7
2022-08-29,EH,Netherlands,3443,1740,57,16,1703,826,820,1646,41
2022-08-30,EH,Netherlands,3411,1796,68,19,1615,773,774,1547,49
2022-08-31,EH,Netherlands,3576,1901,68,27,1675,804,803,1607,41
2022-09-01,EH,Netherlands,3529,1805,54,15,1724,830,840,1670,39
2022-09-02,EH,Netherlands,3444,1770,52,18,1674,811,811,1622,34
2022-09-03,EH,Netherlands,3305,1800,18,7,1505,741,746,1487,11
2022-09-04,EH,Netherlands,3503,1875,14,3,1628,802,812,1614,11
2022-09-05,EH,Netherlands,3642,1905,58,16,1737,846,833,1679,42
2022-09-06,EH,Netherlands,3491,1875,68,20,1616,773,775,1548,48
2022-09-07,EH,Netherlands,3638,1930,63,22,1708,828,817,1645,41
2022-09-08,EH,Netherlands,3533,1861,80,23,1672,794,798,1592,57
2022-09-09,EH,Netherlands,3488,1843,65,17,1645,798,782,1580,48
2022-09-10,EH,Netherlands,3237,1725,34,4,1512,736,742,1478,30
2022-09-11,EH,Netherlands,3471,1891,18,1,1580,774,788,1562,17
2022-09-12,EH,Netherlands,3539,1870,55,16,1669,802,812,1614,39
2022-09-13,EH,Netherlands,3423,1814,68,15,1609,769,772,1541,53
2022-09-14,EH,Netherlands,3632,1965,66,12,1667,803,798,1601,54
2022-09-15,EH,Netherlands,3544,1831,77,11,1713,819,817,1636,66
2022-09-16,EH,Netherlands,3520,1915,51,7,1605,778,776,1554,44
2022-09-17,EH,Netherlands,3241,1786,17,0,1455,726,712,1438,17
2022-09-18,EH,Netherlands,3412,1831,19,0,1581,770,792,1562,19
2022-09-19,EH,Netherlands,3336,1745,54,9,1591,762,775,1537,45
2022-09-20,EH,Netherlands,3435,1802,73,7,1633,778,782,1560,66
2022-09-21,EH,Netherlands,3611,1948,64,16,1663,806,793,1599,48
2022-09-22,EH,Netherlands,3552,1871,73,18,1681,809,799,1608,55
2022-09-23,EH,Netherlands,3549,1890,60,16,1659,802,797,1599,44
2022-09-24,EH,Netherlands,3196,1773,32,4,1423,699,692,1391,28
2022-09-25,EH,Netherlands,3418,1846,27,3,1572,760,785,1545,24
2022-09-26,EH,Netherlands,3470,1854,65,17,1616,782,769,1551,48
2022-09-27,EH,Netherlands,3350,1756,87,21,1594,749,758,1507,66
2022-09-28,EH,Netherlands,3502,1850,71,16,1652,796,785,1581,55
2022-09-29,EH,Netherlands,3531,1908,73,15,1623,773,777,1550,58
2022-09-30,EH,Netherlands,3579,1890,80,17,1689,811,798,1609,63
2022-10-01,EH,Netherlands,3102,1634,35,8,1468,720,713,1433,27
2022-10-02,EH,Netherlands,3376,1783,34,2,1593,769,790,1559,32
2022-10-03,EH,Netherlands,3413,1787,71,17,1626,780,775,1555,54
2022-10-04,EH,Netherlands,3386,1782,81,16,1604,756,767,1523,65
2022-10-05,EH,Netherlands,3388,1820,76,22,1568,749,743,1492,54
2022-10-06,EH,Netherlands,3326,1707,113,28,1619,757,749,1506,85
2022-10-07,EH,Netherlands,3423,1761,75,19,1662,794,793,1587,56
2022-10-08,EH,Netherlands,3121,1654,33,5,1467,720,714,1434,28
2022-10-09,EH,Netherlands,3391,1819,30,3,1572,761,781,1542,27
2022-10-10,EH,Netherlands,3340,1742,73,22,1598,765,760,1525,51
2022-10-11,EH,Netherlands,3314,1787,85,22,1527,721,721,1442,63
2022-10-12,EH,Netherlands,3457,1869,77,22,1588,756,755,1511,55
2022-10-13,EH,Netherlands,3287,1712,60,13,1575,756,759,1515,47
2022-10-14,EH,Netherlands,3341,1733,39,10,1608,785,784,1569,29
2022-10-15,EH,Netherlands,3089,1603,24,9,1486,734,728,1462,15
2022-10-16,EH,Netherlands,3228,1701,19,0,1527,751,757,1508,19
2022-10-17,EH,Netherlands,3195,1642,47,9,1553,750,756,1506,38
2022-10-18,EH,Netherlands,3202,1697,71,15,1505,706,728,1434,56
2022-10-19,EH,Netherlands,3322,1770,66,16,1552,749,737,1486,50
2022-10-20,EH,Netherlands,3330,1769,68,20,1561,744,749,1493,48
2022-10-21,EH,Netherlands,3370,1816,52,15,1554,755,747,1502,37
2022-10-22,EH,Netherlands,3186,1751,25,5,1435,711,699,1410,20
2022-10-23,EH,Netherlands,3213,1725,19,4,1488,722,747,1469,15
2022-10-24,EH,Netherlands,3229,1697,46,10,1532,750,736,1486,36
2022-10-25,EH,Netherlands,3156,1697,69,18,1459,693,697,1390,51
2022-10-26,EH,Netherlands,3339,1833,54,11,1506,726,726,1452,43
2022-10-27,EH,Netherlands,3371,1793,67,11,1578,760,751,1511,56
2022-10-28,EH,Netherlands,3439,1855,45,15,1584,774,765,1539,30
2022-10-29,EH,Netherlands,3162,1715,24,9,1447,706,717,1423,15
2022-10-30,EH,Netherlands,3205,1753,14,4,1452,716,722,1438,10
2022-10-31,EH,Netherlands,3164,1678,58,9,1486,718,710,1428,49
2022-11-01,EH,Netherlands,2788,1518,45,6,1270,612,613,1225,39
2022-11-02,EH,Netherlands,2846,1484,63,10,1362,649,650,1299,53
2022-11-03,EH,Netherlands,2941,1568,62,17,1373,666,645,1311,45
2022-11-04,EH,Netherlands,3072,1670,46,12,1402,679,677,1356,34
2022-11-05,EH,Netherlands,2685,1529,16,1,1156,571,569,1140,15
2022-11-06,EH,Netherlands,2979,1649,16,2,1330,655,659,1314,14
2022-11-07,EH,Netherlands,2940,1537,49,7,1403,672,682,1354,42
2022-11-08,EH,Netherlands,2643,1373,63,8,1270,604,603,1207,55
2022-11-09,EH,Netherlands,2702,1405,54,7,1297,623,620,1243,47
2022-11-10,EH,Netherlands,2920,1510,83,12,1410,666,661,1327,71
2022-11-11,EH,Netherlands,3023,1613,66,13,1410,674,670,1344,53
2022-11-12,EH,Netherlands,2556,1418,27,5,1138,555,556,1111,22
2022-11-13,EH,Netherlands,2980,1634,27,5,1346,658,661,1319,22
2022-11-14,EH,Netherlands,2844,1495,52,7,1349,649,648,1297,45
2022-11-15,EH,Netherlands,2641,1387,81,15,1254,585,588,1173,66
2022-11-16,EH,Netherlands,2707,1423,69,10,1284,607,608,1215,59
2022-11-17,EH,Netherlands,2779,1444,50,6,1335,651,634,1285,44
2022-11-18,EH,Netherlands,2959,1606,59,9,1353,647,647,1294,50
2022-11-19,EH,Netherlands,2497,1395,27,5,1102,535,540,1075,22
2022-11-20,EH,Netherlands,2851,1583,8,0,1268,631,629,1260,8
2022-11-21,EH,Netherlands,2840,1522,48,3,1318,630,640,1270,45
2022-11-22,EH,Netherlands,2546,1343,63,10,1203,572,568,1140,53
2022-11-23,EH,Netherlands,2681,1393,68,14,1288,599,621,1220,54
2022-11-24,EH,Netherlands,2830,1464,74,9,1366,657,635,1292,65
2022-11-25,EH,Netherlands,3022,1658,61,11,1364,653,650,1303,50
2022-11-26,EH,Netherlands,2489,1392,34,3,1097,536,527,1063,31
2022-11-27,EH,Netherlands,2871,1575,16,1,1296,637,643,1280,15
2022-11-28,EH,Netherlands,2826,1502,47,7,1324,635,642,1277,40
2022-11-29,EH,Netherlands,2539,1410,45,4,1129,543,541,1084,41
2022-11-30,EH,Netherlands,2724,1483,63,17,1241,585,593,1178,46
2022-12-01,EH,Netherlands,2821,1498,61,9,1323,637,625,1262,52
2022-12-02,EH,Netherlands,2998,1676,47,13,1322,639,636,1275,34
2022-12-03,EH,Netherlands,2450,1384,12,5,1066,522,532,1054,7
2022-12-04,EH,Netherlands,2877,1629,7,1,1248,615,626,1241,6
2022-12-05,EH,Netherlands,2876,1577,41,7,1299,629,629,1258,34
2022-12-06,EH,Netherlands,2675,1445,69,11,1230,587,574,1161,58
2022-12-07,EH,Netherlands,2741,1471,67,11,1270,600,603,1203,56
2022-12-08,EH,Netherlands,2846,1518,45,7,1328,637,646,1283,38
2022-12-09,EH,Netherlands,2911,1645,35,6,1266,618,613,1231,29
2022-12-10,EH,Netherlands,2467,1414,4,0,1053,524,525,1049,4
2022-12-11,EH,Netherlands,2683,1458,16,0,1225,601,608,1209,16
2022-12-12,EH,Netherlands,2744,1449,61,11,1295,616,618,1234,50
2022-12-13,EH,Netherlands,2616,1396,49,11,1220,590,581,1171,38
2022-12-14,EH,Netherlands,2744,1473,58,10,1271,604,609,1213,48
2022-12-15,EH,Netherlands,2856,1519,66,19,1337,638,633,1271,47
2022-12-16,EH,Netherlands,3001,1695,62,16,1306,618,626,1244,46
2022-12-17,EH,Netherlands,2664,1518,24,6,1146,564,558,1122,18
2022-12-18,EH,Netherlands,2882,1617,29,8,1265,612,624,1236,21
2022-12-19,EH,Netherlands,2932,1589,46,7,1343,658,639,1297,39
2022-12-20,EH,Netherlands,2776,1557,45,8,1219,590,584,1174,37
2022-12-21,EH,Netherlands,2756,1475,56,20,1281,601,624,1225,36
2022-12-22,EH,Netherlands,2988,1626,48,10,1362,657,657,1314,38
2022-12-23,EH,Netherlands,3057,1717,30,7,1340,653,657,1310,23
2022-12-24,EH,Netherlands,2386,1289,19,5,1097,547,531,1078,14
2022-12-25,EH,Netherlands,1846,855,3,1,991,494,494,988,2
2022-12-26,EH,Netherlands,2655,1426,10,0,1229,613,606,1219,10
2022-12-27,EH,Netherlands,2669,1452,46,8,1217,589,582,1171,38
2022-01-01,LW,North Macedonia,378,339,0,0,39,19,20,39,0
2022-01-02,LW,North Macedonia,454,404,0,0,50,25,25,50,0
2022-01-03,LW,North Macedonia,411,363,0,0,48,24,24,48,0
2022-01-04,LW,North Macedonia,360,309,0,0,51,26,25,51,0
2022-01-05,LW,North Macedonia,383,337,0,0,46,23,23,46,0
2022-01-06,LW,North Macedonia,356,311,0,0,45,23,22,45,0
2022-01-07,LW,North Macedonia,388,342,0,0,46,23,23,46,0
2022-01-08,LW,North Macedonia,457,408,0,0,49,24,25,49,0
2022-01-09,LW,North Macedonia,422,376,0,0,46,23,23,46,0
2022-01-10,LW,North Macedonia,321,280,0,0,41,23,18,41,0
2022-01-11,LW,North Macedonia,285,243,0,0,42,20,22,42,0
2022-01-12,LW,North Macedonia,280,247,0,0,33,16,17,33,0
2022-01-13,LW,North Macedonia,249,220,0,0,29,15,14,29,0
2022-01-14,LW,North Macedonia,285,249,0,0,36,18,18,36,0
2022-01-15,LW,North Macedonia,292,260,0,0,32,16,16,32,0
2022-01-16,LW,North Macedonia,308,280,0,0,28,14,14,28,0
2022-01-17,LW,North Macedonia,280,240,0,0,40,21,19,40,0
2022-01-18,LW,North Macedonia,211,185,0,0,26,13,13,26,0
2022-01-19,LW,North Macedonia,222,199,0,0,23,11,12,23,0
2022-01-20,LW,North Macedonia,218,197,0,0,21,11,10,21,0
2022-01-21,LW,North Macedonia,260,229,0,0,31,15,16,31,0
2022-01-22,LW,North Macedonia,276,247,0,0,29,15,14,29,0
2022-01-23,LW,North Macedonia,289,260,0,0,29,14,15,29,0
2022-01-24,LW,North Macedonia,226,204,0,0,22,12,10,22,0
2022-01-25,LW,North Macedonia,181,165,0,0,16,7,9,16,0
2022-01-26,LW,North Macedonia,224,197,0,0,27,14,13,27,0
2022-01-27,LW,North Macedonia,228,204,0,0,24,12,12,24,0
2022-01-28,LW,North Macedonia,297,263,0,0,34,17,17,34,0
2022-01-29,LW,North Macedonia,298,272,0,0,26,13,13,26,0
2022-01-30,LW,North Macedonia,285,257,0,0,28,13,15,28,0
2022-01-31,LW,North Macedonia,253,225,0,0,28,15,13,28,0
2022-02-01,LW,North Macedonia,230,199,0,0,31,15,16,31,0
2022-02-02,LW,North Macedonia,217,194,0,0,23,11,12,23,0
2022-02-03,LW,North Macedonia,248,223,0,0,25,14,11,25,0
2022-02-04,LW,North Macedonia,317,283,0,0,34,17,17,34,0
2022-02-05,LW,North Macedonia,301,273,0,0,28,13,15,28,0
2022-02-06,LW,North Macedonia,316,285,0,0,31,15,16,31,0
2022-02-07,LW,North Macedonia,260,229,0,0,31,16,15,31,0
2022-02-08,LW,North Macedonia,255,229,0,0,26,13,13,26,0
2022-02-09,LW,North Macedonia,243,213,0,0,30,14,16,30,0
2022-02-10,LW,North Macedonia,247,216,0,0,31,17,14,31,0
2022-02-11,LW,North Macedonia,288,252,0,0,36,18,18,36,0
2022-02-12,LW,North Macedonia,302,276,0,0,26,12,14,26,0
2022-02-13,LW,North Macedonia,299,270,0,0,29,14,15,29,0
2022-02-14,LW,North Macedonia,255,222,0,0,33,18,15,33,0
2022-02-15,LW,North Macedonia,219,192,0,0,27,13,14,27,0
2022-02-16,LW,North Macedonia,251,227,0,0,24,12,12,24,0
2022-02-17,LW,North Macedonia,268,245,0,0,23,12,11,23,0
2022-02-18,LW,North Macedonia,327,294,0,0,33,17,16,33,0
2022-02-19,LW,North Macedonia,355,327,0,0,28,13,15,28,0
2022-02-20,LW,North Macedonia,336,306,0,0,30,15,15,30,0
2022-02-21,LW,North Macedonia,293,253,0,0,40,21,19,40,0
2022-02-22,LW,North Macedonia,262,232,0,0,30,14,16,30,0
2022-02-23,LW,North Macedonia,298,274,0,0,24,12,12,24,0
2022-02-24,LW,North Macedonia,299,277,0,0,22,11,11,22,0
2022-02-25,LW,North Macedonia,366,334,0,0,32,17,15,32,0
2022-02-26,LW,North Macedonia,331,302,0,0,29,14,15,29,0
2022-02-27,LW,North Macedonia,344,316,0,0,28,14,14,28,0
2022-02-28,LW,North Macedonia,291,258,0,0,33,17,16,33,0
2022-03-01,LW,North Macedonia,302,272,0,0,30,14,16,30,0
2022-03-02,LW,North Macedonia,298,276,0,0,22,11,11,22,0
2022-03-03,LW,North Macedonia,344,317,0,0,27,14,13,27,0
2022-03-04,LW,North Macedonia,382,343,0,0,39,20,19,39,0
2022-03-05,LW,North Macedonia,376,347,0,0,29,14,15,29,0
2022-03-06,LW,North Macedonia,382,353,0,0,29,14,15,29,0
2022-03-07,LW,North Macedonia,340,306,0,0,34,18,16,34,0
2022-03-08,LW,North Macedonia,306,273,0,0,33,16,17,33,0
2022-03-09,LW,North Macedonia,332,304,0,0,28,14,14,28,0
2022-03-10,LW,North Macedonia,345,325,0,0,20,10,10,20,0
2022-03-11,LW,North Macedonia,351,311,0,0,40,20,20,40,0
2022-03-12,LW,North Macedonia,372,343,0,0,29,14,15,29,0
2022-03-13,LW,North Macedonia,380,350,0,0,30,14,16,30,0
2022-03-14,LW,North Macedonia,377,334,0,0,43,22,21,43,0
2022-03-15,LW,North Macedonia,347,311,0,0,36,17,19,36,0
2022-03-16,LW,North Macedonia,363,329,0,0,34,16,18,34,0
2022-03-17,LW,North Macedonia,338,302,0,0,36,21,15,36,0
2022-03-18,LW,North Macedonia,389,342,0,0,47,23,24,47,0
2022-03-19,LW,North Macedonia,403,370,0,0,33,17,16,33,0
2022-03-20,LW,North Macedonia,393,360,0,0,33,16,17,33,0
2022-03-21,LW,North Macedonia,385,343,0,0,42,21,21,42,0
2022-03-22,LW,North Macedonia,330,290,0,0,40,21,19,40,0
2022-03-23,LW,North Macedonia,406,376,0,0,30,14,16,30,0
2022-03-24,LW,North Macedonia,371,345,0,0,26,14,12,26,0
2022-03-25,LW,North Macedonia,407,365,0,0,42,21,21,42,0
2022-03-26,LW,North Macedonia,409,373,0,0,36,17,19,36,0
2022-03-27,LW,North Macedonia,523,478,0,0,45,22,23,45,0
2022-03-28,LW,North Macedonia,473,428,1,0,45,23,21,44,1
2022-03-29,LW,North Macedonia,454,402,0,0,52,25,27,52,0
2022-03-30,LW,North Macedonia,472,427,0,0,45,22,23,45,0
2022-03-31,LW,North Macedonia,450,421,0,0,29,16,13,29,0
2022-04-01,LW,North Macedonia,522,480,0,0,42,20,22,42,0
2022-04-02,LW,North Macedonia,539,491,0,0,48,24,24,48,0
2022-04-03,LW,North Macedonia,519,470,0,0,49,23,26,49,0
2022-04-04,LW,North Macedonia,487,436,0,0,51,26,25,51,0
2022-04-05,LW,North Macedonia,460,408,0,0,52,26,26,52,0
2022-04-06,LW,North Macedonia,464,422,0,0,42,20,22,42,0
2022-04-07,LW,North Macedonia,449,412,0,0,37,20,17,37,0
2022-04-08,LW,North Macedonia,600,561,0,0,39,19,20,39,0
2022-04-09,LW,North Macedonia,691,639,0,0,52,27,25,52,0
2022-04-10,LW,North Macedonia,610,561,0,0,49,24,25,49,0
2022-04-11,LW,North Macedonia,561,517,0,0,44,22,22,44,0
2022-04-12,LW,North Macedonia,529,485,0,0,44,22,22,44,0
2022-04-13,LW,North Macedonia,610,557,0,0,53,26,27,53,0
2022-04-14,LW,North Macedonia,637,594,0,0,43,22,21,43,0
2022-04-15,LW,North Macedonia,600,550,0,0,50,25,25,50,0
2022-04-16,LW,North Macedonia,698,649,0,0,49,24,25,49,0
2022-04-17,LW,North Macedonia,658,613,0,0,45,23,22,45,0
2022-04-18,LW,North Macedonia,605,556,0,0,49,25,24,49,0
2022-04-19,LW,North Macedonia,513,468,1,0,45,22,22,44,1
2022-04-20,LW,North Macedonia,549,498,0,0,51,25,26,51,0
2022-04-21,LW,North Macedonia,565,520,0,0,45,21,24,45,0
2022-04-22,LW,North Macedonia,575,530,0,0,45,24,21,45,0
2022-04-23,LW,North Macedonia,711,666,0,0,45,22,23,45,0
2022-04-24,LW,North Macedonia,659,611,0,0,48,24,24,48,0
2022-04-25,LW,North Macedonia,533,485,0,0,48,23,25,48,0
2022-04-26,LW,North Macedonia,539,490,0,0,49,25,24,49,0
2022-04-27,LW,North Macedonia,584,538,0,0,46,23,23,46,0
2022-04-28,LW,North Macedonia,643,598,0,0,45,23,22,45,0
2022-04-29,LW,North Macedonia,632,588,0,0,44,22,22,44,0
2022-04-30,LW,North Macedonia,777,725,0,0,52,26,26,52,0
2022-05-01,LW,North Macedonia,785,738,0,0,47,23,24,47,0
2022-05-02,LW,North Macedonia,692,647,0,0,45,23,22,45,0
2022-05-03,LW,North Macedonia,668,619,0,0,49,25,24,49,0
2022-05-04,LW,North Macedonia,647,602,0,0,45,23,22,45,0
2022-05-05,LW,North Macedonia,761,705,0,0,56,26,30,56,0
2022-05-06,LW,North Macedonia,695,645,0,0,50,25,25,50,0
2022-05-07,LW,North Macedonia,885,834,0,0,51,24,27,51,0
2022-05-08,LW,North Macedonia,817,770,0,0,47,24,23,47,0
2022-05-09,LW,North Macedonia,743,697,0,0,46,23,23,46,0
2022-05-10,LW,North Macedonia,737,681,0,0,56,28,28,56,0
2022-05-11,LW,North Macedonia,721,669,0,0,52,26,26,52,0
2022-05-12,LW,North Macedonia,725,672,2,0,53,26,25,51,2
2022-05-13,LW,North Macedonia,793,744,0,0,49,26,23,49,0
2022-05-14,LW,North Macedonia,885,824,0,0,61,33,28,61,0
2022-05-15,LW,North Macedonia,849,801,0,0,48,24,24,48,0
2022-05-16,LW,North Macedonia,672,625,0,0,47,24,23,47,0
2022-05-17,LW,North Macedonia,731,682,2,0,49,24,23,47,2
2022-05-18,LW,North Macedonia,733,687,0,0,46,23,23,46,0
2022-05-19,LW,North Macedonia,723,681,0,0,42,21,21,42,0
2022-05-20,LW,North Macedonia,742,692,0,0,50,25,25,50,0
2022-05-21,LW,North Macedonia,908,863,0,0,45,21,24,45,0
2022-05-22,LW,North Macedonia,852,799,0,0,53,26,27,53,0
2022-05-23,LW,North Macedonia,660,610,1,0,50,26,23,49,1
2022-05-24,LW,North Macedonia,705,652,0,0,53,27,26,53,0
2022-05-25,LW,North Macedonia,833,775,0,0,58,28,30,58,0
2022-05-26,LW,North Macedonia,812,757,0,0,55,28,27,55,0
2022-05-27,LW,North Macedonia,850,802,0,0,48,24,24,48,0
2022-05-28,LW,North Macedonia,914,868,0,0,46,23,23,46,0
2022-05-29,LW,North Macedonia,868,810,0,0,58,29,29,58,0
2022-05-30,LW,North Macedonia,759,702,0,0,57,28,29,57,0
2022-05-31,LW,North Macedonia,827,769,1,0,58,27,30,57,1
2022-06-01,LW,North Macedonia,930,864,0,0,66,35,31,66,0
2022-06-02,LW,North Macedonia,869,805,0,0,64,31,33,64,0
2022-06-03,LW,North Macedonia,910,849,0,0,61,30,31,61,0
2022-06-04,LW,North Macedonia,985,929,0,0,56,27,29,56,0
2022-06-05,LW,North Macedonia,933,863,0,0,70,35,35,70,0
2022-06-06,LW,North Macedonia,869,802,0,0,67,34,33,67,0
2022-06-07,LW,North Macedonia,884,818,1,0,66,30,35,65,1
2022-06-08,LW,North Macedonia,896,822,0,0,74,38,36,74,0
2022-06-09,LW,North Macedonia,831,765,0,0,66,33,33,66,0
2022-06-10,LW,North Macedonia,897,827,0,0,70,35,35,70,0
2022-06-11,LW,North Macedonia,1004,946,0,0,58,29,29,58,0
2022-06-12,LW,North Macedonia,989,917,0,0,72,38,34,72,0
2022-06-13,LW,North Macedonia,896,833,0,0,63,32,31,63,0
2022-06-14,LW,North Macedonia,945,890,0,0,55,26,29,55,0
2022-06-15,LW,North Macedonia,1035,963,0,0,72,34,38,72,0
2022-06-16,LW,North Macedonia,917,826,0,0,91,44,47,91,0
2022-06-17,LW,North Macedonia,943,868,0,0,75,42,33,75,0
2022-06-18,LW,North Macedonia,1042,980,0,0,62,30,32,62,0
2022-06-19,LW,North Macedonia,1059,991,0,0,68,36,32,68,0
2022-06-20,LW,North Macedonia,876,811,0,0,65,31,34,65,0
2022-06-21,LW,North Macedonia,885,826,0,0,59,31,28,59,0
2022-06-22,LW,North Macedonia,935,866,0,0,69,34,35,69,0
2022-06-23,LW,North Macedonia,852,783,0,0,69,35,34,69,0
2022-06-24,LW,North Macedonia,858,793,0,0,65,31,34,65,0
2022-06-25,LW,North Macedonia,1061,1001,0,0,60,32,28,60,0
2022-06-26,LW,North Macedonia,983,918,0,0,65,32,33,65,0
2022-06-27,LW,North Macedonia,865,792,0,0,73,37,36,73,0
2022-06-28,LW,North Macedonia,997,940,0,0,57,28,29,57,0
2022-06-29,LW,North Macedonia,1020,946,0,0,74,37,37,74,0
2022-06-30,LW,North Macedonia,931,864,0,0,67,32,35,67,0
2022-07-01,LW,North Macedonia,909,841,0,0,68,36,32,68,0
2022-07-02,LW,North Macedonia,1045,980,0,0,65,31,34,65,0
2022-07-03,LW,North Macedonia,967,896,0,0,71,37,34,71,0
2022-07-04,LW,North Macedonia,920,856,0,0,64,32,32,64,0
2022-07-05,LW,North Macedonia,1017,958,0,0,59,28,31,59,0
2022-07-06,LW,North Macedonia,1069,988,0,0,81,41,40,81,0
2022-07-07,LW,North Macedonia,951,879,0,0,72,35,37,72,0
2022-07-08,LW,North Macedonia,968,888,0,0,80,40,40,80,0
2022-07-09,LW,North Macedonia,1069,1008,0,0,61,31,30,61,0
2022-07-10,LW,North Macedonia,1049,978,0,0,71,35,36,71,0
2022-07-11,LW,North Macedonia,937,872,0,0,65,34,31,65,0
2022-07-12,LW,North Macedonia,975,908,1,0,67,32,34,66,1
2022-07-13,LW,North Macedonia,1041,964,0,0,77,39,38,77,0
2022-07-14,LW,North Macedonia,971,895,0,0,76,37,39,76,0
2022-07-15,LW,North Macedonia,977,902,0,0,75,39,36,75,0
2022-07-16,LW,North Macedonia,1046,982,0,0,64,32,32,64,0
2022-07-17,LW,North Macedonia,1028,954,0,0,74,37,37,74,0
2022-07-18,LW,North Macedonia,947,876,0,0,71,36,35,71,0
2022-07-19,LW,North Macedonia,984,911,0,0,73,35,38,73,0
2022-07-20,LW,North Macedonia,996,928,0,0,68,36,32,68,0
2022-07-21,LW,North Macedonia,952,879,0,0,73,35,38,73,0
2022-07-22,LW,North Macedonia,931,848,0,0,83,43,40,83,0
2022-07-23,LW,North Macedonia,1069,1003,0,0,66,32,34,66,0
2022-07-24,LW,North Macedonia,1040,971,0,0,69,35,34,69,0
2022-07-25,LW,North Macedonia,956,885,0,0,71,36,35,71,0
2022-07-26,LW,North Macedonia,964,888,0,0,76,37,39,76,0
2022-07-27,LW,North Macedonia,977,898,0,0,79,40,39,79,0
2022-07-28,LW,North Macedonia,972,902,0,0,70,34,36,70,0
2022-07-29,LW,North Macedonia,949,875,0,0,74,37,37,74,0
2022-07-30,LW,North Macedonia,1082,1004,0,0,78,39,39,78,0
2022-07-31,LW,North Macedonia,1055,980,0,0,75,36,39,75,0
2022-08-01,LW,North Macedonia,942,870,0,0,72,38,34,72,0
2022-08-02,LW,North Macedonia,987,926,0,0,61,31,30,61,0
2022-08-03,LW,North Macedonia,1053,983,0,0,70,35,35,70,0
2022-08-04,LW,North Macedonia,1002,936,0,0,66,32,34,66,0
2022-08-05,LW,North Macedonia,904,825,0,0,79,40,39,79,0
2022-08-06,LW,North Macedonia,1116,1048,0,0,68,35,33,68,0
2022-08-07,LW,North Macedonia,1018,947,0,0,71,34,37,71,0
2022-08-08,LW,North Macedonia,904,838,0,0,66,34,32,66,0
2022-08-09,LW,North Macedonia,888,820,0,0,68,34,34,68,0
2022-08-10,LW,North Macedonia,1002,926,0,0,76,38,38,76,0
2022-08-11,LW,North Macedonia,940,869,0,0,71,34,37,71,0
2022-08-12,LW,North Macedonia,943,870,0,0,73,37,36,73,0
2022-08-13,LW,North Macedonia,1082,1010,0,0,72,34,38,72,0
2022-08-14,LW,North Macedonia,993,920,0,0,73,39,34,73,0
2022-08-15,LW,North Macedonia,840,770,0,0,70,36,34,70,0
2022-08-16,LW,North Macedonia,898,828,0,0,70,34,36,70,0
2022-08-17,LW,North Macedonia,980,910,0,0,70,35,35,70,0
2022-08-18,LW,North Macedonia,883,819,0,0,64,31,33,64,0
2022-08-19,LW,North Macedonia,855,783,0,0,72,37,35,72,0
2022-08-20,LW,North Macedonia,979,913,1,1,66,31,34,65,0
2022-08-21,LW,North Macedonia,960,886,1,0,74,38,35,73,1
2022-08-22,LW,North Macedonia,792,737,0,0,55,28,27,55,0
2022-08-23,LW,North Macedonia,921,851,0,0,70,34,36,70,0
2022-08-24,LW,North Macedonia,1039,971,0,0,68,33,35,68,0
2022-08-25,LW,North Macedonia,928,859,0,0,69,35,34,69,0
2022-08-26,LW,North Macedonia,929,864,0,0,65,34,31,65,0
2022-08-27,LW,North Macedonia,1030,966,1,1,64,31,32,63,0
2022-08-28,LW,North Macedonia,993,926,0,0,67,34,33,67,0
2022-08-29,LW,North Macedonia,821,755,0,0,66,33,33,66,0
2022-08-30,LW,North Macedonia,943,879,0,0,64,32,32,64,0
2022-08-31,LW,North Macedonia,920,856,0,0,64,31,33,64,0
2022-09-01,LW,North Macedonia,873,810,0,0,63,32,31,63,0
2022-09-02,LW,North Macedonia,904,835,0,0,69,34,35,69,0
2022-09-03,LW,North Macedonia,1027,958,0,0,69,35,34,69,0
2022-09-04,LW,North Macedonia,876,807,0,0,69,35,34,69,0
2022-09-05,LW,North Macedonia,864,794,0,0,70,34,36,70,0
2022-09-06,LW,North Macedonia,920,853,0,0,67,33,34,67,0
2022-09-07,LW,North Macedonia,940,865,0,0,75,38,37,75,0
2022-09-08,LW,North Macedonia,828,769,0,0,59,29,30,59,0
2022-09-09,LW,North Macedonia,840,768,0,0,72,37,35,72,0
2022-09-10,LW,North Macedonia,916,856,0,0,60,30,30,60,0
2022-09-11,LW,North Macedonia,876,807,0,0,69,35,34,69,0
2022-09-12,LW,North Macedonia,854,790,0,0,64,31,33,64,0
2022-09-13,LW,North Macedonia,852,779,0,0,73,36,37,73,0
2022-09-14,LW,North Macedonia,920,852,0,0,68,34,34,68,0
2022-09-15,LW,North Macedonia,809,749,0,0,60,31,29,60,0
2022-09-16,LW,North Macedonia,838,765,0,0,73,36,37,73,0
2022-09-17,LW,North Macedonia,943,877,0,0,66,34,32,66,0
2022-09-18,LW,North Macedonia,926,858,0,0,68,34,34,68,0
2022-09-19,LW,North Macedonia,742,678,0,0,64,32,32,64,0
2022-09-20,LW,North Macedonia,802,737,0,0,65,31,34,65,0
2022-09-21,LW,North Macedonia,897,836,0,0,61,32,29,61,0
2022-09-22,LW,North Macedonia,831,770,0,0,61,30,31,61,0
2022-09-23,LW,North Macedonia,842,777,0,0,65,32,33,65,0
2022-09-24,LW,North Macedonia,935,871,0,0,64,32,32,64,0
2022-09-25,LW,North Macedonia,901,834,0,0,67,35,32,67,0
2022-09-26,LW,North Macedonia,702,645,0,0,57,29,28,57,0
2022-09-27,LW,North Macedonia,840,780,0,0,60,30,30,60,0
2022-09-28,LW,North Macedonia,903,844,0,0,59,29,30,59,0
2022-09-29,LW,North Macedonia,822,766,0,0,56,28,28,56,0
2022-09-30,LW,North Macedonia,786,722,0,0,64,31,33,64,0
2022-10-01,LW,North Macedonia,841,784,0,0,57,29,28,57,0
2022-10-02,LW,North Macedonia,815,745,0,0,70,36,34,70,0
2022-10-03,LW,North Macedonia,780,722,0,0,58,29,29,58,0
2022-10-04,LW,North Macedonia,734,683,0,0,51,26,25,51,0
2022-10-05,LW,North Macedonia,802,744,0,0,58,29,29,58,0
2022-10-06,LW,North Macedonia,790,731,0,0,59,29,30,59,0
2022-10-07,LW,North Macedonia,844,781,0,0,63,31,32,63,0
2022-10-08,LW,North Macedonia,861,803,0,0,58,29,29,58,0
2022-10-09,LW,North Macedonia,872,811,0,0,61,31,30,61,0
2022-10-10,LW,North Macedonia,744,690,0,0,54,27,27,54,0
2022-10-11,LW,North Macedonia,745,695,0,0,50,26,24,50,0
2022-10-12,LW,North Macedonia,747,696,0,0,51,25,26,51,0
2022-10-13,LW,North Macedonia,750,701,0,0,49,25,24,49,0
2022-10-14,LW,North Macedonia,841,774,0,0,67,32,35,67,0
2022-10-15,LW,North Macedonia,908,860,0,0,48,25,23,48,0
2022-10-16,LW,North Macedonia,824,763,0,0,61,30,31,61,0
2022-10-17,LW,North Macedonia,743,692,0,0,51,25,26,51,0
2022-10-18,LW,North Macedonia,748,693,0,0,55,29,26,55,0
2022-10-19,LW,North Macedonia,728,675,0,0,53,26,27,53,0
2022-10-20,LW,North Macedonia,686,632,1,0,54,26,27,53,1
2022-10-21,LW,North Macedonia,726,673,0,0,53,27,26,53,0
2022-10-22,LW,North Macedonia,830,784,0,0,46,23,23,46,0
2022-10-23,LW,North Macedonia,787,726,0,0,61,30,31,61,0
2022-10-24,LW,North Macedonia,684,631,0,0,53,26,27,53,0
2022-10-25,LW,North Macedonia,685,630,1,0,55,28,26,54,1
2022-10-26,LW,North Macedonia,683,625,1,1,58,27,30,57,0
2022-10-27,LW,North Macedonia,711,657,1,0,54,28,25,53,1
2022-10-28,LW,North Macedonia,703,649,0,0,54,26,28,54,0
2022-10-29,LW,North Macedonia,853,802,0,0,51,26,25,51,0
2022-10-30,LW,North Macedonia,732,676,0,0,56,27,29,56,0
2022-10-31,LW,North Macedonia,630,582,0,0,48,25,23,48,0
2022-11-01,LW,North Macedonia,518,474,0,0,44,23,21,44,0
2022-11-02,LW,North Macedonia,446,402,0,0,44,22,22,44,0
2022-11-03,LW,North Macedonia,471,422,0,0,49,24,25,49,0
2022-11-04,LW,North Macedonia,520,467,0,0,53,27,26,53,0
2022-11-05,LW,North Macedonia,577,538,0,0,39,19,20,39,0
2022-11-06,LW,North Macedonia,553,493,0,0,60,29,31,60,0
2022-11-07,LW,North Macedonia,443,394,0,0,49,26,23,49,0
2022-11-08,LW,North Macedonia,380,334,0,0,46,23,23,46,0
2022-11-09,LW,North Macedonia,418,377,0,0,41,20,21,41,0
2022-11-10,LW,North Macedonia,394,347,0,0,47,23,24,47,0
2022-11-11,LW,North Macedonia,434,385,0,0,49,26,23,49,0
2022-11-12,LW,North Macedonia,463,429,0,0,34,17,17,34,0
2022-11-13,LW,North Macedonia,458,405,0,0,53,26,27,53,0
2022-11-14,LW,North Macedonia,408,359,0,0,49,25,24,49,0
2022-11-15,LW,North Macedonia,346,308,0,0,38,18,20,38,0
2022-11-16,LW,North Macedonia,414,376,0,0,38,20,18,38,0
2022-11-17,LW,North Macedonia,385,333,0,0,52,25,27,52,0
2022-11-18,LW,North Macedonia,384,333,0,0,51,26,25,51,0
2022-11-19,LW,North Macedonia,391,356,1,0,35,17,17,34,1
2022-11-20,LW,North Macedonia,446,392,0,0,54,27,27,54,0
2022-11-21,LW,North Macedonia,331,286,0,0,45,22,23,45,0
2022-11-22,LW,North Macedonia,325,286,0,0,39,19,20,39,0
2022-11-23,LW,North Macedonia,293,255,0,0,38,20,18,38,0
2022-11-24,LW,North Macedonia,370,323,0,0,47,23,24,47,0
2022-11-25,LW,North Macedonia,418,369,0,0,49,25,24,49,0
2022-11-26,LW,North Macedonia,362,329,0,0,33,16,17,33,0
2022-11-27,LW,North Macedonia,437,385,0,0,52,26,26,52,0
2022-11-28,LW,North Macedonia,397,348,0,0,49,25,24,49,0
2022-11-29,LW,North Macedonia,355,313,0,0,42,21,21,42,0
2022-11-30,LW,North Macedonia,364,323,0,0,41,21,20,41,0
2022-12-01,LW,North Macedonia,383,340,0,0,43,21,22,43,0
2022-12-02,LW,North Macedonia,351,302,0,0,49,25,24,49,0
2022-12-03,LW,North Macedonia,357,325,0,0,32,16,16,32,0
2022-12-04,LW,North Macedonia,400,349,0,0,51,25,26,51,0
2022-12-05,LW,North Macedonia,360,315,0,0,45,24,21,45,0
2022-12-06,LW,North Macedonia,348,309,0,0,39,19,20,39,0
2022-12-07,LW,North Macedonia,361,321,0,0,40,20,20,40,0
2022-12-08,LW,North Macedonia,382,341,0,0,41,20,21,41,0
2022-12-09,LW,North Macedonia,372,325,0,0,47,24,23,47,0
2022-12-10,LW,North Macedonia,347,318,0,0,29,15,14,29,0
2022-12-11,LW,North Macedonia,366,313,0,0,53,25,28,53,0
2022-12-12,LW,North Macedonia,326,275,0,0,51,25,26,51,0
2022-12-13,LW,North Macedonia,340,289,0,0,51,28,23,51,0
2022-12-14,LW,North Macedonia,373,320,1,0,53,26,26,52,1
2022-12-15,LW,North Macedonia,381,329,0,0,52,26,26,52,0
2022-12-16,LW,North Macedonia,397,341,1,1,56,28,27,55,0
2022-12-17,LW,North Macedonia,397,364,0,0,33,16,17,33,0
2022-12-18,LW,North Macedonia,423,368,0,0,55,27,28,55,0
2022-12-19,LW,North Macedonia,439,385,0,0,54,27,27,54,0
2022-12-20,LW,North Macedonia,432,386,0,0,46,23,23,46,0
2022-12-21,LW,North Macedonia,432,375,0,0,57,29,28,57,0
2022-12-22,LW,North Macedonia,477,423,0,0,54,27,27,54,0
2022-12-23,LW,North Macedonia,468,421,2,0,47,23,22,45,2
2022-12-24,LW,North Macedonia,430,391,0,0,39,19,20,39,0
2022-12-25,LW,North Macedonia,331,277,0,0,54,26,28,54,0
2022-12-26,LW,North Macedonia,391,337,0,0,54,27,27,54,0
2022-12-27,LW,North Macedonia,430,387,0,0,43,23,20,43,0
2022-01-01,EN,Norway,655,157,181,3,498,157,160,317,178
2022-01-02,EN,Norway,1297,248,613,3,1049,213,223,436,610
2022-01-03,EN,Norway,1443,190,831,3,1253,215,207,422,828
2022-01-04,EN,Norway,1298,175,744,17,1123,190,189,379,727
2022-01-05,EN,Norway,1340,177,756,15,1163,204,203,407,741
2022-01-06,EN,Norway,1447,180,846,18,1267,212,209,421,828
2022-01-07,EN,Norway,1448,249,795,10,1199,202,202,404,785
2022-01-08,EN,Norway,782,196,248,8,586,172,166,338,240
2022-01-09,EN,Norway,1206,254,581,2,952,183,188,371,579
2022-01-10,EN,Norway,1268,193,755,10,1075,162,158,320,745
2022-01-11,EN,Norway,1189,196,695,2,993,148,150,298,693
2022-01-12,EN,Norway,1093,164,632,15,929,146,151,297,617
2022-01-13,EN,Norway,1218,204,664,20,1014,175,175,350,644
2022-01-14,EN,Norway,1249,193,720,15,1056,165,171,336,705
2022-01-15,EN,Norway,718,179,252,14,539,147,140,287,238
2022-01-16,EN,Norway,917,210,414,11,707,146,147,293,403
2022-01-17,EN,Norway,1234,195,730,16,1039,156,153,309,714
2022-01-18,EN,Norway,1123,153,717,16,970,124,129,253,701
2022-01-19,EN,Norway,1075,139,681,12,936,125,130,255,669
2022-01-20,EN,Norway,1181,176,703,15,1005,148,154,302,688
2022-01-21,EN,Norway,1297,186,763,16,1111,176,172,348,747
2022-01-22,EN,Norway,680,174,240,12,506,136,130,266,228
2022-01-23,EN,Norway,988,192,504,7,796,140,152,292,497
2022-01-24,EN,Norway,1145,152,679,17,993,159,155,314,662
2022-01-25,EN,Norway,1053,123,684,14,930,123,123,246,670
2022-01-26,EN,Norway,1152,150,732,18,1002,133,137,270,714
2022-01-27,EN,Norway,1147,142,692,9,1005,155,158,313,683
2022-01-28,EN,Norway,1255,165,750,12,1090,171,169,340,738
2022-01-29,EN,Norway,607,162,188,4,445,132,125,257,184
2022-01-30,EN,Norway,940,147,501,11,793,143,149,292,490
2022-01-31,EN,Norway,1150,151,704,20,999,145,150,295,684
2022-02-01,EN,Norway,1080,139,676,16,941,134,131,265,660
2022-02-02,EN,Norway,1213,174,728,22,1039,158,153,311,706
2022-02-03,EN,Norway,1241,134,751,11,1107,177,179,356,740
2022-02-04,EN,Norway,1123,170,638,21,953,154,161,315,617
2022-02-05,EN,Norway,691,148,262,10,543,143,138,281,252
2022-02-06,EN,Norway,1063,210,534,11,853,156,163,319,523
2022-02-07,EN,Norway,1267,145,782,18,1122,174,166,340,764
2022-02-08,EN,Norway,1127,151,697,18,976,137,142,279,679
2022-02-09,EN,Norway,1077,139,652,17,938,143,143,286,635
2022-02-10,EN,Norway,1175,149,699,28,1026,162,165,327,671
2022-02-11,EN,Norway,1253,134,761,32,1119,180,178,358,729
2022-02-12,EN,Norway,737,157,266,11,580,161,153,314,255
2022-02-13,EN,Norway,1095,176,567,21,919,170,182,352,546
2022-02-14,EN,Norway,1215,146,719,6,1069,176,174,350,713
2022-02-15,EN,Norway,1215,162,756,23,1053,148,149,297,733
2022-02-16,EN,Norway,1262,184,754,16,1078,161,163,324,738
2022-02-17,EN,Norway,1306,160,780,22,1146,183,183,366,758
2022-02-18,EN,Norway,1383,165,798,23,1218,208,212,420,775
2022-02-19,EN,Norway,808,187,275,11,621,177,169,346,264
2022-02-20,EN,Norway,1133,205,573,8,928,176,179,355,565
2022-02-21,EN,Norway,1310,152,810,12,1158,174,174,348,798
2022-02-22,EN,Norway,1213,134,764,11,1079,158,157,315,753
2022-02-23,EN,Norway,1221,151,735,14,1070,164,171,335,721
2022-02-24,EN,Norway,1246,159,731,29,1087,176,180,356,702
2022-02-25,EN,Norway,1412,154,805,14,1258,228,225,453,791
2022-02-26,EN,Norway,802,131,294,13,671,187,190,377,281
2022-02-27,EN,Norway,1105,172,532,11,933,195,206,401,521
2022-02-28,EN,Norway,1394,144,851,16,1250,202,197,399,835
2022-03-01,EN,Norway,1281,133,798,15,1148,174,176,350,783
2022-03-02,EN,Norway,1325,131,809,18,1194,194,191,385,791
2022-03-03,EN,Norway,1397,170,844,13,1227,192,191,383,831
2022-03-04,EN,Norway,1435,154,830,17,1281,224,227,451,813
2022-03-05,EN,Norway,748,125,275,6,623,175,173,348,269
2022-03-06,EN,Norway,1189,160,632,14,1029,191,206,397,618
2022-03-07,EN,Norway,1391,129,850,25,1262,210,202,412,825
2022-03-08,EN,Norway,1296,118,819,24,1178,180,179,359,795
2022-03-09,EN,Norway,1317,133,819,19,1184,178,187,365,800
2022-03-10,EN,Norway,1375,102,873,11,1273,201,199,400,862
2022-03-11,EN,Norway,1447,153,843,11,1294,224,227,451,832
2022-03-12,EN,Norway,803,159,291,14,644,179,174,353,277
2022-03-13,EN,Norway,1229,179,644,12,1050,195,211,406,632
2022-03-14,EN,Norway,1481,154,896,29,1327,217,214,431,867
2022-03-15,EN,Norway,1357,139,863,29,1218,177,178,355,834
2022-03-16,EN,Norway,1355,139,840,17,1216,184,192,376,823
2022-03-17,EN,Norway,1440,154,879,9,1286,205,202,407,870
2022-03-18,EN,Norway,1471,130,876,25,1341,231,234,465,851
2022-03-19,EN,Norway,749,110,290,10,639,174,175,349,280
2022-03-20,EN,Norway,1158,123,636,14,1035,197,202,399,622
2022-03-21,EN,Norway,1427,140,860,19,1287,214,213,427,841
2022-03-22,EN,Norway,1350,100,884,20,1250,181,185,366,864
2022-03-23,EN,Norway,1415,117,883,18,1298,212,203,415,865
2022-03-24,EN,Norway,1408,115,884,20,1293,206,203,409,864
2022-03-25,EN,Norway,1473,143,855,21,1330,235,240,475,834
2022-03-26,EN,Norway,829,135,312,10,694,196,186,382,302
2022-03-27,EN,Norway,1265,133,654,17,1132,230,248,478,637
2022-03-28,EN,Norway,1605,124,969,24,1481,259,253,512,945
2022-03-29,EN,Norway,1446,109,901,24,1337,219,217,436,877
2022-03-30,EN,Norway,1602,143,950,24,1459,252,257,509,926
2022-03-31,EN,Norway,1675,159,1005,29,1516,255,256,511,976
2022-04-01,EN,Norway,1642,159,917,22,1483,286,280,566,895
2022-04-02,EN,Norway,886,119,338,20,767,216,213,429,318
2022-04-03,EN,Norway,1304,149,662,23,1155,244,249,493,639
2022-04-04,EN,Norway,1608,159,941,18,1449,252,256,508,923
2022-04-05,EN,Norway,1556,111,959,31,1445,241,245,486,928
2022-04-06,EN,Norway,1688,154,975,23,1534,277,282,559,952
2022-04-07,EN,Norway,1737,202,995,11,1535,269,271,540,984
2022-04-08,EN,Norway,1733,185,958,27,1548,296,294,590,931
2022-04-09,EN,Norway,939,161,329,14,778,228,221,449,315
2022-04-10,EN,Norway,1263,157,587,14,1106,259,260,519,573
2022-04-11,EN,Norway,1487,153,815,28,1334,261,258,519,787
2022-04-12,EN,Norway,1476,145,824,28,1331,252,255,507,796
2022-04-13,EN,Norway,1478,152,807,20,1326,259,260,519,787
2022-04-14,EN,Norway,1233,164,577,9,1069,247,245,492,568
2022-04-15,EN,Norway,886,150,239,7,736,247,250,497,232
2022-04-16,EN,Norway,808,138,228,12,670,222,220,442,216
2022-04-17,EN,Norway,1205,144,556,5,1061,248,257,505,551
2022-04-18,EN,Norway,1503,193,767,10,1310,270,273,543,757
2022-04-19,EN,Norway,1681,159,989,11,1522,265,268,533,978
2022-04-20,EN,Norway,1689,144,1003,28,1545,270,272,542,975
2022-04-21,EN,Norway,1732,160,1036,30,1572,269,267,536,1006
2022-04-22,EN,Norway,1734,150,982,29,1584,300,302,602,953
2022-04-23,EN,Norway,877,132,334,13,745,209,202,411,321
2022-04-24,EN,Norway,1350,146,683,12,1204,254,267,521,671
2022-04-25,EN,Norway,1718,156,1000,26,1562,289,273,562,974
2022-04-26,EN,Norway,1680,156,987,19,1524,267,270,537,968
2022-04-27,EN,Norway,1674,135,976,24,1539,279,284,563,952
2022-04-28,EN,Norway,1712,147,998,25,1565,283,284,567,973
2022-04-29,EN,Norway,1688,166,957,16,1522,282,283,565,941
2022-04-30,EN,Norway,928,143,362,20,785,214,209,423,342
2022-05-01,EN,Norway,1364,160,676,8,1204,258,270,528,668
2022-05-02,EN,Norway,1689,155,977,16,1534,281,276,557,961
2022-05-03,EN,Norway,1710,153,1018,25,1557,269,270,539,993
2022-05-04,EN,Norway,1760,166,1023,17,1594,281,290,571,1006
2022-05-05,EN,Norway,1827,195,1041,21,1632,295,296,591,1020
2022-05-06,EN,Norway,1743,174,944,18,1569,311,314,625,926
2022-05-07,EN,Norway,920,118,330,16,802,240,232,472,314
2022-05-08,EN,Norway,1401,128,716,16,1273,278,279,557,700
2022-05-09,EN,Norway,1748,165,1002,25,1583,289,292,581,977
2022-05-10,EN,Norway,1719,140,1019,13,1579,281,279,560,1006
2022-05-11,EN,Norway,1710,139,1002,13,1571,283,286,569,989
2022-05-12,EN,Norway,1789,167,1030,26,1622,293,299,592,1004
2022-05-13,EN,Norway,1750,149,990,21,1601,310,301,611,969
2022-05-14,EN,Norway,945,139,336,17,806,236,234,470,319
2022-05-15,EN,Norway,1402,172,665,13,1230,279,286,565,652
2022-05-16,EN,Norway,1667,167,919,14,1500,293,288,581,905
2022-05-17,EN,Norway,1127,150,539,7,977,215,223,438,532
2022-05-18,EN,Norway,1771,171,1025,19,1600,290,285,575,1006
2022-05-19,EN,Norway,1771,172,1002,25,1599,299,298,597,977
2022-05-20,EN,Norway,1779,166,989,36,1613,312,312,624,953
2022-05-21,EN,Norway,1013,154,350,21,859,260,249,509,329
2022-05-22,EN,Norway,1429,149,682,9,1280,298,300,598,673
2022-05-23,EN,Norway,1782,171,1023,29,1611,295,293,588,994
2022-05-24,EN,Norway,1780,196,1034,22,1584,275,275,550,1012
2022-05-25,EN,Norway,1826,213,1006,29,1613,298,309,607,977
2022-05-26,EN,Norway,1477,188,716,4,1289,286,287,573,712
2022-05-27,EN,Norway,1568,181,831,22,1387,279,277,556,809
2022-05-28,EN,Norway,988,137,349,14,851,251,251,502,335
2022-05-29,EN,Norway,1485,177,718,18,1308,289,301,590,700
2022-05-30,EN,Norway,1857,214,1033,20,1643,306,304,610,1013
2022-05-31,EN,Norway,1772,189,1026,22,1583,278,279,557,1004
2022-06-01,EN,Norway,1829,197,1007,22,1632,312,313,625,985
2022-06-02,EN,Norway,1816,181,1013,18,1635,310,312,622,995
2022-06-03,EN,Norway,1791,160,984,24,1631,329,318,647,960
2022-06-04,EN,Norway,1014,122,325,13,892,282,285,567,312
2022-06-05,EN,Norway,1321,147,575,15,1174,298,301,599,560
2022-06-06,EN,Norway,1606,163,826,12,1443,309,308,617,814
2022-06-07,EN,Norway,1787,184,995,18,1603,301,307,608,977
2022-06-08,EN,Norway,1811,179,1013,15,1632,310,309,619,998
2022-06-09,EN,Norway,1938,269,1016,16,1669,327,326,653,1000
2022-06-10,EN,Norway,1846,197,991,21,1649,326,332,658,970
2022-06-11,EN,Norway,1083,178,341,10,905,281,283,564,331
2022-06-12,EN,Norway,1536,219,711,11,1317,301,305,606,700
2022-06-13,EN,Norway,1850,223,997,18,1627,314,316,630,979
2022-06-14,EN,Norway,1784,176,967,17,1608,321,320,641,950
2022-06-15,EN,Norway,1820,197,971,24,1623,326,326,652,947
2022-06-16,EN,Norway,1807,219,915,16,1588,335,338,673,899
2022-06-17,EN,Norway,1784,179,895,12,1605,349,361,710,883
2022-06-18,EN,Norway,1127,160,355,15,967,308,304,612,340
2022-06-19,EN,Norway,1467,198,652,12,1269,308,309,617,640
2022-06-20,EN,Norway,1747,163,911,16,1584,337,336,673,895
2022-06-21,EN,Norway,1755,163,895,19,1592,345,352,697,876
2022-06-22,EN,Norway,1821,207,915,25,1614,352,347,699,890
2022-06-23,EN,Norway,1842,189,939,16,1653,353,361,714,923
2022-06-24,EN,Norway,1758,194,858,22,1564,355,351,706,836
2022-06-25,EN,Norway,1096,150,315,15,946,321,310,631,300
2022-06-26,EN,Norway,1363,246,470,6,1117,318,329,647,464
2022-06-27,EN,Norway,1540,220,628,4,1320,346,346,692,624
2022-06-28,EN,Norway,1583,166,706,11,1417,355,356,711,695
2022-06-29,EN,Norway,1718,217,769,19,1501,366,366,732,750
2022-06-30,EN,Norway,1778,234,846,20,1544,355,343,698,826
2022-07-01,EN,Norway,1647,201,740,18,1446,355,351,706,722
2022-07-02,EN,Norway,1140,193,294,12,947,323,330,653,282
2022-07-03,EN,Norway,1480,256,580,8,1224,324,320,644,572
2022-07-04,EN,Norway,1625,226,746,17,1399,325,328,653,729
2022-07-05,EN,Norway,1534,196,733,20,1338,300,305,605,713
2022-07-06,EN,Norway,1539,173,725,25,1366,320,321,641,700
2022-07-07,EN,Norway,1559,171,728,14,1388,325,335,660,714
2022-07-08,EN,Norway,1583,188,719,24,1395,334,342,676,695
2022-07-09,EN,Norway,1004,134,268,9,870,306,296,602,259
2022-07-10,EN,Norway,1323,196,522,11,1127,302,303,605,511
2022-07-11,EN,Norway,1508,180,723,18,1328,305,300,605,705
2022-07-12,EN,Norway,1581,186,775,25,1395,308,312,620,750
2022-07-13,EN,Norway,1526,197,706,14,1329,312,311,623,692
2022-07-14,EN,Norway,1593,251,710,14,1342,317,315,632,696
2022-07-15,EN,Norway,1531,204,686,8,1327,320,321,641,678
2022-07-16,EN,Norway,998,156,260,12,842,286,296,582,248
2022-07-17,EN,Norway,1284,189,506,8,1095,298,291,589,498
2022-07-18,EN,Norway,1523,159,732,15,1364,320,312,632,717
2022-07-19,EN,Norway,1575,170,744,20,1405,326,335,661,724
2022-07-20,EN,Norway,1548,190,693,24,1358,335,330,665,669
2022-07-21,EN,Norway,1695,206,801,17,1489,341,347,688,784
2022-07-22,EN,Norway,1715,215,789,10,1500,353,358,711,779
2022-07-23,EN,Norway,1138,176,308,12,962,328,326,654,296
2022-07-24,EN,Norway,1481,225,597,9,1256,330,329,659,588
2022-07-25,EN,Norway,1686,210,795,18,1476,339,342,681,777
2022-07-26,EN,Norway,1696,211,804,26,1485,338,343,681,778
2022-07-27,EN,Norway,1679,206,789,31,1473,345,339,684,758
2022-07-28,EN,Norway,1720,203,823,28,1517,346,348,694,795
2022-07-29,EN,Norway,1736,235,780,25,1501,359,362,721,755
2022-07-30,EN,Norway,1188,199,313,13,989,342,334,676,300
2022-07-31,EN,Norway,1536,268,604,16,1268,326,338,664,588
2022-08-01,EN,Norway,1744,223,816,11,1521,352,353,705,805
2022-08-02,EN,Norway,1635,206,783,25,1429,321,325,646,758
2022-08-03,EN,Norway,1706,205,783,11,1501,358,360,718,772
2022-08-04,EN,Norway,1685,180,816,13,1505,341,348,689,803
2022-08-05,EN,Norway,1709,235,782,23,1474,347,345,692,759
2022-08-06,EN,Norway,1097,145,302,8,952,322,328,650,294
2022-08-07,EN,Norway,1476,202,612,13,1274,332,330,662,599
2022-08-08,EN,Norway,1751,217,849,23,1534,347,338,685,826
2022-08-09,EN,Norway,1649,205,791,20,1444,323,330,653,771
2022-08-10,EN,Norway,1710,204,798,22,1506,349,359,708,776
2022-08-11,EN,Norway,1726,231,834,31,1495,334,327,661,803
2022-08-12,EN,Norway,1755,220,827,26,1535,359,349,708,801
2022-08-13,EN,Norway,1165,164,341,15,1001,334,326,660,326
2022-08-14,EN,Norway,1476,203,644,22,1273,308,321,629,622
2022-08-15,EN,Norway,1722,210,906,16,1512,307,299,606,890
2022-08-16,EN,Norway,1566,216,824,10,1350,263,263,526,814
2022-08-17,EN,Norway,1783,217,934,17,1566,319,313,632,917
2022-08-18,EN,Norway,1779,222,945,16,1557,307,305,612,929
2022-08-19,EN,Norway,1773,245,886,19,1528,321,321,642,867
2022-08-20,EN,Norway,1097,225,302,11,872,287,283,570,291
2022-08-21,EN,Norway,1504,245,647,6,1259,299,313,612,641
2022-08-22,EN,Norway,1861,219,1008,28,1642,320,314,634,980
2022-08-23,EN,Norway,1762,195,995,31,1567,281,291,572,964
2022-08-24,EN,Norway,1817,193,995,31,1624,313,316,629,964
2022-08-25,EN,Norway,1844,220,1001,23,1624,313,310,623,978
2022-08-26,EN,Norway,1899,232,999,22,1667,335,333,668,977
2022-08-27,EN,Norway,1119,187,358,16,932,289,285,574,342
2022-08-28,EN,Norway,1502,181,702,13,1321,304,315,619,689
2022-08-29,EN,Norway,1878,178,1053,16,1700,324,323,647,1037
2022-08-30,EN,Norway,1830,181,1025,22,1649,318,306,624,1003
2022-08-31,EN,Norway,1850,192,1029,14,1658,309,320,629,1015
2022-09-01,EN,Norway,1847,185,1021,18,1662,325,316,641,1003
2022-09-02,EN,Norway,1836,185,1016,26,1651,318,317,635,990
2022-09-03,EN,Norway,1028,154,339,15,874,270,265,535,324
2022-09-04,EN,Norway,1496,206,705,14,1290,292,293,585,691
2022-09-05,EN,Norway,1817,215,987,22,1602,308,307,615,965
2022-09-06,EN,Norway,1734,179,986,27,1555,283,286,569,959
2022-09-07,EN,Norway,1793,180,1001,7,1613,307,305,612,994
2022-09-08,EN,Norway,1832,193,1022,21,1639,305,312,617,1001
2022-09-09,EN,Norway,1836,200,984,22,1636,330,322,652,962
2022-09-10,EN,Norway,1069,156,371,11,913,274,268,542,360
2022-09-11,EN,Norway,1473,189,686,11,1284,294,304,598,675
2022-09-12,EN,Norway,1852,195,1037,15,1657,311,309,620,1022
2022-09-13,EN,Norway,1734,189,979,21,1545,277,289,566,958
2022-09-14,EN,Norway,1805,194,998,19,1611,309,304,613,979
2022-09-15,EN,Norway,1855,213,1026,31,1642,306,310,616,995
2022-09-16,EN,Norway,1819,200,980,16,1619,323,316,639,964
2022-09-17,EN,Norway,1044,142,336,6,902,286,280,566,330
2022-09-18,EN,Norway,1499,219,701,13,1280,283,296,579,688
2022-09-19,EN,Norway,1870,217,1041,14,1653,309,303,612,1027
2022-09-20,EN,Norway,1721,200,971,16,1521,274,276,550,955
2022-09-21,EN,Norway,1822,174,1023,12,1648,313,312,625,1011
2022-09-22,EN,Norway,1864,200,1014,12,1664,323,327,650,1002
2022-09-23,EN,Norway,1781,201,960,16,1580,310,310,620,944
2022-09-24,EN,Norway,1040,159,358,17,881,265,258,523,341
2022-09-25,EN,Norway,1458,171,701,17,1287,292,294,586,684
2022-09-26,EN,Norway,1776,200,972,13,1576,302,302,604,959
2022-09-27,EN,Norway,1778,226,981,20,1552,283,288,571,961
2022-09-28,EN,Norway,1831,238,987,14,1593,304,302,606,973
2022-09-29,EN,Norway,1870,253,1028,18,1617,295,294,589,1010
2022-09-30,EN,Norway,1867,230,969,24,1637,331,337,668,945
2022-10-01,EN,Norway,1177,259,342,6,918,290,286,576,336
2022-10-02,EN,Norway,1505,205,704,18,1300,292,304,596,686
2022-10-03,EN,Norway,1767,180,958,18,1587,319,310,629,940
2022-10-04,EN,Norway,1609,157,903,22,1452,275,274,549,881
2022-10-05,EN,Norway,1662,180,900,8,1482,293,289,582,892
2022-10-06,EN,Norway,1751,216,948,26,1535,295,292,587,922
2022-10-07,EN,Norway,1779,206,928,9,1573,316,329,645,919
2022-10-08,EN,Norway,1091,172,346,13,919,291,282,573,333
2022-10-09,EN,Norway,1493,196,691,12,1297,298,308,606,679
2022-10-10,EN,Norway,1762,213,940,15,1549,305,304,609,925
2022-10-11,EN,Norway,1624,153,919,14,1471,282,270,552,905
2022-10-12,EN,Norway,1722,212,932,23,1510,286,292,578,909
2022-10-13,EN,Norway,1779,228,948,17,1551,298,305,603,931
2022-10-14,EN,Norway,1816,230,941,14,1586,324,321,645,927
2022-10-15,EN,Norway,1060,179,351,11,881,266,264,530,340
2022-10-16,EN,Norway,1491,197,694,8,1294,295,305,600,686
2022-10-17,EN,Norway,1778,178,990,21,1600,308,302,610,969
2022-10-18,EN,Norway,1720,167,1022,27,1553,268,263,531,995
2022-10-19,EN,Norway,1687,166,968,34,1521,280,273,553,934
2022-10-20,EN,Norway,1736,160,998,18,1576,286,292,578,980
2022-10-21,EN,Norway,1727,186,958,15,1541,289,294,583,943
2022-10-22,EN,Norway,979,145,359,14,834,238,237,475,345
2022-10-23,EN,Norway,1424,166,713,14,1258,270,275,545,699
2022-10-24,EN,Norway,1777,180,1001,14,1597,299,297,596,987
2022-10-25,EN,Norway,1710,157,1013,26,1553,265,275,540,987
2022-10-26,EN,Norway,1727,174,984,9,1553,286,283,569,975
2022-10-27,EN,Norway,1754,155,1030,12,1599,288,281,569,1018
2022-10-28,EN,Norway,1689,188,921,2,1501,286,294,580,919
2022-10-29,EN,Norway,974,138,345,9,836,248,243,491,336
2022-10-30,EN,Norway,1387,170,695,18,1217,259,263,522,677
2022-10-31,EN,Norway,1664,182,942,17,1482,271,269,540,925
2022-11-01,EN,Norway,1570,142,955,8,1428,236,237,473,947
2022-11-02,EN,Norway,1645,178,950,19,1467,256,261,517,931
2022-11-03,EN,Norway,1639,168,947,11,1471,260,264,524,936
2022-11-04,EN,Norway,1657,182,924,14,1475,276,275,551,910
2022-11-05,EN,Norway,808,124,278,8,684,207,199,406,270
2022-11-06,EN,Norway,1329,176,644,10,1153,249,260,509,634
2022-11-07,EN,Norway,1675,194,949,19,1481,268,264,532,930
2022-11-08,EN,Norway,1531,155,929,6,1376,223,224,447,923
2022-11-09,EN,Norway,1592,186,924,18,1406,243,239,482,906
2022-11-10,EN,Norway,1655,153,971,15,1502,263,268,531,956
2022-11-11,EN,Norway,1636,154,925,18,1482,278,279,557,907
2022-11-12,EN,Norway,803,126,291,11,677,195,191,386,280
2022-11-13,EN,Norway,1285,138,636,4,1147,251,260,511,632
2022-11-14,EN,Norway,1547,147,884,6,1400,261,255,516,878
2022-11-15,EN,Norway,1493,151,908,13,1342,217,217,434,895
2022-11-16,EN,Norway,1526,168,902,11,1358,227,229,456,891
2022-11-17,EN,Norway,1630,196,932,10,1434,251,251,502,922
2022-11-18,EN,Norway,1659,195,912,9,1464,275,277,552,903
2022-11-19,EN,Norway,851,155,305,10,696,196,195,391,295
2022-11-20,EN,Norway,1341,195,631,10,1146,255,260,515,621
2022-11-21,EN,Norway,1642,220,923,8,1422,248,251,499,915
2022-11-22,EN,Norway,1507,173,914,5,1334,209,211,420,909
2022-11-23,EN,Norway,1526,159,909,4,1367,229,229,458,905
2022-11-24,EN,Norway,1647,179,958,4,1468,259,251,510,954
2022-11-25,EN,Norway,1690,228,917,5,1462,271,274,545,912
2022-11-26,EN,Norway,821,165,283,1,656,189,184,373,282
2022-11-27,EN,Norway,1325,205,635,14,1120,239,246,485,621
2022-11-28,EN,Norway,1666,235,936,14,1431,251,244,495,922
2022-11-29,EN,Norway,1491,160,907,15,1331,213,211,424,892
2022-11-30,EN,Norway,1569,192,920,19,1377,223,234,457,901
2022-12-01,EN,Norway,1665,177,957,23,1488,268,263,531,934
2022-12-02,EN,Norway,1599,191,882,12,1408,263,263,526,870
2022-12-03,EN,Norway,806,161,278,2,645,187,180,367,276
2022-12-04,EN,Norway,1348,247,610,7,1101,243,248,491,603
2022-12-05,EN,Norway,1616,212,915,28,1404,241,248,489,887
2022-12-06,EN,Norway,1435,171,848,20,1264,209,207,416,828
2022-12-07,EN,Norway,1484,228,817,20,1256,217,222,439,797
2022-12-08,EN,Norway,1590,191,894,26,1399,251,254,505,868
2022-12-09,EN,Norway,1683,233,912,22,1450,269,269,538,890
2022-12-10,EN,Norway,905,192,337,17,713,189,187,376,320
2022-12-11,EN,Norway,1369,269,620,5,1100,235,245,480,615
2022-12-12,EN,Norway,1614,242,902,26,1372,236,234,470,876
2022-12-13,EN,Norway,1411,172,830,15,1239,203,206,409,815
2022-12-14,EN,Norway,1558,243,859,22,1315,230,226,456,837
2022-12-15,EN,Norway,1573,214,852,23,1359,251,256,507,829
2022-12-16,EN,Norway,1390,201,713,8,1189,238,238,476,705
2022-12-17,EN,Norway,961,200,322,1,761,220,219,439,321
2022-12-18,EN,Norway,1383,274,594,4,1109,258,257,515,590
2022-12-19,EN,Norway,1470,163,822,11,1307,239,246,485,811
2022-12-20,EN,Norway,1521,184,850,6,1337,245,242,487,844
2022-12-21,EN,Norway,1542,202,835,6,1340,254,251,505,829
2022-12-22,EN,Norway,1637,258,857,10,1379,260,262,522,847
2022-12-23,EN,Norway,1478,210,762,11,1268,253,253,506,751
2022-12-24,EN,Norway,528,149,113,0,379,136,130,266,113
2022-12-25,EN,Norway,490,149,101,0,341,118,122,240,101
2022-12-26,EN,Norway,1198,252,528,5,946,209,209,418,523
2022-12-27,EN,Norway,1287,186,693,6,1101,204,204,408,687
2022-01-01,EP,Poland,1410,791,44,3,619,288,287,575,41
2022-01-02,EP,Poland,1983,1099,58,4,884,417,409,826,54
2022-01-03,EP,Poland,1792,888,76,2,904,411,417,828,74
2022-01-04,EP,Poland,1588,835,98,12,753,322,333,655,86
2022-01-05,EP,Poland,1610,833,100,15,777,342,335,677,85
2022-01-06,EP,Poland,1520,760,70,2,760,347,343,690,68
2022-01-07,EP,Poland,1794,919,97,18,875,389,389,778,79
2022-01-08,EP,Poland,1747,991,65,11,756,344,347,691,54
2022-01-09,EP,Poland,1950,1096,67,9,854,392,395,787,58
2022-01-10,EP,Poland,1606,870,106,27,736,312,318,630,79
2022-01-11,EP,Poland,1332,740,113,18,592,234,245,479,95
2022-01-12,EP,Poland,1349,722,112,26,627,266,249,515,86
2022-01-13,EP,Poland,1352,744,91,6,608,256,261,517,85
2022-01-14,EP,Poland,1550,856,91,8,694,298,305,603,83
2022-01-15,EP,Poland,1484,889,97,34,595,250,248,498,63
2022-01-16,EP,Poland,1472,851,73,13,621,275,273,548,60
2022-01-17,EP,Poland,1386,740,78,5,646,279,289,568,73
2022-01-18,EP,Poland,1228,671,124,27,557,214,219,433,97
2022-01-19,EP,Poland,1223,682,112,23,541,219,210,429,89
2022-01-20,EP,Poland,1256,691,80,4,565,243,242,485,76
2022-01-21,EP,Poland,1476,827,97,15,649,277,275,552,82
2022-01-22,EP,Poland,1314,782,67,3,532,233,232,465,64
2022-01-23,EP,Poland,1367,782,62,5,585,262,261,523,57
2022-01-24,EP,Poland,1259,644,84,13,615,256,275,531,71
2022-01-25,EP,Poland,1068,575,85,11,493,205,203,408,74
2022-01-26,EP,Poland,1182,663,84,10,519,214,221,435,74
2022-01-27,EP,Poland,1288,681,93,11,607,262,252,514,82
2022-01-28,EP,Poland,1486,830,77,8,656,292,287,579,69
2022-01-29,EP,Poland,1377,836,61,5,541,239,241,480,56
2022-01-30,EP,Poland,1369,800,45,1,569,263,261,524,44
2022-01-31,EP,Poland,1319,710,81,15,609,260,268,528,66
2022-02-01,EP,Poland,1200,660,83,14,540,233,224,457,69
2022-02-02,EP,Poland,1230,655,84,8,575,243,248,491,76
2022-02-03,EP,Poland,1341,705,95,26,636,274,267,541,69
2022-02-04,EP,Poland,1510,786,86,16,724,317,321,638,70
2022-02-05,EP,Poland,1370,768,61,7,602,274,267,541,54
2022-02-06,EP,Poland,1415,761,53,8,654,297,304,601,45
2022-02-07,EP,Poland,1342,648,84,16,694,300,310,610,68
2022-02-08,EP,Poland,1174,626,74,12,548,238,236,474,62
2022-02-09,EP,Poland,1280,665,87,23,615,265,263,528,64
2022-02-10,EP,Poland,1384,684,93,19,700,303,304,607,74
2022-02-11,EP,Poland,1599,817,95,18,782,340,347,687,77
2022-02-12,EP,Poland,1508,797,95,20,711,306,310,616,75
2022-02-13,EP,Poland,1549,812,75,19,737,330,332,662,56
2022-02-14,EP,Poland,1444,688,104,24,756,323,329,652,80
2022-02-15,EP,Poland,1274,650,94,22,624,266,264,530,72
2022-02-16,EP,Poland,1337,688,102,27,649,270,277,547,75
2022-02-17,EP,Poland,1278,670,59,9,608,282,267,549,50
2022-02-18,EP,Poland,1587,829,109,19,758,322,327,649,90
2022-02-19,EP,Poland,1500,883,48,1,617,287,282,569,47
2022-02-20,EP,Poland,1563,851,59,7,712,321,332,653,52
2022-02-21,EP,Poland,1410,707,70,3,703,313,320,633,67
2022-02-22,EP,Poland,1271,646,104,21,625,259,262,521,83
2022-02-23,EP,Poland,1297,669,78,8,628,274,276,550,70
2022-02-24,EP,Poland,1423,737,118,36,686,289,279,568,82
2022-02-25,EP,Poland,1606,817,104,30,789,338,347,685,74
2022-02-26,EP,Poland,1336,695,69,18,641,290,282,572,51
2022-02-27,EP,Poland,1277,556,72,16,721,320,329,649,56
2022-02-28,EP,Poland,1277,481,127,37,796,327,342,669,90
2022-03-01,EP,Poland,1168,441,120,22,727,308,299,607,98
2022-03-02,EP,Poland,1180,418,133,31,762,311,318,629,102
2022-03-03,EP,Poland,1276,483,113,27,793,346,334,680,86
2022-03-04,EP,Poland,1461,576,108,14,885,392,385,777,94
2022-03-05,EP,Poland,1334,598,66,9,736,339,331,670,57
2022-03-06,EP,Poland,1348,546,68,11,802,367,367,734,57
2022-03-07,EP,Poland,1314,454,126,24,860,356,378,734,102
2022-03-08,EP,Poland,1186,436,145,27,750,318,287,605,118
2022-03-09,EP,Poland,1167,427,101,17,740,310,329,639,84
2022-03-10,EP,Poland,1287,457,120,20,830,358,352,710,100
2022-03-11,EP,Poland,1406,531,98,15,875,386,391,777,83
2022-03-12,EP,Poland,1289,546,84,19,743,330,329,659,65
2022-03-13,EP,Poland,1322,528,69,10,794,363,362,725,59
2022-03-14,EP,Poland,1344,484,106,19,860,370,384,754,87
2022-03-15,EP,Poland,1175,449,100,15,726,317,309,626,85
2022-03-16,EP,Poland,1124,384,114,19,740,311,315,626,95
2022-03-17,EP,Poland,1215,405,123,15,810,346,341,687,108
2022-03-18,EP,Poland,1448,512,112,22,936,415,409,824,90
2022-03-19,EP,Poland,1227,518,73,14,709,319,317,636,59
2022-03-20,EP,Poland,1296,498,68,12,798,362,368,730,56
2022-03-21,EP,Poland,1296,436,102,14,860,374,384,758,88
2022-03-22,EP,Poland,1147,427,101,21,720,311,308,619,80
2022-03-23,EP,Poland,1213,405,112,29,808,349,347,696,83
2022-03-24,EP,Poland,1253,430,110,24,823,357,356,713,86
2022-03-25,EP,Poland,1444,536,113,22,908,398,397,795,91
2022-03-26,EP,Poland,1312,543,89,16,769,346,334,680,73
2022-03-27,EP,Poland,1366,540,80,9,826,369,377,746,71
2022-03-28,EP,Poland,1377,484,109,9,893,390,394,784,100
2022-03-29,EP,Poland,1371,476,124,20,895,387,384,771,104
2022-03-30,EP,Poland,1347,507,123,13,840,360,357,717,110
2022-03-31,EP,Poland,1464,522,107,12,942,422,413,835,95
2022-04-01,EP,Poland,1443,553,106,9,890,391,393,784,97
2022-04-02,EP,Poland,1394,616,61,5,778,358,359,717,56
2022-04-03,EP,Poland,1425,598,75,10,827,372,380,752,65
2022-04-04,EP,Poland,1362,500,109,16,862,380,373,753,93
2022-04-05,EP,Poland,1349,516,100,12,833,369,364,733,88
2022-04-06,EP,Poland,1362,510,120,22,852,369,363,732,98
2022-04-07,EP,Poland,1482,522,121,17,960,420,419,839,104
2022-04-08,EP,Poland,1445,518,111,10,927,399,417,816,101
2022-04-09,EP,Poland,1367,531,84,11,836,381,371,752,73
2022-04-10,EP,Poland,1306,442,84,14,864,392,388,780,70
2022-04-11,EP,Poland,1416,480,141,20,936,395,400,795,121
2022-04-12,EP,Poland,1391,507,108,17,884,389,387,776,91
2022-04-13,EP,Poland,1412,473,131,25,939,403,405,808,106
2022-04-14,EP,Poland,1510,501,119,25,1009,449,441,890,94
2022-04-15,EP,Poland,1535,595,105,10,940,418,417,835,95
2022-04-16,EP,Poland,1404,617,65,3,787,364,358,722,62
2022-04-17,EP,Poland,1376,587,62,1,789,365,362,727,61
2022-04-18,EP,Poland,1442,590,75,0,852,386,391,777,75
2022-04-19,EP,Poland,1454,556,107,14,898,391,400,791,93
2022-04-20,EP,Poland,1384,461,134,35,923,389,400,789,99
2022-04-21,EP,Poland,1426,460,118,19,966,425,423,848,99
2022-04-22,EP,Poland,1531,547,132,29,984,436,416,852,103
2022-04-23,EP,Poland,1425,585,82,12,840,370,388,758,70
2022-04-24,EP,Poland,1523,638,70,8,885,402,413,815,62
2022-04-25,EP,Poland,1528,552,127,22,976,426,423,849,105
2022-04-26,EP,Poland,1575,593,141,28,982,424,417,841,113
2022-04-27,EP,Poland,1521,529,130,30,992,432,430,862,100
2022-04-28,EP,Poland,1617,503,149,31,1114,485,480,965,118
2022-04-29,EP,Poland,1715,602,144,27,1113,478,491,969,117
2022-04-30,EP,Poland,1714,733,89,24,981,457,435,892,65
2022-05-01,EP,Poland,1734,720,92,1,1014,462,460,922,91
2022-05-02,EP,Poland,1605,655,111,11,950,422,417,839,100
2022-05-03,EP,Poland,1634,671,99,4,963,425,439,864,95
2022-05-04,EP,Poland,1682,642,153,33,1040,440,447,887,120
2022-05-05,EP,Poland,1749,645,136,22,1104,486,482,968,114
2022-05-06,EP,Poland,1782,682,148,18,1100,479,473,952,130
2022-05-07,EP,Poland,1791,777,98,20,1014,454,462,916,78
2022-05-08,EP,Poland,1798,752,110,12,1046,466,470,936,98
2022-05-09,EP,Poland,1754,681,149,21,1073,464,460,924,128
2022-05-10,EP,Poland,1738,697,148,21,1041,448,445,893,127
2022-05-11,EP,Poland,1751,698,157,21,1053,441,455,896,136
2022-05-12,EP,Poland,1830,700,160,26,1130,487,483,970,134
2022-05-13,EP,Poland,1888,765,164,27,1123,482,477,959,137
2022-05-14,EP,Poland,1852,862,83,12,990,454,453,907,71
2022-05-15,EP,Poland,1839,785,103,12,1054,481,470,951,91
2022-05-16,EP,Poland,1740,688,157,25,1052,451,444,895,132
2022-05-17,EP,Poland,1671,666,124,13,1005,440,441,881,111
2022-05-18,EP,Poland,1686,657,154,23,1029,437,438,875,131
2022-05-19,EP,Poland,1808,710,141,22,1098,482,475,957,119
2022-05-20,EP,Poland,1886,789,130,16,1097,480,487,967,114
2022-05-21,EP,Poland,1848,874,85,8,974,443,446,889,77
2022-05-22,EP,Poland,1844,807,111,12,1037,467,459,926,99
2022-05-23,EP,Poland,1814,743,163,24,1071,452,456,908,139
2022-05-24,EP,Poland,1749,700,152,28,1049,449,448,897,124
2022-05-25,EP,Poland,1737,727,132,19,1010,437,441,878,113
2022-05-26,EP,Poland,1876,780,139,18,1096,479,478,957,121
2022-05-27,EP,Poland,1896,782,149,28,1114,477,488,965,121
2022-05-28,EP,Poland,1898,900,93,20,998,457,448,905,73
2022-05-29,EP,Poland,1964,891,109,12,1073,485,479,964,97
2022-05-30,EP,Poland,1879,781,147,16,1098,474,477,951,131
2022-05-31,EP,Poland,1810,752,135,16,1058,459,464,923,119
2022-06-01,EP,Poland,1842,745,133,17,1097,481,483,964,116
2022-06-02,EP,Poland,1950,730,150,20,1220,538,532,1070,130
2022-06-03,EP,Poland,2070,843,149,17,1227,537,541,1078,132
2022-06-04,EP,Poland,2004,942,85,9,1062,492,485,977,76
2022-06-05,EP,Poland,2019,886,109,13,1133,509,515,1024,96
2022-06-06,EP,Poland,1943,782,155,20,1161,504,502,1006,135
2022-06-07,EP,Poland,1900,790,139,22,1110,488,483,971,117
2022-06-08,EP,Poland,1894,724,149,24,1170,511,510,1021,125
2022-06-09,EP,Poland,1986,802,118,11,1184,526,540,1066,107
2022-06-10,EP,Poland,2123,845,161,12,1278,558,559,1117,149
2022-06-11,EP,Poland,2127,1018,96,13,1109,507,506,1013,83
2022-06-12,EP,Poland,2129,923,111,13,1206,547,548,1095,98
2022-06-13,EP,Poland,1976,805,140,22,1171,514,517,1031,118
2022-06-14,EP,Poland,2010,787,160,30,1223,532,531,1063,130
2022-06-15,EP,Poland,2036,815,139,20,1221,548,534,1082,119
2022-06-16,EP,Poland,2051,894,107,7,1157,527,523,1050,100
2022-06-17,EP,Poland,2113,879,122,11,1234,557,555,1112,111
2022-06-18,EP,Poland,2146,1027,87,9,1119,520,512,1032,78
2022-06-19,EP,Poland,2238,1016,112,6,1222,543,567,1110,106
2022-06-20,EP,Poland,2089,873,141,20,1216,531,544,1075,121
2022-06-21,EP,Poland,2069,856,138,18,1213,538,537,1075,120
2022-06-22,EP,Poland,2105,868,155,28,1237,543,539,1082,127
2022-06-23,EP,Poland,2137,862,149,28,1275,568,558,1126,121
2022-06-24,EP,Poland,2193,956,137,25,1237,552,548,1100,112
2022-06-25,EP,Poland,2149,1050,87,9,1099,505,507,1012,78
2022-06-26,EP,Poland,2240,1047,107,6,1193,541,545,1086,101
2022-06-27,EP,Poland,2186,993,143,18,1193,525,525,1050,125
2022-06-28,EP,Poland,2115,947,121,20,1168,527,520,1047,101
2022-06-29,EP,Poland,2194,989,137,26,1205,527,541,1068,111
2022-06-30,EP,Poland,2236,967,147,25,1269,562,560,1122,122
2022-07-01,EP,Poland,2267,1001,157,19,1266,552,557,1109,138
2022-07-02,EP,Poland,2202,1089,79,9,1113,525,509,1034,70
2022-07-03,EP,Poland,2284,1094,106,10,1190,544,540,1084,96
2022-07-04,EP,Poland,2175,988,142,19,1187,516,529,1045,123
2022-07-05,EP,Poland,2075,887,141,33,1188,525,522,1047,108
2022-07-06,EP,Poland,2116,883,150,31,1233,543,540,1083,119
2022-07-07,EP,Poland,2151,932,128,18,1219,548,543,1091,110
2022-07-08,EP,Poland,2249,1014,137,17,1235,553,545,1098,120
2022-07-09,EP,Poland,2165,1046,84,7,1119,516,519,1035,77
2022-07-10,EP,Poland,2210,1036,102,8,1174,536,536,1072,94
2022-07-11,EP,Poland,2107,944,136,17,1163,505,522,1027,119
2022-07-12,EP,Poland,2070,900,122,20,1170,523,525,1048,102
2022-07-13,EP,Poland,2070,888,133,30,1182,527,522,1049,103
2022-07-14,EP,Poland,2215,944,160,25,1271,558,553,1111,135
2022-07-15,EP,Poland,2245,983,147,19,1262,563,552,1115,128
2022-07-16,EP,Poland,2165,1032,88,12,1133,520,525,1045,76
2022-07-17,EP,Poland,2200,1005,113,6,1195,541,541,1082,107
2022-07-18,EP,Poland,2078,930,127,11,1148,503,518,1021,116
2022-07-19,EP,Poland,2116,943,122,14,1173,525,526,1051,108
2022-07-20,EP,Poland,2172,962,150,31,1210,531,529,1060,119
2022-07-21,EP,Poland,2195,938,145,27,1257,558,554,1112,118
2022-07-22,EP,Poland,2254,1003,142,23,1251,556,553,1109,119
2022-07-23,EP,Poland,2201,1096,97,9,1105,503,505,1008,88
2022-07-24,EP,Poland,2235,1060,101,8,1175,540,534,1074,93
2022-07-25,EP,Poland,2155,991,135,14,1164,507,522,1029,121
2022-07-26,EP,Poland,2085,926,118,20,1159,520,521,1041,98
2022-07-27,EP,Poland,2054,901,154,31,1153,506,493,999,123
2022-07-28,EP,Poland,2138,929,141,24,1209,528,540,1068,117
2022-07-29,EP,Poland,2276,1036,133,16,1240,554,553,1107,117
2022-07-30,EP,Poland,2205,1109,96,17,1096,501,499,1000,79
2022-07-31,EP,Poland,2265,1091,106,9,1174,530,538,1068,97
2022-08-01,EP,Poland,2141,965,144,26,1176,516,516,1032,118
2022-08-02,EP,Poland,2114,956,133,22,1158,516,509,1025,111
2022-08-03,EP,Poland,2132,965,140,24,1167,518,509,1027,116
2022-08-04,EP,Poland,2199,955,147,28,1244,547,550,1097,119
2022-08-05,EP,Poland,2298,1044,142,21,1254,554,558,1112,121
2022-08-06,EP,Poland,2212,1100,84,10,1112,520,508,1028,74
2022-08-07,EP,Poland,2270,1088,100,13,1182,535,547,1082,87
2022-08-08,EP,Poland,2125,946,148,25,1179,517,514,1031,123
2022-08-09,EP,Poland,2096,934,131,31,1162,513,518,1031,100
2022-08-10,EP,Poland,2104,915,149,30,1189,526,514,1040,119
2022-08-11,EP,Poland,2159,931,130,17,1228,547,551,1098,113
2022-08-12,EP,Poland,2263,1003,136,13,1260,565,559,1124,123
2022-08-13,EP,Poland,2179,1070,88,12,1109,513,508,1021,76
2022-08-14,EP,Poland,2206,1031,96,7,1175,538,541,1079,89
2022-08-15,EP,Poland,2083,928,126,8,1155,507,522,1029,118
2022-08-16,EP,Poland,1986,821,123,24,1165,518,524,1042,99
2022-08-17,EP,Poland,2020,838,131,20,1182,527,524,1051,111
2022-08-18,EP,Poland,2100,847,156,21,1253,547,550,1097,135
2022-08-19,EP,Poland,2194,945,154,19,1249,551,544,1095,135
2022-08-20,EP,Poland,2161,1059,84,13,1102,514,504,1018,71
2022-08-21,EP,Poland,2193,1022,98,8,1171,533,540,1073,90
2022-08-22,EP,Poland,2028,816,168,17,1212,516,528,1044,151
2022-08-23,EP,Poland,1963,804,133,28,1159,513,513,1026,105
2022-08-24,EP,Poland,2021,811,134,22,1210,538,538,1076,112
2022-08-25,EP,Poland,2099,841,151,33,1258,557,550,1107,118
2022-08-26,EP,Poland,2175,916,142,19,1259,556,561,1117,123
2022-08-27,EP,Poland,2250,1087,96,17,1163,535,532,1067,79
2022-08-28,EP,Poland,2139,969,102,13,1170,528,540,1068,89
2022-08-29,EP,Poland,2053,812,169,31,1241,534,538,1072,138
2022-08-30,EP,Poland,1966,808,121,23,1158,520,517,1037,98
2022-08-31,EP,Poland,2051,792,167,34,1259,542,550,1092,133
2022-09-01,EP,Poland,2091,844,149,19,1247,556,542,1098,130
2022-09-02,EP,Poland,2089,856,137,23,1233,550,546,1096,114
2022-09-03,EP,Poland,2108,1036,86,14,1072,492,494,986,72
2022-09-04,EP,Poland,2180,957,121,13,1223,551,551,1102,108
2022-09-05,EP,Poland,2063,824,163,33,1239,530,546,1076,130
2022-09-06,EP,Poland,1995,805,142,30,1190,530,518,1048,112
2022-09-07,EP,Poland,2052,819,169,31,1233,538,526,1064,138
2022-09-08,EP,Poland,2055,847,127,22,1208,539,542,1081,105
2022-09-09,EP,Poland,2212,924,145,33,1288,572,571,1143,112
2022-09-10,EP,Poland,2158,1040,95,5,1118,512,511,1023,90
2022-09-11,EP,Poland,2198,992,95,3,1206,549,562,1111,92
2022-09-12,EP,Poland,2039,816,151,24,1223,532,540,1072,127
2022-09-13,EP,Poland,2001,801,150,28,1200,526,524,1050,122
2022-09-14,EP,Poland,2063,830,134,24,1233,555,544,1099,110
2022-09-15,EP,Poland,2084,844,154,16,1240,545,541,1086,138
2022-09-16,EP,Poland,2154,902,154,30,1252,553,545,1098,124
2022-09-17,EP,Poland,2153,1040,99,18,1113,505,509,1014,81
2022-09-18,EP,Poland,2251,1049,107,8,1202,545,550,1095,99
2022-09-19,EP,Poland,2119,887,149,26,1232,540,543,1083,123
2022-09-20,EP,Poland,2027,862,146,26,1165,507,512,1019,120
2022-09-21,EP,Poland,2016,786,172,34,1230,531,527,1058,138
2022-09-22,EP,Poland,2095,840,161,27,1255,546,548,1094,134
2022-09-23,EP,Poland,2143,916,151,32,1227,545,531,1076,119
2022-09-24,EP,Poland,2092,1004,102,25,1088,489,497,986,77
2022-09-25,EP,Poland,2126,950,109,10,1176,538,529,1067,99
2022-09-26,EP,Poland,1985,800,135,19,1185,516,534,1050,116
2022-09-27,EP,Poland,1978,818,161,29,1160,495,504,999,132
2022-09-28,EP,Poland,2033,805,187,39,1228,527,514,1041,148
2022-09-29,EP,Poland,2029,827,137,23,1202,537,528,1065,114
2022-09-30,EP,Poland,2073,895,135,11,1178,522,521,1043,124
2022-10-01,EP,Poland,2097,1047,89,12,1050,477,484,961,77
2022-10-02,EP,Poland,2089,963,95,10,1126,514,517,1031,85
2022-10-03,EP,Poland,1921,759,152,24,1162,500,510,1010,128
2022-10-04,EP,Poland,1865,778,135,24,1087,476,476,952,111
2022-10-05,EP,Poland,1894,800,136,30,1094,476,482,958,106
2022-10-06,EP,Poland,1964,789,161,36,1175,515,499,1014,125
2022-10-07,EP,Poland,2003,840,140,23,1163,508,515,1023,117
2022-10-08,EP,Poland,1965,943,91,15,1022,470,461,931,76
2022-10-09,EP,Poland,1986,896,108,15,1090,485,497,982,93
2022-10-10,EP,Poland,1871,743,155,19,1128,481,492,973,136
2022-10-11,EP,Poland,1776,718,147,20,1058,456,455,911,127
2022-10-12,EP,Poland,1810,712,153,35,1098,473,472,945,118
2022-10-13,EP,Poland,1902,769,154,31,1133,494,485,979,123
2022-10-14,EP,Poland,2048,857,158,34,1191,516,517,1033,124
2022-10-15,EP,Poland,1912,912,95,15,1000,457,448,905,80
2022-10-16,EP,Poland,1973,911,106,16,1062,476,480,956,90
2022-10-17,EP,Poland,1845,768,165,33,1077,451,461,912,132
2022-10-18,EP,Poland,1767,714,150,31,1053,449,454,903,119
2022-10-19,EP,Poland,1771,715,168,22,1056,446,442,888,146
2022-10-20,EP,Poland,1878,729,171,26,1149,496,482,978,145
2022-10-21,EP,Poland,1948,839,171,30,1109,474,464,938,141
2022-10-22,EP,Poland,1869,889,86,11,980,452,442,894,75
2022-10-23,EP,Poland,1909,901,101,8,1008,452,455,907,93
2022-10-24,EP,Poland,1795,740,149,22,1055,453,453,906,127
2022-10-25,EP,Poland,1754,693,162,27,1061,446,453,899,135
2022-10-26,EP,Poland,1745,693,153,23,1052,451,448,899,130
2022-10-27,EP,Poland,1817,712,163,33,1105,479,463,942,130
2022-10-28,EP,Poland,1841,757,157,24,1084,461,466,927,133
2022-10-29,EP,Poland,1772,820,96,21,952,423,433,856,75
2022-10-30,EP,Poland,1662,737,97,15,925,413,415,828,82
2022-10-31,EP,Poland,1559,659,101,14,900,401,398,799,87
2022-11-01,EP,Poland,1350,586,89,1,764,332,343,675,88
2022-11-02,EP,Poland,1447,614,128,20,833,346,359,705,108
2022-11-03,EP,Poland,1550,622,148,26,928,398,382,780,122
2022-11-04,EP,Poland,1706,693,143,25,1013,430,440,870,118
2022-11-05,EP,Poland,1534,668,87,15,866,395,384,779,72
2022-11-06,EP,Poland,1631,729,94,13,902,399,409,808,81
2022-11-07,EP,Poland,1567,625,134,25,942,400,408,808,109
2022-11-08,EP,Poland,1351,541,134,24,810,339,337,676,110
2022-11-09,EP,Poland,1452,584,160,27,868,352,356,708,133
2022-11-10,EP,Poland,1461,549,123,19,912,408,381,789,104
2022-11-11,EP,Poland,1571,656,110,18,915,402,403,805,92
2022-11-12,EP,Poland,1484,624,88,16,860,385,387,772,72
2022-11-13,EP,Poland,1537,646,90,12,891,400,401,801,78
2022-11-14,EP,Poland,1499,538,132,23,961,415,414,829,109
2022-11-15,EP,Poland,1342,531,122,18,811,335,354,689,104
2022-11-16,EP,Poland,1323,520,125,22,803,344,334,678,103
2022-11-17,EP,Poland,1434,549,133,30,885,381,371,752,103
2022-11-18,EP,Poland,1542,591,122,19,951,412,417,829,103
2022-11-19,EP,Poland,1411,574,83,13,837,376,378,754,70
2022-11-20,EP,Poland,1472,611,93,9,861,383,385,768,84
2022-11-21,EP,Poland,1421,513,101,16,908,407,400,807,85
2022-11-22,EP,Poland,1321,503,117,14,818,343,358,701,103
2022-11-23,EP,Poland,1300,512,109,13,788,342,337,679,96
2022-11-24,EP,Poland,1374,558,89,4,816,367,360,727,85
2022-11-25,EP,Poland,1549,590,102,3,959,431,426,857,99
2022-11-26,EP,Poland,1359,563,68,0,796,365,363,728,68
2022-11-27,EP,Poland,1450,590,81,5,860,386,393,779,76
2022-11-28,EP,Poland,1470,540,127,36,930,403,400,803,91
2022-11-29,EP,Poland,1280,474,127,21,806,336,343,679,106
2022-11-30,EP,Poland,1285,488,98,11,797,350,349,699,87
2022-12-01,EP,Poland,1398,509,118,17,889,393,378,771,101
2022-12-02,EP,Poland,1510,546,109,9,964,427,428,855,100
2022-12-03,EP,Poland,1366,537,76,6,829,373,380,753,70
2022-12-04,EP,Poland,1420,566,83,6,854,383,388,771,77
2022-12-05,EP,Poland,1466,540,119,14,926,404,403,807,105
2022-12-06,EP,Poland,1254,471,102,9,783,346,335,681,93
2022-12-07,EP,Poland,1288,500,99,6,788,341,348,689,93
2022-12-08,EP,Poland,1391,493,124,19,898,386,388,774,105
2022-12-09,EP,Poland,1538,564,133,21,974,419,422,841,112
2022-12-10,EP,Poland,1374,530,78,10,844,382,384,766,68
2022-12-11,EP,Poland,1407,571,76,7,836,382,378,760,69
2022-12-12,EP,Poland,1465,548,111,15,917,405,401,806,96
2022-12-13,EP,Poland,1389,526,131,22,863,364,368,732,109
2022-12-14,EP,Poland,1307,479,129,30,828,351,348,699,99
2022-12-15,EP,Poland,1479,549,112,13,930,416,402,818,99
2022-12-16,EP,Poland,1535,595,103,10,940,412,425,837,93
2022-12-17,EP,Poland,1477,602,85,12,875,398,392,790,73
2022-12-18,EP,Poland,1521,622,80,3,899,409,410,819,77
2022-12-19,EP,Poland,1507,561,108,26,946,418,420,838,82
2022-12-20,EP,Poland,1467,561,123,18,906,381,402,783,105
2022-12-21,EP,Poland,1435,547,89,12,888,406,393,799,77
2022-12-22,EP,Poland,1539,583,112,11,956,425,419,844,101
2022-12-23,EP,Poland,1650,622,88,4,1028,469,471,940,84
2022-12-24,EP,Poland,1215,535,57,3,680,309,314,623,54
2022-12-25,EP,Poland,933,480,62,2,453,201,190,391,60
2022-12-26,EP,Poland,1350,554,75,1,796,363,358,721,74
2022-12-27,EP,Poland,1364,537,103,11,827,365,359,724,92
2022-01-01,LP,Portugal,1760,926,106,1,834,372,356,728,105
2022-01-02,LP,Portugal,1892,938,164,0,954,391,399,790,164
2022-01-03,LP,Portugal,1786,820,143,0,966,404,419,823,143
2022-01-04,LP,Portugal,1661,890,120,0,771,323,328,651,120
2022-01-05,LP,Portugal,1560,838,121,0,722,312,289,601,121
2022-01-06,LP,Portugal,1510,777,125,1,733,304,304,608,124
2022-01-07,LP,Portugal,1684,846,132,1,838,351,355,706,131
2022-01-08,LP,Portugal,1992,1146,116,1,846,366,364,730,115
2022-01-09,LP,Portugal,1841,987,116,0,854,365,373,738,116
2022-01-10,LP,Portugal,1451,746,120,2,705,294,291,585,118
2022-01-11,LP,Portugal,1204,670,116,4,534,197,221,418,112
2022-01-12,LP,Portugal,1196,646,114,6,550,235,201,436,108
2022-01-13,LP,Portugal,1142,601,113,4,541,206,222,428,109
2022-01-14,LP,Portugal,1405,687,133,6,718,304,281,585,127
2022-01-15,LP,Portugal,1613,944,106,5,669,275,288,563,101
2022-01-16,LP,Portugal,1489,766,125,9,723,302,296,598,116
2022-01-17,LP,Portugal,1296,611,123,4,685,275,287,562,119
2022-01-18,LP,Portugal,1096,608,93,1,488,189,206,395,92
2022-01-19,LP,Portugal,1157,618,121,2,539,221,197,418,119
2022-01-20,LP,Portugal,1168,630,113,7,538,204,221,425,106
2022-01-21,LP,Portugal,1409,687,135,5,722,297,290,587,130
2022-01-22,LP,Portugal,1595,939,108,4,656,269,279,548,104
2022-01-23,LP,Portugal,1491,795,112,0,696,298,286,584,112
2022-01-24,LP,Portugal,1289,593,128,6,696,276,292,568,122
2022-01-25,LP,Portugal,1105,604,107,7,501,194,200,394,100
2022-01-26,LP,Portugal,1172,642,104,2,530,229,197,426,102
2022-01-27,LP,Portugal,1182,642,105,2,540,211,224,435,103
2022-01-28,LP,Portugal,1402,675,134,6,727,303,290,593,128
2022-01-29,LP,Portugal,1673,1011,108,3,662,276,278,554,105
2022-01-30,LP,Portugal,1543,826,115,8,717,303,299,602,107
2022-01-31,LP,Portugal,1347,672,117,4,675,268,290,558,113
2022-02-01,LP,Portugal,1181,649,100,4,532,208,224,432,96
2022-02-02,LP,Portugal,1180,609,112,13,571,243,216,459,99
2022-02-03,LP,Portugal,1277,667,115,8,610,246,249,495,107
2022-02-04,LP,Portugal,1625,866,120,5,759,323,316,639,115
2022-02-05,LP,Portugal,1936,1198,104,2,738,315,319,634,102
2022-02-06,LP,Portugal,1703,967,106,3,736,311,319,630,103
2022-02-07,LP,Portugal,1471,710,116,1,761,313,332,645,115
2022-02-08,LP,Portugal,1223,667,102,6,556,230,224,454,96
2022-02-09,LP,Portugal,1268,654,110,7,614,258,246,504,103
2022-02-10,LP,Portugal,1404,702,114,5,702,291,297,588,109
2022-02-11,LP,Portugal,1593,763,128,3,830,356,346,702,125
2022-02-12,LP,Portugal,1907,1053,108,3,854,375,371,746,105
2022-02-13,LP,Portugal,1634,813,124,7,821,346,351,697,117
2022-02-14,LP,Portugal,1527,711,123,2,816,344,349,693,121
2022-02-15,LP,Portugal,1297,678,107,5,619,251,261,512,102
2022-02-16,LP,Portugal,1362,690,118,7,672,289,265,554,111
2022-02-17,LP,Portugal,1447,723,118,3,724,300,306,606,115
2022-02-18,LP,Portugal,1645,809,129,3,836,360,347,707,126
2022-02-19,LP,Portugal,2137,1235,112,4,902,392,398,790,108
2022-02-20,LP,Portugal,1833,976,112,8,857,373,372,745,104
2022-02-21,LP,Portugal,1596,750,117,0,846,357,372,729,117
2022-02-22,LP,Portugal,1437,767,120,7,670,264,286,550,113
2022-02-23,LP,Portugal,1502,783,130,3,719,304,285,589,127
2022-02-24,LP,Portugal,1610,809,121,4,801,349,331,680,117
2022-02-25,LP,Portugal,1738,851,136,7,887,373,378,751,129
2022-02-26,LP,Portugal,2039,1119,127,6,920,399,394,793,121
2022-02-27,LP,Portugal,1893,1016,121,7,877,383,373,756,114
2022-02-28,LP,Portugal,1599,727,134,3,872,361,377,738,131
2022-03-01,LP,Portugal,1499,789,122,5,710,287,301,588,117
2022-03-02,LP,Portugal,1466,749,131,7,717,297,289,586,124
2022-03-03,LP,Portugal,1573,782,118,1,791,336,337,673,117
2022-03-04,LP,Portugal,1765,849,139,4,916,395,382,777,135
2022-03-05,LP,Portugal,2069,1147,123,4,922,402,397,799,119
2022-03-06,LP,Portugal,1841,929,126,6,912,394,392,786,120
2022-03-07,LP,Portugal,1622,757,133,4,865,359,373,732,129
2022-03-08,LP,Portugal,1452,771,103,5,681,279,299,578,98
2022-03-09,LP,Portugal,1452,738,118,7,714,312,284,596,111
2022-03-10,LP,Portugal,1608,809,122,6,799,335,342,677,116
2022-03-11,LP,Portugal,1712,824,136,6,888,378,374,752,130
2022-03-12,LP,Portugal,2036,1118,125,5,918,398,395,793,120
2022-03-13,LP,Portugal,1921,1013,129,3,908,393,386,779,126
2022-03-14,LP,Portugal,1515,710,93,3,805,351,361,712,90
2022-03-15,LP,Portugal,1417,715,91,4,702,302,309,611,87
2022-03-16,LP,Portugal,1538,749,132,5,789,334,323,657,127
2022-03-17,LP,Portugal,1606,796,123,3,810,349,338,687,120
2022-03-18,LP,Portugal,1726,790,138,4,936,397,401,798,134
2022-03-19,LP,Portugal,2096,1132,122,6,964,416,426,842,116
2022-03-20,LP,Portugal,1887,959,128,0,928,404,396,800,128
2022-03-21,LP,Portugal,1644,743,136,1,901,376,389,765,135
2022-03-22,LP,Portugal,1525,792,122,3,733,299,312,611,119
2022-03-23,LP,Portugal,1454,718,134,5,736,310,292,602,129
2022-03-24,LP,Portugal,1596,765,133,8,831,349,349,698,125
2022-03-25,LP,Portugal,1763,816,144,8,947,396,407,803,136
2022-03-26,LP,Portugal,2089,1109,145,9,980,421,414,835,136
2022-03-27,LP,Portugal,2080,972,162,7,1108,481,465,946,155
2022-03-28,LP,Portugal,1778,743,164,6,1035,426,445,871,158
2022-03-29,LP,Portugal,1734,790,165,9,944,382,397,779,156
2022-03-30,LP,Portugal,1751,753,176,9,998,422,400,822,167
2022-03-31,LP,Portugal,1867,829,168,6,1038,431,439,870,162
2022-04-01,LP,Portugal,1937,805,179,6,1132,474,479,953,173
2022-04-02,LP,Portugal,2290,1150,168,5,1140,487,485,972,163
2022-04-03,LP,Portugal,2138,999,162,1,1139,493,484,977,161
2022-04-04,LP,Portugal,1804,698,169,6,1106,461,476,937,163
2022-04-05,LP,Portugal,1755,790,169,5,965,392,404,796,164
2022-04-06,LP,Portugal,1824,797,173,4,1027,432,422,854,169
2022-04-07,LP,Portugal,1936,855,171,6,1081,457,453,910,165
2022-04-08,LP,Portugal,2001,826,172,6,1175,510,493,1003,166
2022-04-09,LP,Portugal,2320,1123,179,8,1197,508,510,1018,171
2022-04-10,LP,Portugal,2072,923,159,2,1149,492,498,990,157
2022-04-11,LP,Portugal,1882,768,179,1,1114,461,474,935,178
2022-04-12,LP,Portugal,1906,878,176,3,1028,427,425,852,173
2022-04-13,LP,Portugal,1933,844,178,11,1089,464,447,911,167
2022-04-14,LP,Portugal,1959,836,176,7,1123,469,478,947,169
2022-04-15,LP,Portugal,1931,789,176,6,1142,483,483,966,170
2022-04-16,LP,Portugal,2268,1074,179,2,1194,506,509,1015,177
2022-04-17,LP,Portugal,2084,918,164,2,1166,502,500,1002,162
2022-04-18,LP,Portugal,2007,836,185,4,1171,491,495,986,181
2022-04-19,LP,Portugal,1913,895,180,7,1018,413,425,838,173
2022-04-20,LP,Portugal,1960,854,181,4,1106,476,449,925,177
2022-04-21,LP,Portugal,2011,890,176,5,1121,471,474,945,171
2022-04-22,LP,Portugal,1991,836,165,1,1155,502,488,990,164
2022-04-23,LP,Portugal,2310,1111,167,3,1199,519,513,1032,164
2022-04-24,LP,Portugal,2145,953,164,1,1192,519,509,1028,163
2022-04-25,LP,Portugal,1973,802,172,8,1171,486,513,999,164
2022-04-26,LP,Portugal,1789,750,166,4,1039,438,435,873,162
2022-04-27,LP,Portugal,1804,727,173,8,1077,456,448,904,165
2022-04-28,LP,Portugal,1847,740,175,10,1107,465,467,932,165
2022-04-29,LP,Portugal,1936,771,179,11,1165,490,496,986,168
2022-04-30,LP,Portugal,2227,1030,170,1,1197,514,513,1027,169
2022-05-01,LP,Portugal,2061,839,166,1,1222,533,523,1056,165
2022-05-02,LP,Portugal,1953,783,177,4,1170,483,510,993,173
2022-05-03,LP,Portugal,1776,728,180,1,1048,429,439,868,179
2022-05-04,LP,Portugal,1888,740,186,6,1148,493,469,962,180
2022-05-05,LP,Portugal,1889,740,183,9,1149,481,485,966,174
2022-05-06,LP,Portugal,1875,699,176,5,1176,507,493,1000,171
2022-05-07,LP,Portugal,2045,861,172,6,1184,510,502,1012,166
2022-05-08,LP,Portugal,1978,781,164,6,1197,514,519,1033,158
2022-05-09,LP,Portugal,1871,683,178,6,1188,499,511,1010,172
2022-05-10,LP,Portugal,1745,721,180,11,1024,418,426,844,169
2022-05-11,LP,Portugal,1803,697,183,5,1106,468,455,923,178
2022-05-12,LP,Portugal,1936,780,193,4,1156,483,480,963,189
2022-05-13,LP,Portugal,1850,681,178,5,1169,500,491,991,173
2022-05-14,LP,Portugal,2051,876,163,4,1175,505,507,1012,159
2022-05-15,LP,Portugal,1991,770,171,1,1221,530,520,1050,170
2022-05-16,LP,Portugal,1910,706,178,5,1204,502,524,1026,173
2022-05-17,LP,Portugal,1772,723,184,9,1049,428,437,865,175
2022-05-18,LP,Portugal,1831,689,184,8,1142,487,471,958,176
2022-05-19,LP,Portugal,1865,700,180,9,1165,501,484,985,171
2022-05-20,LP,Portugal,1836,648,183,7,1188,494,511,1005,176
2022-05-21,LP,Portugal,2059,841,177,3,1218,522,519,1041,174
2022-05-22,LP,Portugal,1945,733,158,7,1212,528,526,1054,151
2022-05-23,LP,Portugal,2144,886,202,14,1258,527,529,1056,188
2022-05-24,LP,Portugal,1991,853,187,9,1138,476,475,951,178
2022-05-25,LP,Portugal,1949,758,193,8,1191,502,496,998,185
2022-05-26,LP,Portugal,1944,729,183,11,1215,518,514,1032,172
2022-05-27,LP,Portugal,1960,739,186,4,1221,515,520,1035,182
2022-05-28,LP,Portugal,2104,879,174,4,1225,520,531,1051,170
2022-05-29,LP,Portugal,2041,794,172,3,1247,543,532,1075,169
2022-05-30,LP,Portugal,1891,644,178,9,1247,525,544,1069,169
2022-05-31,LP,Portugal,1814,668,199,12,1146,477,470,947,187
2022-06-01,LP,Portugal,1873,668,184,7,1205,515,506,1021,177
2022-06-02,LP,Portugal,1996,768,171,7,1228,524,533,1057,164
2022-06-03,LP,Portugal,2001,731,189,9,1270,540,541,1081,180
2022-06-04,LP,Portugal,2170,899,177,3,1271,540,554,1094,174
2022-06-05,LP,Portugal,2059,795,173,5,1264,554,537,1091,168
2022-06-06,LP,Portugal,2033,751,169,8,1282,550,563,1113,161
2022-06-07,LP,Portugal,1892,724,179,4,1168,492,497,989,175
2022-06-08,LP,Portugal,1899,716,186,8,1183,501,496,997,178
2022-06-09,LP,Portugal,1976,751,195,4,1225,519,511,1030,191
2022-06-10,LP,Portugal,1910,659,192,4,1251,535,524,1059,188
2022-06-11,LP,Portugal,2180,883,191,5,1297,552,554,1106,186
2022-06-12,LP,Portugal,2048,768,190,3,1280,542,548,1090,187
2022-06-13,LP,Portugal,1977,697,191,7,1280,545,544,1089,184
2022-06-14,LP,Portugal,1863,678,189,4,1185,495,501,996,185
2022-06-15,LP,Portugal,1912,680,186,5,1232,526,520,1046,181
2022-06-16,LP,Portugal,1974,727,189,6,1247,531,527,1058,183
2022-06-17,LP,Portugal,1992,712,189,7,1280,553,538,1091,182
2022-06-18,LP,Portugal,2114,844,187,6,1270,539,544,1083,181
2022-06-19,LP,Portugal,2086,784,184,2,1302,561,557,1118,182
2022-06-20,LP,Portugal,2054,745,206,6,1309,538,565,1103,200
2022-06-21,LP,Portugal,1998,786,207,7,1212,507,498,1005,200
2022-06-22,LP,Portugal,2047,818,211,7,1229,516,502,1018,204
2022-06-23,LP,Portugal,2092,854,205,7,1238,517,516,1033,198
2022-06-24,LP,Portugal,2020,752,206,8,1268,520,542,1062,198
2022-06-25,LP,Portugal,2216,904,211,3,1312,549,552,1101,208
2022-06-26,LP,Portugal,2180,841,218,4,1339,563,558,1121,214
2022-06-27,LP,Portugal,2086,759,209,4,1327,556,562,1118,205
2022-06-28,LP,Portugal,1956,751,204,10,1205,495,506,1001,194
2022-06-29,LP,Portugal,2000,749,212,7,1251,535,504,1039,205
2022-06-30,LP,Portugal,2131,843,208,14,1288,533,547,1080,194
2022-07-01,LP,Portugal,2039,723,209,10,1316,547,560,1107,199
2022-07-02,LP,Portugal,2244,895,216,6,1349,570,563,1133,210
2022-07-03,LP,Portugal,2185,844,208,5,1341,569,564,1133,203
2022-07-04,LP,Portugal,2167,787,209,7,1380,583,588,1171,202
2022-07-05,LP,Portugal,2049,816,203,5,1233,516,514,1030,198
2022-07-06,LP,Portugal,2079,809,212,8,1270,533,525,1058,204
2022-07-07,LP,Portugal,2118,822,204,1,1296,546,546,1092,203
2022-07-08,LP,Portugal,2102,767,198,3,1335,571,566,1137,195
2022-07-09,LP,Portugal,2248,902,205,1,1346,564,577,1141,204
2022-07-10,LP,Portugal,2144,801,202,0,1343,578,563,1141,202
2022-07-11,LP,Portugal,2144,779,200,2,1365,577,588,1165,198
2022-07-12,LP,Portugal,2080,798,193,3,1282,550,539,1089,190
2022-07-13,LP,Portugal,2007,772,191,2,1235,527,517,1044,189
2022-07-14,LP,Portugal,2106,826,212,2,1280,527,541,1068,210
2022-07-15,LP,Portugal,2107,791,203,3,1316,562,551,1113,200
2022-07-16,LP,Portugal,2292,937,213,0,1355,562,580,1142,213
2022-07-17,LP,Portugal,2202,863,214,0,1339,566,559,1125,214
2022-07-18,LP,Portugal,2148,753,207,3,1395,599,589,1188,204
2022-07-19,LP,Portugal,2093,829,215,5,1264,522,527,1049,210
2022-07-20,LP,Portugal,2100,786,205,0,1314,558,551,1109,205
2022-07-21,LP,Portugal,2061,768,202,2,1293,542,549,1091,200
2022-07-22,LP,Portugal,2096,765,201,3,1331,569,561,1130,198
2022-07-23,LP,Portugal,2312,923,205,1,1389,595,589,1184,204
2022-07-24,LP,Portugal,2203,842,202,0,1361,585,574,1159,202
2022-07-25,LP,Portugal,2162,791,208,3,1371,572,591,1163,205
2022-07-26,LP,Portugal,2100,831,210,3,1269,525,534,1059,207
2022-07-27,LP,Portugal,2026,766,206,3,1260,534,520,1054,203
2022-07-28,LP,Portugal,2178,875,206,0,1303,549,548,1097,206
2022-07-29,LP,Portugal,2139,817,205,1,1322,559,558,1117,204
2022-07-30,LP,Portugal,2325,942,211,3,1383,587,585,1172,208
2022-07-31,LP,Portugal,2235,890,205,1,1345,571,569,1140,204
2022-08-01,LP,Portugal,2210,823,205,0,1387,584,598,1182,205
2022-08-02,LP,Portugal,2151,890,208,1,1261,534,519,1053,207
2022-08-03,LP,Portugal,2102,818,205,4,1284,541,538,1079,201
2022-08-04,LP,Portugal,2139,844,196,2,1295,552,547,1099,194
2022-08-05,LP,Portugal,2120,785,212,3,1335,562,561,1123,209
2022-08-06,LP,Portugal,2352,982,215,1,1370,576,579,1155,214
2022-08-07,LP,Portugal,2228,881,209,1,1347,567,571,1138,208
2022-08-08,LP,Portugal,2215,823,216,2,1392,581,595,1176,214
2022-08-09,LP,Portugal,2183,933,208,2,1250,526,516,1042,206
2022-08-10,LP,Portugal,2287,1004,201,0,1283,546,536,1082,201
2022-08-11,LP,Portugal,2204,901,208,4,1303,550,545,1095,204
2022-08-12,LP,Portugal,2183,837,224,3,1346,563,559,1122,221
2022-08-13,LP,Portugal,2495,1115,217,1,1380,579,584,1163,216
2022-08-14,LP,Portugal,2466,1101,210,1,1365,581,574,1155,209
2022-08-15,LP,Portugal,2167,811,211,4,1356,572,573,1145,207
2022-08-16,LP,Portugal,2190,942,212,1,1248,518,518,1036,211
2022-08-17,LP,Portugal,2203,934,208,0,1269,535,526,1061,208
2022-08-18,LP,Portugal,2196,901,204,4,1295,545,546,1091,200
2022-08-19,LP,Portugal,2126,818,206,3,1308,551,551,1102,203
2022-08-20,LP,Portugal,2392,979,216,3,1413,595,602,1197,213
2022-08-21,LP,Portugal,2247,875,212,7,1372,574,586,1160,205
2022-08-22,LP,Portugal,2211,840,218,7,1371,570,583,1153,211
2022-08-23,LP,Portugal,2086,834,208,8,1252,524,520,1044,200
2022-08-24,LP,Portugal,2130,832,209,12,1298,552,537,1089,197
2022-08-25,LP,Portugal,2156,856,208,7,1300,551,541,1092,201
2022-08-26,LP,Portugal,2062,835,205,7,1227,507,515,1022,198
2022-08-27,LP,Portugal,2302,975,208,1,1327,560,559,1119,207
2022-08-28,LP,Portugal,2154,894,202,0,1260,531,527,1058,202
2022-08-29,LP,Portugal,2255,872,208,0,1383,585,590,1175,208
2022-08-30,LP,Portugal,2051,806,203,0,1245,524,518,1042,203
2022-08-31,LP,Portugal,2032,738,205,1,1294,545,544,1089,204
2022-09-01,LP,Portugal,2077,781,202,2,1296,548,546,1094,200
2022-09-02,LP,Portugal,2175,881,201,0,1294,551,542,1093,201
2022-09-03,LP,Portugal,2259,897,212,0,1362,570,580,1150,212
2022-09-04,LP,Portugal,2138,804,209,0,1334,570,555,1125,209
2022-09-05,LP,Portugal,2057,707,214,3,1350,564,572,1136,211
2022-09-06,LP,Portugal,1961,738,197,4,1223,514,512,1026,193
2022-09-07,LP,Portugal,1948,693,198,0,1255,526,531,1057,198
2022-09-08,LP,Portugal,2077,806,205,2,1271,530,536,1066,203
2022-09-09,LP,Portugal,2048,736,201,3,1312,554,557,1111,198
2022-09-10,LP,Portugal,2209,870,195,1,1339,573,571,1144,194
2022-09-11,LP,Portugal,2113,779,209,0,1334,563,562,1125,209
2022-09-12,LP,Portugal,1994,675,191,0,1319,562,566,1128,191
2022-09-13,LP,Portugal,1975,757,193,1,1218,514,511,1025,192
2022-09-14,LP,Portugal,1991,770,197,1,1221,520,504,1024,196
2022-09-15,LP,Portugal,2081,817,194,2,1264,528,542,1070,192
2022-09-16,LP,Portugal,1907,749,201,3,1158,478,479,957,198
2022-09-17,LP,Portugal,2204,884,202,1,1320,555,563,1118,201
2022-09-18,LP,Portugal,2090,769,195,1,1321,570,556,1126,194
2022-09-19,LP,Portugal,2047,726,210,5,1321,550,561,1111,205
2022-09-20,LP,Portugal,1934,710,204,5,1224,515,505,1020,199
2022-09-21,LP,Portugal,1924,724,193,2,1200,507,500,1007,191
2022-09-22,LP,Portugal,2027,761,191,2,1266,534,541,1075,189
2022-09-23,LP,Portugal,1962,674,198,4,1288,540,550,1090,194
2022-09-24,LP,Portugal,2197,908,196,0,1289,548,545,1093,196
2022-09-25,LP,Portugal,2056,751,196,0,1305,560,549,1109,196
2022-09-26,LP,Portugal,2146,839,205,2,1307,548,554,1102,203
2022-09-27,LP,Portugal,1995,816,191,2,1179,493,495,988,189
2022-09-28,LP,Portugal,2117,885,194,2,1232,527,511,1038,192
2022-09-29,LP,Portugal,2157,958,186,0,1199,507,506,1013,186
2022-09-30,LP,Portugal,2067,777,200,1,1290,545,545,1090,199
2022-10-01,LP,Portugal,2181,925,173,0,1256,540,543,1083,173
2022-10-02,LP,Portugal,2046,792,157,0,1254,549,548,1097,157
2022-10-03,LP,Portugal,2042,763,179,1,1279,537,563,1100,178
2022-10-04,LP,Portugal,1926,778,162,2,1148,495,491,986,160
2022-10-05,LP,Portugal,1960,760,175,2,1200,517,508,1025,173
2022-10-06,LP,Portugal,2018,804,174,0,1214,524,516,1040,174
2022-10-07,LP,Portugal,2041,799,172,1,1242,532,538,1070,171
2022-10-08,LP,Portugal,2278,1008,165,0,1270,549,556,1105,165
2022-10-09,LP,Portugal,2084,810,163,0,1274,558,553,1111,163
2022-10-10,LP,Portugal,1982,718,173,4,1264,543,548,1091,169
2022-10-11,LP,Portugal,1865,699,177,0,1166,491,498,989,177
2022-10-12,LP,Portugal,1949,752,175,0,1197,515,507,1022,175
2022-10-13,LP,Portugal,1962,750,178,0,1212,519,515,1034,178
2022-10-14,LP,Portugal,2053,761,179,1,1292,551,562,1113,178
2022-10-15,LP,Portugal,2277,1006,169,1,1271,553,549,1102,168
2022-10-16,LP,Portugal,2089,819,161,0,1270,558,551,1109,161
2022-10-17,LP,Portugal,1961,744,172,1,1217,515,530,1045,171
2022-10-18,LP,Portugal,1765,673,154,5,1092,473,465,938,149
2022-10-19,LP,Portugal,1760,620,173,6,1140,485,482,967,167
2022-10-20,LP,Portugal,1939,774,163,6,1165,503,499,1002,157
2022-10-21,LP,Portugal,1976,778,179,8,1198,507,512,1019,171
2022-10-22,LP,Portugal,2134,889,165,2,1245,539,541,1080,163
2022-10-23,LP,Portugal,2045,837,160,1,1208,530,518,1048,159
2022-10-24,LP,Portugal,1827,608,179,1,1219,519,521,1040,178
2022-10-25,LP,Portugal,1825,717,170,1,1108,468,470,938,169
2022-10-26,LP,Portugal,1874,704,165,3,1170,499,506,1005,162
2022-10-27,LP,Portugal,1957,769,177,5,1188,507,504,1011,172
2022-10-28,LP,Portugal,1975,746,176,0,1229,528,525,1053,176
2022-10-29,LP,Portugal,2168,940,164,3,1228,534,530,1064,161
2022-10-30,LP,Portugal,2136,981,144,0,1155,509,502,1011,144
2022-10-31,LP,Portugal,1864,756,152,1,1108,469,487,956,151
2022-11-01,LP,Portugal,1713,814,138,4,899,382,379,761,134
2022-11-02,LP,Portugal,1690,737,158,1,953,403,392,795,157
2022-11-03,LP,Portugal,1769,786,144,9,983,419,420,839,135
2022-11-04,LP,Portugal,2008,910,161,1,1098,475,462,937,160
2022-11-05,LP,Portugal,2107,1007,129,2,1100,487,484,971,127
2022-11-06,LP,Portugal,1987,915,143,2,1072,464,465,929,141
2022-11-07,LP,Portugal,1856,800,153,3,1056,450,453,903,150
2022-11-08,LP,Portugal,1698,836,140,1,862,363,359,722,139
2022-11-09,LP,Portugal,1596,753,140,2,843,356,347,703,138
2022-11-10,LP,Portugal,1795,862,135,0,933,397,401,798,135
2022-11-11,LP,Portugal,2005,936,171,1,1069,451,447,898,170
2022-11-12,LP,Portugal,2223,1194,129,0,1029,449,451,900,129
2022-11-13,LP,Portugal,2022,1000,143,0,1022,439,440,879,143
2022-11-14,LP,Portugal,1810,764,155,2,1046,443,448,891,153
2022-11-15,LP,Portugal,1565,764,129,0,801,336,336,672,129
2022-11-16,LP,Portugal,1508,691,138,2,817,346,333,679,136
2022-11-17,LP,Portugal,1697,820,132,2,877,370,375,745,130
2022-11-18,LP,Portugal,1968,925,148,1,1043,452,443,895,147
2022-11-19,LP,Portugal,2079,1101,129,3,978,427,422,849,126
2022-11-20,LP,Portugal,1928,946,130,2,982,426,426,852,128
2022-11-21,LP,Portugal,1800,797,155,0,1003,419,429,848,155
2022-11-22,LP,Portugal,1620,836,126,0,784,328,330,658,126
2022-11-23,LP,Portugal,1510,716,134,3,794,332,328,660,131
2022-11-24,LP,Portugal,1598,738,136,2,860,364,360,724,134
2022-11-25,LP,Portugal,1936,909,142,1,1027,447,438,885,141
2022-11-26,LP,Portugal,2028,1057,127,0,971,425,419,844,127
2022-11-27,LP,Portugal,1864,871,146,1,993,416,431,847,145
2022-11-28,LP,Portugal,1784,798,142,1,986,420,424,844,141
2022-11-29,LP,Portugal,1572,789,141,2,783,317,325,642,139
2022-11-30,LP,Portugal,1633,832,139,0,801,340,322,662,139
2022-12-01,LP,Portugal,1711,852,129,2,859,366,364,730,127
2022-12-02,LP,Portugal,1900,882,153,3,1018,434,431,865,150
2022-12-03,LP,Portugal,2151,1198,123,1,953,413,417,830,122
2022-12-04,LP,Portugal,1959,981,147,1,978,409,422,831,146
2022-12-05,LP,Portugal,1830,806,162,1,1024,429,433,862,161
2022-12-06,LP,Portugal,1692,867,138,1,825,346,341,687,137
2022-12-07,LP,Portugal,1626,762,149,4,864,365,350,715,145
2022-12-08,LP,Portugal,1613,857,115,2,756,300,341,641,113
2022-12-09,LP,Portugal,1690,865,111,0,825,355,359,714,111
2022-12-10,LP,Portugal,2076,1119,126,4,957,436,395,831,122
2022-12-11,LP,Portugal,1874,950,126,1,924,400,398,798,125
2022-12-12,LP,Portugal,1719,747,153,2,972,404,415,819,151
2022-12-13,LP,Portugal,1649,807,121,7,842,357,364,721,114
2022-12-14,LP,Portugal,1723,852,150,2,871,369,352,721,148
2022-12-15,LP,Portugal,1833,924,143,5,909,381,385,766,138
2022-12-16,LP,Portugal,1998,933,159,4,1065,457,449,906,155
2022-12-17,LP,Portugal,2223,1195,137,1,1028,446,445,891,136
2022-12-18,LP,Portugal,1952,935,155,1,1017,428,434,862,154
2022-12-19,LP,Portugal,1929,866,160,4,1063,446,457,903,156
2022-12-20,LP,Portugal,1950,987,153,0,963,408,402,810,153
2022-12-21,LP,Portugal,1787,829,142,1,958,411,405,816,141
2022-12-22,LP,Portugal,1943,956,146,6,987,419,422,841,140
2022-12-23,LP,Portugal,2102,993,168,0,1109,469,472,941,168
2022-12-24,LP,Portugal,1896,984,123,1,912,398,391,789,122
2022-12-25,LP,Portugal,1404,711,84,2,693,298,311,609,82
2022-12-26,LP,Portugal,2002,959,160,0,1043,439,444,883,160
2022-12-27,LP,Portugal,1990,1010,152,5,980,410,418,828,147
2022-01-01,LR,Romania,1138,890,5,2,248,120,123,243,3
2022-01-02,LR,Romania,1509,1082,35,3,427,192,200,392,32
2022-01-03,LR,Romania,1382,903,48,6,479,217,214,431,42
2022-01-04,LR,Romania,1256,862,34,5,394,181,179,360,29
2022-01-05,LR,Romania,1279,852,54,6,427,185,188,373,48
2022-01-06,LR,Romania,1315,919,46,4,396,175,175,350,42
2022-01-07,LR,Romania,1437,989,48,4,448,198,202,400,44
2022-01-08,LR,Romania,1421,1062,16,0,359,173,170,343,16
2022-01-09,LR,Romania,1467,1037,35,1,430,197,198,395,34
2022-01-10,LR,Romania,1185,859,39,1,326,142,145,287,38
2022-01-11,LR,Romania,1080,796,50,8,284,119,115,234,42
2022-01-12,LR,Romania,1067,769,61,4,298,118,119,237,57
2022-01-13,LR,Romania,1108,805,71,8,303,118,114,232,63
2022-01-14,LR,Romania,1211,871,60,4,340,137,143,280,56
2022-01-15,LR,Romania,1153,912,23,4,241,113,105,218,19
2022-01-16,LR,Romania,1234,945,35,1,289,124,130,254,34
2022-01-17,LR,Romania,1021,739,44,5,282,122,116,238,39
2022-01-18,LR,Romania,977,720,65,13,257,97,95,192,52
2022-01-19,LR,Romania,978,732,57,10,246,90,99,189,47
2022-01-20,LR,Romania,1071,769,88,12,302,108,106,214,76
2022-01-21,LR,Romania,1150,824,64,9,326,131,131,262,55
2022-01-22,LR,Romania,1137,892,28,6,245,113,104,217,22
2022-01-23,LR,Romania,1171,909,36,5,262,110,116,226,31
2022-01-24,LR,Romania,866,607,38,4,259,109,112,221,34
2022-01-25,LR,Romania,796,562,45,10,234,96,93,189,35
2022-01-26,LR,Romania,923,660,64,15,263,98,101,199,49
2022-01-27,LR,Romania,1056,768,78,11,288,109,101,210,67
2022-01-28,LR,Romania,1161,839,62,10,322,125,135,260,52
2022-01-29,LR,Romania,1108,871,25,3,237,106,106,212,22
2022-01-30,LR,Romania,1134,869,41,4,265,113,111,224,37
2022-01-31,LR,Romania,1014,719,52,7,295,119,124,243,45
2022-02-01,LR,Romania,979,707,56,9,272,108,108,216,47
2022-02-02,LR,Romania,984,687,72,12,297,113,112,225,60
2022-02-03,LR,Romania,1095,802,67,8,293,111,115,226,59
2022-02-04,LR,Romania,1163,828,63,8,335,135,137,272,55
2022-02-05,LR,Romania,1147,881,26,8,266,125,115,240,18
2022-02-06,LR,Romania,1144,879,30,4,265,117,118,235,26
2022-02-07,LR,Romania,990,702,50,8,288,122,116,238,42
2022-02-08,LR,Romania,945,685,51,7,260,102,107,209,44
2022-02-09,LR,Romania,987,705,68,11,282,105,109,214,57
2022-02-10,LR,Romania,1118,816,72,10,302,112,118,230,62
2022-02-11,LR,Romania,1252,901,63,9,351,142,146,288,54
2022-02-12,LR,Romania,1187,929,26,6,258,123,109,232,20
2022-02-13,LR,Romania,1265,979,31,4,286,125,130,255,27
2022-02-14,LR,Romania,1207,890,50,8,317,130,137,267,42
2022-02-15,LR,Romania,1188,866,60,14,322,133,129,262,46
2022-02-16,LR,Romania,1126,814,71,18,312,118,123,241,53
2022-02-17,LR,Romania,1201,888,74,12,313,120,119,239,62
2022-02-18,LR,Romania,1292,961,56,6,331,141,134,275,50
2022-02-19,LR,Romania,1374,1099,23,6,275,125,127,252,17
2022-02-20,LR,Romania,1332,1028,28,3,304,136,140,276,25
2022-02-21,LR,Romania,1158,837,53,7,321,135,133,268,46
2022-02-22,LR,Romania,1133,838,73,15,295,109,113,222,58
2022-02-23,LR,Romania,1154,828,84,17,326,124,118,242,67
2022-02-24,LR,Romania,1187,868,65,16,319,123,131,254,49
2022-02-25,LR,Romania,1239,870,66,10,369,148,155,303,56
2022-02-26,LR,Romania,1217,916,25,3,301,140,136,276,22
2022-02-27,LR,Romania,1217,872,38,7,345,151,156,307,31
2022-02-28,LR,Romania,1222,830,68,5,392,162,162,324,63
2022-03-01,LR,Romania,1139,806,50,8,333,137,146,283,42
2022-03-02,LR,Romania,1261,845,66,13,416,175,175,350,53
2022-03-03,LR,Romania,1350,923,67,11,427,184,176,360,56
2022-03-04,LR,Romania,1412,935,64,9,477,204,209,413,55
2022-03-05,LR,Romania,1390,1030,37,12,360,162,161,323,25
2022-03-06,LR,Romania,1389,990,43,7,399,178,178,356,36
2022-03-07,LR,Romania,1315,862,67,12,453,193,193,386,55
2022-03-08,LR,Romania,1185,832,44,11,353,160,149,309,33
2022-03-09,LR,Romania,1238,869,61,8,369,149,159,308,53
2022-03-10,LR,Romania,1284,893,82,21,391,159,150,309,61
2022-03-11,LR,Romania,1359,905,66,13,454,189,199,388,53
2022-03-12,LR,Romania,1249,901,27,7,348,165,156,321,20
2022-03-13,LR,Romania,1303,944,38,5,359,158,163,321,33
2022-03-14,LR,Romania,1243,802,84,17,441,174,183,357,67
2022-03-15,LR,Romania,1210,851,73,14,359,147,139,286,59
2022-03-16,LR,Romania,1198,816,65,13,382,158,159,317,52
2022-03-17,LR,Romania,1301,902,91,11,399,153,155,308,80
2022-03-18,LR,Romania,1396,937,58,7,459,199,202,401,51
2022-03-19,LR,Romania,1324,977,38,10,347,159,150,309,28
2022-03-20,LR,Romania,1358,972,41,7,386,173,172,345,34
2022-03-21,LR,Romania,1263,839,69,15,424,176,179,355,54
2022-03-22,LR,Romania,1136,792,51,9,344,144,149,293,42
2022-03-23,LR,Romania,1231,866,67,16,365,152,146,298,51
2022-03-24,LR,Romania,1329,930,86,14,399,160,153,313,72
2022-03-25,LR,Romania,1395,950,69,11,445,185,191,376,58
2022-03-26,LR,Romania,1391,1039,33,8,352,165,154,319,25
2022-03-27,LR,Romania,1474,1030,44,8,444,200,200,400,36
2022-03-28,LR,Romania,1367,903,58,6,464,204,202,406,52
2022-03-29,LR,Romania,1331,931,67,9,400,164,169,333,58
2022-03-30,LR,Romania,1379,931,81,11,448,181,186,367,70
2022-03-31,LR,Romania,1494,1007,77,9,487,211,199,410,68
2022-04-01,LR,Romania,1600,1081,68,5,519,222,229,451,63
2022-04-02,LR,Romania,1585,1185,34,2,400,185,181,366,32
2022-04-03,LR,Romania,1625,1163,46,7,462,207,209,416,39
2022-04-04,LR,Romania,1468,947,81,14,521,217,223,440,67
2022-04-05,LR,Romania,1429,989,81,19,440,185,174,359,62
2022-04-06,LR,Romania,1475,995,89,19,480,190,201,391,70
2022-04-07,LR,Romania,1621,1099,101,23,522,211,210,421,78
2022-04-08,LR,Romania,1708,1162,84,18,546,231,231,462,66
2022-04-09,LR,Romania,1635,1212,44,5,423,193,186,379,39
2022-04-10,LR,Romania,1643,1185,42,3,458,206,210,416,39
2022-04-11,LR,Romania,1624,1090,89,18,534,223,222,445,71
2022-04-12,LR,Romania,1597,1135,81,11,462,191,190,381,70
2022-04-13,LR,Romania,1574,1059,89,12,515,210,216,426,77
2022-04-14,LR,Romania,1758,1198,86,12,560,240,234,474,74
2022-04-15,LR,Romania,1769,1189,78,11,580,248,254,502,67
2022-04-16,LR,Romania,1685,1223,43,4,462,214,205,419,39
2022-04-17,LR,Romania,1705,1223,36,4,482,222,224,446,32
2022-04-18,LR,Romania,1630,1115,57,10,515,229,229,458,47
2022-04-19,LR,Romania,1605,1119,67,8,486,215,204,419,59
2022-04-20,LR,Romania,1578,1048,78,17,530,222,230,452,61
2022-04-21,LR,Romania,1710,1163,67,9,547,245,235,480,58
2022-04-22,LR,Romania,1698,1165,50,1,533,241,242,483,49
2022-04-23,LR,Romania,1769,1294,31,2,475,220,224,444,29
2022-04-24,LR,Romania,1766,1298,32,2,468,218,218,436,30
2022-04-25,LR,Romania,1596,1063,53,4,533,234,246,480,49
2022-04-26,LR,Romania,1609,1118,57,8,491,218,216,434,49
2022-04-27,LR,Romania,1631,1104,61,10,527,233,233,466,51
2022-04-28,LR,Romania,1712,1154,70,13,558,243,245,488,57
2022-04-29,LR,Romania,1828,1227,67,11,601,267,267,534,56
2022-04-30,LR,Romania,1811,1328,35,4,483,226,222,448,31
2022-05-01,LR,Romania,1863,1326,47,6,537,244,246,490,41
2022-05-02,LR,Romania,1680,1133,64,6,547,239,244,483,58
2022-05-03,LR,Romania,1635,1161,64,14,474,205,205,410,50
2022-05-04,LR,Romania,1690,1172,73,14,518,219,226,445,59
2022-05-05,LR,Romania,1771,1209,88,11,562,240,234,474,77
2022-05-06,LR,Romania,1770,1210,77,12,560,242,241,483,65
2022-05-07,LR,Romania,1767,1324,38,6,443,206,199,405,32
2022-05-08,LR,Romania,1812,1317,49,7,495,221,225,446,42
2022-05-09,LR,Romania,1678,1151,74,8,527,220,233,453,66
2022-05-10,LR,Romania,1624,1175,79,16,449,190,180,370,63
2022-05-11,LR,Romania,1613,1105,89,11,508,203,216,419,78
2022-05-12,LR,Romania,1684,1170,87,13,514,217,210,427,74
2022-05-13,LR,Romania,1807,1222,83,14,585,253,249,502,69
2022-05-14,LR,Romania,1830,1409,34,7,421,197,190,387,27
2022-05-15,LR,Romania,1816,1308,46,5,508,230,232,462,41
2022-05-16,LR,Romania,1697,1158,91,13,539,220,228,448,78
2022-05-17,LR,Romania,1641,1188,76,15,453,190,187,377,61
2022-05-18,LR,Romania,1648,1153,74,8,495,205,216,421,66
2022-05-19,LR,Romania,1732,1199,95,14,533,225,213,438,81
2022-05-20,LR,Romania,1836,1287,88,15,549,229,232,461,73
2022-05-21,LR,Romania,1820,1388,38,11,432,198,196,394,27
2022-05-22,LR,Romania,1833,1325,50,9,508,230,228,458,41
2022-05-23,LR,Romania,1725,1208,73,10,517,223,221,444,63
2022-05-24,LR,Romania,1633,1187,81,16,446,183,182,365,65
2022-05-25,LR,Romania,1795,1290,79,9,505,209,217,426,70
2022-05-26,LR,Romania,1810,1268,97,18,542,229,216,445,79
2022-05-27,LR,Romania,1928,1368,87,17,560,238,235,473,70
2022-05-28,LR,Romania,2005,1566,33,6,439,204,202,406,27
2022-05-29,LR,Romania,2043,1548,42,1,495,224,229,453,41
2022-05-30,LR,Romania,1850,1293,85,15,557,233,239,472,70
2022-05-31,LR,Romania,1865,1397,72,11,468,201,195,396,61
2022-06-01,LR,Romania,1893,1390,71,16,503,214,218,432,55
2022-06-02,LR,Romania,1903,1390,79,9,513,217,217,434,70
2022-06-03,LR,Romania,2053,1486,77,8,567,244,246,490,69
2022-06-04,LR,Romania,2057,1590,36,4,467,219,212,431,32
2022-06-05,LR,Romania,1991,1506,43,4,485,222,220,442,39
2022-06-06,LR,Romania,2040,1501,69,8,539,235,235,470,61
2022-06-07,LR,Romania,1808,1329,79,8,479,198,202,400,71
2022-06-08,LR,Romania,1965,1421,89,10,544,227,228,455,79
2022-06-09,LR,Romania,2007,1424,94,10,583,249,240,489,84
2022-06-10,LR,Romania,2209,1581,80,11,628,273,275,548,69
2022-06-11,LR,Romania,2205,1719,37,5,486,228,221,449,32
2022-06-12,LR,Romania,2149,1624,44,4,525,238,243,481,40
2022-06-13,LR,Romania,1978,1442,56,5,536,240,240,480,51
2022-06-14,LR,Romania,1954,1432,78,13,522,219,225,444,65
2022-06-15,LR,Romania,1979,1393,81,12,586,251,254,505,69
2022-06-16,LR,Romania,2039,1427,93,14,612,264,255,519,79
2022-06-17,LR,Romania,2182,1580,79,9,602,261,262,523,70
2022-06-18,LR,Romania,2162,1657,51,8,505,229,225,454,43
2022-06-19,LR,Romania,2101,1557,55,8,544,240,249,489,47
2022-06-20,LR,Romania,2000,1422,88,9,578,245,245,490,79
2022-06-21,LR,Romania,2107,1582,73,9,525,226,226,452,64
2022-06-22,LR,Romania,2129,1523,77,11,606,266,263,529,66
2022-06-23,LR,Romania,2157,1564,86,9,593,253,254,507,77
2022-06-24,LR,Romania,2264,1648,83,11,616,267,266,533,72
2022-06-25,LR,Romania,2415,1912,42,4,503,232,229,461,38
2022-06-26,LR,Romania,2285,1739,47,6,546,248,251,499,41
2022-06-27,LR,Romania,2184,1596,87,10,588,249,252,501,77
2022-06-28,LR,Romania,2139,1613,82,19,526,226,218,444,63
2022-06-29,LR,Romania,2265,1686,82,13,579,246,251,497,69
2022-06-30,LR,Romania,2276,1653,93,14,623,267,263,530,79
2022-07-01,LR,Romania,2439,1828,86,13,611,263,262,525,73
2022-07-02,LR,Romania,2481,1976,46,4,505,234,225,459,42
2022-07-03,LR,Romania,2456,1895,51,5,561,247,263,510,46
2022-07-04,LR,Romania,2236,1653,75,6,583,257,251,508,69
2022-07-05,LR,Romania,2368,1828,84,5,540,226,230,456,79
2022-07-06,LR,Romania,2145,1557,80,8,588,253,255,508,72
2022-07-07,LR,Romania,2292,1679,82,9,613,271,260,531,73
2022-07-08,LR,Romania,2419,1818,75,8,601,259,267,526,67
2022-07-09,LR,Romania,2397,1879,39,4,518,241,238,479,35
2022-07-10,LR,Romania,2347,1801,39,3,546,247,260,507,36
2022-07-11,LR,Romania,2219,1635,84,10,584,254,246,500,74
2022-07-12,LR,Romania,2275,1735,89,14,540,226,225,451,75
2022-07-13,LR,Romania,2278,1679,84,9,599,253,262,515,75
2022-07-14,LR,Romania,2289,1686,79,6,603,266,258,524,73
2022-07-15,LR,Romania,2536,1912,77,10,624,273,274,547,67
2022-07-16,LR,Romania,2442,1923,39,2,519,247,233,480,37
2022-07-17,LR,Romania,2326,1822,41,4,504,227,236,463,37
2022-07-18,LR,Romania,2252,1667,76,8,585,253,256,509,68
2022-07-19,LR,Romania,2243,1699,81,10,544,235,228,463,71
2022-07-20,LR,Romania,2385,1783,82,11,602,258,262,520,71
2022-07-21,LR,Romania,2354,1741,86,7,613,267,260,527,79
2022-07-22,LR,Romania,2442,1846,85,11,596,255,256,511,74
2022-07-23,LR,Romania,2471,1953,39,3,518,240,239,479,36
2022-07-24,LR,Romania,2401,1875,44,3,526,239,243,482,41
2022-07-25,LR,Romania,2314,1720,80,12,594,256,258,514,68
2022-07-26,LR,Romania,2268,1741,74,5,527,223,230,453,69
2022-07-27,LR,Romania,2398,1800,88,11,598,254,256,510,77
2022-07-28,LR,Romania,2457,1834,84,11,623,271,268,539,73
2022-07-29,LR,Romania,2505,1884,81,10,621,272,268,540,71
2022-07-30,LR,Romania,2574,2053,46,9,521,237,238,475,37
2022-07-31,LR,Romania,2436,1897,40,2,539,250,249,499,38
2022-08-01,LR,Romania,2273,1698,73,13,575,249,253,502,60
2022-08-02,LR,Romania,2295,1744,91,13,551,228,232,460,78
2022-08-03,LR,Romania,2404,1803,77,9,601,256,268,524,68
2022-08-04,LR,Romania,2335,1701,83,14,634,278,273,551,69
2022-08-05,LR,Romania,2457,1839,79,9,618,269,270,539,70
2022-08-06,LR,Romania,2461,1942,42,8,519,241,236,477,34
2022-08-07,LR,Romania,2583,2015,39,5,568,264,265,529,34
2022-08-08,LR,Romania,2408,1813,75,7,595,265,255,520,68
2022-08-09,LR,Romania,2386,1850,71,4,536,233,232,465,67
2022-08-10,LR,Romania,2443,1831,84,12,612,259,269,528,72
2022-08-11,LR,Romania,2344,1725,84,14,619,272,263,535,70
2022-08-12,LR,Romania,2521,1897,84,11,624,274,266,540,73
2022-08-13,LR,Romania,2574,2064,37,5,510,236,237,473,32
2022-08-14,LR,Romania,2517,1976,38,0,541,248,255,503,38
2022-08-15,LR,Romania,2324,1740,59,1,584,264,261,525,58
2022-08-16,LR,Romania,2237,1721,62,6,516,224,230,454,56
2022-08-17,LR,Romania,2318,1732,69,10,586,257,260,517,59
2022-08-18,LR,Romania,2366,1749,86,12,617,270,261,531,74
2022-08-19,LR,Romania,2540,1937,74,7,603,264,265,529,67
2022-08-20,LR,Romania,2722,2210,46,3,512,235,231,466,43
2022-08-21,LR,Romania,2608,2061,38,2,547,251,258,509,36
2022-08-22,LR,Romania,2269,1686,62,3,583,259,262,521,59
2022-08-23,LR,Romania,2378,1849,64,7,529,229,236,465,57
2022-08-24,LR,Romania,2444,1847,74,7,597,263,260,523,67
2022-08-25,LR,Romania,2371,1741,77,12,630,284,269,553,65
2022-08-26,LR,Romania,2471,1842,76,13,629,276,277,553,63
2022-08-27,LR,Romania,2642,2134,37,6,508,236,235,471,31
2022-08-28,LR,Romania,2511,1938,46,5,573,265,262,527,41
2022-08-29,LR,Romania,2398,1796,75,8,602,262,265,527,67
2022-08-30,LR,Romania,2357,1830,66,2,527,229,232,461,64
2022-08-31,LR,Romania,2442,1835,80,3,607,262,265,527,77
2022-09-01,LR,Romania,2491,1887,66,3,604,266,272,538,63
2022-09-02,LR,Romania,2412,1822,64,4,590,263,263,526,60
2022-09-03,LR,Romania,2557,2035,38,2,522,242,242,484,36
2022-09-04,LR,Romania,2551,1997,45,8,554,256,253,509,37
2022-09-05,LR,Romania,2259,1632,83,7,627,278,266,544,76
2022-09-06,LR,Romania,2195,1680,76,6,515,215,224,439,70
2022-09-07,LR,Romania,2191,1661,65,14,530,231,234,465,51
2022-09-08,LR,Romania,2299,1725,83,12,574,250,241,491,71
2022-09-09,LR,Romania,2405,1847,68,5,558,245,245,490,63
2022-09-10,LR,Romania,2555,2101,38,5,454,211,205,416,33
2022-09-11,LR,Romania,2424,1938,43,5,486,220,223,443,38
2022-09-12,LR,Romania,2116,1574,77,18,542,230,235,465,59
2022-09-13,LR,Romania,2023,1562,69,13,461,195,197,392,56
2022-09-14,LR,Romania,2236,1689,83,11,547,230,234,464,72
2022-09-15,LR,Romania,2238,1680,86,7,558,240,232,472,79
2022-09-16,LR,Romania,2347,1809,70,7,538,235,233,468,63
2022-09-17,LR,Romania,2399,1945,29,2,454,215,210,425,27
2022-09-18,LR,Romania,2266,1780,37,2,486,220,229,449,35
2022-09-19,LR,Romania,2122,1567,74,16,555,238,243,481,58
2022-09-20,LR,Romania,2063,1579,74,13,484,209,201,410,61
2022-09-21,LR,Romania,2183,1630,83,14,553,230,240,470,69
2022-09-22,LR,Romania,2204,1658,78,7,546,238,230,468,71
2022-09-23,LR,Romania,2139,1592,73,10,547,239,235,474,63
2022-09-24,LR,Romania,2256,1822,38,6,434,198,198,396,32
2022-09-25,LR,Romania,2235,1766,36,3,469,215,218,433,33
2022-09-26,LR,Romania,2126,1626,65,6,500,219,216,435,59
2022-09-27,LR,Romania,2053,1599,66,6,454,190,198,388,60
2022-09-28,LR,Romania,2160,1632,77,10,528,225,226,451,67
2022-09-29,LR,Romania,2227,1719,72,5,508,216,220,436,67
2022-09-30,LR,Romania,2309,1754,80,13,555,237,238,475,67
2022-10-01,LR,Romania,2346,1939,31,5,407,190,186,376,26
2022-10-02,LR,Romania,2264,1806,35,5,458,208,215,423,30
2022-10-03,LR,Romania,1943,1440,61,6,503,219,223,442,55
2022-10-04,LR,Romania,1908,1457,70,8,451,190,191,381,62
2022-10-05,LR,Romania,1910,1408,78,13,502,207,217,424,65
2022-10-06,LR,Romania,1981,1470,74,12,511,224,213,437,62
2022-10-07,LR,Romania,2105,1582,71,7,523,228,224,452,64
2022-10-08,LR,Romania,2125,1721,35,10,404,186,183,369,25
2022-10-09,LR,Romania,2109,1649,43,7,460,206,211,417,36
2022-10-10,LR,Romania,1870,1365,72,12,505,210,223,433,60
2022-10-11,LR,Romania,1882,1427,78,12,455,187,190,377,66
2022-10-12,LR,Romania,1994,1494,75,4,500,213,212,425,71
2022-10-13,LR,Romania,1976,1486,79,10,490,210,201,411,69
2022-10-14,LR,Romania,2160,1618,95,9,542,224,223,447,86
2022-10-15,LR,Romania,2125,1718,34,4,407,188,185,373,30
2022-10-16,LR,Romania,2113,1657,40,6,456,207,209,416,34
2022-10-17,LR,Romania,1945,1450,69,13,495,212,214,426,56
2022-10-18,LR,Romania,1899,1447,68,10,452,191,193,384,58
2022-10-19,LR,Romania,1909,1408,71,10,501,216,214,430,61
2022-10-20,LR,Romania,2010,1485,88,13,525,220,217,437,75
2022-10-21,LR,Romania,2039,1532,79,13,507,211,217,428,66
2022-10-22,LR,Romania,2140,1700,41,2,440,204,195,399,39
2022-10-23,LR,Romania,2082,1611,42,8,471,214,215,429,34
2022-10-24,LR,Romania,1940,1427,68,5,513,219,226,445,63
2022-10-25,LR,Romania,1782,1351,59,6,431,189,183,372,53
2022-10-26,LR,Romania,1958,1445,79,13,513,211,223,434,66
2022-10-27,LR,Romania,1973,1462,87,12,511,217,207,424,75
2022-10-28,LR,Romania,2011,1493,71,7,518,219,228,447,64
2022-10-29,LR,Romania,2088,1643,45,12,445,207,193,400,33
2022-10-30,LR,Romania,1982,1561,40,5,421,185,196,381,35
2022-10-31,LR,Romania,1766,1299,70,9,467,195,202,397,61
2022-11-01,LR,Romania,1705,1264,68,9,441,189,184,373,59
2022-11-02,LR,Romania,1707,1248,91,11,459,178,190,368,80
2022-11-03,LR,Romania,1762,1321,85,7,441,182,174,356,78
2022-11-04,LR,Romania,1829,1346,66,4,483,209,208,417,62
2022-11-05,LR,Romania,1866,1475,31,2,391,184,176,360,29
2022-11-06,LR,Romania,1877,1454,42,6,423,187,194,381,36
2022-11-07,LR,Romania,1738,1296,62,5,442,186,194,380,57
2022-11-08,LR,Romania,1634,1209,69,8,425,181,175,356,61
2022-11-09,LR,Romania,1653,1218,72,9,435,176,187,363,63
2022-11-10,LR,Romania,1675,1250,64,7,425,186,175,361,57
2022-11-11,LR,Romania,1711,1239,77,5,472,198,197,395,72
2022-11-12,LR,Romania,1727,1343,43,6,384,172,169,341,37
2022-11-13,LR,Romania,1718,1297,37,5,421,188,196,384,32
2022-11-14,LR,Romania,1659,1191,69,4,468,195,204,399,65
2022-11-15,LR,Romania,1603,1170,68,9,433,187,178,365,59
2022-11-16,LR,Romania,1579,1133,79,9,446,182,185,367,70
2022-11-17,LR,Romania,1677,1218,83,11,459,191,185,376,72
2022-11-18,LR,Romania,1692,1225,74,8,467,194,199,393,66
2022-11-19,LR,Romania,1726,1354,31,4,372,172,169,341,27
2022-11-20,LR,Romania,1698,1289,30,1,409,187,192,379,29
2022-11-21,LR,Romania,1593,1141,68,6,452,188,196,384,62
2022-11-22,LR,Romania,1620,1173,60,5,447,194,193,387,55
2022-11-23,LR,Romania,1543,1110,64,0,433,186,183,369,64
2022-11-24,LR,Romania,1625,1170,69,4,455,194,192,386,65
2022-11-25,LR,Romania,1666,1188,81,4,478,196,201,397,77
2022-11-26,LR,Romania,1664,1284,35,6,380,173,172,345,29
2022-11-27,LR,Romania,1678,1248,44,3,430,189,197,386,41
2022-11-28,LR,Romania,1581,1119,65,8,462,192,205,397,57
2022-11-29,LR,Romania,1581,1102,87,21,479,197,195,392,66
2022-11-30,LR,Romania,1562,1125,58,3,437,197,182,379,55
2022-12-01,LR,Romania,1535,1165,38,1,370,169,163,332,37
2022-12-02,LR,Romania,1557,1153,35,1,404,185,184,369,34
2022-12-03,LR,Romania,1673,1291,32,8,382,178,172,350,24
2022-12-04,LR,Romania,1625,1214,38,6,411,181,192,373,32
2022-12-05,LR,Romania,1547,1104,59,3,443,189,195,384,56
2022-12-06,LR,Romania,1507,1081,54,2,426,185,187,372,52
2022-12-07,LR,Romania,1528,1085,88,13,443,176,179,355,75
2022-12-08,LR,Romania,1603,1165,80,5,438,181,177,358,75
2022-12-09,LR,Romania,1652,1181,73,4,471,198,200,398,69
2022-12-10,LR,Romania,1656,1274,46,11,382,168,168,336,35
2022-12-11,LR,Romania,1591,1199,37,2,392,178,177,355,35
2022-12-12,LR,Romania,1508,1077,60,8,431,186,185,371,52
2022-12-13,LR,Romania,1516,1108,71,10,408,168,169,337,61
2022-12-14,LR,Romania,1618,1157,91,11,461,181,189,370,80
2022-12-15,LR,Romania,1737,1237,92,9,500,208,200,408,83
2022-12-16,LR,Romania,1768,1269,70,2,499,216,213,429,68
2022-12-17,LR,Romania,1777,1354,33,3,423,193,197,390,30
2022-12-18,LR,Romania,1745,1295,43,7,450,201,206,407,36
2022-12-19,LR,Romania,1709,1222,73,17,487,204,210,414,56
2022-12-20,LR,Romania,1700,1214,76,7,486,202,208,410,69
2022-12-21,LR,Romania,1568,1055,75,6,513,219,219,438,69
2022-12-22,LR,Romania,1762,1253,62,3,509,226,221,447,59
2022-12-23,LR,Romania,1776,1268,59,2,508,221,228,449,57
2022-12-24,LR,Romania,1615,1256,20,2,359,174,165,339,18
2022-12-25,LR,Romania,1434,1191,12,2,243,112,119,231,10
2022-12-26,LR,Romania,1579,1160,31,4,419,197,191,388,27
2022-12-27,LR,Romania,1589,1160,55,8,429,188,186,374,47
2022-01-01,LY,Serbia & Montenegro,1292,1196,10,0,96,41,45,86,10
2022-01-02,LY,Serbia & Montenegro,1714,1494,20,2,220,107,93,200,18
2022-01-03,LY,Serbia & Montenegro,1437,1248,19,1,189,82,88,170,18
2022-01-04,LY,Serbia & Montenegro,1306,1164,15,0,142,63,64,127,15
2022-01-05,LY,Serbia & Montenegro,1357,1199,25,6,158,67,66,133,19
2022-01-06,LY,Serbia & Montenegro,1380,1215,19,1,165,72,74,146,18
2022-01-07,LY,Serbia & Montenegro,1477,1282,18,0,195,90,87,177,18
2022-01-08,LY,Serbia & Montenegro,1607,1441,18,0,166,70,78,148,18
2022-01-09,LY,Serbia & Montenegro,1620,1410,18,1,210,93,99,192,17
2022-01-10,LY,Serbia & Montenegro,1190,996,16,0,194,90,88,178,16
2022-01-11,LY,Serbia & Montenegro,1018,880,11,0,138,64,63,127,11
2022-01-12,LY,Serbia & Montenegro,1026,892,14,0,134,62,58,120,14
2022-01-13,LY,Serbia & Montenegro,983,828,21,3,155,65,69,134,18
2022-01-14,LY,Serbia & Montenegro,1218,1022,20,1,196,87,89,176,19
2022-01-15,LY,Serbia & Montenegro,1194,1060,20,2,134,55,59,114,18
2022-01-16,LY,Serbia & Montenegro,1209,1049,19,2,160,75,66,141,17
2022-01-17,LY,Serbia & Montenegro,1017,847,27,11,170,69,74,143,16
2022-01-18,LY,Serbia & Montenegro,847,731,16,8,116,51,49,100,8
2022-01-19,LY,Serbia & Montenegro,871,756,16,5,115,53,46,99,11
2022-01-20,LY,Serbia & Montenegro,923,770,22,3,153,64,67,131,19
2022-01-21,LY,Serbia & Montenegro,1085,924,21,4,161,70,70,140,17
2022-01-22,LY,Serbia & Montenegro,1112,995,16,0,117,50,51,101,16
2022-01-23,LY,Serbia & Montenegro,1152,998,16,0,154,70,68,138,16
2022-01-24,LY,Serbia & Montenegro,861,724,17,0,137,58,62,120,17
2022-01-25,LY,Serbia & Montenegro,725,609,11,2,116,53,52,105,9
2022-01-26,LY,Serbia & Montenegro,816,702,11,1,114,53,50,103,10
2022-01-27,LY,Serbia & Montenegro,901,758,21,2,143,60,62,122,19
2022-01-28,LY,Serbia & Montenegro,1116,937,22,4,179,80,77,157,18
2022-01-29,LY,Serbia & Montenegro,1119,996,18,1,123,49,56,105,17
2022-01-30,LY,Serbia & Montenegro,1113,970,18,0,143,65,60,125,18
2022-01-31,LY,Serbia & Montenegro,956,799,22,8,157,66,69,135,14
2022-02-01,LY,Serbia & Montenegro,894,777,13,4,117,51,53,104,9
2022-02-02,LY,Serbia & Montenegro,853,744,17,5,109,47,45,92,12
2022-02-03,LY,Serbia & Montenegro,935,792,21,5,143,62,60,122,16
2022-02-04,LY,Serbia & Montenegro,1139,963,24,9,176,78,74,152,15
2022-02-05,LY,Serbia & Montenegro,1223,1097,16,0,126,56,54,110,16
2022-02-06,LY,Serbia & Montenegro,1193,1062,17,3,131,57,57,114,14
2022-02-07,LY,Serbia & Montenegro,976,836,15,1,140,60,65,125,14
2022-02-08,LY,Serbia & Montenegro,909,783,19,10,126,53,54,107,9
2022-02-09,LY,Serbia & Montenegro,918,801,20,9,117,50,47,97,11
2022-02-10,LY,Serbia & Montenegro,1029,857,25,9,172,75,72,147,16
2022-02-11,LY,Serbia & Montenegro,1200,1010,28,12,190,84,78,162,16
2022-02-12,LY,Serbia & Montenegro,1264,1133,19,1,131,54,58,112,18
2022-02-13,LY,Serbia & Montenegro,1210,1073,13,0,137,63,61,124,13
2022-02-14,LY,Serbia & Montenegro,994,838,16,0,156,66,74,140,16
2022-02-15,LY,Serbia & Montenegro,918,786,12,0,132,59,61,120,12
2022-02-16,LY,Serbia & Montenegro,964,843,10,0,121,54,57,111,10
2022-02-17,LY,Serbia & Montenegro,1020,879,22,2,141,60,59,119,20
2022-02-18,LY,Serbia & Montenegro,1187,1005,26,10,182,79,77,156,16
2022-02-19,LY,Serbia & Montenegro,1276,1144,18,2,132,57,57,114,16
2022-02-20,LY,Serbia & Montenegro,1316,1164,15,0,152,70,67,137,15
2022-02-21,LY,Serbia & Montenegro,1123,957,25,9,166,68,73,141,16
2022-02-22,LY,Serbia & Montenegro,984,850,23,8,134,53,58,111,15
2022-02-23,LY,Serbia & Montenegro,1013,883,17,7,130,56,57,113,10
2022-02-24,LY,Serbia & Montenegro,1064,902,24,8,162,72,66,138,16
2022-02-25,LY,Serbia & Montenegro,1366,1185,20,5,181,81,80,161,15
2022-02-26,LY,Serbia & Montenegro,1371,1246,15,0,125,50,60,110,15
2022-02-27,LY,Serbia & Montenegro,1373,1222,15,0,151,68,68,136,15
2022-02-28,LY,Serbia & Montenegro,1154,1003,17,1,151,70,64,134,16
2022-03-01,LY,Serbia & Montenegro,1098,956,19,3,142,57,66,123,16
2022-03-02,LY,Serbia & Montenegro,1078,950,18,5,128,54,56,110,13
2022-03-03,LY,Serbia & Montenegro,1207,1032,27,9,175,76,72,148,18
2022-03-04,LY,Serbia & Montenegro,1436,1226,24,6,210,95,91,186,18
2022-03-05,LY,Serbia & Montenegro,1446,1312,16,3,134,60,58,118,13
2022-03-06,LY,Serbia & Montenegro,1420,1261,17,1,159,68,74,142,16
2022-03-07,LY,Serbia & Montenegro,1292,1115,17,0,177,81,79,160,17
2022-03-08,LY,Serbia & Montenegro,1124,996,22,11,128,54,52,106,11
2022-03-09,LY,Serbia & Montenegro,1133,999,23,10,134,57,54,111,13
2022-03-10,LY,Serbia & Montenegro,1135,991,21,0,144,61,62,123,21
2022-03-11,LY,Serbia & Montenegro,1360,1155,26,6,205,92,87,179,20
2022-03-12,LY,Serbia & Montenegro,1358,1228,15,0,130,53,62,115,15
2022-03-13,LY,Serbia & Montenegro,1413,1253,21,1,160,72,67,139,20
2022-03-14,LY,Serbia & Montenegro,1282,1107,17,1,175,75,83,158,16
2022-03-15,LY,Serbia & Montenegro,1144,1013,14,1,131,58,59,117,13
2022-03-16,LY,Serbia & Montenegro,1245,1083,20,5,162,76,66,142,15
2022-03-17,LY,Serbia & Montenegro,1237,1063,21,1,174,77,76,153,20
2022-03-18,LY,Serbia & Montenegro,1417,1218,19,1,199,91,89,180,18
2022-03-19,LY,Serbia & Montenegro,1465,1326,14,1,139,59,66,125,13
2022-03-20,LY,Serbia & Montenegro,1445,1271,19,0,174,79,76,155,19
2022-03-21,LY,Serbia & Montenegro,1295,1113,24,7,182,77,81,158,17
2022-03-22,LY,Serbia & Montenegro,1083,938,24,10,145,58,63,121,14
2022-03-23,LY,Serbia & Montenegro,1259,1114,25,9,145,62,58,120,16
2022-03-24,LY,Serbia & Montenegro,1280,1098,23,4,182,77,82,159,19
2022-03-25,LY,Serbia & Montenegro,1466,1256,28,9,210,92,90,182,19
2022-03-26,LY,Serbia & Montenegro,1496,1351,17,1,145,64,64,128,16
2022-03-27,LY,Serbia & Montenegro,1816,1633,16,1,183,84,83,167,15
2022-03-28,LY,Serbia & Montenegro,1602,1394,29,9,208,90,89,179,20
2022-03-29,LY,Serbia & Montenegro,1488,1327,27,10,161,69,65,134,17
2022-03-30,LY,Serbia & Montenegro,1540,1383,29,10,157,65,63,128,19
2022-03-31,LY,Serbia & Montenegro,1582,1416,16,4,166,77,73,150,12
2022-04-01,LY,Serbia & Montenegro,1808,1597,25,4,211,91,95,186,21
2022-04-02,LY,Serbia & Montenegro,1875,1727,17,0,148,66,65,131,17
2022-04-03,LY,Serbia & Montenegro,1862,1684,14,0,178,81,83,164,14
2022-04-04,LY,Serbia & Montenegro,1625,1413,25,10,212,91,96,187,15
2022-04-05,LY,Serbia & Montenegro,1528,1389,23,11,139,57,59,116,12
2022-04-06,LY,Serbia & Montenegro,1649,1484,27,9,165,74,64,138,18
2022-04-07,LY,Serbia & Montenegro,1683,1499,17,2,184,85,82,167,15
2022-04-08,LY,Serbia & Montenegro,2011,1766,28,9,245,106,111,217,19
2022-04-09,LY,Serbia & Montenegro,2205,2044,19,1,161,73,69,142,18
2022-04-10,LY,Serbia & Montenegro,2143,1932,19,0,211,94,98,192,19
2022-04-11,LY,Serbia & Montenegro,1834,1586,27,5,248,110,111,221,22
2022-04-12,LY,Serbia & Montenegro,1644,1480,25,10,164,71,68,139,15
2022-04-13,LY,Serbia & Montenegro,1794,1629,24,7,165,72,69,141,17
2022-04-14,LY,Serbia & Montenegro,1896,1681,26,7,215,93,96,189,19
2022-04-15,LY,Serbia & Montenegro,2097,1844,29,4,253,111,113,224,25
2022-04-16,LY,Serbia & Montenegro,2272,2081,29,2,191,79,83,162,27
2022-04-17,LY,Serbia & Montenegro,2171,1979,19,0,192,86,87,173,19
2022-04-18,LY,Serbia & Montenegro,1977,1758,23,6,219,103,93,196,17
2022-04-19,LY,Serbia & Montenegro,1786,1608,22,6,178,75,81,156,16
2022-04-20,LY,Serbia & Montenegro,1857,1691,19,2,166,74,73,147,17
2022-04-21,LY,Serbia & Montenegro,1877,1657,26,6,220,99,95,194,20
2022-04-22,LY,Serbia & Montenegro,2107,1887,23,3,220,99,98,197,20
2022-04-23,LY,Serbia & Montenegro,2321,2121,22,1,200,87,91,178,21
2022-04-24,LY,Serbia & Montenegro,2383,2171,15,0,212,95,102,197,15
2022-04-25,LY,Serbia & Montenegro,2017,1804,21,1,213,98,94,192,20
2022-04-26,LY,Serbia & Montenegro,1811,1632,24,9,179,77,78,155,15
2022-04-27,LY,Serbia & Montenegro,1926,1750,26,9,176,75,75,150,17
2022-04-28,LY,Serbia & Montenegro,1995,1770,25,1,225,102,98,200,24
2022-04-29,LY,Serbia & Montenegro,2175,1921,34,3,254,111,109,220,31
2022-04-30,LY,Serbia & Montenegro,2521,2305,22,1,216,96,98,194,21
2022-05-01,LY,Serbia & Montenegro,2510,2291,18,0,219,101,100,201,18
2022-05-02,LY,Serbia & Montenegro,2149,1932,24,0,217,97,96,193,24
2022-05-03,LY,Serbia & Montenegro,2095,1899,22,0,196,86,88,174,22
2022-05-04,LY,Serbia & Montenegro,2015,1827,28,7,188,79,81,160,21
2022-05-05,LY,Serbia & Montenegro,2160,1925,25,7,235,105,105,210,18
2022-05-06,LY,Serbia & Montenegro,2352,2104,24,1,248,113,111,224,23
2022-05-07,LY,Serbia & Montenegro,2683,2482,20,0,201,87,94,181,20
2022-05-08,LY,Serbia & Montenegro,2582,2371,20,0,211,95,96,191,20
2022-05-09,LY,Serbia & Montenegro,2131,1892,35,14,239,103,101,204,21
2022-05-10,LY,Serbia & Montenegro,2098,1894,26,11,204,89,89,178,15
2022-05-11,LY,Serbia & Montenegro,2138,1938,30,10,200,83,87,170,20
2022-05-12,LY,Serbia & Montenegro,2182,1941,32,11,241,110,99,209,21
2022-05-13,LY,Serbia & Montenegro,2456,2204,31,7,252,108,113,221,24
2022-05-14,LY,Serbia & Montenegro,2625,2425,20,0,200,87,93,180,20
2022-05-15,LY,Serbia & Montenegro,2616,2380,24,1,236,109,103,212,23
2022-05-16,LY,Serbia & Montenegro,2165,1923,33,10,242,105,104,209,23
2022-05-17,LY,Serbia & Montenegro,2161,1952,26,9,209,93,90,183,17
2022-05-18,LY,Serbia & Montenegro,2159,1957,30,10,202,84,88,172,20
2022-05-19,LY,Serbia & Montenegro,2234,1950,24,7,284,125,135,260,17
2022-05-20,LY,Serbia & Montenegro,2513,2233,33,10,280,126,121,247,23
2022-05-21,LY,Serbia & Montenegro,2889,2646,25,1,243,107,111,218,24
2022-05-22,LY,Serbia & Montenegro,2768,2499,18,0,269,131,120,251,18
2022-05-23,LY,Serbia & Montenegro,2231,1997,26,7,234,104,104,208,19
2022-05-24,LY,Serbia & Montenegro,2297,2083,17,1,214,99,98,197,16
2022-05-25,LY,Serbia & Montenegro,2580,2364,20,3,216,95,101,196,17
2022-05-26,LY,Serbia & Montenegro,2543,2275,26,7,268,123,119,242,19
2022-05-27,LY,Serbia & Montenegro,2665,2389,33,7,276,123,120,243,26
2022-05-28,LY,Serbia & Montenegro,2990,2766,20,0,224,102,102,204,20
2022-05-29,LY,Serbia & Montenegro,2923,2667,16,0,256,123,117,240,16
2022-05-30,LY,Serbia & Montenegro,2518,2247,31,10,271,117,123,240,21
2022-05-31,LY,Serbia & Montenegro,2371,2148,26,10,223,97,100,197,16
2022-06-01,LY,Serbia & Montenegro,2567,2324,33,11,243,102,108,210,22
2022-06-02,LY,Serbia & Montenegro,2629,2336,28,7,293,136,129,265,21
2022-06-03,LY,Serbia & Montenegro,2864,2579,27,5,285,130,128,258,22
2022-06-04,LY,Serbia & Montenegro,3185,2954,24,1,231,103,104,207,23
2022-06-05,LY,Serbia & Montenegro,2982,2713,20,1,269,130,119,249,19
2022-06-06,LY,Serbia & Montenegro,2629,2348,31,11,281,123,127,250,20
2022-06-07,LY,Serbia & Montenegro,2668,2414,30,10,254,108,116,224,20
2022-06-08,LY,Serbia & Montenegro,2575,2343,24,3,232,103,105,208,21
2022-06-09,LY,Serbia & Montenegro,2578,2289,30,7,289,131,128,259,23
2022-06-10,LY,Serbia & Montenegro,2845,2550,35,3,295,135,125,260,32
2022-06-11,LY,Serbia & Montenegro,3015,2761,22,0,254,112,120,232,22
2022-06-12,LY,Serbia & Montenegro,3099,2805,24,1,294,135,135,270,23
2022-06-13,LY,Serbia & Montenegro,2761,2460,29,2,301,133,139,272,27
2022-06-14,LY,Serbia & Montenegro,2682,2427,28,0,255,115,112,227,28
2022-06-15,LY,Serbia & Montenegro,2856,2587,35,4,269,114,120,234,31
2022-06-16,LY,Serbia & Montenegro,2882,2580,27,4,302,136,139,275,23
2022-06-17,LY,Serbia & Montenegro,2997,2675,28,3,322,151,143,294,25
2022-06-18,LY,Serbia & Montenegro,3261,2970,29,0,291,128,134,262,29
2022-06-19,LY,Serbia & Montenegro,3194,2878,26,1,316,148,142,290,25
2022-06-20,LY,Serbia & Montenegro,2866,2534,41,11,332,146,145,291,30
2022-06-21,LY,Serbia & Montenegro,2773,2482,30,6,291,128,133,261,24
2022-06-22,LY,Serbia & Montenegro,2861,2578,42,8,283,120,121,241,34
2022-06-23,LY,Serbia & Montenegro,2771,2456,33,10,315,145,137,282,23
2022-06-24,LY,Serbia & Montenegro,2942,2618,34,4,324,141,149,290,30
2022-06-25,LY,Serbia & Montenegro,3103,2809,31,3,294,128,135,263,28
2022-06-26,LY,Serbia & Montenegro,3298,2974,29,0,324,158,137,295,29
2022-06-27,LY,Serbia & Montenegro,2921,2602,38,7,319,135,146,281,31
2022-06-28,LY,Serbia & Montenegro,3041,2733,40,6,308,128,140,268,34
2022-06-29,LY,Serbia & Montenegro,2932,2639,39,6,293,129,125,254,33
2022-06-30,LY,Serbia & Montenegro,2863,2520,34,6,343,153,156,309,28
2022-07-01,LY,Serbia & Montenegro,3127,2784,43,9,343,155,145,300,34
2022-07-02,LY,Serbia & Montenegro,3337,3013,37,3,324,144,143,287,34
2022-07-03,LY,Serbia & Montenegro,3271,2932,30,0,339,154,155,309,30
2022-07-04,LY,Serbia & Montenegro,3048,2712,48,14,336,145,143,288,34
2022-07-05,LY,Serbia & Montenegro,3016,2696,45,13,320,139,136,275,32
2022-07-06,LY,Serbia & Montenegro,3343,3012,40,7,331,142,149,291,33
2022-07-07,LY,Serbia & Montenegro,3129,2791,42,11,338,148,148,296,31
2022-07-08,LY,Serbia & Montenegro,3224,2863,42,9,361,164,155,319,33
2022-07-09,LY,Serbia & Montenegro,3448,3128,32,0,320,137,151,288,32
2022-07-10,LY,Serbia & Montenegro,3365,3035,34,0,330,150,146,296,34
2022-07-11,LY,Serbia & Montenegro,3086,2744,46,12,342,145,151,296,34
2022-07-12,LY,Serbia & Montenegro,3046,2733,37,9,313,139,137,276,28
2022-07-13,LY,Serbia & Montenegro,3083,2765,44,12,318,141,133,274,32
2022-07-14,LY,Serbia & Montenegro,3052,2729,39,11,323,143,141,284,28
2022-07-15,LY,Serbia & Montenegro,3095,2736,44,7,359,161,154,315,37
2022-07-16,LY,Serbia & Montenegro,3442,3112,40,5,330,139,151,290,35
2022-07-17,LY,Serbia & Montenegro,3338,3017,30,0,321,150,141,291,30
2022-07-18,LY,Serbia & Montenegro,3038,2708,43,12,330,142,145,287,31
2022-07-19,LY,Serbia & Montenegro,3036,2701,46,12,335,141,148,289,34
2022-07-20,LY,Serbia & Montenegro,3051,2725,39,10,326,146,141,287,29
2022-07-21,LY,Serbia & Montenegro,3082,2733,40,10,349,149,160,309,30
2022-07-22,LY,Serbia & Montenegro,3138,2769,45,8,369,168,156,324,37
2022-07-23,LY,Serbia & Montenegro,3432,3101,37,0,331,146,148,294,37
2022-07-24,LY,Serbia & Montenegro,3373,3054,36,0,319,145,138,283,36
2022-07-25,LY,Serbia & Montenegro,3024,2668,37,3,356,156,163,319,34
2022-07-26,LY,Serbia & Montenegro,3078,2759,28,4,319,144,147,291,24
2022-07-27,LY,Serbia & Montenegro,3023,2718,43,7,305,132,130,262,36
2022-07-28,LY,Serbia & Montenegro,2900,2562,38,6,338,151,149,300,32
2022-07-29,LY,Serbia & Montenegro,3228,2873,36,5,355,160,159,319,31
2022-07-30,LY,Serbia & Montenegro,3324,2986,40,0,338,147,151,298,40
2022-07-31,LY,Serbia & Montenegro,3301,2964,33,0,337,154,150,304,33
2022-08-01,LY,Serbia & Montenegro,2990,2648,38,5,342,150,154,304,33
2022-08-02,LY,Serbia & Montenegro,3100,2774,36,6,326,142,148,290,30
2022-08-03,LY,Serbia & Montenegro,3094,2790,40,6,304,136,128,264,34
2022-08-04,LY,Serbia & Montenegro,3074,2734,35,7,340,156,149,305,28
2022-08-05,LY,Serbia & Montenegro,3140,2777,41,3,363,161,161,322,38
2022-08-06,LY,Serbia & Montenegro,3428,3096,33,2,332,146,153,299,31
2022-08-07,LY,Serbia & Montenegro,3246,2907,31,1,339,161,147,308,30
2022-08-08,LY,Serbia & Montenegro,2906,2595,38,6,311,131,142,273,32
2022-08-09,LY,Serbia & Montenegro,2855,2544,34,5,311,141,136,277,29
2022-08-10,LY,Serbia & Montenegro,3082,2761,38,5,321,140,143,283,33
2022-08-11,LY,Serbia & Montenegro,3075,2730,38,5,345,148,159,307,33
2022-08-12,LY,Serbia & Montenegro,3136,2766,38,7,370,170,162,332,31
2022-08-13,LY,Serbia & Montenegro,3188,2870,36,1,318,140,142,282,35
2022-08-14,LY,Serbia & Montenegro,3156,2833,30,0,323,148,145,293,30
2022-08-15,LY,Serbia & Montenegro,3032,2693,38,7,339,146,155,301,31
2022-08-16,LY,Serbia & Montenegro,2978,2657,41,10,321,138,142,280,31
2022-08-17,LY,Serbia & Montenegro,3067,2749,45,10,318,138,135,273,35
2022-08-18,LY,Serbia & Montenegro,3043,2697,41,9,346,152,153,305,32
2022-08-19,LY,Serbia & Montenegro,2954,2611,38,7,343,152,153,305,31
2022-08-20,LY,Serbia & Montenegro,3142,2804,36,0,338,153,149,302,36
2022-08-21,LY,Serbia & Montenegro,2974,2648,36,0,326,146,144,290,36
2022-08-22,LY,Serbia & Montenegro,2785,2459,43,3,326,140,143,283,40
2022-08-23,LY,Serbia & Montenegro,2832,2513,29,3,319,144,146,290,26
2022-08-24,LY,Serbia & Montenegro,2934,2636,39,9,298,135,124,259,30
2022-08-25,LY,Serbia & Montenegro,2902,2568,38,9,334,149,147,296,29
2022-08-26,LY,Serbia & Montenegro,3017,2665,48,9,352,152,152,304,39
2022-08-27,LY,Serbia & Montenegro,3151,2816,38,6,335,144,153,297,32
2022-08-28,LY,Serbia & Montenegro,3160,2847,33,1,313,139,141,280,32
2022-08-29,LY,Serbia & Montenegro,2688,2363,43,9,325,144,138,282,34
2022-08-30,LY,Serbia & Montenegro,2915,2588,38,10,327,140,149,289,28
2022-08-31,LY,Serbia & Montenegro,2911,2613,41,10,298,135,122,257,31
2022-09-01,LY,Serbia & Montenegro,2782,2448,38,6,334,144,152,296,32
2022-09-02,LY,Serbia & Montenegro,2884,2573,26,0,311,146,139,285,26
2022-09-03,LY,Serbia & Montenegro,3189,2866,29,0,323,143,151,294,29
2022-09-04,LY,Serbia & Montenegro,2989,2677,27,0,312,148,137,285,27
2022-09-05,LY,Serbia & Montenegro,2855,2527,42,13,328,139,147,286,29
2022-09-06,LY,Serbia & Montenegro,2906,2594,35,10,312,133,144,277,25
2022-09-07,LY,Serbia & Montenegro,2964,2665,42,15,299,128,129,257,27
2022-09-08,LY,Serbia & Montenegro,2861,2528,35,11,333,153,145,298,24
2022-09-09,LY,Serbia & Montenegro,2795,2479,35,9,316,143,138,281,26
2022-09-10,LY,Serbia & Montenegro,2885,2590,33,3,295,129,133,262,30
2022-09-11,LY,Serbia & Montenegro,2891,2568,28,1,323,149,146,295,27
2022-09-12,LY,Serbia & Montenegro,2756,2426,39,10,330,141,150,291,29
2022-09-13,LY,Serbia & Montenegro,2771,2471,37,11,300,132,131,263,26
2022-09-14,LY,Serbia & Montenegro,2744,2472,41,10,272,117,114,231,31
2022-09-15,LY,Serbia & Montenegro,2701,2379,38,11,322,141,143,284,27
2022-09-16,LY,Serbia & Montenegro,2697,2388,29,7,309,144,136,280,22
2022-09-17,LY,Serbia & Montenegro,3027,2728,31,0,299,129,139,268,31
2022-09-18,LY,Serbia & Montenegro,2970,2677,22,0,293,140,131,271,22
2022-09-19,LY,Serbia & Montenegro,2659,2366,33,10,293,127,133,260,23
2022-09-20,LY,Serbia & Montenegro,2604,2336,27,9,268,117,124,241,18
2022-09-21,LY,Serbia & Montenegro,2724,2458,25,5,266,122,119,241,20
2022-09-22,LY,Serbia & Montenegro,2644,2335,29,4,309,143,137,280,25
2022-09-23,LY,Serbia & Montenegro,2876,2570,32,7,306,140,134,274,25
2022-09-24,LY,Serbia & Montenegro,3066,2797,23,2,269,119,127,246,21
2022-09-25,LY,Serbia & Montenegro,2944,2643,26,1,301,142,133,275,25
2022-09-26,LY,Serbia & Montenegro,2362,2103,25,6,259,111,123,234,19
2022-09-27,LY,Serbia & Montenegro,2425,2145,29,9,280,125,126,251,20
2022-09-28,LY,Serbia & Montenegro,2639,2385,29,8,254,114,111,225,21
2022-09-29,LY,Serbia & Montenegro,2552,2264,31,12,288,132,125,257,19
2022-09-30,LY,Serbia & Montenegro,2679,2388,32,9,291,132,127,259,23
2022-10-01,LY,Serbia & Montenegro,2913,2661,18,0,252,112,122,234,18
2022-10-02,LY,Serbia & Montenegro,2833,2558,21,1,275,133,121,254,20
2022-10-03,LY,Serbia & Montenegro,2567,2292,34,9,275,118,123,241,25
2022-10-04,LY,Serbia & Montenegro,2370,2141,24,10,229,100,105,205,14
2022-10-05,LY,Serbia & Montenegro,2441,2224,27,11,217,100,90,190,16
2022-10-06,LY,Serbia & Montenegro,2479,2189,36,17,290,128,126,254,19
2022-10-07,LY,Serbia & Montenegro,2637,2351,35,13,286,122,129,251,22
2022-10-08,LY,Serbia & Montenegro,2931,2680,21,4,251,114,116,230,17
2022-10-09,LY,Serbia & Montenegro,2841,2585,20,2,256,120,116,236,18
2022-10-10,LY,Serbia & Montenegro,2469,2186,24,5,283,128,131,259,19
2022-10-11,LY,Serbia & Montenegro,2292,2063,35,17,229,99,95,194,18
2022-10-12,LY,Serbia & Montenegro,2371,2144,29,13,227,98,100,198,16
2022-10-13,LY,Serbia & Montenegro,2368,2113,30,13,255,114,111,225,17
2022-10-14,LY,Serbia & Montenegro,2566,2297,37,13,269,117,115,232,24
2022-10-15,LY,Serbia & Montenegro,2782,2544,25,6,238,101,112,213,19
2022-10-16,LY,Serbia & Montenegro,2837,2589,16,0,248,120,112,232,16
2022-10-17,LY,Serbia & Montenegro,2295,2033,29,9,262,112,121,233,20
2022-10-18,LY,Serbia & Montenegro,2223,2008,25,11,215,95,95,190,14
2022-10-19,LY,Serbia & Montenegro,2319,2112,31,13,207,93,83,176,18
2022-10-20,LY,Serbia & Montenegro,2307,2063,28,11,244,107,109,216,17
2022-10-21,LY,Serbia & Montenegro,2441,2184,26,4,257,118,113,231,22
2022-10-22,LY,Serbia & Montenegro,2885,2665,17,1,220,96,107,203,16
2022-10-23,LY,Serbia & Montenegro,2698,2460,17,1,238,109,112,221,16
2022-10-24,LY,Serbia & Montenegro,2272,2017,23,6,255,118,114,232,17
2022-10-25,LY,Serbia & Montenegro,2260,2039,24,12,221,97,100,197,12
2022-10-26,LY,Serbia & Montenegro,2321,2110,23,5,211,96,92,188,18
2022-10-27,LY,Serbia & Montenegro,2354,2110,31,16,244,105,108,213,15
2022-10-28,LY,Serbia & Montenegro,2474,2214,35,10,260,113,112,225,25
2022-10-29,LY,Serbia & Montenegro,2842,2628,18,0,214,95,101,196,18
2022-10-30,LY,Serbia & Montenegro,2486,2272,16,0,214,103,95,198,16
2022-10-31,LY,Serbia & Montenegro,2070,1846,28,7,224,97,99,196,21
2022-11-01,LY,Serbia & Montenegro,1800,1604,29,15,196,83,84,167,14
2022-11-02,LY,Serbia & Montenegro,1837,1645,19,0,192,88,85,173,19
2022-11-03,LY,Serbia & Montenegro,1729,1536,20,3,193,84,89,173,17
2022-11-04,LY,Serbia & Montenegro,1840,1598,20,2,242,114,108,222,18
2022-11-05,LY,Serbia & Montenegro,2057,1877,16,0,180,84,80,164,16
2022-11-06,LY,Serbia & Montenegro,2082,1872,18,0,210,95,97,192,18
2022-11-07,LY,Serbia & Montenegro,1643,1403,29,11,240,101,110,211,18
2022-11-08,LY,Serbia & Montenegro,1464,1294,23,9,170,72,75,147,14
2022-11-09,LY,Serbia & Montenegro,1503,1312,32,13,191,82,77,159,19
2022-11-10,LY,Serbia & Montenegro,1497,1302,28,12,195,84,83,167,16
2022-11-11,LY,Serbia & Montenegro,1648,1422,22,0,226,98,106,204,22
2022-11-12,LY,Serbia & Montenegro,1726,1554,17,0,172,79,76,155,17
2022-11-13,LY,Serbia & Montenegro,1784,1570,18,0,214,99,97,196,18
2022-11-14,LY,Serbia & Montenegro,1562,1309,30,12,253,112,111,223,18
2022-11-15,LY,Serbia & Montenegro,1387,1213,28,14,174,71,75,146,14
2022-11-16,LY,Serbia & Montenegro,1487,1273,30,11,214,94,90,184,19
2022-11-17,LY,Serbia & Montenegro,1503,1272,32,11,231,100,99,199,21
2022-11-18,LY,Serbia & Montenegro,1612,1388,24,7,224,101,99,200,17
2022-11-19,LY,Serbia & Montenegro,1640,1471,19,3,169,72,78,150,16
2022-11-20,LY,Serbia & Montenegro,1734,1524,19,0,210,97,94,191,19
2022-11-21,LY,Serbia & Montenegro,1484,1243,26,9,241,106,109,215,17
2022-11-22,LY,Serbia & Montenegro,1282,1100,22,6,182,78,82,160,16
2022-11-23,LY,Serbia & Montenegro,1364,1153,22,4,211,94,95,189,18
2022-11-24,LY,Serbia & Montenegro,1434,1222,23,7,212,97,92,189,16
2022-11-25,LY,Serbia & Montenegro,1582,1331,30,8,251,112,109,221,22
2022-11-26,LY,Serbia & Montenegro,1599,1429,14,1,170,77,79,156,13
2022-11-27,LY,Serbia & Montenegro,1731,1533,16,0,198,96,86,182,16
2022-11-28,LY,Serbia & Montenegro,1464,1220,30,9,244,105,109,214,21
2022-11-29,LY,Serbia & Montenegro,1313,1121,32,17,192,75,85,160,15
2022-11-30,LY,Serbia & Montenegro,1396,1191,31,13,205,89,85,174,18
2022-12-01,LY,Serbia & Montenegro,1438,1229,24,6,209,91,94,185,18
2022-12-02,LY,Serbia & Montenegro,1572,1327,33,12,245,107,105,212,21
2022-12-03,LY,Serbia & Montenegro,1551,1367,21,2,184,82,81,163,19
2022-12-04,LY,Serbia & Montenegro,1717,1507,19,0,210,97,94,191,19
2022-12-05,LY,Serbia & Montenegro,1427,1188,19,2,239,106,114,220,17
2022-12-06,LY,Serbia & Montenegro,1342,1160,18,1,182,83,81,164,17
2022-12-07,LY,Serbia & Montenegro,1423,1228,27,4,195,85,83,168,23
2022-12-08,LY,Serbia & Montenegro,1414,1209,23,6,205,92,90,182,17
2022-12-09,LY,Serbia & Montenegro,1536,1303,26,7,233,104,103,207,19
2022-12-10,LY,Serbia & Montenegro,1535,1360,22,4,175,75,78,153,18
2022-12-11,LY,Serbia & Montenegro,1685,1480,18,0,205,96,91,187,18
2022-12-12,LY,Serbia & Montenegro,1461,1220,25,3,241,106,110,216,22
2022-12-13,LY,Serbia & Montenegro,1346,1149,28,10,197,79,90,169,18
2022-12-14,LY,Serbia & Montenegro,1425,1224,20,1,201,94,87,181,19
2022-12-15,LY,Serbia & Montenegro,1507,1300,24,10,207,95,88,183,14
2022-12-16,LY,Serbia & Montenegro,1674,1438,17,2,236,109,110,219,15
2022-12-17,LY,Serbia & Montenegro,1705,1502,21,0,203,89,93,182,21
2022-12-18,LY,Serbia & Montenegro,1820,1602,21,1,218,97,100,197,20
2022-12-19,LY,Serbia & Montenegro,1624,1379,17,2,245,114,114,228,15
2022-12-20,LY,Serbia & Montenegro,1559,1364,21,3,195,85,89,174,18
2022-12-21,LY,Serbia & Montenegro,1610,1392,24,2,218,98,96,194,22
2022-12-22,LY,Serbia & Montenegro,1769,1554,22,3,215,98,95,193,19
2022-12-23,LY,Serbia & Montenegro,1926,1672,19,2,254,115,120,235,17
2022-12-24,LY,Serbia & Montenegro,1664,1470,23,1,194,89,82,171,22
2022-12-25,LY,Serbia & Montenegro,1535,1337,19,0,198,89,90,179,19
2022-12-26,LY,Serbia & Montenegro,1624,1393,19,3,231,105,107,212,16
2022-12-27,LY,Serbia & Montenegro,1592,1406,17,0,186,80,89,169,17
2022-01-01,LZ,Slovakia,645,628,0,0,17,9,8,17,0
2022-01-02,LZ,Slovakia,893,839,0,0,54,28,26,54,0
2022-01-03,LZ,Slovakia,845,787,0,0,58,29,29,58,0
2022-01-04,LZ,Slovakia,691,667,1,0,24,11,12,23,1
2022-01-05,LZ,Slovakia,702,670,2,0,32,14,16,30,2
2022-01-06,LZ,Slovakia,662,638,0,0,24,13,11,24,0
2022-01-07,LZ,Slovakia,817,754,3,1,63,29,31,60,2
2022-01-08,LZ,Slovakia,771,739,3,0,32,14,15,29,3
2022-01-09,LZ,Slovakia,831,786,0,0,45,22,23,45,0
2022-01-10,LZ,Slovakia,685,651,1,0,34,17,16,33,1
2022-01-11,LZ,Slovakia,562,529,3,1,33,14,16,30,2
2022-01-12,LZ,Slovakia,576,535,8,2,41,15,18,33,6
2022-01-13,LZ,Slovakia,611,573,4,0,38,15,19,34,4
2022-01-14,LZ,Slovakia,731,689,4,2,42,17,21,38,2
2022-01-15,LZ,Slovakia,672,652,2,1,20,11,7,18,1
2022-01-16,LZ,Slovakia,656,608,4,0,48,23,21,44,4
2022-01-17,LZ,Slovakia,577,543,0,0,34,18,16,34,0
2022-01-18,LZ,Slovakia,513,479,12,3,34,10,12,22,9
2022-01-19,LZ,Slovakia,518,460,13,6,58,20,25,45,7
2022-01-20,LZ,Slovakia,558,525,1,0,33,18,14,32,1
2022-01-21,LZ,Slovakia,659,623,2,0,36,17,17,34,2
2022-01-22,LZ,Slovakia,573,562,1,0,11,4,6,10,1
2022-01-23,LZ,Slovakia,621,587,2,1,34,15,17,32,1
2022-01-24,LZ,Slovakia,521,476,8,1,45,19,18,37,7
2022-01-25,LZ,Slovakia,407,385,4,1,22,10,8,18,3
2022-01-26,LZ,Slovakia,480,443,6,2,37,17,14,31,4
2022-01-27,LZ,Slovakia,578,542,7,2,36,15,14,29,5
2022-01-28,LZ,Slovakia,674,638,1,0,36,16,19,35,1
2022-01-29,LZ,Slovakia,615,598,0,0,17,9,8,17,0
2022-01-30,LZ,Slovakia,630,597,0,0,33,16,17,33,0
2022-01-31,LZ,Slovakia,621,581,4,2,40,18,18,36,2
2022-02-01,LZ,Slovakia,549,524,6,0,25,8,11,19,6
2022-02-02,LZ,Slovakia,563,519,4,1,44,21,19,40,3
2022-02-03,LZ,Slovakia,574,537,6,3,37,17,14,31,3
2022-02-04,LZ,Slovakia,646,610,3,1,36,17,16,33,2
2022-02-05,LZ,Slovakia,600,574,0,0,26,12,14,26,0
2022-02-06,LZ,Slovakia,619,591,1,0,28,14,13,27,1
2022-02-07,LZ,Slovakia,629,575,3,0,54,26,25,51,3
2022-02-08,LZ,Slovakia,521,490,6,3,31,11,14,25,3
2022-02-09,LZ,Slovakia,585,544,2,0,41,18,21,39,2
2022-02-10,LZ,Slovakia,635,593,6,2,42,20,16,36,4
2022-02-11,LZ,Slovakia,690,635,6,2,55,24,25,49,4
2022-02-12,LZ,Slovakia,644,614,2,2,30,15,13,28,0
2022-02-13,LZ,Slovakia,690,648,3,2,42,17,22,39,1
2022-02-14,LZ,Slovakia,682,623,2,2,59,31,26,57,0
2022-02-15,LZ,Slovakia,605,567,4,2,38,15,19,34,2
2022-02-16,LZ,Slovakia,605,533,4,3,72,33,35,68,1
2022-02-17,LZ,Slovakia,618,583,0,0,35,20,15,35,0
2022-02-18,LZ,Slovakia,740,683,6,0,57,25,26,51,6
2022-02-19,LZ,Slovakia,711,671,2,1,40,21,17,38,1
2022-02-20,LZ,Slovakia,719,678,1,0,41,20,20,40,1
2022-02-21,LZ,Slovakia,646,587,1,0,59,29,29,58,1
2022-02-22,LZ,Slovakia,602,560,3,0,42,18,21,39,3
2022-02-23,LZ,Slovakia,603,556,4,0,47,22,21,43,4
2022-02-24,LZ,Slovakia,800,753,8,6,47,20,19,39,2
2022-02-25,LZ,Slovakia,925,843,11,0,82,34,37,71,11
2022-02-26,LZ,Slovakia,848,816,2,0,32,16,14,30,2
2022-02-27,LZ,Slovakia,834,785,3,0,49,23,23,46,3
2022-02-28,LZ,Slovakia,765,716,1,1,49,25,23,48,0
2022-03-01,LZ,Slovakia,715,665,12,5,50,15,23,38,7
2022-03-02,LZ,Slovakia,784,721,8,4,63,28,27,55,4
2022-03-03,LZ,Slovakia,828,778,3,2,50,23,24,47,1
2022-03-04,LZ,Slovakia,923,847,6,2,76,37,33,70,4
2022-03-05,LZ,Slovakia,896,843,3,2,53,24,26,50,1
2022-03-06,LZ,Slovakia,901,852,7,3,49,20,22,42,4
2022-03-07,LZ,Slovakia,814,743,8,4,71,31,32,63,4
2022-03-08,LZ,Slovakia,765,712,3,1,53,25,25,50,2
2022-03-09,LZ,Slovakia,793,719,10,4,74,34,30,64,6
2022-03-10,LZ,Slovakia,800,752,11,3,48,19,18,37,8
2022-03-11,LZ,Slovakia,914,843,7,4,71,32,32,64,3
2022-03-12,LZ,Slovakia,813,787,2,0,26,13,11,24,2
2022-03-13,LZ,Slovakia,857,806,1,0,51,21,29,50,1
2022-03-14,LZ,Slovakia,774,710,6,1,64,31,27,58,5
2022-03-15,LZ,Slovakia,775,731,8,2,44,17,19,36,6
2022-03-16,LZ,Slovakia,757,696,4,0,61,24,33,57,4
2022-03-17,LZ,Slovakia,807,747,7,2,60,26,27,53,5
2022-03-18,LZ,Slovakia,921,857,5,3,64,36,23,59,2
2022-03-19,LZ,Slovakia,845,801,2,0,44,20,22,42,2
2022-03-20,LZ,Slovakia,868,825,2,1,43,21,20,41,1
2022-03-21,LZ,Slovakia,783,722,7,1,61,25,29,54,6
2022-03-22,LZ,Slovakia,731,668,8,4,63,29,26,55,4
2022-03-23,LZ,Slovakia,756,691,7,2,65,31,27,58,5
2022-03-24,LZ,Slovakia,812,749,4,1,63,28,31,59,3
2022-03-25,LZ,Slovakia,951,865,5,2,86,42,39,81,3
2022-03-26,LZ,Slovakia,910,875,0,0,35,16,19,35,0
2022-03-27,LZ,Slovakia,930,870,0,0,60,27,33,60,0
2022-03-28,LZ,Slovakia,848,780,13,6,68,30,25,55,7
2022-03-29,LZ,Slovakia,894,825,4,4,69,28,37,65,0
2022-03-30,LZ,Slovakia,881,788,9,6,93,46,38,84,3
2022-03-31,LZ,Slovakia,948,876,3,1,72,35,34,69,2
2022-04-01,LZ,Slovakia,1004,933,7,0,71,32,32,64,7
2022-04-02,LZ,Slovakia,1077,1049,1,0,28,14,13,27,1
2022-04-03,LZ,Slovakia,1056,998,1,0,58,27,30,57,1
2022-04-04,LZ,Slovakia,921,854,3,1,67,33,31,64,2
2022-04-05,LZ,Slovakia,921,860,2,0,61,29,30,59,2
2022-04-06,LZ,Slovakia,934,855,5,1,79,38,36,74,4
2022-04-07,LZ,Slovakia,1021,955,6,0,66,32,28,60,6
2022-04-08,LZ,Slovakia,1108,1054,1,1,54,27,26,53,0
2022-04-09,LZ,Slovakia,1126,1094,1,0,32,15,16,31,1
2022-04-10,LZ,Slovakia,1103,1040,1,0,63,31,31,62,1
2022-04-11,LZ,Slovakia,1017,951,3,1,66,29,34,63,2
2022-04-12,LZ,Slovakia,1059,984,10,3,75,32,33,65,7
2022-04-13,LZ,Slovakia,1032,950,5,1,82,40,37,77,4
2022-04-14,LZ,Slovakia,1120,1051,4,1,69,34,31,65,3
2022-04-15,LZ,Slovakia,1160,1098,2,1,62,30,30,60,1
2022-04-16,LZ,Slovakia,1160,1134,2,0,26,12,12,24,2
2022-04-17,LZ,Slovakia,1128,1079,1,0,49,23,25,48,1
2022-04-18,LZ,Slovakia,1094,1026,4,1,68,32,32,64,3
2022-04-19,LZ,Slovakia,1161,1096,4,4,65,30,31,61,0
2022-04-20,LZ,Slovakia,1043,977,9,4,66,29,28,57,5
2022-04-21,LZ,Slovakia,1106,1046,14,8,60,22,24,46,6
2022-04-22,LZ,Slovakia,1122,1051,6,3,71,35,30,65,3
2022-04-23,LZ,Slovakia,1231,1180,2,1,51,22,27,49,1
2022-04-24,LZ,Slovakia,1254,1168,5,2,86,40,41,81,3
2022-04-25,LZ,Slovakia,1053,995,7,3,58,26,25,51,4
2022-04-26,LZ,Slovakia,1107,1042,10,4,65,26,29,55,6
2022-04-27,LZ,Slovakia,1099,1010,15,6,89,34,40,74,9
2022-04-28,LZ,Slovakia,1184,1109,6,3,75,40,29,69,3
2022-04-29,LZ,Slovakia,1246,1167,10,2,79,36,33,69,8
2022-04-30,LZ,Slovakia,1314,1279,2,1,35,13,20,33,1
2022-05-01,LZ,Slovakia,1380,1315,3,1,65,30,32,62,2
2022-05-02,LZ,Slovakia,1176,1108,8,3,68,31,29,60,5
2022-05-03,LZ,Slovakia,1197,1118,10,3,79,34,35,69,7
2022-05-04,LZ,Slovakia,1246,1166,5,2,80,37,38,75,3
2022-05-05,LZ,Slovakia,1348,1258,7,4,90,38,45,83,3
2022-05-06,LZ,Slovakia,1287,1209,6,0,78,35,37,72,6
2022-05-07,LZ,Slovakia,1372,1318,2,0,54,27,25,52,2
2022-05-08,LZ,Slovakia,1369,1302,6,0,67,29,32,61,6
2022-05-09,LZ,Slovakia,1195,1108,5,2,87,44,38,82,3
2022-05-10,LZ,Slovakia,1181,1097,10,3,84,39,35,74,7
2022-05-11,LZ,Slovakia,1231,1141,8,4,90,41,41,82,4
2022-05-12,LZ,Slovakia,1318,1241,8,2,77,32,37,69,6
2022-05-13,LZ,Slovakia,1333,1246,10,2,87,41,36,77,8
2022-05-14,LZ,Slovakia,1448,1384,4,0,64,32,28,60,4
2022-05-15,LZ,Slovakia,1423,1345,6,1,78,32,40,72,5
2022-05-16,LZ,Slovakia,1224,1150,7,6,74,34,33,67,1
2022-05-17,LZ,Slovakia,1181,1110,3,1,71,35,33,68,2
2022-05-18,LZ,Slovakia,1232,1144,10,5,88,38,40,78,5
2022-05-19,LZ,Slovakia,1292,1220,5,4,72,35,32,67,1
2022-05-20,LZ,Slovakia,1421,1344,3,0,77,40,34,74,3
2022-05-21,LZ,Slovakia,1511,1470,0,0,41,23,18,41,0
2022-05-22,LZ,Slovakia,1474,1405,2,0,69,31,36,67,2
2022-05-23,LZ,Slovakia,1359,1270,1,0,89,43,45,88,1
2022-05-24,LZ,Slovakia,1321,1252,14,7,69,27,28,55,7
2022-05-25,LZ,Slovakia,1323,1251,6,4,72,35,31,66,2
2022-05-26,LZ,Slovakia,1394,1302,10,3,92,38,44,82,7
2022-05-27,LZ,Slovakia,1480,1386,16,7,94,38,40,78,9
2022-05-28,LZ,Slovakia,1617,1558,1,0,59,31,27,58,1
2022-05-29,LZ,Slovakia,1613,1534,3,1,79,34,42,76,2
2022-05-30,LZ,Slovakia,1394,1311,7,3,83,42,34,76,4
2022-05-31,LZ,Slovakia,1419,1345,6,5,74,32,36,68,1
2022-06-01,LZ,Slovakia,1496,1403,12,5,93,41,40,81,7
2022-06-02,LZ,Slovakia,1519,1427,11,3,92,41,40,81,8
2022-06-03,LZ,Slovakia,1605,1516,7,5,89,41,41,82,2
2022-06-04,LZ,Slovakia,1733,1672,2,0,61,32,27,59,2
2022-06-05,LZ,Slovakia,1778,1701,6,0,77,32,39,71,6
2022-06-06,LZ,Slovakia,1442,1361,5,3,81,41,35,76,2
2022-06-07,LZ,Slovakia,1487,1402,5,3,85,39,41,80,2
2022-06-08,LZ,Slovakia,1474,1376,4,1,98,46,48,94,3
2022-06-09,LZ,Slovakia,1606,1503,5,3,103,50,48,98,2
2022-06-10,LZ,Slovakia,1717,1600,7,0,117,57,53,110,7
2022-06-11,LZ,Slovakia,1809,1729,6,0,80,33,41,74,6
2022-06-12,LZ,Slovakia,1791,1696,1,0,95,48,46,94,1
2022-06-13,LZ,Slovakia,1526,1435,5,3,91,42,44,86,2
2022-06-14,LZ,Slovakia,1549,1458,8,5,91,44,39,83,3
2022-06-15,LZ,Slovakia,1576,1456,16,5,120,50,54,104,11
2022-06-16,LZ,Slovakia,1570,1477,8,2,93,45,40,85,6
2022-06-17,LZ,Slovakia,1745,1627,5,1,118,57,56,113,4
2022-06-18,LZ,Slovakia,1821,1751,3,1,70,32,35,67,2
2022-06-19,LZ,Slovakia,1756,1675,1,1,81,40,40,80,0
2022-06-20,LZ,Slovakia,1596,1489,6,3,107,49,52,101,3
2022-06-21,LZ,Slovakia,1671,1577,5,2,94,46,43,89,3
2022-06-22,LZ,Slovakia,1750,1629,7,1,121,54,60,114,6
2022-06-23,LZ,Slovakia,1723,1595,8,2,128,63,57,120,6
2022-06-24,LZ,Slovakia,1891,1759,7,1,132,66,59,125,6
2022-06-25,LZ,Slovakia,1952,1866,3,0,86,41,42,83,3
2022-06-26,LZ,Slovakia,1965,1864,4,1,101,46,51,97,3
2022-06-27,LZ,Slovakia,1825,1724,7,2,101,46,48,94,5
2022-06-28,LZ,Slovakia,1804,1689,4,2,115,57,54,111,2
2022-06-29,LZ,Slovakia,1840,1710,2,1,130,61,67,128,1
2022-06-30,LZ,Slovakia,1806,1674,14,7,132,60,58,118,7
2022-07-01,LZ,Slovakia,2008,1895,3,2,113,55,55,110,1
2022-07-02,LZ,Slovakia,1989,1883,0,0,106,54,52,106,0
2022-07-03,LZ,Slovakia,2007,1912,0,0,95,48,47,95,0
2022-07-04,LZ,Slovakia,1847,1756,3,0,91,43,45,88,3
2022-07-05,LZ,Slovakia,1850,1727,6,0,123,59,58,117,6
2022-07-06,LZ,Slovakia,1851,1741,3,2,110,53,54,107,1
2022-07-07,LZ,Slovakia,1880,1773,6,1,107,51,50,101,5
2022-07-08,LZ,Slovakia,1965,1842,4,2,123,62,57,119,2
2022-07-09,LZ,Slovakia,2045,1948,4,1,97,46,47,93,3
2022-07-10,LZ,Slovakia,2047,1934,4,0,113,51,58,109,4
2022-07-11,LZ,Slovakia,1788,1686,3,1,102,51,48,99,2
2022-07-12,LZ,Slovakia,1848,1724,7,2,124,58,59,117,5
2022-07-13,LZ,Slovakia,1772,1651,4,1,121,59,58,117,3
2022-07-14,LZ,Slovakia,1879,1752,6,4,127,60,61,121,2
2022-07-15,LZ,Slovakia,1951,1824,7,1,127,63,57,120,6
2022-07-16,LZ,Slovakia,2023,1937,1,0,86,43,42,85,1
2022-07-17,LZ,Slovakia,1954,1838,3,1,116,55,58,113,2
2022-07-18,LZ,Slovakia,1785,1677,1,0,108,51,56,107,1
2022-07-19,LZ,Slovakia,1867,1742,4,0,125,63,58,121,4
2022-07-20,LZ,Slovakia,1892,1759,5,3,133,61,67,128,2
2022-07-21,LZ,Slovakia,1921,1796,4,0,125,58,63,121,4
2022-07-22,LZ,Slovakia,1960,1827,4,1,133,67,62,129,3
2022-07-23,LZ,Slovakia,2163,2061,3,2,102,49,50,99,1
2022-07-24,LZ,Slovakia,1986,1877,0,0,109,51,58,109,0
2022-07-25,LZ,Slovakia,1882,1785,5,4,97,50,42,92,1
2022-07-26,LZ,Slovakia,1851,1738,9,6,113,51,53,104,3
2022-07-27,LZ,Slovakia,1859,1732,11,4,127,57,59,116,7
2022-07-28,LZ,Slovakia,1934,1819,12,5,115,54,49,103,7
2022-07-29,LZ,Slovakia,2077,1957,3,0,120,59,58,117,3
2022-07-30,LZ,Slovakia,2132,2048,2,1,84,39,43,82,1
2022-07-31,LZ,Slovakia,2098,1985,1,0,113,55,57,112,1
2022-08-01,LZ,Slovakia,1854,1753,7,4,101,47,47,94,3
2022-08-02,LZ,Slovakia,1873,1746,9,7,127,59,59,118,2
2022-08-03,LZ,Slovakia,1909,1779,9,5,130,57,64,121,4
2022-08-04,LZ,Slovakia,1874,1768,6,1,106,50,50,100,5
2022-08-05,LZ,Slovakia,2002,1879,5,3,123,62,56,118,2
2022-08-06,LZ,Slovakia,2096,2012,1,0,84,41,42,83,1
2022-08-07,LZ,Slovakia,2054,1947,2,0,107,52,53,105,2
2022-08-08,LZ,Slovakia,1823,1715,8,4,108,52,48,100,4
2022-08-09,LZ,Slovakia,1820,1708,9,3,112,49,54,103,6
2022-08-10,LZ,Slovakia,1844,1716,14,4,128,54,60,114,10
2022-08-11,LZ,Slovakia,1933,1795,14,6,138,61,63,124,8
2022-08-12,LZ,Slovakia,2042,1914,4,1,128,64,60,124,3
2022-08-13,LZ,Slovakia,2057,1968,0,0,89,44,45,89,0
2022-08-14,LZ,Slovakia,1975,1879,3,0,96,47,46,93,3
2022-08-15,LZ,Slovakia,1709,1610,10,9,99,44,45,89,1
2022-08-16,LZ,Slovakia,1743,1619,10,1,124,56,58,114,9
2022-08-17,LZ,Slovakia,1775,1655,4,1,120,56,60,116,3
2022-08-18,LZ,Slovakia,1877,1748,3,1,129,65,61,126,2
2022-08-19,LZ,Slovakia,2010,1886,8,3,124,59,57,116,5
2022-08-20,LZ,Slovakia,2086,1994,2,1,92,45,45,90,1
2022-08-21,LZ,Slovakia,1926,1832,0,0,94,46,48,94,0
2022-08-22,LZ,Slovakia,1656,1559,1,0,97,51,45,96,1
2022-08-23,LZ,Slovakia,1693,1580,5,0,113,52,56,108,5
2022-08-24,LZ,Slovakia,1766,1635,4,2,131,62,65,127,2
2022-08-25,LZ,Slovakia,1821,1698,5,1,123,57,61,118,4
2022-08-26,LZ,Slovakia,1918,1791,2,0,127,60,65,125,2
2022-08-27,LZ,Slovakia,2191,2103,2,0,88,43,43,86,2
2022-08-28,LZ,Slovakia,1929,1832,1,1,97,49,47,96,0
2022-08-29,LZ,Slovakia,1686,1576,6,0,110,59,45,104,6
2022-08-30,LZ,Slovakia,1708,1574,10,1,134,61,63,124,9
2022-08-31,LZ,Slovakia,1736,1624,8,2,112,51,53,104,6
2022-09-01,LZ,Slovakia,1753,1654,0,0,99,52,47,99,0
2022-09-02,LZ,Slovakia,1836,1718,1,0,118,57,60,117,1
2022-09-03,LZ,Slovakia,2084,1999,2,0,85,42,41,83,2
2022-09-04,LZ,Slovakia,1977,1871,4,1,106,51,51,102,3
2022-09-05,LZ,Slovakia,1629,1529,3,3,100,48,49,97,0
2022-09-06,LZ,Slovakia,1697,1590,6,3,107,51,50,101,3
2022-09-07,LZ,Slovakia,1656,1531,9,1,125,57,59,116,8
2022-09-08,LZ,Slovakia,1718,1601,5,4,117,55,57,112,1
2022-09-09,LZ,Slovakia,1864,1747,5,2,117,53,59,112,3
2022-09-10,LZ,Slovakia,2077,1991,1,0,86,42,43,85,1
2022-09-11,LZ,Slovakia,1990,1891,1,0,99,51,47,98,1
2022-09-12,LZ,Slovakia,1632,1528,6,4,104,50,48,98,2
2022-09-13,LZ,Slovakia,1615,1502,11,7,113,48,54,102,4
2022-09-14,LZ,Slovakia,1748,1633,12,7,115,50,53,103,5
2022-09-15,LZ,Slovakia,1742,1644,4,0,98,51,43,94,4
2022-09-16,LZ,Slovakia,1850,1747,6,1,103,47,50,97,5
2022-09-17,LZ,Slovakia,1985,1925,3,0,60,28,29,57,3
2022-09-18,LZ,Slovakia,1956,1856,5,0,100,47,48,95,5
2022-09-19,LZ,Slovakia,1679,1588,3,2,91,47,41,88,1
2022-09-20,LZ,Slovakia,1702,1605,5,1,97,46,46,92,4
2022-09-21,LZ,Slovakia,1668,1577,8,3,91,41,42,83,5
2022-09-22,LZ,Slovakia,1718,1605,9,4,113,51,53,104,5
2022-09-23,LZ,Slovakia,1702,1601,14,4,101,45,42,87,10
2022-09-24,LZ,Slovakia,1881,1806,3,0,75,34,38,72,3
2022-09-25,LZ,Slovakia,1826,1751,3,1,75,34,38,72,2
2022-09-26,LZ,Slovakia,1598,1516,6,1,82,40,36,76,5
2022-09-27,LZ,Slovakia,1588,1502,7,1,86,38,41,79,6
2022-09-28,LZ,Slovakia,1636,1548,13,10,88,38,37,75,3
2022-09-29,LZ,Slovakia,1669,1586,11,5,83,35,37,72,6
2022-09-30,LZ,Slovakia,1661,1581,3,2,80,39,38,77,1
2022-10-01,LZ,Slovakia,1939,1890,0,0,49,24,25,49,0
2022-10-02,LZ,Slovakia,1870,1796,4,0,74,33,37,70,4
2022-10-03,LZ,Slovakia,1471,1399,6,1,72,35,31,66,5
2022-10-04,LZ,Slovakia,1467,1385,11,4,82,34,37,71,7
2022-10-05,LZ,Slovakia,1478,1379,18,6,99,43,38,81,12
2022-10-06,LZ,Slovakia,1507,1412,16,1,95,38,41,79,15
2022-10-07,LZ,Slovakia,1603,1513,15,5,90,38,37,75,10
2022-10-08,LZ,Slovakia,1725,1680,2,1,45,22,21,43,1
2022-10-09,LZ,Slovakia,1650,1583,2,1,67,31,34,65,1
2022-10-10,LZ,Slovakia,1444,1366,6,4,78,36,36,72,2
2022-10-11,LZ,Slovakia,1349,1267,9,3,82,37,36,73,6
2022-10-12,LZ,Slovakia,1466,1366,10,2,100,44,46,90,8
2022-10-13,LZ,Slovakia,1523,1437,13,3,86,37,36,73,10
2022-10-14,LZ,Slovakia,1603,1524,3,1,79,38,38,76,2
2022-10-15,LZ,Slovakia,1678,1635,3,0,43,20,20,40,3
2022-10-16,LZ,Slovakia,1643,1573,5,0,70,33,32,65,5
2022-10-17,LZ,Slovakia,1430,1351,9,3,79,35,35,70,6
2022-10-18,LZ,Slovakia,1336,1261,2,1,75,35,38,73,1
2022-10-19,LZ,Slovakia,1362,1290,2,1,72,35,35,70,1
2022-10-20,LZ,Slovakia,1453,1391,9,4,62,25,28,53,5
2022-10-21,LZ,Slovakia,1514,1431,7,1,83,41,35,76,6
2022-10-22,LZ,Slovakia,1620,1579,1,0,41,22,18,40,1
2022-10-23,LZ,Slovakia,1585,1519,2,1,66,28,36,64,1
2022-10-24,LZ,Slovakia,1356,1287,4,0,69,34,31,65,4
2022-10-25,LZ,Slovakia,1334,1243,12,2,91,38,41,79,10
2022-10-26,LZ,Slovakia,1351,1280,4,3,71,33,34,67,1
2022-10-27,LZ,Slovakia,1324,1257,4,2,67,31,32,63,2
2022-10-28,LZ,Slovakia,1406,1325,2,0,81,44,35,79,2
2022-10-29,LZ,Slovakia,1524,1484,1,1,40,20,19,39,0
2022-10-30,LZ,Slovakia,1375,1321,1,0,54,25,28,53,1
2022-10-31,LZ,Slovakia,1124,1074,4,0,50,23,23,46,4
2022-11-01,LZ,Slovakia,1021,987,2,0,34,15,17,32,2
2022-11-02,LZ,Slovakia,1060,993,5,1,67,31,31,62,4
2022-11-03,LZ,Slovakia,1087,1030,11,5,57,20,26,46,6
2022-11-04,LZ,Slovakia,1200,1128,12,2,72,31,29,60,10
2022-11-05,LZ,Slovakia,1208,1169,0,0,39,20,19,39,0
2022-11-06,LZ,Slovakia,1253,1183,4,1,70,32,34,66,3
2022-11-07,LZ,Slovakia,1080,1024,7,5,56,22,27,49,2
2022-11-08,LZ,Slovakia,962,901,8,3,61,24,29,53,5
2022-11-09,LZ,Slovakia,1000,921,9,7,79,40,30,70,2
2022-11-10,LZ,Slovakia,1018,963,7,4,55,27,21,48,3
2022-11-11,LZ,Slovakia,1109,1029,9,1,80,32,39,71,8
2022-11-12,LZ,Slovakia,1080,1046,2,2,34,16,16,32,0
2022-11-13,LZ,Slovakia,1085,1038,3,0,47,24,20,44,3
2022-11-14,LZ,Slovakia,984,930,8,4,54,20,26,46,4
2022-11-15,LZ,Slovakia,910,864,4,0,46,21,21,42,4
2022-11-16,LZ,Slovakia,962,888,7,3,74,34,33,67,4
2022-11-17,LZ,Slovakia,1023,979,2,0,44,21,21,42,2
2022-11-18,LZ,Slovakia,1069,1013,1,1,56,27,28,55,0
2022-11-19,LZ,Slovakia,1049,1018,0,0,31,16,15,31,0
2022-11-20,LZ,Slovakia,1121,1061,1,0,60,29,30,59,1
2022-11-21,LZ,Slovakia,964,924,1,1,40,19,20,39,0
2022-11-22,LZ,Slovakia,922,882,3,2,40,20,17,37,1
2022-11-23,LZ,Slovakia,947,889,6,2,58,26,26,52,4
2022-11-24,LZ,Slovakia,1021,958,4,0,63,29,30,59,4
2022-11-25,LZ,Slovakia,1044,982,5,2,62,27,30,57,3
2022-11-26,LZ,Slovakia,1035,993,3,1,42,21,18,39,2
2022-11-27,LZ,Slovakia,1049,999,6,1,50,23,21,44,5
2022-11-28,LZ,Slovakia,942,881,9,3,61,26,26,52,6
2022-11-29,LZ,Slovakia,887,838,3,2,49,23,23,46,1
2022-11-30,LZ,Slovakia,916,842,9,3,74,30,35,65,6
2022-12-01,LZ,Slovakia,931,881,11,7,50,20,19,39,4
2022-12-02,LZ,Slovakia,1021,945,1,0,76,38,37,75,1
2022-12-03,LZ,Slovakia,984,956,1,0,28,14,13,27,1
2022-12-04,LZ,Slovakia,1045,981,4,0,64,31,29,60,4
2022-12-05,LZ,Slovakia,937,890,2,0,47,23,22,45,2
2022-12-06,LZ,Slovakia,910,864,3,0,46,19,24,43,3
2022-12-07,LZ,Slovakia,952,899,4,0,53,23,26,49,4
2022-12-08,LZ,Slovakia,907,860,4,0,47,20,23,43,4
2022-12-09,LZ,Slovakia,1030,957,6,0,73,36,31,67,6
2022-12-10,LZ,Slovakia,961,922,1,0,39,18,20,38,1
2022-12-11,LZ,Slovakia,1087,1044,1,0,43,22,20,42,1
2022-12-12,LZ,Slovakia,976,927,3,2,49,23,23,46,1
2022-12-13,LZ,Slovakia,979,930,1,0,49,24,24,48,1
2022-12-14,LZ,Slovakia,908,854,2,0,54,27,25,52,2
2022-12-15,LZ,Slovakia,1064,1016,2,0,48,22,24,46,2
2022-12-16,LZ,Slovakia,1064,1003,1,0,61,32,28,60,1
2022-12-17,LZ,Slovakia,1095,1056,0,0,39,22,17,39,0
2022-12-18,LZ,Slovakia,1110,1055,2,0,55,23,30,53,2
2022-12-19,LZ,Slovakia,993,923,5,2,70,32,33,65,3
2022-12-20,LZ,Slovakia,983,936,2,1,47,22,23,45,1
2022-12-21,LZ,Slovakia,1009,952,3,0,57,28,26,54,3
2022-12-22,LZ,Slovakia,1068,1034,2,0,34,15,17,32,2
2022-12-23,LZ,Slovakia,1125,1073,0,0,52,27,25,52,0
2022-12-24,LZ,Slovakia,1045,1025,0,0,20,9,11,20,0
2022-12-25,LZ,Slovakia,854,839,0,0,15,8,7,15,0
2022-12-26,LZ,Slovakia,937,888,0,0,49,26,23,49,0
2022-12-27,LZ,Slovakia,971,918,6,0,53,23,24,47,6
2022-01-01,LJ,Slovenia,743,730,0,0,13,6,7,13,0
2022-01-02,LJ,Slovenia,970,929,0,0,41,19,22,41,0
2022-01-03,LJ,Slovenia,884,825,3,0,59,29,27,56,3
2022-01-04,LJ,Slovenia,801,762,2,0,39,18,19,37,2
2022-01-05,LJ,Slovenia,828,787,0,0,41,21,20,41,0
2022-01-06,LJ,Slovenia,800,745,2,2,55,28,25,53,0
2022-01-07,LJ,Slovenia,879,819,7,1,60,26,27,53,6
2022-01-08,LJ,Slovenia,944,911,2,1,33,15,16,31,1
2022-01-09,LJ,Slovenia,955,922,0,0,33,17,16,33,0
2022-01-10,LJ,Slovenia,659,616,0,0,43,22,21,43,0
2022-01-11,LJ,Slovenia,612,574,4,2,38,17,17,34,2
2022-01-12,LJ,Slovenia,557,514,4,1,43,17,22,39,3
2022-01-13,LJ,Slovenia,513,470,0,0,43,22,21,43,0
2022-01-14,LJ,Slovenia,678,622,5,1,56,25,26,51,4
2022-01-15,LJ,Slovenia,696,668,3,3,28,12,13,25,0
2022-01-16,LJ,Slovenia,676,641,3,0,35,16,16,32,3
2022-01-17,LJ,Slovenia,592,541,4,3,51,25,22,47,1
2022-01-18,LJ,Slovenia,482,447,2,0,35,17,16,33,2
2022-01-19,LJ,Slovenia,523,465,4,1,58,25,29,54,3
2022-01-20,LJ,Slovenia,501,461,3,2,40,19,18,37,1
2022-01-21,LJ,Slovenia,675,614,8,2,61,25,28,53,6
2022-01-22,LJ,Slovenia,622,599,5,3,23,10,8,18,2
2022-01-23,LJ,Slovenia,620,591,0,0,29,15,14,29,0
2022-01-24,LJ,Slovenia,521,477,1,0,44,19,24,43,1
2022-01-25,LJ,Slovenia,438,397,3,0,41,21,17,38,3
2022-01-26,LJ,Slovenia,493,452,1,0,41,20,20,40,1
2022-01-27,LJ,Slovenia,482,444,0,0,38,19,19,38,0
2022-01-28,LJ,Slovenia,678,628,1,0,50,24,25,49,1
2022-01-29,LJ,Slovenia,629,595,2,0,34,15,17,32,2
2022-01-30,LJ,Slovenia,589,557,1,1,32,17,14,31,0
2022-01-31,LJ,Slovenia,582,537,1,1,45,22,22,44,0
2022-02-01,LJ,Slovenia,523,493,3,3,30,13,14,27,0
2022-02-02,LJ,Slovenia,499,460,2,2,39,20,17,37,0
2022-02-03,LJ,Slovenia,522,471,3,2,51,22,26,48,1
2022-02-04,LJ,Slovenia,716,661,0,0,55,28,27,55,0
2022-02-05,LJ,Slovenia,730,696,3,1,34,15,16,31,2
2022-02-06,LJ,Slovenia,656,619,0,0,37,19,18,37,0
2022-02-07,LJ,Slovenia,590,556,1,1,34,19,14,33,0
2022-02-08,LJ,Slovenia,521,489,1,1,32,13,18,31,0
2022-02-09,LJ,Slovenia,538,486,6,1,52,24,22,46,5
2022-02-10,LJ,Slovenia,586,534,2,2,52,27,23,50,0
2022-02-11,LJ,Slovenia,739,688,0,0,51,26,25,51,0
2022-02-12,LJ,Slovenia,746,715,4,1,31,12,15,27,3
2022-02-13,LJ,Slovenia,670,629,0,0,41,20,21,41,0
2022-02-14,LJ,Slovenia,590,543,4,3,47,22,21,43,1
2022-02-15,LJ,Slovenia,560,513,0,0,47,24,23,47,0
2022-02-16,LJ,Slovenia,568,509,4,3,59,26,29,55,1
2022-02-17,LJ,Slovenia,573,523,2,1,50,25,23,48,1
2022-02-18,LJ,Slovenia,750,687,4,2,63,27,32,59,2
2022-02-19,LJ,Slovenia,804,770,0,0,34,16,18,34,0
2022-02-20,LJ,Slovenia,751,711,0,0,40,21,19,40,0
2022-02-21,LJ,Slovenia,630,593,0,0,37,20,17,37,0
2022-02-22,LJ,Slovenia,585,543,9,4,42,18,15,33,5
2022-02-23,LJ,Slovenia,606,555,3,1,51,22,26,48,2
2022-02-24,LJ,Slovenia,636,585,4,2,51,26,21,47,2
2022-02-25,LJ,Slovenia,768,716,1,1,52,23,28,51,0
2022-02-26,LJ,Slovenia,760,724,0,0,36,17,19,36,0
2022-02-27,LJ,Slovenia,731,692,1,1,39,18,20,38,0
2022-02-28,LJ,Slovenia,661,619,1,1,42,20,21,41,0
2022-03-01,LJ,Slovenia,660,619,8,1,41,18,15,33,7
2022-03-02,LJ,Slovenia,638,576,8,5,62,28,26,54,3
2022-03-03,LJ,Slovenia,667,608,9,3,59,26,24,50,6
2022-03-04,LJ,Slovenia,865,809,3,2,56,25,28,53,1
2022-03-05,LJ,Slovenia,787,760,0,0,27,14,13,27,0
2022-03-06,LJ,Slovenia,785,754,1,0,31,14,16,30,1
2022-03-07,LJ,Slovenia,730,695,3,1,35,18,14,32,2
2022-03-08,LJ,Slovenia,660,616,8,5,44,17,19,36,3
2022-03-09,LJ,Slovenia,662,611,1,0,51,26,24,50,1
2022-03-10,LJ,Slovenia,689,631,11,2,58,24,23,47,9
2022-03-11,LJ,Slovenia,776,712,2,1,64,31,31,62,1
2022-03-12,LJ,Slovenia,783,743,0,0,40,19,21,40,0
2022-03-13,LJ,Slovenia,788,756,1,1,32,15,16,31,0
2022-03-14,LJ,Slovenia,747,701,5,3,46,22,19,41,2
2022-03-15,LJ,Slovenia,663,628,2,0,35,18,15,33,2
2022-03-16,LJ,Slovenia,690,640,7,6,50,19,24,43,1
2022-03-17,LJ,Slovenia,688,632,9,7,56,24,23,47,2
2022-03-18,LJ,Slovenia,800,739,4,1,61,28,29,57,3
2022-03-19,LJ,Slovenia,813,772,1,0,41,15,25,40,1
2022-03-20,LJ,Slovenia,818,782,0,0,36,17,19,36,0
2022-03-21,LJ,Slovenia,744,685,5,2,59,29,25,54,3
2022-03-22,LJ,Slovenia,627,585,3,1,42,18,21,39,2
2022-03-23,LJ,Slovenia,742,682,8,2,60,28,24,52,6
2022-03-24,LJ,Slovenia,751,687,4,3,64,32,28,60,1
2022-03-25,LJ,Slovenia,892,819,10,2,73,29,34,63,8
2022-03-26,LJ,Slovenia,864,821,2,2,43,18,23,41,0
2022-03-27,LJ,Slovenia,1157,1097,1,1,60,31,28,59,0
2022-03-28,LJ,Slovenia,972,907,1,1,65,30,34,64,0
2022-03-29,LJ,Slovenia,862,799,3,1,63,34,26,60,2
2022-03-30,LJ,Slovenia,900,846,1,1,54,26,27,53,0
2022-03-31,LJ,Slovenia,992,941,0,0,51,26,25,51,0
2022-04-01,LJ,Slovenia,1079,1033,0,0,46,23,23,46,0
2022-04-02,LJ,Slovenia,1066,1042,0,0,24,11,13,24,0
2022-04-03,LJ,Slovenia,1144,1101,0,0,43,20,23,43,0
2022-04-04,LJ,Slovenia,999,947,1,1,52,28,23,51,0
2022-04-05,LJ,Slovenia,876,828,4,0,48,22,22,44,4
2022-04-06,LJ,Slovenia,949,895,2,0,54,24,28,52,2
2022-04-07,LJ,Slovenia,1039,963,7,2,76,36,33,69,5
2022-04-08,LJ,Slovenia,1254,1187,2,1,67,33,32,65,1
2022-04-09,LJ,Slovenia,1371,1340,1,1,31,15,15,30,0
2022-04-10,LJ,Slovenia,1337,1283,2,2,54,25,27,52,0
2022-04-11,LJ,Slovenia,1087,1029,4,1,58,28,26,54,3
2022-04-12,LJ,Slovenia,992,951,1,1,41,22,18,40,0
2022-04-13,LJ,Slovenia,1124,1065,3,1,59,27,29,56,2
2022-04-14,LJ,Slovenia,1225,1148,5,5,77,36,36,72,0
2022-04-15,LJ,Slovenia,1317,1247,6,3,70,30,34,64,3
2022-04-16,LJ,Slovenia,1362,1333,0,0,29,15,14,29,0
2022-04-17,LJ,Slovenia,1374,1333,2,2,41,19,20,39,0
2022-04-18,LJ,Slovenia,1227,1170,2,2,57,29,26,55,0
2022-04-19,LJ,Slovenia,1068,1015,4,3,53,24,25,49,1
2022-04-20,LJ,Slovenia,1179,1114,5,2,65,31,29,60,3
2022-04-21,LJ,Slovenia,1250,1189,5,3,61,29,27,56,2
2022-04-22,LJ,Slovenia,1273,1225,0,0,48,23,25,48,0
2022-04-23,LJ,Slovenia,1420,1374,2,2,46,23,21,44,0
2022-04-24,LJ,Slovenia,1497,1451,1,1,46,22,23,45,0
2022-04-25,LJ,Slovenia,1226,1158,5,4,68,32,31,63,1
2022-04-26,LJ,Slovenia,1091,1033,1,1,58,31,26,57,0
2022-04-27,LJ,Slovenia,1148,1092,3,3,56,26,27,53,0
2022-04-28,LJ,Slovenia,1229,1159,3,2,70,33,34,67,1
2022-04-29,LJ,Slovenia,1358,1281,2,2,77,36,39,75,0
2022-04-30,LJ,Slovenia,1452,1411,6,2,41,15,20,35,4
2022-05-01,LJ,Slovenia,1515,1467,0,0,48,26,22,48,0
2022-05-02,LJ,Slovenia,1340,1284,1,1,56,27,28,55,0
2022-05-03,LJ,Slovenia,1284,1226,3,2,58,27,28,55,1
2022-05-04,LJ,Slovenia,1219,1148,9,4,71,31,31,62,5
2022-05-05,LJ,Slovenia,1343,1281,5,3,62,29,28,57,2
2022-05-06,LJ,Slovenia,1431,1369,0,0,62,32,30,62,0
2022-05-07,LJ,Slovenia,1588,1551,2,2,37,16,19,35,0
2022-05-08,LJ,Slovenia,1556,1502,3,3,54,25,26,51,0
2022-05-09,LJ,Slovenia,1351,1271,12,4,80,32,36,68,8
2022-05-10,LJ,Slovenia,1289,1210,8,3,79,36,35,71,5
2022-05-11,LJ,Slovenia,1304,1232,12,3,72,30,30,60,9
2022-05-12,LJ,Slovenia,1348,1277,4,0,71,33,34,67,4
2022-05-13,LJ,Slovenia,1492,1416,4,1,76,37,35,72,3
2022-05-14,LJ,Slovenia,1612,1570,1,0,42,19,22,41,1
2022-05-15,LJ,Slovenia,1622,1557,1,1,65,30,34,64,0
2022-05-16,LJ,Slovenia,1280,1197,6,1,83,43,34,77,5
2022-05-17,LJ,Slovenia,1336,1279,5,4,57,26,26,52,1
2022-05-18,LJ,Slovenia,1295,1238,6,2,57,25,26,51,4
2022-05-19,LJ,Slovenia,1316,1240,7,3,76,32,37,69,4
2022-05-20,LJ,Slovenia,1520,1447,2,2,73,34,37,71,0
2022-05-21,LJ,Slovenia,1720,1658,1,1,62,32,29,61,0
2022-05-22,LJ,Slovenia,1710,1638,5,1,72,32,35,67,4
2022-05-23,LJ,Slovenia,1364,1300,2,1,64,33,29,62,1
2022-05-24,LJ,Slovenia,1502,1439,0,0,63,30,33,63,0
2022-05-25,LJ,Slovenia,1646,1596,0,0,50,28,22,50,0
2022-05-26,LJ,Slovenia,1578,1505,3,0,73,33,37,70,3
2022-05-27,LJ,Slovenia,1578,1496,6,3,82,38,38,76,3
2022-05-28,LJ,Slovenia,1810,1772,0,0,38,18,20,38,0
2022-05-29,LJ,Slovenia,1836,1774,1,1,62,30,31,61,0
2022-05-30,LJ,Slovenia,1576,1505,4,3,71,36,31,67,1
2022-05-31,LJ,Slovenia,1429,1376,6,4,53,22,25,47,2
2022-06-01,LJ,Slovenia,1590,1519,7,5,71,31,33,64,2
2022-06-02,LJ,Slovenia,1555,1475,8,6,80,37,35,72,2
2022-06-03,LJ,Slovenia,1734,1630,5,2,104,52,47,99,3
2022-06-04,LJ,Slovenia,1947,1890,2,0,57,29,26,55,2
2022-06-05,LJ,Slovenia,1772,1710,1,1,62,28,33,61,0
2022-06-06,LJ,Slovenia,1668,1598,6,1,70,36,28,64,5
2022-06-07,LJ,Slovenia,1569,1513,4,1,56,25,27,52,3
2022-06-08,LJ,Slovenia,1547,1475,5,4,72,37,30,67,1
2022-06-09,LJ,Slovenia,1600,1533,0,0,67,33,34,67,0
2022-06-10,LJ,Slovenia,1748,1666,1,1,82,37,44,81,0
2022-06-11,LJ,Slovenia,1896,1832,1,1,64,31,32,63,0
2022-06-12,LJ,Slovenia,1847,1773,1,0,74,37,36,73,1
2022-06-13,LJ,Slovenia,1672,1612,4,1,60,28,28,56,3
2022-06-14,LJ,Slovenia,1574,1498,4,4,76,35,37,72,0
2022-06-15,LJ,Slovenia,1795,1720,5,2,75,34,36,70,3
2022-06-16,LJ,Slovenia,1615,1539,4,1,76,35,37,72,3
2022-06-17,LJ,Slovenia,1776,1691,5,2,85,37,43,80,3
2022-06-18,LJ,Slovenia,1893,1829,4,1,64,30,30,60,3
2022-06-19,LJ,Slovenia,1912,1824,5,1,88,47,36,83,4
2022-06-20,LJ,Slovenia,1577,1515,3,0,62,30,29,59,3
2022-06-21,LJ,Slovenia,1573,1498,3,1,75,40,32,72,2
2022-06-22,LJ,Slovenia,1674,1600,2,0,74,31,41,72,2
2022-06-23,LJ,Slovenia,1579,1494,2,2,85,41,42,83,0
2022-06-24,LJ,Slovenia,1727,1645,4,4,82,40,38,78,0
2022-06-25,LJ,Slovenia,1834,1786,0,0,48,24,24,48,0
2022-06-26,LJ,Slovenia,1848,1772,0,0,76,38,38,76,0
2022-06-27,LJ,Slovenia,1626,1549,6,4,77,38,33,71,2
2022-06-28,LJ,Slovenia,1713,1633,3,1,80,40,37,77,2
2022-06-29,LJ,Slovenia,1762,1693,2,2,69,33,34,67,0
2022-06-30,LJ,Slovenia,1667,1597,3,2,70,31,36,67,1
2022-07-01,LJ,Slovenia,1760,1683,4,2,77,36,37,73,2
2022-07-02,LJ,Slovenia,1941,1883,2,0,58,27,29,56,2
2022-07-03,LJ,Slovenia,1848,1783,2,0,65,29,34,63,2
2022-07-04,LJ,Slovenia,1581,1491,3,1,90,42,45,87,2
2022-07-05,LJ,Slovenia,1645,1569,1,1,76,38,37,75,0
2022-07-06,LJ,Slovenia,1862,1775,9,2,87,38,40,78,7
2022-07-07,LJ,Slovenia,1756,1692,0,0,64,32,32,64,0
2022-07-08,LJ,Slovenia,1808,1717,1,1,91,42,48,90,0
2022-07-09,LJ,Slovenia,1977,1916,0,0,61,32,29,61,0
2022-07-10,LJ,Slovenia,1892,1799,0,0,93,46,47,93,0
2022-07-11,LJ,Slovenia,1707,1629,3,0,78,37,38,75,3
2022-07-12,LJ,Slovenia,1713,1628,0,0,85,46,39,85,0
2022-07-13,LJ,Slovenia,1676,1612,1,1,64,32,31,63,0
2022-07-14,LJ,Slovenia,1697,1628,2,0,69,34,33,67,2
2022-07-15,LJ,Slovenia,1747,1678,0,0,69,33,36,69,0
2022-07-16,LJ,Slovenia,1964,1903,0,0,61,30,31,61,0
2022-07-17,LJ,Slovenia,1879,1817,0,0,62,32,30,62,0
2022-07-18,LJ,Slovenia,1728,1656,1,1,72,37,34,71,0
2022-07-19,LJ,Slovenia,1636,1563,2,1,73,36,35,71,1
2022-07-20,LJ,Slovenia,1655,1577,0,0,78,39,39,78,0
2022-07-21,LJ,Slovenia,1723,1653,1,1,70,34,35,69,0
2022-07-22,LJ,Slovenia,1751,1679,4,1,72,32,36,68,3
2022-07-23,LJ,Slovenia,1839,1779,0,0,60,28,32,60,0
2022-07-24,LJ,Slovenia,1819,1755,0,0,64,33,31,64,0
2022-07-25,LJ,Slovenia,1696,1626,2,1,70,36,32,68,1
2022-07-26,LJ,Slovenia,1689,1616,2,1,73,38,33,71,1
2022-07-27,LJ,Slovenia,1698,1637,0,0,61,26,35,61,0
2022-07-28,LJ,Slovenia,1652,1574,1,0,78,39,38,77,1
2022-07-29,LJ,Slovenia,1783,1710,1,0,73,36,36,72,1
2022-07-30,LJ,Slovenia,1906,1855,1,0,51,24,26,50,1
2022-07-31,LJ,Slovenia,1941,1873,0,0,68,34,34,68,0
2022-08-01,LJ,Slovenia,1730,1662,2,1,68,33,33,66,1
2022-08-02,LJ,Slovenia,1720,1643,1,1,77,35,41,76,0
2022-08-03,LJ,Slovenia,1746,1667,4,1,79,39,36,75,3
2022-08-04,LJ,Slovenia,1668,1602,6,6,66,32,28,60,0
2022-08-05,LJ,Slovenia,1651,1575,1,1,76,37,38,75,0
2022-08-06,LJ,Slovenia,1889,1835,0,0,54,26,28,54,0
2022-08-07,LJ,Slovenia,1860,1794,0,0,66,31,35,66,0
2022-08-08,LJ,Slovenia,1700,1634,1,1,66,33,32,65,0
2022-08-09,LJ,Slovenia,1627,1550,2,2,77,37,38,75,0
2022-08-10,LJ,Slovenia,1729,1651,4,1,78,40,34,74,3
2022-08-11,LJ,Slovenia,1748,1685,2,2,63,30,31,61,0
2022-08-12,LJ,Slovenia,1751,1684,2,0,67,32,33,65,2
2022-08-13,LJ,Slovenia,1804,1765,0,0,39,21,18,39,0
2022-08-14,LJ,Slovenia,1792,1737,0,0,55,27,28,55,0
2022-08-15,LJ,Slovenia,1652,1588,3,1,64,30,31,61,2
2022-08-16,LJ,Slovenia,1626,1549,5,1,77,38,34,72,4
2022-08-17,LJ,Slovenia,1684,1605,2,2,79,39,38,77,0
2022-08-18,LJ,Slovenia,1712,1646,2,1,66,31,33,64,1
2022-08-19,LJ,Slovenia,1701,1623,0,0,78,38,40,78,0
2022-08-20,LJ,Slovenia,1769,1711,0,0,58,30,28,58,0
2022-08-21,LJ,Slovenia,1755,1693,1,1,62,31,30,61,0
2022-08-22,LJ,Slovenia,1566,1511,2,2,55,26,27,53,0
2022-08-23,LJ,Slovenia,1601,1526,2,1,75,37,36,73,1
2022-08-24,LJ,Slovenia,1702,1625,5,1,77,35,37,72,4
2022-08-25,LJ,Slovenia,1644,1578,3,1,66,30,33,63,2
2022-08-26,LJ,Slovenia,1726,1642,3,2,84,38,43,81,1
2022-08-27,LJ,Slovenia,1729,1676,2,2,53,27,24,51,0
2022-08-28,LJ,Slovenia,1740,1678,3,3,62,26,33,59,0
2022-08-29,LJ,Slovenia,1510,1433,3,1,77,35,39,74,2
2022-08-30,LJ,Slovenia,1617,1532,4,1,85,43,38,81,3
2022-08-31,LJ,Slovenia,1655,1591,0,0,64,35,29,64,0
2022-09-01,LJ,Slovenia,1638,1560,1,1,78,37,40,77,0
2022-09-02,LJ,Slovenia,1642,1559,3,0,83,38,42,80,3
2022-09-03,LJ,Slovenia,1848,1794,1,1,54,31,22,53,0
2022-09-04,LJ,Slovenia,1828,1746,1,1,82,39,42,81,0
2022-09-05,LJ,Slovenia,1660,1575,12,3,85,38,35,73,9
2022-09-06,LJ,Slovenia,1666,1582,7,3,84,39,38,77,4
2022-09-07,LJ,Slovenia,1690,1612,11,7,78,31,36,67,4
2022-09-08,LJ,Slovenia,1680,1607,4,2,73,32,37,69,2
2022-09-09,LJ,Slovenia,1740,1658,2,2,82,39,41,80,0
2022-09-10,LJ,Slovenia,1755,1707,2,2,48,24,22,46,0
2022-09-11,LJ,Slovenia,1756,1686,3,1,70,31,36,67,2
2022-09-12,LJ,Slovenia,1614,1533,2,1,81,44,35,79,1
2022-09-13,LJ,Slovenia,1555,1477,10,6,78,34,34,68,4
2022-09-14,LJ,Slovenia,1551,1485,3,1,66,33,30,63,2
2022-09-15,LJ,Slovenia,1536,1474,1,1,62,32,29,61,0
2022-09-16,LJ,Slovenia,1570,1511,0,0,59,31,28,59,0
2022-09-17,LJ,Slovenia,1821,1776,0,0,45,21,24,45,0
2022-09-18,LJ,Slovenia,1767,1695,1,1,72,36,35,71,0
2022-09-19,LJ,Slovenia,1536,1468,1,1,68,32,35,67,0
2022-09-20,LJ,Slovenia,1523,1442,4,3,81,35,42,77,1
2022-09-21,LJ,Slovenia,1587,1505,6,4,82,41,35,76,2
2022-09-22,LJ,Slovenia,1616,1547,3,3,69,33,33,66,0
2022-09-23,LJ,Slovenia,1664,1575,3,1,89,43,43,86,2
2022-09-24,LJ,Slovenia,1824,1765,0,0,59,32,27,59,0
2022-09-25,LJ,Slovenia,1799,1744,0,0,55,25,30,55,0
2022-09-26,LJ,Slovenia,1441,1378,1,1,63,31,31,62,0
2022-09-27,LJ,Slovenia,1484,1420,2,1,64,33,29,62,1
2022-09-28,LJ,Slovenia,1540,1471,4,1,69,33,32,65,3
2022-09-29,LJ,Slovenia,1556,1494,0,0,62,30,32,62,0
2022-09-30,LJ,Slovenia,1647,1584,1,1,63,32,30,62,0
2022-10-01,LJ,Slovenia,1713,1663,1,1,50,24,25,49,0
2022-10-02,LJ,Slovenia,1710,1644,1,0,66,28,37,65,1
2022-10-03,LJ,Slovenia,1557,1480,5,3,77,38,34,72,2
2022-10-04,LJ,Slovenia,1444,1375,6,3,69,32,31,63,3
2022-10-05,LJ,Slovenia,1358,1294,3,1,64,27,34,61,2
2022-10-06,LJ,Slovenia,1440,1356,4,2,84,43,37,80,2
2022-10-07,LJ,Slovenia,1628,1544,4,2,84,35,45,80,2
2022-10-08,LJ,Slovenia,1777,1723,0,0,54,26,28,54,0
2022-10-09,LJ,Slovenia,1673,1621,0,0,52,30,22,52,0
2022-10-10,LJ,Slovenia,1490,1436,3,3,54,25,26,51,0
2022-10-11,LJ,Slovenia,1438,1370,2,2,68,30,36,66,0
2022-10-12,LJ,Slovenia,1442,1382,1,0,60,31,28,59,1
2022-10-13,LJ,Slovenia,1433,1364,2,1,69,35,32,67,1
2022-10-14,LJ,Slovenia,1521,1446,8,1,75,32,35,67,7
2022-10-15,LJ,Slovenia,1638,1584,1,1,54,28,25,53,0
2022-10-16,LJ,Slovenia,1686,1621,2,1,65,30,33,63,1
2022-10-17,LJ,Slovenia,1427,1348,7,2,79,37,35,72,5
2022-10-18,LJ,Slovenia,1384,1309,6,4,75,34,35,69,2
2022-10-19,LJ,Slovenia,1317,1247,5,4,70,34,31,65,1
2022-10-20,LJ,Slovenia,1361,1301,1,1,60,30,29,59,0
2022-10-21,LJ,Slovenia,1473,1406,2,1,67,34,31,65,1
2022-10-22,LJ,Slovenia,1701,1659,0,0,42,21,21,42,0
2022-10-23,LJ,Slovenia,1590,1526,4,2,64,29,31,60,2
2022-10-24,LJ,Slovenia,1400,1338,1,1,62,32,29,61,0
2022-10-25,LJ,Slovenia,1366,1310,1,0,56,27,28,55,1
2022-10-26,LJ,Slovenia,1380,1328,2,1,52,23,27,50,1
2022-10-27,LJ,Slovenia,1361,1288,7,5,73,33,33,66,2
2022-10-28,LJ,Slovenia,1445,1380,3,2,65,31,31,62,1
2022-10-29,LJ,Slovenia,1615,1564,2,2,51,22,27,49,0
2022-10-30,LJ,Slovenia,1376,1328,1,1,48,24,23,47,0
2022-10-31,LJ,Slovenia,1151,1095,1,1,56,27,28,55,0
2022-11-01,LJ,Slovenia,1028,971,3,0,57,29,25,54,3
2022-11-02,LJ,Slovenia,945,882,1,1,63,29,33,62,0
2022-11-03,LJ,Slovenia,907,844,0,0,63,32,31,63,0
2022-11-04,LJ,Slovenia,1115,1062,3,1,53,25,25,50,2
2022-11-05,LJ,Slovenia,1196,1140,0,0,56,28,28,56,0
2022-11-06,LJ,Slovenia,1086,1041,2,2,45,19,24,43,0
2022-11-07,LJ,Slovenia,927,856,2,2,71,34,35,69,0
2022-11-08,LJ,Slovenia,826,767,3,3,59,29,27,56,0
2022-11-09,LJ,Slovenia,805,746,2,0,59,29,28,57,2
2022-11-10,LJ,Slovenia,846,797,1,0,49,23,25,48,1
2022-11-11,LJ,Slovenia,948,888,2,1,60,27,31,58,1
2022-11-12,LJ,Slovenia,932,893,1,0,39,21,17,38,1
2022-11-13,LJ,Slovenia,937,900,0,0,37,18,19,37,0
2022-11-14,LJ,Slovenia,866,815,3,1,51,23,25,48,2
2022-11-15,LJ,Slovenia,783,722,3,3,61,32,26,58,0
2022-11-16,LJ,Slovenia,795,734,0,0,61,28,33,61,0
2022-11-17,LJ,Slovenia,831,778,4,3,53,24,25,49,1
2022-11-18,LJ,Slovenia,924,873,1,0,51,25,25,50,1
2022-11-19,LJ,Slovenia,941,904,0,0,37,18,19,37,0
2022-11-20,LJ,Slovenia,963,920,2,2,43,21,20,41,0
2022-11-21,LJ,Slovenia,845,783,5,2,62,27,30,57,3
2022-11-22,LJ,Slovenia,730,683,0,0,47,23,24,47,0
2022-11-23,LJ,Slovenia,736,682,2,0,54,26,26,52,2
2022-11-24,LJ,Slovenia,807,756,3,1,51,24,24,48,2
2022-11-25,LJ,Slovenia,937,865,6,1,72,33,33,66,5
2022-11-26,LJ,Slovenia,855,809,4,0,46,21,21,42,4
2022-11-27,LJ,Slovenia,912,856,3,1,56,27,26,53,2
2022-11-28,LJ,Slovenia,853,793,4,2,60,30,26,56,2
2022-11-29,LJ,Slovenia,783,739,0,0,44,23,21,44,0
2022-11-30,LJ,Slovenia,731,687,1,0,44,22,21,43,1
2022-12-01,LJ,Slovenia,772,728,0,0,44,19,25,44,0
2022-12-02,LJ,Slovenia,906,849,0,0,57,29,28,57,0
2022-12-03,LJ,Slovenia,843,810,0,0,33,17,16,33,0
2022-12-04,LJ,Slovenia,897,863,0,0,34,15,19,34,0
2022-12-05,LJ,Slovenia,810,751,7,5,59,28,24,52,2
2022-12-06,LJ,Slovenia,789,724,9,3,65,27,29,56,6
2022-12-07,LJ,Slovenia,769,710,7,7,59,27,25,52,0
2022-12-08,LJ,Slovenia,770,717,0,0,53,28,25,53,0
2022-12-09,LJ,Slovenia,886,832,0,0,54,29,25,54,0
2022-12-10,LJ,Slovenia,830,791,1,1,39,20,18,38,0
2022-12-11,LJ,Slovenia,871,835,1,0,36,16,19,35,1
2022-12-12,LJ,Slovenia,864,794,11,4,70,31,28,59,7
2022-12-13,LJ,Slovenia,743,682,10,3,61,24,27,51,7
2022-12-14,LJ,Slovenia,781,735,2,0,46,23,21,44,2
2022-12-15,LJ,Slovenia,787,743,2,2,44,21,21,42,0
2022-12-16,LJ,Slovenia,992,925,2,1,67,31,34,65,1
2022-12-17,LJ,Slovenia,931,893,0,0,38,16,22,38,0
2022-12-18,LJ,Slovenia,937,898,0,0,39,20,19,39,0
2022-12-19,LJ,Slovenia,833,782,2,0,51,25,24,49,2
2022-12-20,LJ,Slovenia,874,820,4,2,54,27,23,50,2
2022-12-21,LJ,Slovenia,893,839,2,2,54,24,28,52,0
2022-12-22,LJ,Slovenia,926,881,4,1,45,23,18,41,3
2022-12-23,LJ,Slovenia,1012,950,2,0,62,28,32,60,2
2022-12-24,LJ,Slovenia,858,830,3,0,28,14,11,25,3
2022-12-25,LJ,Slovenia,720,702,0,0,18,9,9,18,0
2022-12-26,LJ,Slovenia,869,829,2,2,40,17,21,38,0
2022-12-27,LJ,Slovenia,858,810,2,0,48,24,22,46,2
2022-01-01,LE,Spain,3769,764,728,4,3005,1142,1135,2277,724
2022-01-02,LE,Spain,4596,850,1048,4,3746,1363,1335,2698,1044
2022-01-03,LE,Spain,4275,849,1041,22,3426,1201,1184,2385,1019
2022-01-04,LE,Spain,3897,729,937,20,3168,1113,1118,2231,917
2022-01-05,LE,Spain,3654,672,914,23,2982,1039,1029,2068,891
2022-01-06,LE,Spain,3567,661,831,13,2906,1030,1045,2075,818
2022-01-07,LE,Spain,4019,743,1001,20,3276,1145,1130,2275,981
2022-01-08,LE,Spain,4251,758,920,9,3493,1283,1290,2573,911
2022-01-09,LE,Spain,4400,790,1065,5,3610,1282,1263,2545,1060
2022-01-10,LE,Spain,3421,605,943,26,2816,939,934,1873,917
2022-01-11,LE,Spain,2803,513,799,34,2290,749,742,1491,765
2022-01-12,LE,Spain,2773,474,817,40,2299,736,746,1482,777
2022-01-13,LE,Spain,2742,452,822,38,2290,732,736,1468,784
2022-01-14,LE,Spain,3402,610,960,30,2792,903,929,1832,930
2022-01-15,LE,Spain,3200,562,695,21,2638,982,961,1943,674
2022-01-16,LE,Spain,3474,622,864,20,2852,1005,983,1988,844
2022-01-17,LE,Spain,3034,580,871,51,2454,802,781,1583,820
2022-01-18,LE,Spain,2597,480,794,57,2117,655,668,1323,737
2022-01-19,LE,Spain,2719,468,836,49,2251,690,725,1415,787
2022-01-20,LE,Spain,2774,476,820,51,2298,741,737,1478,769
2022-01-21,LE,Spain,3412,624,991,53,2788,895,902,1797,938
2022-01-22,LE,Spain,3215,580,728,33,2635,961,946,1907,695
2022-01-23,LE,Spain,3425,626,866,23,2799,959,974,1933,843
2022-01-24,LE,Spain,3000,579,869,36,2421,789,763,1552,833
2022-01-25,LE,Spain,2525,467,756,48,2058,645,657,1302,708
2022-01-26,LE,Spain,2703,484,797,45,2219,718,704,1422,752
2022-01-27,LE,Spain,2804,471,842,47,2333,738,753,1491,795
2022-01-28,LE,Spain,3426,639,985,30,2787,886,916,1802,955
2022-01-29,LE,Spain,3162,579,674,10,2583,955,954,1909,664
2022-01-30,LE,Spain,3536,667,888,14,2869,1008,973,1981,874
2022-01-31,LE,Spain,3144,645,876,33,2499,827,796,1623,843
2022-02-01,LE,Spain,2863,501,829,36,2362,761,772,1533,793
2022-02-02,LE,Spain,2991,538,825,34,2453,798,830,1628,791
2022-02-03,LE,Spain,3184,537,919,49,2647,859,869,1728,870
2022-02-04,LE,Spain,3682,670,1060,36,3012,973,979,1952,1024
2022-02-05,LE,Spain,3567,675,718,20,2892,1094,1080,2174,698
2022-02-06,LE,Spain,3772,681,948,17,3091,1083,1060,2143,931
2022-02-07,LE,Spain,3614,817,950,34,2797,928,919,1847,916
2022-02-08,LE,Spain,3058,669,789,30,2389,797,803,1600,759
2022-02-09,LE,Spain,3260,682,889,41,2578,855,834,1689,848
2022-02-10,LE,Spain,3528,762,903,35,2766,925,938,1863,868
2022-02-11,LE,Spain,4154,899,1073,31,3255,1079,1103,2182,1042
2022-02-12,LE,Spain,4130,955,788,21,3175,1184,1203,2387,767
2022-02-13,LE,Spain,4139,878,933,16,3261,1179,1149,2328,917
2022-02-14,LE,Spain,3820,866,942,31,2954,1011,1001,2012,911
2022-02-15,LE,Spain,3337,733,830,45,2604,890,884,1774,785
2022-02-16,LE,Spain,3507,771,897,42,2736,916,923,1839,855
2022-02-17,LE,Spain,3648,816,929,48,2832,953,950,1903,881
2022-02-18,LE,Spain,4185,941,1081,40,3244,1069,1094,2163,1041
2022-02-19,LE,Spain,4346,1086,753,18,3260,1248,1259,2507,735
2022-02-20,LE,Spain,4465,1033,982,23,3432,1241,1209,2450,959
2022-02-21,LE,Spain,3994,976,976,39,3018,1019,1023,2042,937
2022-02-22,LE,Spain,3491,803,858,33,2688,901,929,1830,825
2022-02-23,LE,Spain,3633,809,924,63,2824,954,946,1900,861
2022-02-24,LE,Spain,3907,855,1002,53,3052,1020,1030,2050,949
2022-02-25,LE,Spain,4465,1002,1102,32,3463,1179,1182,2361,1070
2022-02-26,LE,Spain,4493,1037,851,20,3456,1294,1311,2605,831
2022-02-27,LE,Spain,4547,1053,955,24,3494,1280,1259,2539,931
2022-02-28,LE,Spain,4171,1005,1007,39,3166,1089,1070,2159,968
2022-03-01,LE,Spain,3867,855,1019,53,3012,992,1001,1993,966
2022-03-02,LE,Spain,3815,860,978,44,2955,1000,977,1977,934
2022-03-03,LE,Spain,4102,930,1032,41,3172,1072,1068,2140,991
2022-03-04,LE,Spain,4626,1080,1136,38,3546,1201,1209,2410,1098
2022-03-05,LE,Spain,4632,1108,888,17,3524,1309,1327,2636,871
2022-03-06,LE,Spain,4720,1073,1049,22,3647,1302,1296,2598,1027
2022-03-07,LE,Spain,4195,1005,1029,31,3190,1093,1068,2161,998
2022-03-08,LE,Spain,3792,853,919,46,2939,1008,1012,2020,873
2022-03-09,LE,Spain,3841,877,978,48,2964,982,1004,1986,930
2022-03-10,LE,Spain,4166,920,1036,39,3246,1112,1098,2210,997
2022-03-11,LE,Spain,4609,1085,1148,26,3524,1180,1196,2376,1122
2022-03-12,LE,Spain,4574,1070,889,12,3504,1299,1316,2615,877
2022-03-13,LE,Spain,4625,1031,1024,10,3594,1303,1267,2570,1014
2022-03-14,LE,Spain,4148,935,997,22,3213,1115,1101,2216,975
2022-03-15,LE,Spain,3812,846,907,23,2966,1029,1030,2059,884
2022-03-16,LE,Spain,3797,881,924,25,2916,998,994,1992,899
2022-03-17,LE,Spain,4042,883,1007,37,3159,1072,1080,2152,970
2022-03-18,LE,Spain,4618,1059,1138,22,3559,1204,1217,2421,1116
2022-03-19,LE,Spain,4614,1053,880,22,3561,1336,1345,2681,858
2022-03-20,LE,Spain,4702,1037,1016,6,3665,1322,1327,2649,1010
2022-03-21,LE,Spain,4288,1025,1030,29,3263,1131,1102,2233,1001
2022-03-22,LE,Spain,3837,874,932,31,2963,1015,1016,2031,901
2022-03-23,LE,Spain,3816,844,954,27,2972,1007,1011,2018,927
2022-03-24,LE,Spain,4114,906,1012,32,3208,1090,1106,2196,980
2022-03-25,LE,Spain,4675,1083,1131,25,3592,1230,1231,2461,1106
2022-03-26,LE,Spain,4639,1106,862,16,3533,1327,1344,2671,846
2022-03-27,LE,Spain,5320,1205,1061,15,4115,1538,1516,3054,1046
2022-03-28,LE,Spain,5019,1117,1155,49,3902,1382,1365,2747,1106
2022-03-29,LE,Spain,4745,1060,1025,46,3685,1326,1334,2660,979
2022-03-30,LE,Spain,4801,1090,1078,46,3711,1315,1318,2633,1032
2022-03-31,LE,Spain,5091,1191,1124,41,3900,1376,1400,2776,1083
2022-04-01,LE,Spain,5590,1218,1243,29,4372,1558,1571,3129,1214
2022-04-02,LE,Spain,5707,1258,980,19,4449,1728,1741,3469,961
2022-04-03,LE,Spain,5641,1266,1086,28,4375,1656,1633,3289,1058
2022-04-04,LE,Spain,5305,1137,1182,46,4168,1503,1483,2986,1136
2022-04-05,LE,Spain,5069,1033,1117,41,4036,1466,1453,2919,1076
2022-04-06,LE,Spain,5158,1074,1173,59,4084,1436,1475,2911,1114
2022-04-07,LE,Spain,5486,1160,1220,40,4326,1541,1565,3106,1180
2022-04-08,LE,Spain,5885,1212,1299,37,4673,1665,1709,3374,1262
2022-04-09,LE,Spain,6160,1279,1080,18,4881,1896,1905,3801,1062
2022-04-10,LE,Spain,5871,1227,1140,16,4644,1772,1732,3504,1124
2022-04-11,LE,Spain,5431,1130,1176,25,4301,1566,1559,3125,1151
2022-04-12,LE,Spain,5345,1105,1123,29,4240,1542,1575,3117,1094
2022-04-13,LE,Spain,5631,1171,1255,26,4460,1594,1611,3205,1229
2022-04-14,LE,Spain,5774,1241,1199,24,4533,1646,1688,3334,1175
2022-04-15,LE,Spain,5676,1225,1102,16,4451,1663,1686,3349,1086
2022-04-16,LE,Spain,6110,1290,1078,9,4820,1871,1871,3742,1069
2022-04-17,LE,Spain,5916,1285,1194,13,4631,1714,1723,3437,1181
2022-04-18,LE,Spain,5865,1201,1291,34,4664,1729,1644,3373,1257
2022-04-19,LE,Spain,5425,1124,1122,23,4301,1601,1578,3179,1099
2022-04-20,LE,Spain,5350,1157,1139,34,4193,1532,1522,3054,1105
2022-04-21,LE,Spain,5619,1233,1192,34,4386,1594,1600,3194,1158
2022-04-22,LE,Spain,5838,1244,1256,16,4594,1652,1686,3338,1240
2022-04-23,LE,Spain,5962,1320,954,7,4642,1857,1831,3688,947
2022-04-24,LE,Spain,5965,1332,1110,11,4633,1776,1747,3523,1099
2022-04-25,LE,Spain,5660,1240,1234,34,4420,1601,1585,3186,1200
2022-04-26,LE,Spain,5259,1096,1112,30,4163,1532,1519,3051,1082
2022-04-27,LE,Spain,5297,1155,1148,36,4142,1497,1497,2994,1112
2022-04-28,LE,Spain,5577,1180,1189,28,4397,1587,1621,3208,1161
2022-04-29,LE,Spain,5891,1238,1298,27,4653,1662,1693,3355,1271
2022-04-30,LE,Spain,6035,1369,1013,22,4666,1811,1842,3653,991
2022-05-01,LE,Spain,5989,1303,1128,14,4686,1798,1760,3558,1114
2022-05-02,LE,Spain,5696,1222,1160,13,4474,1675,1639,3314,1147
2022-05-03,LE,Spain,5469,1163,1098,15,4306,1607,1601,3208,1083
2022-05-04,LE,Spain,5542,1234,1140,26,4308,1574,1594,3168,1114
2022-05-05,LE,Spain,5847,1259,1258,41,4588,1665,1665,3330,1217
2022-05-06,LE,Spain,6068,1269,1333,46,4799,1714,1752,3466,1287
2022-05-07,LE,Spain,6095,1332,1031,19,4763,1865,1867,3732,1012
2022-05-08,LE,Spain,6008,1354,1120,16,4654,1794,1740,3534,1104
2022-05-09,LE,Spain,5808,1288,1195,25,4520,1666,1659,3325,1170
2022-05-10,LE,Spain,5561,1143,1191,42,4418,1621,1606,3227,1149
2022-05-11,LE,Spain,5531,1208,1185,49,4323,1567,1571,3138,1136
2022-05-12,LE,Spain,5878,1276,1262,58,4602,1652,1688,3340,1204
2022-05-13,LE,Spain,6021,1264,1331,38,4757,1698,1728,3426,1293
2022-05-14,LE,Spain,6105,1305,1023,24,4800,1898,1879,3777,999
2022-05-15,LE,Spain,6037,1378,1135,10,4659,1782,1742,3524,1125
2022-05-16,LE,Spain,5792,1303,1205,26,4489,1644,1640,3284,1179
2022-05-17,LE,Spain,5648,1173,1178,44,4475,1636,1661,3297,1134
2022-05-18,LE,Spain,5688,1202,1249,36,4486,1593,1644,3237,1213
2022-05-19,LE,Spain,6094,1262,1274,47,4832,1799,1759,3558,1227
2022-05-20,LE,Spain,6077,1250,1284,44,4827,1750,1793,3543,1240
2022-05-21,LE,Spain,6194,1339,990,22,4855,1919,1946,3865,968
2022-05-22,LE,Spain,6246,1333,1199,24,4913,1880,1834,3714,1175
2022-05-23,LE,Spain,5947,1305,1226,35,4642,1719,1697,3416,1191
2022-05-24,LE,Spain,5817,1225,1155,42,4592,1734,1703,3437,1113
2022-05-25,LE,Spain,5916,1294,1176,48,4622,1698,1748,3446,1128
2022-05-26,LE,Spain,6163,1331,1247,47,4832,1769,1816,3585,1200
2022-05-27,LE,Spain,6256,1296,1355,31,4960,1790,1815,3605,1324
2022-05-28,LE,Spain,6439,1333,1094,29,5106,2016,1996,4012,1065
2022-05-29,LE,Spain,6473,1368,1158,25,5105,2001,1946,3947,1133
2022-05-30,LE,Spain,6155,1341,1281,35,4814,1776,1757,3533,1246
2022-05-31,LE,Spain,5890,1242,1195,44,4648,1737,1716,3453,1151
2022-06-01,LE,Spain,5980,1299,1215,45,4681,1721,1745,3466,1170
2022-06-02,LE,Spain,6204,1318,1280,51,4886,1795,1811,3606,1229
2022-06-03,LE,Spain,6377,1297,1324,41,5080,1854,1902,3756,1283
2022-06-04,LE,Spain,6442,1363,1047,23,5079,2023,2009,4032,1024
2022-06-05,LE,Spain,6380,1358,1193,18,5022,1929,1900,3829,1175
2022-06-06,LE,Spain,6281,1364,1242,31,4917,1859,1816,3675,1211
2022-06-07,LE,Spain,6032,1264,1190,33,4768,1790,1788,3578,1157
2022-06-08,LE,Spain,5950,1279,1262,46,4671,1703,1706,3409,1216
2022-06-09,LE,Spain,6220,1281,1293,50,4939,1809,1837,3646,1243
2022-06-10,LE,Spain,6370,1269,1354,35,5101,1844,1903,3747,1319
2022-06-11,LE,Spain,6512,1382,1084,17,5130,2028,2018,4046,1067
2022-06-12,LE,Spain,6442,1362,1218,19,5080,1966,1896,3862,1199
2022-06-13,LE,Spain,6159,1319,1272,20,4840,1790,1778,3568,1252
2022-06-14,LE,Spain,6092,1282,1213,60,4810,1799,1798,3597,1153
2022-06-15,LE,Spain,6121,1325,1230,34,4796,1775,1791,3566,1196
2022-06-16,LE,Spain,6347,1340,1319,42,5007,1821,1867,3688,1277
2022-06-17,LE,Spain,6593,1367,1423,48,5226,1894,1909,3803,1375
2022-06-18,LE,Spain,6605,1353,1101,25,5252,2085,2066,4151,1076
2022-06-19,LE,Spain,6578,1387,1280,30,5191,1969,1942,3911,1250
2022-06-20,LE,Spain,6419,1370,1314,41,5049,1888,1847,3735,1273
2022-06-21,LE,Spain,6308,1352,1257,35,4956,1848,1851,3699,1222
2022-06-22,LE,Spain,6294,1397,1289,50,4897,1800,1808,3608,1239
2022-06-23,LE,Spain,6458,1365,1353,40,5093,1869,1871,3740,1313
2022-06-24,LE,Spain,6512,1367,1388,29,5145,1863,1894,3757,1359
2022-06-25,LE,Spain,6443,1407,1091,20,5036,1965,1980,3945,1071
2022-06-26,LE,Spain,6509,1426,1281,16,5083,1917,1885,3802,1265
2022-06-27,LE,Spain,6479,1448,1319,30,5031,1849,1863,3712,1289
2022-06-28,LE,Spain,6496,1392,1291,56,5104,1890,1923,3813,1235
2022-06-29,LE,Spain,6336,1404,1288,52,4932,1834,1810,3644,1236
2022-06-30,LE,Spain,6630,1439,1330,46,5191,1956,1905,3861,1284
2022-07-01,LE,Spain,6851,1460,1442,30,5391,1939,2010,3949,1412
2022-07-02,LE,Spain,6741,1445,1132,13,5296,2089,2075,4164,1119
2022-07-03,LE,Spain,6709,1473,1289,6,5236,1992,1955,3947,1283
2022-07-04,LE,Spain,6707,1485,1342,42,5222,1940,1940,3880,1300
2022-07-05,LE,Spain,6525,1436,1283,37,5089,1901,1905,3806,1246
2022-07-06,LE,Spain,6463,1422,1300,24,5041,1872,1869,3741,1276
2022-07-07,LE,Spain,6760,1505,1385,45,5255,1938,1932,3870,1340
2022-07-08,LE,Spain,6895,1462,1478,38,5433,1955,2000,3955,1440
2022-07-09,LE,Spain,6975,1458,1175,18,5517,2168,2174,4342,1157
2022-07-10,LE,Spain,6794,1472,1304,16,5322,2016,2002,4018,1288
2022-07-11,LE,Spain,6779,1496,1373,29,5283,1972,1938,3910,1344
2022-07-12,LE,Spain,6598,1462,1280,28,5136,1929,1927,3856,1252
2022-07-13,LE,Spain,6504,1421,1342,43,5083,1871,1870,3741,1299
2022-07-14,LE,Spain,6688,1470,1372,45,5218,1913,1933,3846,1327
2022-07-15,LE,Spain,6805,1477,1468,45,5328,1909,1951,3860,1423
2022-07-16,LE,Spain,7015,1484,1223,21,5531,2157,2151,4308,1202
2022-07-17,LE,Spain,6745,1505,1290,9,5240,1991,1959,3950,1281
2022-07-18,LE,Spain,6768,1504,1402,33,5264,1933,1929,3862,1369
2022-07-19,LE,Spain,6588,1442,1285,36,5146,1927,1934,3861,1249
2022-07-20,LE,Spain,6622,1491,1348,33,5131,1889,1894,3783,1315
2022-07-21,LE,Spain,6724,1502,1366,33,5222,1924,1932,3856,1333
2022-07-22,LE,Spain,6871,1508,1421,34,5363,1979,1963,3942,1387
2022-07-23,LE,Spain,7089,1541,1213,18,5548,2149,2186,4335,1195
2022-07-24,LE,Spain,6804,1513,1259,17,5291,2031,2001,4032,1242
2022-07-25,LE,Spain,6732,1471,1386,24,5261,1935,1940,3875,1362
2022-07-26,LE,Spain,6612,1441,1320,48,5171,1932,1919,3851,1272
2022-07-27,LE,Spain,6428,1411,1332,39,5017,1846,1839,3685,1293
2022-07-28,LE,Spain,6767,1496,1386,38,5271,1944,1941,3885,1348
2022-07-29,LE,Spain,6888,1493,1408,28,5395,1981,2006,3987,1380
2022-07-30,LE,Spain,7035,1517,1187,9,5518,2170,2161,4331,1178
2022-07-31,LE,Spain,6971,1511,1316,13,5460,2091,2053,4144,1303
2022-08-01,LE,Spain,6899,1556,1397,27,5343,1971,1975,3946,1370
2022-08-02,LE,Spain,6650,1497,1275,38,5153,1943,1935,3878,1237
2022-08-03,LE,Spain,6479,1469,1291,38,5010,1860,1859,3719,1253
2022-08-04,LE,Spain,6696,1504,1328,31,5192,1933,1931,3864,1297
2022-08-05,LE,Spain,6785,1465,1387,23,5320,1944,1989,3933,1364
2022-08-06,LE,Spain,7000,1482,1194,9,5518,2178,2146,4324,1185
2022-08-07,LE,Spain,6788,1501,1256,5,5287,2021,2010,4031,1251
2022-08-08,LE,Spain,6703,1497,1362,22,5206,1929,1915,3844,1340
2022-08-09,LE,Spain,6543,1439,1274,39,5104,1914,1916,3830,1235
2022-08-10,LE,Spain,6509,1465,1328,33,5044,1856,1860,3716,1295
2022-08-11,LE,Spain,6640,1495,1328,37,5145,1906,1911,3817,1291
2022-08-12,LE,Spain,6789,1436,1390,37,5353,1967,1996,3963,1353
2022-08-13,LE,Spain,6927,1455,1180,20,5472,2144,2148,4292,1160
2022-08-14,LE,Spain,6840,1565,1248,5,5275,2022,2005,4027,1243
2022-08-15,LE,Spain,6613,1467,1330,15,5146,1917,1899,3816,1315
2022-08-16,LE,Spain,6472,1438,1274,22,5034,1881,1879,3760,1252
2022-08-17,LE,Spain,6271,1442,1269,29,4829,1781,1779,3560,1240
2022-08-18,LE,Spain,6655,1542,1311,40,5113,1900,1902,3802,1271
2022-08-19,LE,Spain,6745,1474,1383,25,5271,1927,1961,3888,1358
2022-08-20,LE,Spain,7009,1519,1190,14,5490,2160,2140,4300,1176
2022-08-21,LE,Spain,6815,1540,1256,13,5275,2025,1994,4019,1243
2022-08-22,LE,Spain,6629,1480,1348,24,5149,1909,1892,3801,1324
2022-08-23,LE,Spain,6484,1436,1289,49,5048,1881,1878,3759,1240
2022-08-24,LE,Spain,6467,1477,1317,36,4990,1818,1855,3673,1281
2022-08-25,LE,Spain,6660,1490,1316,28,5170,1933,1921,3854,1288
2022-08-26,LE,Spain,6684,1417,1395,24,5267,1917,1955,3872,1371
2022-08-27,LE,Spain,6871,1446,1180,15,5425,2142,2103,4245,1165
2022-08-28,LE,Spain,6735,1448,1259,8,5287,2020,2008,4028,1251
2022-08-29,LE,Spain,6621,1508,1318,23,5113,1910,1885,3795,1295
2022-08-30,LE,Spain,6439,1435,1279,48,5004,1860,1865,3725,1231
2022-08-31,LE,Spain,6406,1497,1299,46,4909,1812,1798,3610,1253
2022-09-01,LE,Spain,6576,1461,1356,50,5115,1872,1887,3759,1306
2022-09-02,LE,Spain,6642,1490,1391,36,5152,1875,1886,3761,1355
2022-09-03,LE,Spain,6822,1475,1161,5,5347,2096,2090,4186,1156
2022-09-04,LE,Spain,6646,1508,1240,13,5138,1950,1948,3898,1227
2022-09-05,LE,Spain,6515,1485,1365,20,5030,1845,1820,3665,1345
2022-09-06,LE,Spain,6342,1406,1276,46,4936,1823,1837,3660,1230
2022-09-07,LE,Spain,6298,1423,1321,43,4875,1778,1776,3554,1278
2022-09-08,LE,Spain,6418,1420,1322,29,4998,1826,1850,3676,1293
2022-09-09,LE,Spain,6612,1458,1413,24,5154,1864,1877,3741,1389
2022-09-10,LE,Spain,6794,1453,1184,10,5341,2068,2089,4157,1174
2022-09-11,LE,Spain,6606,1445,1250,10,5161,1970,1941,3911,1240
2022-09-12,LE,Spain,6359,1416,1290,25,4943,1845,1808,3653,1265
2022-09-13,LE,Spain,6125,1358,1205,24,4767,1780,1782,3562,1181
2022-09-14,LE,Spain,6188,1387,1273,36,4801,1752,1776,3528,1237
2022-09-15,LE,Spain,6462,1423,1351,32,5039,1826,1862,3688,1319
2022-09-16,LE,Spain,5681,1153,1372,26,4528,1562,1594,3156,1346
2022-09-17,LE,Spain,6667,1485,1102,17,5182,2048,2032,4080,1085
2022-09-18,LE,Spain,6557,1437,1228,7,5120,1974,1918,3892,1221
2022-09-19,LE,Spain,6287,1422,1307,29,4865,1794,1764,3558,1278
2022-09-20,LE,Spain,6128,1352,1218,27,4776,1772,1786,3558,1191
2022-09-21,LE,Spain,6050,1346,1280,35,4704,1714,1710,3424,1245
2022-09-22,LE,Spain,6319,1398,1296,34,4921,1797,1828,3625,1262
2022-09-23,LE,Spain,6500,1400,1380,29,5100,1847,1873,3720,1351
2022-09-24,LE,Spain,6464,1374,1077,22,5090,2014,1999,4013,1055
2022-09-25,LE,Spain,6152,1469,923,11,4683,1894,1866,3760,912
2022-09-26,LE,Spain,6270,1420,1253,34,4850,1805,1792,3597,1219
2022-09-27,LE,Spain,6108,1358,1233,27,4750,1772,1745,3517,1206
2022-09-28,LE,Spain,6085,1407,1250,23,4678,1708,1720,3428,1227
2022-09-29,LE,Spain,6032,1382,1259,22,4650,1678,1713,3391,1237
2022-09-30,LE,Spain,6558,1409,1387,33,5149,1860,1902,3762,1354
2022-10-01,LE,Spain,6523,1424,1084,14,5099,1990,2025,4015,1070
2022-10-02,LE,Spain,6431,1455,1217,16,4976,1908,1851,3759,1201
2022-10-03,LE,Spain,6323,1403,1303,42,4920,1841,1776,3617,1261
2022-10-04,LE,Spain,6031,1363,1237,58,4668,1705,1726,3431,1179
2022-10-05,LE,Spain,5990,1381,1281,64,4609,1684,1644,3328,1217
2022-10-06,LE,Spain,6073,1403,1269,34,4670,1675,1726,3401,1235
2022-10-07,LE,Spain,6401,1391,1348,24,5010,1815,1847,3662,1324
2022-10-08,LE,Spain,6514,1456,1072,10,5058,1998,1988,3986,1062
2022-10-09,LE,Spain,6375,1463,1210,11,4912,1867,1835,3702,1199
2022-10-10,LE,Spain,6094,1378,1254,30,4716,1742,1720,3462,1224
2022-10-11,LE,Spain,5889,1299,1194,40,4590,1712,1684,3396,1154
2022-10-12,LE,Spain,5805,1384,1110,27,4421,1651,1660,3311,1083
2022-10-13,LE,Spain,6102,1399,1265,24,4703,1707,1731,3438,1241
2022-10-14,LE,Spain,6460,1424,1378,43,5036,1815,1843,3658,1335
2022-10-15,LE,Spain,6541,1421,1116,25,5120,1985,2019,4004,1091
2022-10-16,LE,Spain,6462,1418,1220,18,5044,1931,1893,3824,1202
2022-10-17,LE,Spain,6093,1357,1320,41,4736,1720,1696,3416,1279
2022-10-18,LE,Spain,5886,1316,1229,53,4570,1674,1667,3341,1176
2022-10-19,LE,Spain,5840,1393,1240,35,4447,1605,1602,3207,1205
2022-10-20,LE,Spain,6052,1361,1264,35,4691,1700,1727,3427,1229
2022-10-21,LE,Spain,6209,1369,1359,32,4840,1725,1756,3481,1327
2022-10-22,LE,Spain,6544,1429,1096,27,5115,2003,2016,4019,1069
2022-10-23,LE,Spain,6308,1413,1169,21,4895,1868,1858,3726,1148
2022-10-24,LE,Spain,5985,1345,1296,44,4640,1702,1642,3344,1252
2022-10-25,LE,Spain,5858,1296,1214,44,4562,1675,1673,3348,1170
2022-10-26,LE,Spain,5849,1374,1245,23,4475,1605,1625,3230,1222
2022-10-27,LE,Spain,6083,1403,1303,48,4680,1686,1691,3377,1255
2022-10-28,LE,Spain,6460,1406,1412,31,5054,1803,1839,3642,1381
2022-10-29,LE,Spain,6618,1440,1165,18,5178,2014,1999,4013,1147
2022-10-30,LE,Spain,5896,1393,1146,16,4503,1697,1660,3357,1130
2022-10-31,LE,Spain,5395,1310,1122,23,4085,1484,1479,2963,1099
2022-11-01,LE,Spain,4878,1160,1055,25,3718,1322,1341,2663,1030
2022-11-02,LE,Spain,4747,1126,1117,29,3621,1268,1236,2504,1088
2022-11-03,LE,Spain,5003,1209,1099,39,3794,1343,1352,2695,1060
2022-11-04,LE,Spain,5555,1351,1274,20,4204,1453,1477,2930,1254
2022-11-05,LE,Spain,5544,1367,1003,15,4177,1581,1593,3174,988
2022-11-06,LE,Spain,5521,1301,1124,14,4220,1570,1526,3096,1110
2022-11-07,LE,Spain,5052,1272,1120,29,3780,1335,1325,2660,1091
2022-11-08,LE,Spain,4472,1074,1065,44,3398,1171,1162,2333,1021
2022-11-09,LE,Spain,4379,1014,1087,39,3365,1138,1140,2278,1048
2022-11-10,LE,Spain,4781,1174,1108,42,3607,1245,1254,2499,1066
2022-11-11,LE,Spain,5323,1307,1255,34,4016,1366,1395,2761,1221
2022-11-12,LE,Spain,5137,1293,994,14,3844,1429,1421,2850,980
2022-11-13,LE,Spain,5255,1307,1119,18,3948,1430,1399,2829,1101
2022-11-14,LE,Spain,4967,1282,1108,23,3685,1294,1283,2577,1085
2022-11-15,LE,Spain,4366,1053,1050,31,3313,1130,1133,2263,1019
2022-11-16,LE,Spain,4330,976,1076,28,3354,1143,1135,2278,1048
2022-11-17,LE,Spain,4630,1104,1115,38,3526,1201,1210,2411,1077
2022-11-18,LE,Spain,5245,1285,1206,20,3960,1366,1388,2754,1186
2022-11-19,LE,Spain,5041,1233,991,15,3808,1407,1410,2817,976
2022-11-20,LE,Spain,5104,1233,1096,13,3871,1397,1378,2775,1083
2022-11-21,LE,Spain,4863,1215,1114,25,3648,1263,1271,2534,1089
2022-11-22,LE,Spain,4277,1052,1052,29,3225,1090,1083,2173,1023
2022-11-23,LE,Spain,4225,945,1069,27,3280,1103,1108,2211,1042
2022-11-24,LE,Spain,4541,1046,1091,26,3495,1193,1211,2404,1065
2022-11-25,LE,Spain,5208,1257,1263,19,3951,1339,1349,2688,1244
2022-11-26,LE,Spain,4922,1195,1034,28,3727,1344,1349,2693,1006
2022-11-27,LE,Spain,5040,1192,1168,24,3848,1350,1330,2680,1144
2022-11-28,LE,Spain,4755,1199,1095,36,3556,1243,1218,2461,1059
2022-11-29,LE,Spain,4194,978,1064,42,3216,1076,1076,2152,1022
2022-11-30,LE,Spain,4257,963,1096,41,3294,1094,1104,2198,1055
2022-12-01,LE,Spain,4555,1081,1121,30,3474,1180,1173,2353,1091
2022-12-02,LE,Spain,5261,1251,1280,24,4010,1354,1376,2730,1256
2022-12-03,LE,Spain,5072,1191,1082,16,3881,1402,1397,2799,1066
2022-12-04,LE,Spain,4922,1194,1068,19,3728,1344,1316,2660,1049
2022-12-05,LE,Spain,4763,1202,1098,17,3561,1246,1217,2463,1081
2022-12-06,LE,Spain,4286,1014,1023,25,3272,1124,1125,2249,998
2022-12-07,LE,Spain,4343,987,1097,53,3356,1131,1128,2259,1044
2022-12-08,LE,Spain,4510,1049,1016,13,3461,1218,1227,2445,1003
2022-12-09,LE,Spain,4800,1156,1089,19,3644,1271,1284,2555,1070
2022-12-10,LE,Spain,5080,1223,1047,23,3857,1389,1421,2810,1024
2022-12-11,LE,Spain,4953,1154,1146,13,3799,1324,1329,2653,1133
2022-12-12,LE,Spain,4699,1210,1096,25,3489,1205,1188,2393,1071
2022-12-13,LE,Spain,4344,1106,1019,22,3238,1116,1103,2219,997
2022-12-14,LE,Spain,4272,1048,1031,29,3224,1095,1098,2193,1002
2022-12-15,LE,Spain,4674,1183,1057,34,3491,1218,1216,2434,1023
2022-12-16,LE,Spain,5222,1331,1245,33,3891,1317,1329,2646,1212
2022-12-17,LE,Spain,5162,1341,1009,12,3821,1401,1411,2812,997
2022-12-18,LE,Spain,5050,1279,1070,18,3771,1359,1342,2701,1052
2022-12-19,LE,Spain,5047,1320,1128,24,3727,1297,1302,2599,1104
2022-12-20,LE,Spain,4924,1260,1102,24,3664,1283,1279,2562,1078
2022-12-21,LE,Spain,4890,1143,1146,27,3747,1295,1306,2601,1119
2022-12-22,LE,Spain,5200,1268,1203,21,3932,1365,1364,2729,1182
2022-12-23,LE,Spain,5485,1389,1231,14,4096,1439,1426,2865,1217
2022-12-24,LE,Spain,4499,1203,858,4,3296,1212,1226,2438,854
2022-12-25,LE,Spain,3479,948,755,0,2531,881,895,1776,755
2022-12-26,LE,Spain,4993,1259,1087,13,3734,1329,1318,2647,1074
2022-12-27,LE,Spain,4919,1281,1029,17,3638,1298,1311,2609,1012
2022-01-01,ES,Sweden,987,669,37,1,318,138,143,281,36
2022-01-02,ES,Sweden,1620,949,185,1,671,240,246,486,184
2022-01-03,ES,Sweden,1604,877,213,10,727,256,258,514,203
2022-01-04,ES,Sweden,1466,808,201,7,658,228,229,457,194
2022-01-05,ES,Sweden,1383,762,182,6,621,218,221,439,176
2022-01-06,ES,Sweden,1290,715,171,11,575,200,204,404,160
2022-01-07,ES,Sweden,1533,851,201,8,682,244,237,481,193
2022-01-08,ES,Sweden,1232,755,69,2,477,207,201,408,67
2022-01-09,ES,Sweden,1509,868,185,3,641,222,234,456,182
2022-01-10,ES,Sweden,1313,622,242,12,691,225,224,449,230
2022-01-11,ES,Sweden,1232,660,215,18,572,179,178,357,197
2022-01-12,ES,Sweden,1189,650,206,13,539,167,166,333,193
2022-01-13,ES,Sweden,1276,677,242,14,599,177,180,357,228
2022-01-14,ES,Sweden,1315,688,217,7,627,206,204,410,210
2022-01-15,ES,Sweden,1007,646,69,4,361,145,147,292,65
2022-01-16,ES,Sweden,1316,781,170,0,535,184,181,365,170
2022-01-17,ES,Sweden,1224,621,245,11,603,180,178,358,234
2022-01-18,ES,Sweden,1114,583,240,12,531,140,151,291,228
2022-01-19,ES,Sweden,1162,651,210,14,511,158,143,301,196
2022-01-20,ES,Sweden,1211,602,261,15,609,168,180,348,246
2022-01-21,ES,Sweden,1323,666,257,20,657,202,198,400,237
2022-01-22,ES,Sweden,980,626,74,7,354,142,138,280,67
2022-01-23,ES,Sweden,1244,749,168,2,495,164,163,327,166
2022-01-24,ES,Sweden,1218,642,221,16,576,177,178,355,205
2022-01-25,ES,Sweden,1066,589,215,18,477,132,130,262,197
2022-01-26,ES,Sweden,1159,612,220,10,547,161,166,327,210
2022-01-27,ES,Sweden,1238,679,231,6,559,163,165,328,225
2022-01-28,ES,Sweden,1274,653,242,14,621,190,189,379,228
2022-01-29,ES,Sweden,979,643,58,2,336,142,136,278,56
2022-01-30,ES,Sweden,1164,669,157,1,495,168,170,338,156
2022-01-31,ES,Sweden,1206,607,243,15,599,176,180,356,228
2022-02-01,ES,Sweden,1116,586,220,10,530,156,154,310,210
2022-02-02,ES,Sweden,1156,623,210,8,533,158,165,323,202
2022-02-03,ES,Sweden,1244,652,258,6,592,169,165,334,252
2022-02-04,ES,Sweden,1343,740,216,10,603,192,195,387,206
2022-02-05,ES,Sweden,1047,660,80,6,387,155,152,307,74
2022-02-06,ES,Sweden,1268,739,182,4,529,173,174,347,178
2022-02-07,ES,Sweden,1233,643,226,19,590,186,178,364,207
2022-02-08,ES,Sweden,1095,604,202,17,491,145,144,289,185
2022-02-09,ES,Sweden,1218,650,224,22,568,167,177,344,202
2022-02-10,ES,Sweden,1299,677,260,20,622,184,178,362,240
2022-02-11,ES,Sweden,1345,692,251,25,653,198,204,402,226
2022-02-12,ES,Sweden,1088,662,75,5,426,172,179,351,70
2022-02-13,ES,Sweden,1302,742,176,4,560,189,195,384,172
2022-02-14,ES,Sweden,1263,664,220,9,599,195,184,379,211
2022-02-15,ES,Sweden,1149,629,213,15,520,152,155,307,198
2022-02-16,ES,Sweden,1270,725,228,19,545,157,160,317,209
2022-02-17,ES,Sweden,1315,696,263,19,619,179,177,356,244
2022-02-18,ES,Sweden,1496,812,264,23,684,212,208,420,241
2022-02-19,ES,Sweden,1179,724,105,4,455,176,174,350,101
2022-02-20,ES,Sweden,1389,806,185,6,583,196,202,398,179
2022-02-21,ES,Sweden,1281,693,214,6,588,184,190,374,208
2022-02-22,ES,Sweden,1216,634,240,17,582,170,172,342,223
2022-02-23,ES,Sweden,1284,692,236,18,592,179,177,356,218
2022-02-24,ES,Sweden,1323,688,265,10,635,190,180,370,255
2022-02-25,ES,Sweden,1513,780,263,20,733,229,241,470,243
2022-02-26,ES,Sweden,1259,734,91,6,525,220,214,434,85
2022-02-27,ES,Sweden,1489,878,193,10,611,214,204,418,183
2022-02-28,ES,Sweden,1348,666,265,16,682,207,210,417,249
2022-03-01,ES,Sweden,1189,619,216,17,570,178,176,354,199
2022-03-02,ES,Sweden,1234,599,236,23,635,200,199,399,213
2022-03-03,ES,Sweden,1231,568,281,17,663,189,193,382,264
2022-03-04,ES,Sweden,1473,729,271,21,744,234,239,473,250
2022-03-05,ES,Sweden,1152,612,80,11,540,227,233,460,69
2022-03-06,ES,Sweden,1310,696,174,9,614,222,218,440,165
2022-03-07,ES,Sweden,1333,629,265,25,704,218,221,439,240
2022-03-08,ES,Sweden,1177,583,221,10,594,186,187,373,211
2022-03-09,ES,Sweden,1245,615,243,27,630,198,189,387,216
2022-03-10,ES,Sweden,1337,671,276,17,666,200,190,390,259
2022-03-11,ES,Sweden,1497,781,272,19,716,216,228,444,253
2022-03-12,ES,Sweden,1094,640,73,9,454,189,192,381,64
2022-03-13,ES,Sweden,1342,735,195,9,607,209,203,412,186
2022-03-14,ES,Sweden,1379,703,256,13,676,215,205,420,243
2022-03-15,ES,Sweden,1242,655,236,20,587,174,177,351,216
2022-03-16,ES,Sweden,1263,608,258,13,655,199,198,397,245
2022-03-17,ES,Sweden,1351,656,289,12,695,203,203,406,277
2022-03-18,ES,Sweden,1461,721,273,14,740,234,233,467,259
2022-03-19,ES,Sweden,1032,591,67,7,441,184,190,374,60
2022-03-20,ES,Sweden,1263,650,194,7,613,207,212,419,187
2022-03-21,ES,Sweden,1355,690,236,14,665,214,215,429,222
2022-03-22,ES,Sweden,1209,596,233,23,613,191,189,380,210
2022-03-23,ES,Sweden,1268,569,290,25,699,203,206,409,265
2022-03-24,ES,Sweden,1348,651,305,20,697,193,199,392,285
2022-03-25,ES,Sweden,1554,789,286,21,765,242,237,479,265
2022-03-26,ES,Sweden,1070,620,78,7,450,183,189,372,71
2022-03-27,ES,Sweden,1516,765,215,7,751,267,269,536,208
2022-03-28,ES,Sweden,1637,771,311,14,866,276,279,555,297
2022-03-29,ES,Sweden,1537,717,321,22,820,250,249,499,299
2022-03-30,ES,Sweden,1557,695,320,14,862,269,273,542,306
2022-03-31,ES,Sweden,1547,683,324,13,864,274,266,540,311
2022-04-01,ES,Sweden,1612,735,317,9,877,281,279,560,308
2022-04-02,ES,Sweden,1103,577,82,8,526,224,220,444,74
2022-04-03,ES,Sweden,1551,813,219,9,738,250,269,519,210
2022-04-04,ES,Sweden,1668,821,299,6,847,277,271,548,293
2022-04-05,ES,Sweden,1538,749,319,20,789,233,237,470,299
2022-04-06,ES,Sweden,1723,858,325,11,865,274,266,540,314
2022-04-07,ES,Sweden,1806,884,322,14,922,297,303,600,308
2022-04-08,ES,Sweden,1878,972,286,15,906,315,305,620,271
2022-04-09,ES,Sweden,1314,750,79,1,564,244,241,485,78
2022-04-10,ES,Sweden,1595,850,204,4,745,265,276,541,200
2022-04-11,ES,Sweden,1664,774,321,26,890,289,280,569,295
2022-04-12,ES,Sweden,1562,742,296,15,820,261,263,524,281
2022-04-13,ES,Sweden,1701,814,334,22,887,279,274,553,312
2022-04-14,ES,Sweden,1654,807,290,13,847,280,277,557,277
2022-04-15,ES,Sweden,1279,673,129,1,606,239,238,477,128
2022-04-16,ES,Sweden,1129,609,81,4,520,217,222,439,77
2022-04-17,ES,Sweden,1456,745,194,4,711,255,262,517,190
2022-04-18,ES,Sweden,1632,783,240,6,849,305,304,609,234
2022-04-19,ES,Sweden,1667,751,331,17,916,290,295,585,314
2022-04-20,ES,Sweden,1709,759,357,17,950,297,296,593,340
2022-04-21,ES,Sweden,1693,727,363,19,966,304,299,603,344
2022-04-22,ES,Sweden,1686,767,326,17,919,299,294,593,309
2022-04-23,ES,Sweden,1190,633,94,0,557,229,234,463,94
2022-04-24,ES,Sweden,1546,761,213,2,785,289,283,572,211
2022-04-25,ES,Sweden,1670,728,323,16,942,308,311,619,307
2022-04-26,ES,Sweden,1613,743,322,20,870,274,274,548,302
2022-04-27,ES,Sweden,1723,781,356,28,942,297,289,586,328
2022-04-28,ES,Sweden,1789,830,354,23,959,306,299,605,331
2022-04-29,ES,Sweden,1825,891,337,24,934,293,304,597,313
2022-04-30,ES,Sweden,1168,641,81,1,527,221,225,446,80
2022-05-01,ES,Sweden,1582,811,208,4,771,278,285,563,204
2022-05-02,ES,Sweden,1820,845,354,22,975,307,314,621,332
2022-05-03,ES,Sweden,1718,792,352,22,926,291,283,574,330
2022-05-04,ES,Sweden,1789,835,365,19,954,293,296,589,346
2022-05-05,ES,Sweden,1876,873,370,23,1003,316,317,633,347
2022-05-06,ES,Sweden,1905,913,350,15,992,325,317,642,335
2022-05-07,ES,Sweden,1293,744,74,2,549,236,239,475,72
2022-05-08,ES,Sweden,1621,807,206,3,814,300,308,608,203
2022-05-09,ES,Sweden,1841,870,345,22,971,316,310,626,323
2022-05-10,ES,Sweden,1760,819,353,29,941,294,294,588,324
2022-05-11,ES,Sweden,1831,874,344,22,957,303,310,613,322
2022-05-12,ES,Sweden,1932,922,344,18,1010,337,329,666,326
2022-05-13,ES,Sweden,1949,928,344,22,1021,338,339,677,322
2022-05-14,ES,Sweden,1348,776,81,7,572,245,246,491,74
2022-05-15,ES,Sweden,1668,847,211,9,821,303,307,610,202
2022-05-16,ES,Sweden,1809,805,351,24,1004,328,325,653,327
2022-05-17,ES,Sweden,1671,742,347,21,929,294,288,582,326
2022-05-18,ES,Sweden,1898,906,369,29,992,312,311,623,340
2022-05-19,ES,Sweden,1963,911,376,24,1052,334,342,676,352
2022-05-20,ES,Sweden,1895,898,318,21,997,344,335,679,297
2022-05-21,ES,Sweden,1428,845,75,0,583,254,254,508,75
2022-05-22,ES,Sweden,1706,896,193,7,810,302,315,617,186
2022-05-23,ES,Sweden,1882,878,357,21,1004,329,318,647,336
2022-05-24,ES,Sweden,1845,848,367,27,997,310,320,630,340
2022-05-25,ES,Sweden,2040,996,363,33,1044,348,333,681,330
2022-05-26,ES,Sweden,1730,919,200,8,811,309,302,611,192
2022-05-27,ES,Sweden,1736,927,231,11,809,285,293,578,220
2022-05-28,ES,Sweden,1418,800,87,5,618,267,264,531,82
2022-05-29,ES,Sweden,1862,959,229,9,903,329,345,674,220
2022-05-30,ES,Sweden,1913,872,360,26,1041,338,343,681,334
2022-05-31,ES,Sweden,1847,839,348,17,1008,336,324,660,331
2022-06-01,ES,Sweden,1995,927,386,24,1068,339,343,682,362
2022-06-02,ES,Sweden,2045,957,366,19,1088,360,362,722,347
2022-06-03,ES,Sweden,2032,959,353,27,1073,357,363,720,326
2022-06-04,ES,Sweden,1401,743,99,5,658,283,276,559,94
2022-06-05,ES,Sweden,1717,912,182,8,805,312,311,623,174
2022-06-06,ES,Sweden,1763,890,227,11,873,320,326,646,216
2022-06-07,ES,Sweden,1942,931,353,30,1011,329,329,658,323
2022-06-08,ES,Sweden,2061,974,396,37,1087,346,345,691,359
2022-06-09,ES,Sweden,2106,964,399,27,1142,368,375,743,372
2022-06-10,ES,Sweden,2012,977,326,27,1035,355,354,709,299
2022-06-11,ES,Sweden,1497,821,97,6,676,291,288,579,91
2022-06-12,ES,Sweden,1794,926,203,8,868,329,336,665,195
2022-06-13,ES,Sweden,2024,972,342,28,1052,360,350,710,314
2022-06-14,ES,Sweden,1944,936,330,19,1008,337,341,678,311
2022-06-15,ES,Sweden,2031,945,368,27,1086,352,366,718,341
2022-06-16,ES,Sweden,2083,1004,355,20,1079,362,362,724,335
2022-06-17,ES,Sweden,2049,992,329,10,1057,366,362,728,319
2022-06-18,ES,Sweden,1570,862,108,2,708,312,288,600,106
2022-06-19,ES,Sweden,1774,911,195,5,863,329,339,668,190
2022-06-20,ES,Sweden,1908,883,332,15,1025,351,342,693,317
2022-06-21,ES,Sweden,1949,923,334,22,1026,343,349,692,312
2022-06-22,ES,Sweden,2043,970,366,35,1073,352,355,707,331
2022-06-23,ES,Sweden,2023,990,314,12,1033,364,355,719,302
2022-06-24,ES,Sweden,1595,893,111,9,702,292,299,591,102
2022-06-25,ES,Sweden,1460,827,74,3,633,280,279,559,71
2022-06-26,ES,Sweden,1829,1008,199,12,821,310,312,622,187
2022-06-27,ES,Sweden,1942,981,308,17,961,328,325,653,291
2022-06-28,ES,Sweden,1768,849,273,16,919,324,322,646,257
2022-06-29,ES,Sweden,1910,936,295,23,974,338,341,679,272
2022-06-30,ES,Sweden,1907,924,298,27,983,345,340,685,271
2022-07-01,ES,Sweden,1972,995,286,17,977,344,347,691,269
2022-07-02,ES,Sweden,1639,908,101,3,731,311,319,630,98
2022-07-03,ES,Sweden,1894,973,240,5,921,341,340,681,235
2022-07-04,ES,Sweden,1880,973,277,23,907,321,309,630,254
2022-07-05,ES,Sweden,1674,862,238,22,812,286,288,574,216
2022-07-06,ES,Sweden,1879,966,283,16,913,309,321,630,267
2022-07-07,ES,Sweden,1764,882,250,23,882,318,314,632,227
2022-07-08,ES,Sweden,1853,970,232,9,883,321,330,651,223
2022-07-09,ES,Sweden,1465,803,98,4,662,287,277,564,94
2022-07-10,ES,Sweden,1684,911,162,3,773,305,306,611,159
2022-07-11,ES,Sweden,1674,869,220,12,805,299,286,585,208
2022-07-12,ES,Sweden,1647,862,218,9,785,279,288,567,209
2022-07-13,ES,Sweden,1764,943,229,7,821,300,292,592,222
2022-07-14,ES,Sweden,1783,953,211,7,830,312,307,619,204
2022-07-15,ES,Sweden,1799,977,204,8,822,310,308,618,196
2022-07-16,ES,Sweden,1396,758,91,0,638,279,268,547,91
2022-07-17,ES,Sweden,1688,936,163,4,752,289,300,589,159
2022-07-18,ES,Sweden,1725,892,223,8,833,302,308,610,215
2022-07-19,ES,Sweden,1700,888,212,10,812,299,301,600,202
2022-07-20,ES,Sweden,1786,946,235,16,840,301,304,605,219
2022-07-21,ES,Sweden,1843,954,245,12,889,321,323,644,233
2022-07-22,ES,Sweden,1901,1031,227,11,870,320,323,643,216
2022-07-23,ES,Sweden,1561,861,109,7,700,296,295,591,102
2022-07-24,ES,Sweden,1816,1022,165,2,794,314,315,629,163
2022-07-25,ES,Sweden,1843,975,241,13,868,319,308,627,228
2022-07-26,ES,Sweden,1773,943,220,11,830,307,303,610,209
2022-07-27,ES,Sweden,1758,942,235,16,816,289,292,581,219
2022-07-28,ES,Sweden,1831,948,254,16,883,311,318,629,238
2022-07-29,ES,Sweden,1833,955,227,18,878,326,325,651,209
2022-07-30,ES,Sweden,1494,803,98,7,691,292,301,593,91
2022-07-31,ES,Sweden,1847,1018,181,3,829,321,327,648,178
2022-08-01,ES,Sweden,1855,983,242,13,872,325,305,630,229
2022-08-02,ES,Sweden,1752,901,228,14,851,311,312,623,214
2022-08-03,ES,Sweden,1808,943,240,10,865,309,316,625,230
2022-08-04,ES,Sweden,1883,967,261,16,916,328,327,655,245
2022-08-05,ES,Sweden,1864,973,234,14,891,322,335,657,220
2022-08-06,ES,Sweden,1522,845,97,5,677,296,284,580,92
2022-08-07,ES,Sweden,1813,994,186,6,819,316,317,633,180
2022-08-08,ES,Sweden,1897,962,261,19,935,335,339,674,242
2022-08-09,ES,Sweden,1750,873,265,13,877,307,305,612,252
2022-08-10,ES,Sweden,1838,933,277,19,905,318,310,628,258
2022-08-11,ES,Sweden,1844,946,258,14,898,316,324,640,244
2022-08-12,ES,Sweden,1851,921,262,21,930,335,333,668,241
2022-08-13,ES,Sweden,1459,779,95,6,680,294,291,585,89
2022-08-14,ES,Sweden,1717,885,202,4,832,313,317,630,198
2022-08-15,ES,Sweden,1823,863,331,18,960,311,318,629,313
2022-08-16,ES,Sweden,1803,860,331,19,943,309,303,612,312
2022-08-17,ES,Sweden,1812,866,338,21,946,306,302,608,317
2022-08-18,ES,Sweden,1845,877,349,16,968,306,313,619,333
2022-08-19,ES,Sweden,1814,840,317,20,974,325,332,657,297
2022-08-20,ES,Sweden,1322,697,79,2,625,273,273,546,77
2022-08-21,ES,Sweden,1803,967,203,5,836,314,319,633,198
2022-08-22,ES,Sweden,1838,807,356,24,1031,342,333,675,332
2022-08-23,ES,Sweden,1755,789,344,29,966,315,307,622,315
2022-08-24,ES,Sweden,1827,843,346,26,984,313,325,638,320
2022-08-25,ES,Sweden,1835,802,367,20,1033,330,336,666,347
2022-08-26,ES,Sweden,1970,935,353,22,1035,340,342,682,331
2022-08-27,ES,Sweden,1367,709,92,4,658,287,279,566,88
2022-08-28,ES,Sweden,1748,895,223,4,853,314,316,630,219
2022-08-29,ES,Sweden,1805,788,349,14,1017,337,331,668,335
2022-08-30,ES,Sweden,1730,738,370,22,992,311,311,622,348
2022-08-31,ES,Sweden,1809,793,368,25,1016,326,322,648,343
2022-09-01,ES,Sweden,1880,839,359,5,1041,340,342,682,354
2022-09-02,ES,Sweden,1794,793,324,8,1001,338,339,677,316
2022-09-03,ES,Sweden,1326,675,94,2,651,275,282,557,92
2022-09-04,ES,Sweden,1658,806,203,1,852,325,324,649,202
2022-09-05,ES,Sweden,1860,823,351,15,1037,341,345,686,336
2022-09-06,ES,Sweden,1701,732,336,14,969,317,316,633,322
2022-09-07,ES,Sweden,1823,797,361,29,1026,330,335,665,332
2022-09-08,ES,Sweden,1850,811,365,10,1039,341,333,674,355
2022-09-09,ES,Sweden,2003,952,365,13,1051,345,341,686,352
2022-09-10,ES,Sweden,1413,747,105,2,666,282,279,561,103
2022-09-11,ES,Sweden,1722,863,206,9,859,324,329,653,197
2022-09-12,ES,Sweden,1981,945,361,21,1036,335,340,675,340
2022-09-13,ES,Sweden,1844,875,347,12,969,315,307,622,335
2022-09-14,ES,Sweden,1966,944,373,17,1022,322,327,649,356
2022-09-15,ES,Sweden,1986,961,361,18,1025,337,327,664,343
2022-09-16,ES,Sweden,1967,981,361,17,986,306,319,625,344
2022-09-17,ES,Sweden,1411,775,94,4,636,275,267,542,90
2022-09-18,ES,Sweden,1819,936,236,1,883,319,328,647,235
2022-09-19,ES,Sweden,2017,998,354,18,1019,338,327,665,336
2022-09-20,ES,Sweden,1893,910,376,24,983,303,304,607,352
2022-09-21,ES,Sweden,1941,916,378,22,1025,321,326,647,356
2022-09-22,ES,Sweden,2004,953,387,24,1051,336,328,664,363
2022-09-23,ES,Sweden,2020,1015,353,19,1005,322,330,652,334
2022-09-24,ES,Sweden,1365,727,90,5,638,277,271,548,85
2022-09-25,ES,Sweden,1738,846,231,4,892,325,336,661,227
2022-09-26,ES,Sweden,1988,963,351,20,1025,338,336,674,331
2022-09-27,ES,Sweden,1736,734,363,14,1002,327,312,639,349
2022-09-28,ES,Sweden,1976,943,382,19,1033,330,321,651,363
2022-09-29,ES,Sweden,1958,957,366,19,1001,319,316,635,347
2022-09-30,ES,Sweden,2016,994,353,16,1022,329,340,669,337
2022-10-01,ES,Sweden,1469,857,83,3,612,265,264,529,80
2022-10-02,ES,Sweden,1816,989,211,3,827,305,311,616,208
2022-10-03,ES,Sweden,1886,862,362,20,1024,332,330,662,342
2022-10-04,ES,Sweden,1783,816,362,12,967,299,306,605,350
2022-10-05,ES,Sweden,1910,897,358,14,1013,328,327,655,344
2022-10-06,ES,Sweden,1918,919,353,6,999,332,314,646,347
2022-10-07,ES,Sweden,1915,953,323,9,962,316,323,639,314
2022-10-08,ES,Sweden,1365,796,69,2,569,252,248,500,67
2022-10-09,ES,Sweden,1769,933,206,3,836,303,327,630,203
2022-10-10,ES,Sweden,1914,886,369,15,1028,336,323,659,354
2022-10-11,ES,Sweden,1780,802,363,21,978,305,310,615,342
2022-10-12,ES,Sweden,1853,849,358,12,1004,322,324,646,346
2022-10-13,ES,Sweden,1928,932,389,16,996,309,298,607,373
2022-10-14,ES,Sweden,1978,1019,325,11,959,316,318,634,314
2022-10-15,ES,Sweden,1398,861,83,6,537,229,225,454,77
2022-10-16,ES,Sweden,1752,953,219,4,799,287,293,580,215
2022-10-17,ES,Sweden,1862,865,355,16,997,321,321,642,339
2022-10-18,ES,Sweden,1731,801,366,11,930,280,284,564,355
2022-10-19,ES,Sweden,1713,758,355,11,955,301,299,600,344
2022-10-20,ES,Sweden,1738,755,376,24,983,305,302,607,352
2022-10-21,ES,Sweden,1923,963,353,17,960,306,301,607,336
2022-10-22,ES,Sweden,1336,800,75,2,536,231,230,461,73
2022-10-23,ES,Sweden,1744,937,214,7,807,292,301,593,207
2022-10-24,ES,Sweden,1853,905,329,15,948,312,307,619,314
2022-10-25,ES,Sweden,1801,861,354,23,940,288,298,586,331
2022-10-26,ES,Sweden,1897,887,377,24,1010,318,315,633,353
2022-10-27,ES,Sweden,1892,892,362,19,1000,315,323,638,343
2022-10-28,ES,Sweden,1924,928,330,15,996,334,332,666,315
2022-10-29,ES,Sweden,1286,690,79,7,596,259,258,517,72
2022-10-30,ES,Sweden,1583,823,192,5,760,287,281,568,187
2022-10-31,ES,Sweden,1706,830,291,18,876,294,291,585,273
2022-11-01,ES,Sweden,1599,765,314,19,834,259,261,520,295
2022-11-02,ES,Sweden,1652,806,301,15,846,271,274,545,286
2022-11-03,ES,Sweden,1699,817,318,12,882,281,283,564,306
2022-11-04,ES,Sweden,1777,891,294,15,886,299,293,592,279
2022-11-05,ES,Sweden,1182,642,82,1,540,227,231,458,81
2022-11-06,ES,Sweden,1642,819,202,4,823,304,317,621,198
2022-11-07,ES,Sweden,1809,855,357,17,954,301,296,597,340
2022-11-08,ES,Sweden,1610,727,360,21,883,265,258,523,339
2022-11-09,ES,Sweden,1671,793,352,20,878,266,260,526,332
2022-11-10,ES,Sweden,1808,846,383,24,962,284,295,579,359
2022-11-11,ES,Sweden,1792,876,323,7,916,298,295,593,316
2022-11-12,ES,Sweden,1083,620,90,3,463,191,182,373,87
2022-11-13,ES,Sweden,1519,784,209,1,735,261,265,526,208
2022-11-14,ES,Sweden,1667,748,352,20,919,279,288,567,332
2022-11-15,ES,Sweden,1526,666,346,18,860,262,252,514,328
2022-11-16,ES,Sweden,1511,626,347,11,885,270,268,538,336
2022-11-17,ES,Sweden,1639,725,357,9,914,273,284,557,348
2022-11-18,ES,Sweden,1669,752,336,17,917,295,286,581,319
2022-11-19,ES,Sweden,1051,612,77,0,439,180,182,362,77
2022-11-20,ES,Sweden,1488,752,200,2,736,265,271,536,198
2022-11-21,ES,Sweden,1650,833,290,5,817,262,265,527,285
2022-11-22,ES,Sweden,1552,676,360,18,876,260,256,516,342
2022-11-23,ES,Sweden,1651,760,366,18,891,262,263,525,348
2022-11-24,ES,Sweden,1754,819,391,20,935,270,274,544,371
2022-11-25,ES,Sweden,1768,821,369,25,947,290,288,578,344
2022-11-26,ES,Sweden,1050,608,75,3,442,188,179,367,72
2022-11-27,ES,Sweden,1557,842,202,3,715,254,259,513,199
2022-11-28,ES,Sweden,1660,778,333,12,882,274,275,549,321
2022-11-29,ES,Sweden,1470,633,349,14,837,240,248,488,335
2022-11-30,ES,Sweden,1593,706,371,18,887,263,253,516,353
2022-12-01,ES,Sweden,1649,748,342,5,901,273,286,559,337
2022-12-02,ES,Sweden,1660,762,316,7,898,292,290,582,309
2022-12-03,ES,Sweden,1050,614,78,1,436,182,176,358,77
2022-12-04,ES,Sweden,1483,771,198,0,712,256,258,514,198
2022-12-05,ES,Sweden,1676,791,318,14,885,285,282,567,304
2022-12-06,ES,Sweden,1490,664,347,14,826,237,242,479,333
2022-12-07,ES,Sweden,1624,783,332,16,841,258,251,509,316
2022-12-08,ES,Sweden,1695,814,339,5,881,269,273,542,334
2022-12-09,ES,Sweden,1794,886,318,8,908,290,300,590,310
2022-12-10,ES,Sweden,1143,673,82,1,470,199,189,388,81
2022-12-11,ES,Sweden,1546,837,210,3,709,248,251,499,207
2022-12-12,ES,Sweden,1633,765,305,12,868,288,275,563,293
2022-12-13,ES,Sweden,1574,750,323,17,824,252,249,501,306
2022-12-14,ES,Sweden,1677,845,320,7,832,253,259,512,313
2022-12-15,ES,Sweden,1688,822,325,2,866,268,273,541,323
2022-12-16,ES,Sweden,1700,802,330,11,898,287,281,568,319
2022-12-17,ES,Sweden,1235,737,91,1,498,201,206,407,90
2022-12-18,ES,Sweden,1623,906,196,1,717,255,266,521,195
2022-12-19,ES,Sweden,1690,862,295,12,828,271,262,533,283
2022-12-20,ES,Sweden,1602,785,290,7,817,262,265,527,283
2022-12-21,ES,Sweden,1643,787,299,7,856,277,280,557,292
2022-12-22,ES,Sweden,1790,882,320,6,908,293,295,588,314
2022-12-23,ES,Sweden,1679,835,271,5,844,289,284,573,266
2022-12-24,ES,Sweden,887,511,44,0,376,167,165,332,44
2022-12-25,ES,Sweden,843,503,37,1,340,149,154,303,36
2022-12-26,ES,Sweden,1483,806,191,1,677,244,242,486,190
2022-12-27,ES,Sweden,1406,702,214,2,704,244,246,490,212
2022-01-01,LS,Switzerland,1965,1128,22,0,837,410,405,815,22
2022-01-02,LS,Switzerland,2865,1521,44,0,1344,643,657,1300,44
2022-01-03,LS,Switzerland,2522,1404,35,1,1118,547,536,1083,34
2022-01-04,LS,Switzerland,2095,1182,38,1,913,446,429,875,37
2022-01-05,LS,Switzerland,1983,1146,24,1,837,400,413,813,23
2022-01-06,LS,Switzerland,1948,1060,45,0,888,421,422,843,45
2022-01-07,LS,Switzerland,2205,1233,32,2,972,465,475,940,30
2022-01-08,LS,Switzerland,2312,1243,38,3,1069,519,512,1031,35
2022-01-09,LS,Switzerland,2520,1347,20,2,1173,579,574,1153,18
2022-01-10,LS,Switzerland,1857,1015,27,1,842,402,413,815,26
2022-01-11,LS,Switzerland,1482,784,33,1,698,333,332,665,32
2022-01-12,LS,Switzerland,1491,798,45,4,693,323,325,648,41
2022-01-13,LS,Switzerland,1611,832,54,2,779,367,358,725,52
2022-01-14,LS,Switzerland,2001,1107,52,2,894,412,430,842,50
2022-01-15,LS,Switzerland,1750,905,51,3,845,398,396,794,48
2022-01-16,LS,Switzerland,1936,1023,19,1,913,445,449,894,18
2022-01-17,LS,Switzerland,1649,880,49,0,769,361,359,720,49
2022-01-18,LS,Switzerland,1457,784,49,2,673,312,312,624,47
2022-01-19,LS,Switzerland,1458,790,50,4,668,314,304,618,46
2022-01-20,LS,Switzerland,1589,843,39,0,746,351,356,707,39
2022-01-21,LS,Switzerland,1965,1037,52,0,928,439,437,876,52
2022-01-22,LS,Switzerland,1723,887,25,1,836,409,402,811,24
2022-01-23,LS,Switzerland,1953,999,40,0,954,459,455,914,40
2022-01-24,LS,Switzerland,1656,837,76,16,819,372,371,743,60
2022-01-25,LS,Switzerland,1308,678,53,6,630,291,286,577,47
2022-01-26,LS,Switzerland,1468,747,54,3,721,334,333,667,51
2022-01-27,LS,Switzerland,1631,804,54,2,827,370,403,773,52
2022-01-28,LS,Switzerland,1912,977,72,4,935,427,436,863,68
2022-01-29,LS,Switzerland,1854,944,45,4,910,434,431,865,41
2022-01-30,LS,Switzerland,2016,1058,23,0,958,482,453,935,23
2022-01-31,LS,Switzerland,1577,830,26,1,747,363,358,721,25
2022-02-01,LS,Switzerland,1449,837,25,0,612,293,294,587,25
2022-02-02,LS,Switzerland,1555,892,35,1,663,309,319,628,34
2022-02-03,LS,Switzerland,1740,856,46,2,884,406,432,838,44
2022-02-04,LS,Switzerland,2019,1085,48,4,934,455,431,886,44
2022-02-05,LS,Switzerland,1930,976,60,4,954,449,445,894,56
2022-02-06,LS,Switzerland,2111,1095,24,0,1016,502,490,992,24
2022-02-07,LS,Switzerland,1869,1066,36,2,803,395,372,767,34
2022-02-08,LS,Switzerland,1659,925,49,3,734,328,357,685,46
2022-02-09,LS,Switzerland,1782,945,52,5,837,399,386,785,47
2022-02-10,LS,Switzerland,2017,1054,64,4,963,444,455,899,60
2022-02-11,LS,Switzerland,2376,1254,55,1,1122,523,544,1067,54
2022-02-12,LS,Switzerland,2478,1208,51,0,1270,594,625,1219,51
2022-02-13,LS,Switzerland,2327,1214,36,0,1113,555,522,1077,36
2022-02-14,LS,Switzerland,1949,1102,37,1,847,405,405,810,36
2022-02-15,LS,Switzerland,1721,935,33,3,786,382,371,753,30
2022-02-16,LS,Switzerland,1730,980,23,0,750,365,362,727,23
2022-02-17,LS,Switzerland,1984,1102,42,4,882,410,430,840,38
2022-02-18,LS,Switzerland,2259,1228,51,4,1031,494,486,980,47
2022-02-19,LS,Switzerland,2564,1287,37,2,1277,627,613,1240,35
2022-02-20,LS,Switzerland,2646,1326,26,0,1320,647,647,1294,26
2022-02-21,LS,Switzerland,2016,1119,34,0,897,440,423,863,34
2022-02-22,LS,Switzerland,1805,999,34,1,806,390,382,772,33
2022-02-23,LS,Switzerland,1936,1076,39,1,860,411,410,821,38
2022-02-24,LS,Switzerland,2069,1095,38,6,974,469,467,936,32
2022-02-25,LS,Switzerland,2489,1356,41,1,1133,542,550,1092,40
2022-02-26,LS,Switzerland,2647,1419,37,1,1228,608,583,1191,36
2022-02-27,LS,Switzerland,2680,1405,54,0,1275,609,612,1221,54
2022-02-28,LS,Switzerland,2280,1288,36,1,992,479,477,956,35
2022-03-01,LS,Switzerland,1978,1133,35,3,845,401,409,810,32
2022-03-02,LS,Switzerland,2140,1154,50,3,986,467,469,936,47
2022-03-03,LS,Switzerland,2202,1142,61,3,1060,498,501,999,58
2022-03-04,LS,Switzerland,2565,1389,77,0,1176,557,542,1099,77
2022-03-05,LS,Switzerland,2517,1354,50,5,1163,554,559,1113,45
2022-03-06,LS,Switzerland,2625,1425,32,2,1200,597,571,1168,30
2022-03-07,LS,Switzerland,2199,1247,40,1,952,457,455,912,39
2022-03-08,LS,Switzerland,1931,1102,32,2,829,393,404,797,30
2022-03-09,LS,Switzerland,2085,1146,52,1,939,451,436,887,51
2022-03-10,LS,Switzerland,2268,1226,43,2,1042,488,511,999,41
2022-03-11,LS,Switzerland,2548,1397,66,3,1151,536,549,1085,63
2022-03-12,LS,Switzerland,2366,1287,33,0,1079,523,523,1046,33
2022-03-13,LS,Switzerland,2532,1372,29,0,1160,578,553,1131,29
2022-03-14,LS,Switzerland,2308,1318,56,3,990,467,467,934,53
2022-03-15,LS,Switzerland,2025,1148,51,5,877,404,422,826,46
2022-03-16,LS,Switzerland,2166,1233,55,3,933,436,442,878,52
2022-03-17,LS,Switzerland,2308,1257,61,5,1051,491,499,990,56
2022-03-18,LS,Switzerland,2527,1418,50,0,1109,528,531,1059,50
2022-03-19,LS,Switzerland,2433,1378,24,0,1055,530,501,1031,24
2022-03-20,LS,Switzerland,2626,1433,28,0,1193,587,578,1165,28
2022-03-21,LS,Switzerland,2188,1258,40,4,930,448,442,890,36
2022-03-22,LS,Switzerland,1947,1111,38,0,836,395,403,798,38
2022-03-23,LS,Switzerland,2099,1173,48,0,926,448,430,878,48
2022-03-24,LS,Switzerland,2279,1226,50,4,1053,497,506,1003,46
2022-03-25,LS,Switzerland,2483,1375,43,2,1108,536,529,1065,41
2022-03-26,LS,Switzerland,2349,1324,34,2,1025,505,486,991,32
2022-03-27,LS,Switzerland,2741,1563,33,1,1178,561,584,1145,32
2022-03-28,LS,Switzerland,2579,1446,58,6,1133,542,533,1075,52
2022-03-29,LS,Switzerland,2397,1427,63,1,970,451,456,907,62
2022-03-30,LS,Switzerland,2378,1385,39,4,993,482,472,954,35
2022-03-31,LS,Switzerland,2581,1497,29,1,1084,526,529,1055,28
2022-04-01,LS,Switzerland,2806,1614,38,0,1192,579,575,1154,38
2022-04-02,LS,Switzerland,2637,1635,26,0,1002,489,487,976,26
2022-04-03,LS,Switzerland,2859,1663,32,0,1196,579,585,1164,32
2022-04-04,LS,Switzerland,2700,1550,57,3,1150,552,541,1093,54
2022-04-05,LS,Switzerland,2390,1442,49,4,948,446,453,899,45
2022-04-06,LS,Switzerland,2597,1512,52,1,1085,517,516,1033,51
2022-04-07,LS,Switzerland,2706,1617,41,1,1089,529,519,1048,40
2022-04-08,LS,Switzerland,2873,1721,36,1,1152,561,555,1116,35
2022-04-09,LS,Switzerland,2936,1821,24,0,1115,546,545,1091,24
2022-04-10,LS,Switzerland,2973,1748,35,0,1225,590,600,1190,35
2022-04-11,LS,Switzerland,2753,1642,47,2,1111,529,535,1064,45
2022-04-12,LS,Switzerland,2624,1568,46,1,1056,502,508,1010,45
2022-04-13,LS,Switzerland,2858,1697,60,2,1161,554,547,1101,58
2022-04-14,LS,Switzerland,3115,1834,46,1,1281,629,606,1235,45
2022-04-15,LS,Switzerland,3015,1819,29,1,1196,596,571,1167,28
2022-04-16,LS,Switzerland,2875,1838,29,0,1037,504,504,1008,29
2022-04-17,LS,Switzerland,2694,1665,21,0,1029,500,508,1008,21
2022-04-18,LS,Switzerland,2929,1745,30,0,1184,574,580,1154,30
2022-04-19,LS,Switzerland,2730,1679,47,2,1051,501,503,1004,45
2022-04-20,LS,Switzerland,2726,1652,38,1,1074,519,517,1036,37
2022-04-21,LS,Switzerland,2830,1738,30,4,1092,530,532,1062,26
2022-04-22,LS,Switzerland,3086,1842,59,2,1244,596,589,1185,57
2022-04-23,LS,Switzerland,2875,1833,31,1,1042,502,509,1011,30
2022-04-24,LS,Switzerland,3067,1906,32,1,1161,552,577,1129,31
2022-04-25,LS,Switzerland,2861,1727,34,1,1134,550,550,1100,33
2022-04-26,LS,Switzerland,2688,1655,46,4,1033,496,491,987,42
2022-04-27,LS,Switzerland,2778,1672,60,2,1106,531,515,1046,58
2022-04-28,LS,Switzerland,2964,1801,57,2,1163,548,558,1106,55
2022-04-29,LS,Switzerland,3201,1940,41,1,1261,616,604,1220,40
2022-04-30,LS,Switzerland,2886,1867,16,1,1019,499,504,1003,15
2022-05-01,LS,Switzerland,3086,1918,33,2,1168,550,585,1135,31
2022-05-02,LS,Switzerland,2988,1810,78,2,1178,561,539,1100,76
2022-05-03,LS,Switzerland,2667,1628,59,0,1039,490,490,980,59
2022-05-04,LS,Switzerland,2864,1760,54,0,1104,527,523,1050,54
2022-05-05,LS,Switzerland,3012,1893,44,4,1119,538,537,1075,40
2022-05-06,LS,Switzerland,3348,2042,59,0,1306,632,615,1247,59
2022-05-07,LS,Switzerland,3051,2028,33,3,1023,500,490,990,30
2022-05-08,LS,Switzerland,3220,2050,36,1,1170,557,577,1134,35
2022-05-09,LS,Switzerland,3009,1866,44,4,1143,556,543,1099,40
2022-05-10,LS,Switzerland,2903,1844,48,0,1059,504,507,1011,48
2022-05-11,LS,Switzerland,3072,1906,49,0,1166,571,546,1117,49
2022-05-12,LS,Switzerland,3163,1994,44,0,1169,565,560,1125,44
2022-05-13,LS,Switzerland,3296,2036,47,2,1260,604,609,1213,45
2022-05-14,LS,Switzerland,3170,2126,33,1,1044,502,509,1011,32
2022-05-15,LS,Switzerland,3186,2023,27,0,1163,558,578,1136,27
2022-05-16,LS,Switzerland,3203,2042,46,1,1161,563,552,1115,45
2022-05-17,LS,Switzerland,2886,1866,35,1,1020,490,495,985,34
2022-05-18,LS,Switzerland,3163,2044,44,0,1119,546,529,1075,44
2022-05-19,LS,Switzerland,3201,2038,40,1,1163,561,562,1123,39
2022-05-20,LS,Switzerland,3314,2102,43,3,1212,591,578,1169,40
2022-05-21,LS,Switzerland,3308,2171,28,1,1137,535,574,1109,27
2022-05-22,LS,Switzerland,3362,1999,27,1,1363,625,711,1336,26
2022-05-23,LS,Switzerland,3101,1767,44,4,1334,625,665,1290,40
2022-05-24,LS,Switzerland,3017,1750,58,3,1267,603,606,1209,55
2022-05-25,LS,Switzerland,3497,1961,59,1,1536,789,688,1477,58
2022-05-26,LS,Switzerland,3362,1988,29,1,1374,720,625,1345,28
2022-05-27,LS,Switzerland,3323,2150,31,2,1173,570,572,1142,29
2022-05-28,LS,Switzerland,3304,2247,41,0,1057,506,510,1016,41
2022-05-29,LS,Switzerland,3759,2372,36,2,1387,634,717,1351,34
2022-05-30,LS,Switzerland,3439,2132,49,1,1307,644,614,1258,48
2022-05-31,LS,Switzerland,3141,2008,61,3,1133,542,530,1072,58
2022-06-01,LS,Switzerland,3286,2083,46,2,1203,580,577,1157,44
2022-06-02,LS,Switzerland,3337,2114,42,0,1223,589,592,1181,42
2022-06-03,LS,Switzerland,3620,2248,51,2,1372,681,640,1321,49
2022-06-04,LS,Switzerland,3403,2294,37,1,1109,538,534,1072,36
2022-06-05,LS,Switzerland,3225,2146,17,2,1079,536,526,1062,15
2022-06-06,LS,Switzerland,3507,2205,33,0,1302,600,669,1269,33
2022-06-07,LS,Switzerland,3279,2136,47,1,1143,555,541,1096,46
2022-06-08,LS,Switzerland,3180,1966,47,1,1214,584,583,1167,46
2022-06-09,LS,Switzerland,3345,2158,33,1,1187,586,568,1154,32
2022-06-10,LS,Switzerland,3574,2233,43,3,1341,658,640,1298,40
2022-06-11,LS,Switzerland,3410,2302,30,3,1108,537,541,1078,27
2022-06-12,LS,Switzerland,3547,2282,30,1,1265,604,631,1235,29
2022-06-13,LS,Switzerland,3481,2217,41,1,1264,615,608,1223,40
2022-06-14,LS,Switzerland,3334,2172,38,2,1162,565,559,1124,36
2022-06-15,LS,Switzerland,2927,1861,31,3,1066,529,506,1035,28
2022-06-16,LS,Switzerland,3618,2342,38,3,1276,621,617,1238,35
2022-06-17,LS,Switzerland,3567,2287,45,3,1280,626,609,1235,42
2022-06-18,LS,Switzerland,3465,2342,30,1,1123,546,547,1093,29
2022-06-19,LS,Switzerland,3633,2306,23,2,1327,646,658,1304,21
2022-06-20,LS,Switzerland,3660,2354,54,0,1306,629,623,1252,54
2022-06-21,LS,Switzerland,3332,2132,40,3,1200,579,581,1160,37
2022-06-22,LS,Switzerland,3364,2122,56,1,1242,590,596,1186,55
2022-06-23,LS,Switzerland,3479,2183,48,5,1296,632,616,1248,43
2022-06-24,LS,Switzerland,3540,2219,42,2,1321,638,641,1279,40
2022-06-25,LS,Switzerland,3388,2187,42,2,1201,593,566,1159,40
2022-06-26,LS,Switzerland,3494,2226,30,4,1268,612,626,1238,26
2022-06-27,LS,Switzerland,3632,2319,39,1,1313,633,641,1274,38
2022-06-28,LS,Switzerland,3329,2169,33,2,1160,567,560,1127,31
2022-06-29,LS,Switzerland,3524,2273,53,2,1251,593,605,1198,51
2022-06-30,LS,Switzerland,3400,2154,31,3,1246,616,599,1215,28
2022-07-01,LS,Switzerland,3731,2415,42,3,1316,649,625,1274,39
2022-07-02,LS,Switzerland,3674,2395,38,0,1279,619,622,1241,38
2022-07-03,LS,Switzerland,3615,2313,37,1,1302,628,637,1265,36
2022-07-04,LS,Switzerland,3593,2317,37,0,1276,615,624,1239,37
2022-07-05,LS,Switzerland,3405,2225,39,0,1180,563,578,1141,39
2022-07-06,LS,Switzerland,3557,2267,45,3,1290,624,621,1245,42
2022-07-07,LS,Switzerland,3584,2299,43,3,1285,613,629,1242,40
2022-07-08,LS,Switzerland,3764,2402,35,3,1362,674,653,1327,32
2022-07-09,LS,Switzerland,3814,2520,43,2,1294,640,611,1251,41
2022-07-10,LS,Switzerland,3661,2345,30,0,1316,635,651,1286,30
2022-07-11,LS,Switzerland,3673,2338,37,4,1335,641,657,1298,33
2022-07-12,LS,Switzerland,3460,2219,39,1,1241,604,598,1202,38
2022-07-13,LS,Switzerland,3562,2301,47,1,1261,613,601,1214,46
2022-07-14,LS,Switzerland,3622,2370,38,3,1252,608,606,1214,35
2022-07-15,LS,Switzerland,3808,2402,46,2,1406,696,664,1360,44
2022-07-16,LS,Switzerland,3765,2450,37,0,1315,640,638,1278,37
2022-07-17,LS,Switzerland,3574,2238,26,0,1336,646,664,1310,26
2022-07-18,LS,Switzerland,3673,2348,39,3,1325,641,645,1286,36
2022-07-19,LS,Switzerland,3423,2215,46,5,1208,574,588,1162,41
2022-07-20,LS,Switzerland,3414,2189,38,3,1225,599,588,1187,35
2022-07-21,LS,Switzerland,3622,2363,37,1,1259,611,611,1222,36
2022-07-22,LS,Switzerland,3745,2424,37,4,1321,645,639,1284,33
2022-07-23,LS,Switzerland,3804,2548,27,3,1256,618,611,1229,24
2022-07-24,LS,Switzerland,3674,2411,20,0,1263,627,616,1243,20
2022-07-25,LS,Switzerland,3650,2386,46,3,1264,603,615,1218,43
2022-07-26,LS,Switzerland,3508,2352,45,1,1156,553,558,1111,44
2022-07-27,LS,Switzerland,3414,2237,45,2,1177,573,559,1132,43
2022-07-28,LS,Switzerland,3620,2375,45,0,1245,605,595,1200,45
2022-07-29,LS,Switzerland,3713,2425,31,0,1288,634,623,1257,31
2022-07-30,LS,Switzerland,3929,2596,31,1,1333,654,648,1302,30
2022-07-31,LS,Switzerland,3777,2464,24,0,1313,644,645,1289,24
2022-08-01,LS,Switzerland,3654,2396,35,0,1258,604,619,1223,35
2022-08-02,LS,Switzerland,3506,2322,38,2,1184,571,575,1146,36
2022-08-03,LS,Switzerland,3589,2352,53,1,1237,592,592,1184,52
2022-08-04,LS,Switzerland,3548,2310,37,0,1238,598,603,1201,37
2022-08-05,LS,Switzerland,3677,2391,41,3,1286,632,613,1245,38
2022-08-06,LS,Switzerland,3803,2564,26,1,1239,593,620,1213,25
2022-08-07,LS,Switzerland,3580,2279,33,0,1301,638,630,1268,33
2022-08-08,LS,Switzerland,3515,2259,35,1,1256,609,612,1221,34
2022-08-09,LS,Switzerland,3443,2278,35,0,1165,568,562,1130,35
2022-08-10,LS,Switzerland,3455,2221,42,0,1234,584,608,1192,42
2022-08-11,LS,Switzerland,3409,2181,42,1,1228,602,584,1186,41
2022-08-12,LS,Switzerland,3579,2251,39,0,1328,651,638,1289,39
2022-08-13,LS,Switzerland,3713,2455,25,1,1258,619,614,1233,24
2022-08-14,LS,Switzerland,3567,2276,26,1,1291,623,642,1265,25
2022-08-15,LS,Switzerland,3385,2145,34,2,1240,600,606,1206,32
2022-08-16,LS,Switzerland,3364,2190,52,4,1174,566,556,1122,48
2022-08-17,LS,Switzerland,3315,2116,45,3,1199,587,567,1154,42
2022-08-18,LS,Switzerland,3401,2194,38,0,1207,582,587,1169,38
2022-08-19,LS,Switzerland,3535,2257,25,1,1278,630,623,1253,24
2022-08-20,LS,Switzerland,3728,2484,30,1,1244,609,605,1214,29
2022-08-21,LS,Switzerland,3610,2311,21,2,1299,641,637,1278,19
2022-08-22,LS,Switzerland,3474,2184,52,2,1290,620,618,1238,50
2022-08-23,LS,Switzerland,3340,2134,43,2,1206,580,583,1163,41
2022-08-24,LS,Switzerland,3475,2237,49,4,1238,593,596,1189,45
2022-08-25,LS,Switzerland,3512,2226,40,0,1286,618,628,1246,40
2022-08-26,LS,Switzerland,3623,2260,42,3,1363,660,661,1321,39
2022-08-27,LS,Switzerland,3533,2341,34,3,1192,576,582,1158,31
2022-08-28,LS,Switzerland,3635,2322,28,1,1313,639,646,1285,27
2022-08-29,LS,Switzerland,3534,2184,41,2,1350,658,651,1309,39
2022-08-30,LS,Switzerland,3307,2093,28,1,1214,594,592,1186,27
2022-08-31,LS,Switzerland,3473,2210,54,2,1263,605,604,1209,52
2022-09-01,LS,Switzerland,3463,2176,51,2,1287,623,613,1236,49
2022-09-02,LS,Switzerland,3426,2057,42,3,1369,671,656,1327,39
2022-09-03,LS,Switzerland,3471,2305,29,0,1166,583,554,1137,29
2022-09-04,LS,Switzerland,3618,2336,31,0,1282,602,649,1251,31
2022-09-05,LS,Switzerland,3574,2250,45,3,1324,634,645,1279,42
2022-09-06,LS,Switzerland,3350,2139,33,2,1211,605,573,1178,31
2022-09-07,LS,Switzerland,3454,2154,36,1,1300,632,632,1264,35
2022-09-08,LS,Switzerland,3487,2210,50,1,1277,623,604,1227,49
2022-09-09,LS,Switzerland,3635,2311,63,5,1324,637,624,1261,58
2022-09-10,LS,Switzerland,3465,2327,32,1,1138,553,553,1106,31
2022-09-11,LS,Switzerland,3701,2358,25,1,1343,644,674,1318,24
2022-09-12,LS,Switzerland,3521,2211,47,6,1310,638,625,1263,41
2022-09-13,LS,Switzerland,3459,2232,63,4,1227,588,576,1164,59
2022-09-14,LS,Switzerland,3395,2162,70,5,1233,577,586,1163,65
2022-09-15,LS,Switzerland,3582,2299,49,2,1283,628,606,1234,47
2022-09-16,LS,Switzerland,2950,1681,42,1,1269,614,613,1227,41
2022-09-17,LS,Switzerland,3475,2325,24,0,1150,561,565,1126,24
2022-09-18,LS,Switzerland,3621,2333,20,0,1288,625,643,1268,20
2022-09-19,LS,Switzerland,3495,2201,44,2,1294,619,631,1250,42
2022-09-20,LS,Switzerland,3371,2172,59,2,1199,570,570,1140,57
2022-09-21,LS,Switzerland,3433,2198,47,4,1235,595,593,1188,43
2022-09-22,LS,Switzerland,3469,2162,47,2,1307,643,617,1260,45
2022-09-23,LS,Switzerland,3534,2188,38,0,1346,658,650,1308,38
2022-09-24,LS,Switzerland,3294,2204,28,1,1090,536,526,1062,27
2022-09-25,LS,Switzerland,3566,2289,26,1,1277,608,643,1251,25
2022-09-26,LS,Switzerland,3389,2133,40,0,1256,610,606,1216,40
2022-09-27,LS,Switzerland,3189,2064,32,3,1125,550,543,1093,29
2022-09-28,LS,Switzerland,3291,2101,42,5,1190,576,572,1148,37
2022-09-29,LS,Switzerland,3070,1931,22,4,1139,563,554,1117,18
2022-09-30,LS,Switzerland,3629,2264,45,3,1365,659,661,1320,42
2022-10-01,LS,Switzerland,3386,2258,24,2,1128,560,544,1104,22
2022-10-02,LS,Switzerland,3440,2184,19,1,1256,603,634,1237,18
2022-10-03,LS,Switzerland,3310,2057,43,1,1253,606,604,1210,42
2022-10-04,LS,Switzerland,3149,2005,48,6,1144,560,536,1096,42
2022-10-05,LS,Switzerland,3160,1985,51,5,1175,550,574,1124,46
2022-10-06,LS,Switzerland,3278,2015,46,4,1263,610,607,1217,42
2022-10-07,LS,Switzerland,3483,2191,42,1,1292,642,608,1250,41
2022-10-08,LS,Switzerland,3291,2142,29,2,1149,556,564,1120,27
2022-10-09,LS,Switzerland,3395,2124,32,2,1271,611,628,1239,30
2022-10-10,LS,Switzerland,3228,1963,43,3,1265,601,621,1222,40
2022-10-11,LS,Switzerland,3120,1996,36,1,1124,557,531,1088,35
2022-10-12,LS,Switzerland,3208,2006,61,4,1202,568,573,1141,57
2022-10-13,LS,Switzerland,3327,2082,49,3,1245,595,601,1196,46
2022-10-14,LS,Switzerland,3472,2142,34,0,1330,656,640,1296,34
2022-10-15,LS,Switzerland,3305,2141,38,1,1164,567,559,1126,37
2022-10-16,LS,Switzerland,3444,2211,33,3,1233,584,616,1200,30
2022-10-17,LS,Switzerland,3153,1961,43,0,1192,583,566,1149,43
2022-10-18,LS,Switzerland,2996,1902,52,3,1094,524,518,1042,49
2022-10-19,LS,Switzerland,3108,1942,63,2,1166,557,546,1103,61
2022-10-20,LS,Switzerland,3260,2044,58,1,1216,579,579,1158,57
2022-10-21,LS,Switzerland,2867,1568,46,2,1299,631,622,1253,44
2022-10-22,LS,Switzerland,3305,2155,26,1,1150,561,563,1124,25
2022-10-23,LS,Switzerland,3308,2086,30,0,1222,591,601,1192,30
2022-10-24,LS,Switzerland,3066,1945,28,1,1121,542,551,1093,27
2022-10-25,LS,Switzerland,3006,1918,46,2,1088,526,516,1042,44
2022-10-26,LS,Switzerland,3200,2023,49,4,1177,566,562,1128,45
2022-10-27,LS,Switzerland,3235,2075,42,4,1160,562,556,1118,38
2022-10-28,LS,Switzerland,3342,2088,51,5,1254,611,592,1203,46
2022-10-29,LS,Switzerland,3216,2153,26,2,1063,517,520,1037,24
2022-10-30,LS,Switzerland,3025,1804,35,0,1221,582,604,1186,35
2022-10-31,LS,Switzerland,2678,1625,34,2,1053,513,506,1019,32
2022-11-01,LS,Switzerland,2392,1394,39,1,998,481,478,959,38
2022-11-02,LS,Switzerland,2471,1426,50,2,1045,499,496,995,48
2022-11-03,LS,Switzerland,2555,1480,36,1,1075,525,514,1039,35
2022-11-04,LS,Switzerland,2730,1612,33,1,1118,546,539,1085,32
2022-11-05,LS,Switzerland,2410,1483,22,2,927,453,452,905,20
2022-11-06,LS,Switzerland,2719,1600,29,0,1119,534,556,1090,29
2022-11-07,LS,Switzerland,2583,1469,55,5,1114,529,530,1059,50
2022-11-08,LS,Switzerland,2263,1285,45,2,978,466,467,933,43
2022-11-09,LS,Switzerland,2208,1230,34,1,978,474,470,944,33
2022-11-10,LS,Switzerland,2424,1371,46,2,1053,511,496,1007,44
2022-11-11,LS,Switzerland,2691,1529,58,2,1162,562,542,1104,56
2022-11-12,LS,Switzerland,2191,1303,32,0,888,422,434,856,32
2022-11-13,LS,Switzerland,2563,1446,39,2,1117,535,543,1078,37
2022-11-14,LS,Switzerland,2413,1381,47,3,1032,490,495,985,44
2022-11-15,LS,Switzerland,2181,1265,49,5,916,439,428,867,44
2022-11-16,LS,Switzerland,2213,1228,37,3,985,471,477,948,34
2022-11-17,LS,Switzerland,2348,1343,31,2,1005,492,482,974,29
2022-11-18,LS,Switzerland,2591,1495,32,1,1096,541,523,1064,31
2022-11-19,LS,Switzerland,2103,1273,18,0,830,406,406,812,18
2022-11-20,LS,Switzerland,2416,1369,30,1,1047,495,522,1017,29
2022-11-21,LS,Switzerland,2355,1362,35,1,993,483,475,958,34
2022-11-22,LS,Switzerland,2029,1167,30,4,862,415,417,832,26
2022-11-23,LS,Switzerland,2062,1175,33,1,887,428,426,854,32
2022-11-24,LS,Switzerland,2319,1285,46,2,1034,495,493,988,44
2022-11-25,LS,Switzerland,2542,1439,32,3,1103,549,522,1071,29
2022-11-26,LS,Switzerland,2041,1178,42,2,863,405,416,821,40
2022-11-27,LS,Switzerland,2457,1398,32,4,1059,504,523,1027,28
2022-11-28,LS,Switzerland,2394,1388,45,1,1006,481,480,961,44
2022-11-29,LS,Switzerland,2006,1103,35,4,903,426,442,868,31
2022-11-30,LS,Switzerland,2127,1178,38,3,949,465,446,911,35
2022-12-01,LS,Switzerland,2085,1041,50,2,1044,503,491,994,48
2022-12-02,LS,Switzerland,2195,1094,41,2,1101,525,535,1060,39
2022-12-03,LS,Switzerland,1878,1028,24,2,850,415,411,826,22
2022-12-04,LS,Switzerland,2242,1188,23,2,1054,508,523,1031,21
2022-12-05,LS,Switzerland,2241,1171,38,1,1070,522,510,1032,37
2022-12-06,LS,Switzerland,2056,1120,31,1,936,453,452,905,30
2022-12-07,LS,Switzerland,2153,1134,40,3,1019,480,499,979,37
2022-12-08,LS,Switzerland,2314,1205,48,1,1109,532,529,1061,47
2022-12-09,LS,Switzerland,2338,1259,30,2,1079,530,519,1049,28
2022-12-10,LS,Switzerland,2115,1135,23,1,980,466,491,957,22
2022-12-11,LS,Switzerland,2401,1226,36,3,1175,575,564,1139,33
2022-12-12,LS,Switzerland,2316,1202,43,7,1114,558,513,1071,36
2022-12-13,LS,Switzerland,2108,1098,49,6,1010,477,484,961,43
2022-12-14,LS,Switzerland,2073,1068,27,3,1005,491,487,978,24
2022-12-15,LS,Switzerland,2310,1214,34,0,1096,529,533,1062,34
2022-12-16,LS,Switzerland,2531,1304,33,1,1227,599,595,1194,32
2022-12-17,LS,Switzerland,2421,1206,46,2,1215,587,582,1169,44
2022-12-18,LS,Switzerland,2507,1305,26,1,1202,587,589,1176,25
2022-12-19,LS,Switzerland,2633,1433,59,9,1200,560,581,1141,50
2022-12-20,LS,Switzerland,2459,1315,70,7,1144,536,538,1074,63
2022-12-21,LS,Switzerland,2355,1185,53,3,1170,561,556,1117,50
2022-12-22,LS,Switzerland,2675,1378,42,3,1297,635,620,1255,39
2022-12-23,LS,Switzerland,2673,1365,26,0,1308,647,635,1282,26
2022-12-24,LS,Switzerland,2074,1054,22,0,1020,498,500,998,22
2022-12-25,LS,Switzerland,1726,823,16,0,903,440,447,887,16
2022-12-26,LS,Switzerland,2487,1265,36,2,1222,586,600,1186,34
2022-12-27,LS,Switzerland,2399,1214,44,0,1185,566,575,1141,44
2022-01-01,LT,Türkiye,2659,965,534,5,1694,588,572,1160,529
2022-01-02,LT,Türkiye,3343,1208,697,6,2135,735,703,1438,691
2022-01-03,LT,Türkiye,2913,992,679,10,1921,606,636,1242,669
2022-01-04,LT,Türkiye,2690,946,582,10,1744,577,585,1162,572
2022-01-05,LT,Türkiye,2731,953,594,8,1778,592,592,1184,586
2022-01-06,LT,Türkiye,2938,1097,622,6,1841,612,607,1219,616
2022-01-07,LT,Türkiye,2994,996,687,12,1998,662,649,1311,675
2022-01-08,LT,Türkiye,3075,1158,609,7,1917,650,658,1308,602
2022-01-09,LT,Türkiye,3152,1166,651,4,1986,675,660,1335,647
2022-01-10,LT,Türkiye,2667,891,630,11,1776,563,583,1146,619
2022-01-11,LT,Türkiye,2417,836,525,6,1581,530,526,1056,519
2022-01-12,LT,Türkiye,2480,887,513,4,1593,537,543,1080,509
2022-01-13,LT,Türkiye,2572,924,566,14,1648,543,539,1082,552
2022-01-14,LT,Türkiye,2809,892,706,12,1917,618,593,1211,694
2022-01-15,LT,Türkiye,2736,979,609,10,1757,567,581,1148,599
2022-01-16,LT,Türkiye,2933,1027,678,7,1906,620,608,1228,671
2022-01-17,LT,Türkiye,2508,793,654,9,1715,509,552,1061,645
2022-01-18,LT,Türkiye,2240,763,519,6,1477,479,479,958,513
2022-01-19,LT,Türkiye,2406,862,533,12,1544,512,499,1011,521
2022-01-20,LT,Türkiye,2627,834,702,13,1793,543,548,1091,689
2022-01-21,LT,Türkiye,2768,806,803,9,1962,586,573,1159,794
2022-01-22,LT,Türkiye,2698,968,625,5,1730,545,560,1105,620
2022-01-23,LT,Türkiye,2688,980,559,6,1708,563,586,1149,553
2022-01-24,LT,Türkiye,1881,765,474,16,1116,296,346,642,458
2022-01-25,LT,Türkiye,1479,758,305,6,721,213,203,416,299
2022-01-26,LT,Türkiye,2096,772,562,6,1324,386,376,762,556
2022-01-27,LT,Türkiye,2561,888,640,10,1673,539,494,1033,630
2022-01-28,LT,Türkiye,2707,807,733,14,1900,599,568,1167,719
2022-01-29,LT,Türkiye,2744,942,683,8,1802,551,568,1119,675
2022-01-30,LT,Türkiye,2930,970,759,7,1960,608,593,1201,752
2022-01-31,LT,Türkiye,2481,766,680,7,1715,505,530,1035,673
2022-02-01,LT,Türkiye,2348,767,614,9,1581,492,475,967,605
2022-02-02,LT,Türkiye,2426,768,667,12,1658,499,492,991,655
2022-02-03,LT,Türkiye,2618,860,693,12,1758,529,536,1065,681
2022-02-04,LT,Türkiye,2722,807,770,9,1915,574,571,1145,761
2022-02-05,LT,Türkiye,2846,963,732,7,1883,569,582,1151,725
2022-02-06,LT,Türkiye,3001,981,809,10,2020,616,595,1211,799
2022-02-07,LT,Türkiye,2449,743,693,10,1706,490,523,1013,683
2022-02-08,LT,Türkiye,2266,756,577,13,1510,475,458,933,564
2022-02-09,LT,Türkiye,2367,786,583,4,1581,502,496,998,579
2022-02-10,LT,Türkiye,2631,885,645,9,1746,555,546,1101,636
2022-02-11,LT,Türkiye,2768,870,734,19,1898,586,578,1164,715
2022-02-12,LT,Türkiye,2806,1008,621,10,1798,583,594,1177,611
2022-02-13,LT,Türkiye,2952,1047,693,3,1905,615,597,1212,690
2022-02-14,LT,Türkiye,2564,795,685,9,1769,528,556,1084,676
2022-02-15,LT,Türkiye,2383,812,564,8,1571,509,498,1007,556
2022-02-16,LT,Türkiye,2455,834,605,11,1621,511,505,1016,594
2022-02-17,LT,Türkiye,2681,923,667,10,1758,542,549,1091,657
2022-02-18,LT,Türkiye,2802,901,702,12,1901,621,578,1199,690
2022-02-19,LT,Türkiye,2917,1050,619,8,1867,603,645,1248,611
2022-02-20,LT,Türkiye,3080,1098,713,7,1982,649,620,1269,706
2022-02-21,LT,Türkiye,2575,831,669,8,1744,530,545,1075,661
2022-02-22,LT,Türkiye,2415,846,560,8,1569,502,507,1009,552
2022-02-23,LT,Türkiye,2515,862,597,7,1653,527,529,1056,590
2022-02-24,LT,Türkiye,2670,899,632,5,1771,577,562,1139,627
2022-02-25,LT,Türkiye,2759,869,705,10,1890,592,593,1185,695
2022-02-26,LT,Türkiye,2872,1016,626,9,1856,605,625,1230,617
2022-02-27,LT,Türkiye,2948,994,715,6,1954,624,615,1239,709
2022-02-28,LT,Türkiye,2715,912,682,8,1803,552,569,1121,674
2022-03-01,LT,Türkiye,2514,894,565,9,1620,527,528,1055,556
2022-03-02,LT,Türkiye,2685,987,604,9,1698,548,546,1094,595
2022-03-03,LT,Türkiye,2856,1025,638,10,1831,593,600,1193,628
2022-03-04,LT,Türkiye,3056,1024,731,6,2032,658,643,1301,725
2022-03-05,LT,Türkiye,3052,1108,637,6,1944,643,664,1307,631
2022-03-06,LT,Türkiye,3157,1133,718,9,2024,655,651,1306,709
2022-03-07,LT,Türkiye,2807,997,687,7,1810,550,573,1123,680
2022-03-08,LT,Türkiye,2483,901,586,5,1582,495,501,996,581
2022-03-09,LT,Türkiye,2635,998,599,10,1637,527,511,1038,589
2022-03-10,LT,Türkiye,2481,1003,464,6,1478,494,520,1014,458
2022-03-11,LT,Türkiye,2440,930,427,4,1510,544,539,1083,423
2022-03-12,LT,Türkiye,2219,1044,326,8,1175,439,410,849,318
2022-03-13,LT,Türkiye,2743,1010,574,5,1733,573,586,1159,569
2022-03-14,LT,Türkiye,2656,901,683,7,1755,543,529,1072,676
2022-03-15,LT,Türkiye,2557,958,595,8,1599,502,502,1004,587
2022-03-16,LT,Türkiye,2655,1005,627,13,1650,506,517,1023,614
2022-03-17,LT,Türkiye,2844,1044,671,9,1800,567,562,1129,662
2022-03-18,LT,Türkiye,2840,1035,636,7,1805,583,586,1169,629
2022-03-19,LT,Türkiye,2751,1099,469,7,1652,586,597,1183,462
2022-03-20,LT,Türkiye,3103,1066,731,5,2037,669,637,1306,726
2022-03-21,LT,Türkiye,2787,932,716,5,1855,561,578,1139,711
2022-03-22,LT,Türkiye,2480,890,601,6,1590,502,487,989,595
2022-03-23,LT,Türkiye,2719,1018,625,9,1701,534,542,1076,616
2022-03-24,LT,Türkiye,2953,1078,719,6,1875,583,573,1156,713
2022-03-25,LT,Türkiye,3105,1054,774,3,2051,646,631,1277,771
2022-03-26,LT,Türkiye,3095,1113,694,5,1982,636,652,1288,689
2022-03-27,LT,Türkiye,3361,1134,808,5,2227,711,708,1419,803
2022-03-28,LT,Türkiye,3010,1063,699,8,1947,615,633,1248,691
2022-03-29,LT,Türkiye,2898,1038,631,8,1860,622,607,1229,623
2022-03-30,LT,Türkiye,2973,1097,667,12,1876,599,610,1209,655
2022-03-31,LT,Türkiye,3125,1127,669,11,1998,670,659,1329,658
2022-04-01,LT,Türkiye,3357,1087,763,6,2270,761,746,1507,757
2022-04-02,LT,Türkiye,3344,1181,642,7,2163,751,770,1521,635
2022-04-03,LT,Türkiye,3402,1199,689,6,2203,770,744,1514,683
2022-04-04,LT,Türkiye,2963,1050,631,6,1913,626,656,1282,625
2022-04-05,LT,Türkiye,2835,1014,579,7,1821,623,619,1242,572
2022-04-06,LT,Türkiye,2950,1116,588,6,1834,611,635,1246,582
2022-04-07,LT,Türkiye,3049,1147,561,9,1902,683,658,1341,552
2022-04-08,LT,Türkiye,3482,1123,728,4,2359,835,796,1631,724
2022-04-09,LT,Türkiye,3479,1195,638,7,2284,811,835,1646,631
2022-04-10,LT,Türkiye,3484,1212,662,6,2272,816,794,1610,656
2022-04-11,LT,Türkiye,3143,1123,625,6,2020,690,705,1395,619
2022-04-12,LT,Türkiye,2960,1079,559,7,1881,657,665,1322,552
2022-04-13,LT,Türkiye,3147,1153,618,10,1994,689,687,1376,608
2022-04-14,LT,Türkiye,3332,1211,629,9,2121,750,742,1492,620
2022-04-15,LT,Türkiye,3572,1177,744,8,2395,828,823,1651,736
2022-04-16,LT,Türkiye,3481,1240,629,9,2241,795,817,1612,620
2022-04-17,LT,Türkiye,3590,1242,706,10,2348,832,810,1642,696
2022-04-18,LT,Türkiye,3271,1131,623,4,2140,756,761,1517,619
2022-04-19,LT,Türkiye,3076,1120,573,5,1956,688,695,1383,568
2022-04-20,LT,Türkiye,3169,1164,618,6,2005,695,692,1387,612
2022-04-21,LT,Türkiye,3307,1149,634,4,2158,759,765,1524,630
2022-04-22,LT,Türkiye,3583,1140,738,8,2443,864,841,1705,730
2022-04-23,LT,Türkiye,3627,1253,628,3,2374,865,881,1746,625
2022-04-24,LT,Türkiye,3700,1287,707,8,2413,859,847,1706,699
2022-04-25,LT,Türkiye,3305,1134,679,2,2171,740,752,1492,677
2022-04-26,LT,Türkiye,3148,1095,651,7,2053,700,702,1402,644
2022-04-27,LT,Türkiye,3323,1169,689,4,2154,725,740,1465,685
2022-04-28,LT,Türkiye,3623,1221,771,6,2402,828,803,1631,765
2022-04-29,LT,Türkiye,4063,1174,1046,6,2889,935,908,1843,1040
2022-04-30,LT,Türkiye,4281,1295,1067,9,2986,942,977,1919,1058
2022-05-01,LT,Türkiye,4136,1320,914,4,2816,963,939,1902,910
2022-05-02,LT,Türkiye,3694,1156,821,4,2538,849,868,1717,817
2022-05-03,LT,Türkiye,3601,1156,801,6,2445,832,812,1644,795
2022-05-04,LT,Türkiye,3654,1130,915,7,2524,795,814,1609,908
2022-05-05,LT,Türkiye,3751,1187,825,9,2564,882,857,1739,816
2022-05-06,LT,Türkiye,3900,1147,847,3,2753,958,948,1906,844
2022-05-07,LT,Türkiye,4177,1221,917,5,2956,1012,1027,2039,912
2022-05-08,LT,Türkiye,4197,1279,994,7,2918,960,964,1924,987
2022-05-09,LT,Türkiye,3699,1119,868,9,2580,845,867,1712,859
2022-05-10,LT,Türkiye,3601,1124,826,6,2477,829,822,1651,820
2022-05-11,LT,Türkiye,3660,1165,841,7,2495,825,829,1654,834
2022-05-12,LT,Türkiye,3776,1180,860,8,2596,864,872,1736,852
2022-05-13,LT,Türkiye,3850,1149,861,6,2701,930,910,1840,855
2022-05-14,LT,Türkiye,4041,1222,846,6,2819,979,994,1973,840
2022-05-15,LT,Türkiye,4001,1279,821,7,2722,955,946,1901,814
2022-05-16,LT,Türkiye,3686,1113,857,7,2573,847,869,1716,850
2022-05-17,LT,Türkiye,3552,1100,827,10,2452,821,804,1625,817
2022-05-18,LT,Türkiye,3816,1212,904,9,2604,854,846,1700,895
2022-05-19,LT,Türkiye,3867,1134,922,4,2733,908,903,1811,918
2022-05-20,LT,Türkiye,3934,1159,828,5,2775,983,964,1947,823
2022-05-21,LT,Türkiye,4112,1216,822,7,2896,1026,1048,2074,815
2022-05-22,LT,Türkiye,4159,1316,901,7,2843,979,963,1942,894
2022-05-23,LT,Türkiye,3704,1105,844,5,2599,871,884,1755,839
2022-05-24,LT,Türkiye,3706,1115,822,6,2591,894,875,1769,816
2022-05-25,LT,Türkiye,3947,1220,868,8,2727,923,936,1859,860
2022-05-26,LT,Türkiye,4022,1176,872,6,2846,993,981,1974,866
2022-05-27,LT,Türkiye,4090,1186,859,2,2904,1038,1007,2045,857
2022-05-28,LT,Türkiye,4187,1231,784,1,2956,1072,1100,2172,783
2022-05-29,LT,Türkiye,4163,1272,792,0,2891,1052,1047,2099,792
2022-05-30,LT,Türkiye,3914,1156,838,2,2758,936,984,1920,836
2022-05-31,LT,Türkiye,3766,1120,791,3,2646,933,922,1855,788
2022-06-01,LT,Türkiye,4105,1244,861,7,2861,1003,997,2000,854
2022-06-02,LT,Türkiye,4117,1209,823,1,2908,1042,1043,2085,822
2022-06-03,LT,Türkiye,4280,1184,854,2,3096,1127,1115,2242,852
2022-06-04,LT,Türkiye,4418,1258,796,3,3160,1173,1191,2364,793
2022-06-05,LT,Türkiye,4256,1231,790,1,3025,1124,1111,2235,789
2022-06-06,LT,Türkiye,4176,1174,870,3,3002,1067,1065,2132,867
2022-06-07,LT,Türkiye,4081,1196,863,4,2885,1005,1017,2022,859
2022-06-08,LT,Türkiye,4174,1205,888,9,2969,1038,1043,2081,879
2022-06-09,LT,Türkiye,4283,1249,883,6,3034,1089,1062,2151,877
2022-06-10,LT,Türkiye,4363,1169,861,2,3194,1161,1172,2333,859
2022-06-11,LT,Türkiye,4547,1283,854,1,3264,1200,1210,2410,853
2022-06-12,LT,Türkiye,4450,1320,809,2,3130,1169,1152,2321,807
2022-06-13,LT,Türkiye,4308,1216,887,5,3092,1091,1114,2205,882
2022-06-14,LT,Türkiye,4175,1245,834,4,2930,1058,1038,2096,830
2022-06-15,LT,Türkiye,4452,1294,892,5,3158,1130,1136,2266,887
2022-06-16,LT,Türkiye,4383,1265,878,4,3118,1119,1121,2240,874
2022-06-17,LT,Türkiye,4441,1183,845,4,3258,1214,1199,2413,841
2022-06-18,LT,Türkiye,4706,1305,858,4,3401,1263,1280,2543,854
2022-06-19,LT,Türkiye,4600,1318,850,4,3282,1218,1214,2432,846
2022-06-20,LT,Türkiye,4431,1216,935,7,3215,1135,1145,2280,928
2022-06-21,LT,Türkiye,4401,1270,907,6,3131,1112,1112,2224,901
2022-06-22,LT,Türkiye,4510,1258,918,8,3252,1169,1165,2334,910
2022-06-23,LT,Türkiye,4531,1274,881,6,3257,1196,1180,2376,875
2022-06-24,LT,Türkiye,4617,1226,895,2,3391,1249,1247,2496,893
2022-06-25,LT,Türkiye,4793,1317,829,6,3476,1318,1329,2647,823
2022-06-26,LT,Türkiye,4892,1427,812,3,3465,1334,1319,2653,809
2022-06-27,LT,Türkiye,4614,1248,886,5,3366,1233,1247,2480,881
2022-06-28,LT,Türkiye,4516,1248,858,7,3268,1195,1215,2410,851
2022-06-29,LT,Türkiye,4681,1311,893,2,3370,1246,1231,2477,891
2022-06-30,LT,Türkiye,4714,1318,861,3,3396,1257,1278,2535,858
2022-07-01,LT,Türkiye,4860,1278,874,9,3582,1367,1341,2708,865
2022-07-02,LT,Türkiye,4986,1360,841,9,3626,1385,1400,2785,832
2022-07-03,LT,Türkiye,4981,1430,842,8,3551,1356,1353,2709,834
2022-07-04,LT,Türkiye,4795,1345,887,7,3450,1277,1286,2563,880
2022-07-05,LT,Türkiye,4695,1324,880,4,3371,1255,1236,2491,876
2022-07-06,LT,Türkiye,4954,1390,914,3,3564,1325,1325,2650,911
2022-07-07,LT,Türkiye,4993,1416,903,4,3577,1339,1335,2674,899
2022-07-08,LT,Türkiye,4974,1286,916,4,3688,1397,1375,2772,912
2022-07-09,LT,Türkiye,5028,1417,830,4,3611,1372,1409,2781,826
2022-07-10,LT,Türkiye,4976,1488,809,1,3488,1353,1326,2679,808
2022-07-11,LT,Türkiye,4730,1341,812,2,3389,1279,1298,2577,810
2022-07-12,LT,Türkiye,4635,1350,807,1,3285,1240,1238,2478,806
2022-07-13,LT,Türkiye,4817,1353,845,3,3464,1312,1307,2619,842
2022-07-14,LT,Türkiye,4810,1334,810,3,3476,1336,1330,2666,807
2022-07-15,LT,Türkiye,4964,1338,841,3,3626,1390,1395,2785,838
2022-07-16,LT,Türkiye,5071,1381,802,1,3690,1432,1456,2888,801
2022-07-17,LT,Türkiye,5069,1460,859,3,3609,1378,1372,2750,856
2022-07-18,LT,Türkiye,4778,1306,854,2,3472,1306,1312,2618,852
2022-07-19,LT,Türkiye,4694,1353,817,2,3341,1255,1269,2524,815
2022-07-20,LT,Türkiye,4946,1389,863,2,3557,1351,1343,2694,861
2022-07-21,LT,Türkiye,4911,1407,808,3,3504,1356,1340,2696,805
2022-07-22,LT,Türkiye,4920,1326,840,4,3594,1378,1376,2754,836
2022-07-23,LT,Türkiye,5125,1391,809,1,3734,1454,1471,2925,808
2022-07-24,LT,Türkiye,5000,1433,806,3,3567,1390,1371,2761,803
2022-07-25,LT,Türkiye,4812,1340,833,4,3472,1304,1335,2639,829
2022-07-26,LT,Türkiye,4828,1364,832,5,3464,1322,1310,2632,827
2022-07-27,LT,Türkiye,4919,1359,876,1,3560,1352,1332,2684,875
2022-07-28,LT,Türkiye,4888,1362,840,7,3526,1340,1346,2686,833
2022-07-29,LT,Türkiye,4956,1326,858,3,3630,1395,1377,2772,855
2022-07-30,LT,Türkiye,5096,1391,777,2,3705,1446,1482,2928,775
2022-07-31,LT,Türkiye,5080,1464,824,6,3616,1406,1386,2792,818
2022-08-01,LT,Türkiye,4874,1313,844,2,3561,1351,1366,2717,842
2022-08-02,LT,Türkiye,4866,1379,808,4,3487,1327,1352,2679,804
2022-08-03,LT,Türkiye,5009,1427,844,6,3582,1382,1356,2738,838
2022-08-04,LT,Türkiye,4940,1386,838,8,3554,1362,1354,2716,830
2022-08-05,LT,Türkiye,4980,1311,876,7,3669,1409,1384,2793,869
2022-08-06,LT,Türkiye,5137,1415,788,4,3722,1454,1480,2934,784
2022-08-07,LT,Türkiye,5096,1469,826,2,3627,1407,1394,2801,824
2022-08-08,LT,Türkiye,4834,1361,828,3,3473,1322,1323,2645,825
2022-08-09,LT,Türkiye,4788,1340,811,1,3448,1316,1321,2637,810
2022-08-10,LT,Türkiye,4968,1394,830,2,3574,1379,1365,2744,828
2022-08-11,LT,Türkiye,4944,1399,828,7,3545,1344,1373,2717,821
2022-08-12,LT,Türkiye,5011,1330,874,6,3681,1412,1395,2807,868
2022-08-13,LT,Türkiye,5067,1370,790,0,3697,1451,1456,2907,790
2022-08-14,LT,Türkiye,5023,1372,852,4,3651,1397,1402,2799,848
2022-08-15,LT,Türkiye,4836,1347,845,4,3489,1319,1325,2644,841
2022-08-16,LT,Türkiye,4796,1361,807,10,3435,1309,1319,2628,797
2022-08-17,LT,Türkiye,4981,1395,862,3,3586,1369,1355,2724,859
2022-08-18,LT,Türkiye,4954,1420,835,4,3534,1355,1344,2699,831
2022-08-19,LT,Türkiye,5012,1347,869,1,3665,1408,1388,2796,868
2022-08-20,LT,Türkiye,5042,1335,812,4,3707,1421,1474,2895,808
2022-08-21,LT,Türkiye,5009,1419,814,2,3590,1395,1381,2776,812
2022-08-22,LT,Türkiye,4731,1304,852,3,3427,1290,1285,2575,849
2022-08-23,LT,Türkiye,4687,1312,791,2,3375,1293,1291,2584,789
2022-08-24,LT,Türkiye,4923,1397,855,4,3526,1324,1347,2671,851
2022-08-25,LT,Türkiye,4946,1435,862,4,3511,1331,1318,2649,858
2022-08-26,LT,Türkiye,4996,1337,872,5,3659,1409,1378,2787,867
2022-08-27,LT,Türkiye,5148,1424,818,2,3724,1452,1454,2906,816
2022-08-28,LT,Türkiye,5111,1488,831,8,3623,1396,1396,2792,823
2022-08-29,LT,Türkiye,4700,1271,853,3,3429,1277,1299,2576,850
2022-08-30,LT,Türkiye,4747,1346,822,6,3401,1292,1287,2579,816
2022-08-31,LT,Türkiye,4844,1342,859,4,3502,1325,1318,2643,855
2022-09-01,LT,Türkiye,4942,1401,855,3,3541,1350,1336,2686,852
2022-09-02,LT,Türkiye,4838,1254,854,2,3584,1359,1371,2730,852
2022-09-03,LT,Türkiye,5094,1411,808,4,3683,1435,1440,2875,804
2022-09-04,LT,Türkiye,5015,1435,838,2,3580,1378,1364,2742,836
2022-09-05,LT,Türkiye,4670,1296,859,3,3374,1256,1259,2515,856
2022-09-06,LT,Türkiye,4611,1383,812,4,3228,1215,1201,2416,808
2022-09-07,LT,Türkiye,4822,1385,823,4,3437,1306,1308,2614,819
2022-09-08,LT,Türkiye,4823,1434,834,3,3389,1275,1280,2555,831
2022-09-09,LT,Türkiye,4784,1285,832,4,3499,1330,1337,2667,828
2022-09-10,LT,Türkiye,5020,1426,802,1,3594,1396,1396,2792,801
2022-09-11,LT,Türkiye,4896,1465,822,4,3431,1310,1299,2609,818
2022-09-12,LT,Türkiye,4501,1300,810,3,3201,1188,1203,2391,807
2022-09-13,LT,Türkiye,4411,1306,797,5,3105,1155,1153,2308,792
2022-09-14,LT,Türkiye,4596,1333,833,4,3263,1210,1220,2430,829
2022-09-15,LT,Türkiye,4657,1384,816,6,3273,1239,1218,2457,810
2022-09-16,LT,Türkiye,4612,1292,834,4,3320,1237,1249,2486,830
2022-09-17,LT,Türkiye,4841,1385,785,2,3456,1339,1332,2671,783
2022-09-18,LT,Türkiye,4790,1456,794,0,3334,1271,1269,2540,794
2022-09-19,LT,Türkiye,4353,1292,765,4,3061,1147,1149,2296,761
2022-09-20,LT,Türkiye,4315,1336,752,2,2979,1118,1109,2227,750
2022-09-21,LT,Türkiye,4467,1347,767,3,3120,1173,1180,2353,764
2022-09-22,LT,Türkiye,4603,1408,795,3,3195,1205,1195,2400,792
2022-09-23,LT,Türkiye,4590,1302,819,5,3288,1235,1234,2469,814
2022-09-24,LT,Türkiye,4729,1374,719,4,3355,1305,1331,2636,715
2022-09-25,LT,Türkiye,4640,1424,727,3,3216,1248,1241,2489,724
2022-09-26,LT,Türkiye,4246,1191,754,2,3055,1149,1152,2301,752
2022-09-27,LT,Türkiye,4215,1248,747,3,2967,1113,1107,2220,744
2022-09-28,LT,Türkiye,4469,1361,777,5,3108,1162,1169,2331,772
2022-09-29,LT,Türkiye,4607,1429,778,4,3178,1199,1201,2400,774
2022-09-30,LT,Türkiye,4557,1310,790,2,3247,1240,1217,2457,788
2022-10-01,LT,Türkiye,4795,1405,757,3,3390,1314,1319,2633,754
2022-10-02,LT,Türkiye,4742,1485,769,0,3257,1239,1249,2488,769
2022-10-03,LT,Türkiye,4267,1283,763,4,2984,1104,1117,2221,759
2022-10-04,LT,Türkiye,4025,1172,734,4,2853,1051,1068,2119,730
2022-10-05,LT,Türkiye,4043,1140,752,1,2903,1080,1071,2151,751
2022-10-06,LT,Türkiye,4288,1348,754,6,2940,1103,1083,2186,748
2022-10-07,LT,Türkiye,4417,1305,770,1,3112,1172,1170,2342,769
2022-10-08,LT,Türkiye,4608,1411,722,1,3197,1238,1237,2475,721
2022-10-09,LT,Türkiye,4525,1400,774,1,3125,1180,1171,2351,773
2022-10-10,LT,Türkiye,4109,1237,751,0,2872,1051,1070,2121,751
2022-10-11,LT,Türkiye,3988,1245,726,2,2743,1008,1009,2017,724
2022-10-12,LT,Türkiye,4242,1355,742,1,2887,1075,1070,2145,741
2022-10-13,LT,Türkiye,4237,1349,751,1,2888,1071,1066,2137,750
2022-10-14,LT,Türkiye,4409,1316,812,4,3093,1153,1128,2281,808
2022-10-15,LT,Türkiye,4645,1438,741,3,3207,1218,1248,2466,738
2022-10-16,LT,Türkiye,4532,1419,763,3,3113,1184,1166,2350,760
2022-10-17,LT,Türkiye,4099,1245,771,4,2854,1040,1043,2083,767
2022-10-18,LT,Türkiye,3969,1313,700,0,2656,975,981,1956,700
2022-10-19,LT,Türkiye,4141,1340,764,5,2801,1015,1022,2037,759
2022-10-20,LT,Türkiye,4236,1394,734,4,2842,1072,1036,2108,730
2022-10-21,LT,Türkiye,4249,1280,788,1,2969,1090,1091,2181,787
2022-10-22,LT,Türkiye,4571,1479,726,1,3092,1179,1187,2366,725
2022-10-23,LT,Türkiye,4470,1432,771,1,3038,1131,1136,2267,770
2022-10-24,LT,Türkiye,4054,1312,755,0,2742,984,1003,1987,755
2022-10-25,LT,Türkiye,3915,1305,708,6,2610,955,947,1902,702
2022-10-26,LT,Türkiye,4096,1356,735,2,2740,996,1009,2005,733
2022-10-27,LT,Türkiye,4173,1412,749,4,2761,1018,994,2012,745
2022-10-28,LT,Türkiye,4219,1321,782,1,2898,1061,1055,2116,781
2022-10-29,LT,Türkiye,4533,1509,743,3,3024,1132,1149,2281,740
2022-10-30,LT,Türkiye,4408,1509,827,2,2899,1041,1031,2072,825
2022-10-31,LT,Türkiye,3905,1309,766,2,2596,901,929,1830,764
2022-11-01,LT,Türkiye,3672,1263,697,2,2409,857,855,1712,695
2022-11-02,LT,Türkiye,3738,1327,722,1,2411,855,834,1689,721
2022-11-03,LT,Türkiye,3775,1318,735,2,2457,865,857,1722,733
2022-11-04,LT,Türkiye,3908,1299,822,4,2609,899,888,1787,818
2022-11-05,LT,Türkiye,4084,1387,750,2,2697,970,977,1947,748
2022-11-06,LT,Türkiye,4193,1444,829,2,2749,958,962,1920,827
2022-11-07,LT,Türkiye,3685,1283,774,3,2402,802,826,1628,771
2022-11-08,LT,Türkiye,3380,1219,683,2,2161,736,742,1478,681
2022-11-09,LT,Türkiye,3484,1269,706,7,2215,758,751,1509,699
2022-11-10,LT,Türkiye,3558,1263,729,4,2295,792,774,1566,725
2022-11-11,LT,Türkiye,3689,1233,817,1,2456,818,821,1639,816
2022-11-12,LT,Türkiye,3762,1329,732,1,2433,846,855,1701,731
2022-11-13,LT,Türkiye,3788,1349,790,2,2439,834,815,1649,788
2022-11-14,LT,Türkiye,3450,1231,738,2,2219,728,753,1481,736
2022-11-15,LT,Türkiye,3292,1244,678,3,2048,690,680,1370,675
2022-11-16,LT,Türkiye,3375,1227,700,4,2148,720,728,1448,696
2022-11-17,LT,Türkiye,3506,1283,734,2,2223,749,740,1489,732
2022-11-18,LT,Türkiye,3596,1263,813,2,2333,768,752,1520,811
2022-11-19,LT,Türkiye,3714,1362,729,2,2352,813,810,1623,727
2022-11-20,LT,Türkiye,3847,1404,825,1,2443,801,817,1618,824
2022-11-21,LT,Türkiye,3357,1237,747,2,2120,667,706,1373,745
2022-11-22,LT,Türkiye,3161,1143,687,2,2018,666,665,1331,685
2022-11-23,LT,Türkiye,3202,1171,692,7,2031,674,665,1339,685
2022-11-24,LT,Türkiye,3346,1208,700,7,2138,729,709,1438,693
2022-11-25,LT,Türkiye,3500,1220,801,3,2280,746,733,1479,798
2022-11-26,LT,Türkiye,3643,1322,738,2,2321,795,788,1583,736
2022-11-27,LT,Türkiye,3755,1379,807,2,2376,781,788,1569,805
2022-11-28,LT,Türkiye,3322,1223,724,2,2099,666,709,1375,722
2022-11-29,LT,Türkiye,3160,1182,650,3,1978,677,651,1328,647
2022-11-30,LT,Türkiye,3225,1215,680,7,2010,669,661,1330,673
2022-12-01,LT,Türkiye,3421,1286,713,3,2135,715,707,1422,710
2022-12-02,LT,Türkiye,3486,1248,805,2,2238,712,721,1433,803
2022-12-03,LT,Türkiye,3567,1363,717,5,2204,746,741,1487,712
2022-12-04,LT,Türkiye,3661,1389,766,2,2272,750,756,1506,764
2022-12-05,LT,Türkiye,3183,1206,699,0,1977,633,645,1278,699
2022-12-06,LT,Türkiye,3100,1194,660,4,1906,622,624,1246,656
2022-12-07,LT,Türkiye,3212,1248,661,6,1964,650,653,1303,655
2022-12-08,LT,Türkiye,3351,1273,699,3,2078,684,695,1379,696
2022-12-09,LT,Türkiye,3452,1260,797,7,2192,710,685,1395,790
2022-12-10,LT,Türkiye,3507,1334,688,3,2173,746,739,1485,685
2022-12-11,LT,Türkiye,3568,1380,745,1,2188,714,729,1443,744
2022-12-12,LT,Türkiye,3233,1229,708,1,2004,642,654,1296,707
2022-12-13,LT,Türkiye,3089,1221,638,8,1868,622,608,1230,630
2022-12-14,LT,Türkiye,3267,1271,660,3,1996,670,666,1336,657
2022-12-15,LT,Türkiye,3494,1316,706,9,2178,738,734,1472,697
2022-12-16,LT,Türkiye,3641,1333,803,2,2308,758,747,1505,801
2022-12-17,LT,Türkiye,3695,1396,721,9,2299,783,795,1578,712
2022-12-18,LT,Türkiye,3690,1425,735,6,2265,777,753,1530,729
2022-12-19,LT,Türkiye,3449,1347,650,2,2102,711,741,1452,648
2022-12-20,LT,Türkiye,3455,1359,655,4,2096,727,714,1441,651
2022-12-21,LT,Türkiye,3241,1033,672,4,2208,771,765,1536,668
2022-12-22,LT,Türkiye,3747,1377,719,4,2370,825,826,1651,715
2022-12-23,LT,Türkiye,3810,1345,779,4,2465,847,839,1686,775
2022-12-24,LT,Türkiye,3690,1334,719,3,2356,819,818,1637,716
2022-12-25,LT,Türkiye,3670,1259,782,5,2411,802,827,1629,777
2022-12-26,LT,Türkiye,3512,1299,711,2,2213,745,757,1502,709
2022-12-27,LT,Türkiye,3415,1307,663,11,2108,722,723,1445,652
2022-01-01,UK,Ukraine,501,250,9,0,251,118,124,242,9
2022-01-02,UK,Ukraine,792,300,51,0,492,225,216,441,51
2022-01-03,UK,Ukraine,704,273,53,0,431,192,186,378,53
2022-01-04,UK,Ukraine,621,264,53,0,357,151,153,304,53
2022-01-05,UK,Ukraine,610,214,46,3,396,175,175,350,43
2022-01-06,UK,Ukraine,631,280,43,1,351,155,153,308,42
2022-01-07,UK,Ukraine,650,270,35,0,380,173,172,345,35
2022-01-08,UK,Ukraine,697,328,43,0,369,161,165,326,43
2022-01-09,UK,Ukraine,779,313,44,0,466,207,215,422,44
2022-01-10,UK,Ukraine,635,240,56,1,395,172,167,339,55
2022-01-11,UK,Ukraine,554,243,41,0,311,135,135,270,41
2022-01-12,UK,Ukraine,559,208,52,1,351,146,153,299,51
2022-01-13,UK,Ukraine,572,253,46,3,319,138,135,273,43
2022-01-14,UK,Ukraine,647,245,63,2,402,170,169,339,61
2022-01-15,UK,Ukraine,629,282,43,0,347,151,153,304,43
2022-01-16,UK,Ukraine,659,272,51,0,387,172,164,336,51
2022-01-17,UK,Ukraine,562,187,49,0,375,161,165,326,49
2022-01-18,UK,Ukraine,495,197,40,1,298,125,133,258,39
2022-01-19,UK,Ukraine,500,186,44,0,314,136,134,270,44
2022-01-20,UK,Ukraine,548,228,49,1,320,140,131,271,48
2022-01-21,UK,Ukraine,591,224,50,0,367,158,159,317,50
2022-01-22,UK,Ukraine,581,269,37,2,312,139,136,275,35
2022-01-23,UK,Ukraine,611,247,46,1,364,159,159,318,45
2022-01-24,UK,Ukraine,477,156,47,4,321,139,135,274,43
2022-01-25,UK,Ukraine,411,154,41,0,257,104,112,216,41
2022-01-26,UK,Ukraine,435,154,44,1,281,120,117,237,43
2022-01-27,UK,Ukraine,540,221,45,1,319,135,139,274,44
2022-01-28,UK,Ukraine,588,207,52,0,381,164,165,329,52
2022-01-29,UK,Ukraine,568,260,41,1,308,136,131,267,40
2022-01-30,UK,Ukraine,611,244,49,1,367,157,161,318,48
2022-01-31,UK,Ukraine,530,185,49,0,345,150,146,296,49
2022-02-01,UK,Ukraine,502,196,40,1,306,130,136,266,39
2022-02-02,UK,Ukraine,459,178,39,2,281,123,119,242,37
2022-02-03,UK,Ukraine,524,209,38,1,315,142,135,277,37
2022-02-04,UK,Ukraine,560,204,54,2,356,152,150,302,52
2022-02-05,UK,Ukraine,590,272,32,0,318,145,141,286,32
2022-02-06,UK,Ukraine,592,221,40,1,371,162,169,331,39
2022-02-07,UK,Ukraine,523,195,49,1,328,140,139,279,48
2022-02-08,UK,Ukraine,474,171,45,0,303,127,131,258,45
2022-02-09,UK,Ukraine,458,169,44,1,289,123,122,245,43
2022-02-10,UK,Ukraine,528,218,39,0,310,137,134,271,39
2022-02-11,UK,Ukraine,583,219,57,0,364,151,156,307,57
2022-02-12,UK,Ukraine,535,225,36,0,310,137,137,274,36
2022-02-13,UK,Ukraine,605,196,50,0,409,183,176,359,50
2022-02-14,UK,Ukraine,518,117,52,2,401,185,164,349,50
2022-02-15,UK,Ukraine,446,127,46,2,319,135,138,273,44
2022-02-16,UK,Ukraine,414,117,46,0,297,128,123,251,46
2022-02-17,UK,Ukraine,420,138,38,0,282,129,115,244,38
2022-02-18,UK,Ukraine,482,148,42,2,334,143,149,292,40
2022-02-19,UK,Ukraine,481,198,28,0,283,128,127,255,28
2022-02-20,UK,Ukraine,490,165,34,0,325,146,145,291,34
2022-02-21,UK,Ukraine,401,113,40,0,288,121,127,248,40
2022-02-22,UK,Ukraine,353,118,34,0,235,102,99,201,34
2022-02-23,UK,Ukraine,393,129,40,2,264,112,112,224,38
2022-02-24,UK,Ukraine,22,8,1,1,14,7,6,13,0
2022-02-25,UK,Ukraine,2,2,0,0,0,0,0,0,0
2022-02-26,UK,Ukraine,3,3,0,0,0,0,0,0,0
2022-02-27,UK,Ukraine,5,5,0,0,0,0,0,0,0
2022-02-28,UK,Ukraine,0,0,0,0,0,0,0,0,0
2022-03-01,UK,Ukraine,3,3,0,0,0,0,0,0,0
2022-03-02,UK,Ukraine,2,2,0,0,0,0,0,0,0
2022-03-03,UK,Ukraine,0,0,0,0,0,0,0,0,0
2022-03-04,UK,Ukraine,4,1,0,0,3,0,3,3,0
2022-03-05,UK,Ukraine,2,2,0,0,0,0,0,0,0
2022-03-06,UK,Ukraine,2,2,0,0,0,0,0,0,0
2022-03-07,UK,Ukraine,3,3,0,0,0,0,0,0,0
2022-03-08,UK,Ukraine,2,1,0,0,1,1,0,1,0
2022-03-09,UK,Ukraine,3,3,0,0,0,0,0,0,0
2022-03-10,UK,Ukraine,3,3,0,0,0,0,0,0,0
2022-03-11,UK,Ukraine,3,3,0,0,0,0,0,0,0
2022-03-12,UK,Ukraine,2,2,0,0,0,0,0,0,0
2022-03-13,UK,Ukraine,7,7,0,0,0,0,0,0,0
2022-03-14,UK,Ukraine,2,2,0,0,0,0,0,0,0
2022-03-15,UK,Ukraine,3,3,0,0,0,0,0,0,0
2022-03-16,UK,Ukraine,4,4,0,0,0,0,0,0,0
2022-03-17,UK,Ukraine,3,3,0,0,0,0,0,0,0
2022-03-18,UK,Ukraine,4,4,0,0,0,0,0,0,0
2022-03-19,UK,Ukraine,3,3,0,0,0,0,0,0,0
2022-03-20,UK,Ukraine,2,2,0,0,0,0,0,0,0
2022-03-21,UK,Ukraine,1,1,0,0,0,0,0,0,0
2022-03-22,UK,Ukraine,4,4,0,0,0,0,0,0,0
2022-03-23,UK,Ukraine,3,3,0,0,0,0,0,0,0
2022-03-24,UK,Ukraine,2,2,0,0,0,0,0,0,0
2022-03-25,UK,Ukraine,4,4,0,0,0,0,0,0,0
2022-03-26,UK,Ukraine,2,2,0,0,0,0,0,0,0
2022-03-27,UK,Ukraine,2,2,0,0,0,0,0,0,0
2022-03-28,UK,Ukraine,2,2,0,0,0,0,0,0,0
2022-03-29,UK,Ukraine,3,3,0,0,0,0,0,0,0
2022-03-30,UK,Ukraine,3,3,0,0,0,0,0,0,0
2022-03-31,UK,Ukraine,1,1,0,0,0,0,0,0,0
2022-04-01,UK,Ukraine,1,1,0,0,0,0,0,0,0
2022-04-02,UK,Ukraine,2,2,0,0,0,0,0,0,0
2022-04-03,UK,Ukraine,0,0,0,0,0,0,0,0,0
2022-04-04,UK,Ukraine,2,1,0,0,1,0,1,1,0
2022-04-05,UK,Ukraine,4,4,0,0,0,0,0,0,0
2022-04-06,UK,Ukraine,2,2,0,0,0,0,0,0,0
2022-04-07,UK,Ukraine,2,2,0,0,0,0,0,0,0
2022-04-08,UK,Ukraine,2,0,0,0,2,1,1,2,0
2022-04-09,UK,Ukraine,1,1,0,0,0,0,0,0,0
2022-04-10,UK,Ukraine,1,1,0,0,0,0,0,0,0
2022-04-11,UK,Ukraine,9,6,0,0,3,1,2,3,0
2022-04-12,UK,Ukraine,2,0,0,0,2,1,1,2,0
2022-04-13,UK,Ukraine,2,2,0,0,0,0,0,0,0
2022-04-14,UK,Ukraine,3,3,0,0,0,0,0,0,0
2022-04-15,UK,Ukraine,3,3,0,0,0,0,0,0,0
2022-04-16,UK,Ukraine,0,0,0,0,0,0,0,0,0
2022-04-17,UK,Ukraine,1,1,0,0,0,0,0,0,0
2022-04-18,UK,Ukraine,3,3,0,0,0,0,0,0,0
2022-04-19,UK,Ukraine,1,1,0,0,0,0,0,0,0
2022-04-20,UK,Ukraine,1,1,0,0,0,0,0,0,0
2022-04-21,UK,Ukraine,1,-1,0,0,2,1,1,2,0
2022-04-22,UK,Ukraine,0,0,0,0,0,0,0,0,0
2022-04-23,UK,Ukraine,0,0,0,0,0,0,0,0,0
2022-04-24,UK,Ukraine,1,1,0,0,0,0,0,0,0
2022-04-25,UK,Ukraine,2,2,0,0,0,0,0,0,0
2022-04-26,UK,Ukraine,2,1,0,0,1,0,1,1,0
2022-04-27,UK,Ukraine,0,0,0,0,0,0,0,0,0
2022-04-28,UK,Ukraine,0,-1,0,0,1,0,1,1,0
2022-04-29,UK,Ukraine,3,2,0,0,1,1,0,1,0
2022-04-30,UK,Ukraine,2,2,0,0,0,0,0,0,0
2022-05-01,UK,Ukraine,2,2,0,0,0,0,0,0,0
2022-05-02,UK,Ukraine,0,-1,0,0,1,0,1,1,0
2022-05-03,UK,Ukraine,1,0,0,0,1,0,1,1,0
2022-05-04,UK,Ukraine,1,1,0,0,0,0,0,0,0
2022-05-05,UK,Ukraine,3,2,0,0,1,0,1,1,0
2022-05-06,UK,Ukraine,5,5,0,0,0,0,0,0,0
2022-05-07,UK,Ukraine,1,1,0,0,0,0,0,0,0
2022-05-08,UK,Ukraine,1,1,0,0,0,0,0,0,0
2022-05-09,UK,Ukraine,3,3,0,0,0,0,0,0,0
2022-05-10,UK,Ukraine,3,3,0,0,0,0,0,0,0
2022-05-11,UK,Ukraine,0,0,0,0,0,0,0,0,0
2022-05-12,UK,Ukraine,2,2,0,0,0,0,0,0,0
2022-05-13,UK,Ukraine,2,2,0,0,0,0,0,0,0
2022-05-14,UK,Ukraine,4,4,0,0,0,0,0,0,0
2022-05-15,UK,Ukraine,5,5,0,0,0,0,0,0,0
2022-05-16,UK,Ukraine,3,2,0,0,1,0,1,1,0
2022-05-17,UK,Ukraine,1,1,0,0,0,0,0,0,0
2022-05-18,UK,Ukraine,4,4,0,0,0,0,0,0,0
2022-05-19,UK,Ukraine,0,0,0,0,0,0,0,0,0
2022-05-20,UK,Ukraine,2,1,0,0,1,1,0,1,0
2022-05-21,UK,Ukraine,2,2,0,0,0,0,0,0,0
2022-05-22,UK,Ukraine,3,3,0,0,0,0,0,0,0
2022-05-23,UK,Ukraine,4,4,0,0,0,0,0,0,0
2022-05-24,UK,Ukraine,1,1,0,0,0,0,0,0,0
2022-05-25,UK,Ukraine,3,3,0,0,0,0,0,0,0
2022-05-26,UK,Ukraine,2,2,0,0,0,0,0,0,0
2022-05-27,UK,Ukraine,1,1,0,0,0,0,0,0,0
2022-05-28,UK,Ukraine,2,2,0,0,0,0,0,0,0
2022-05-29,UK,Ukraine,6,6,0,0,0,0,0,0,0
2022-05-30,UK,Ukraine,4,4,0,0,0,0,0,0,0
2022-05-31,UK,Ukraine,3,-1,0,0,4,2,2,4,0
2022-06-01,UK,Ukraine,2,1,0,0,1,0,1,1,0
2022-06-02,UK,Ukraine,4,4,0,0,0,0,0,0,0
2022-06-03,UK,Ukraine,4,4,0,0,0,0,0,0,0
2022-06-04,UK,Ukraine,1,1,0,0,0,0,0,0,0
2022-06-05,UK,Ukraine,3,3,0,0,0,0,0,0,0
2022-06-06,UK,Ukraine,4,2,0,0,2,1,1,2,0
2022-06-07,UK,Ukraine,3,2,0,0,1,1,0,1,0
2022-06-08,UK,Ukraine,4,4,0,0,0,0,0,0,0
2022-06-09,UK,Ukraine,0,0,0,0,0,0,0,0,0
2022-06-10,UK,Ukraine,4,4,0,0,0,0,0,0,0
2022-06-11,UK,Ukraine,2,2,0,0,0,0,0,0,0
2022-06-12,UK,Ukraine,5,5,0,0,0,0,0,0,0
2022-06-13,UK,Ukraine,4,4,0,0,0,0,0,0,0
2022-06-14,UK,Ukraine,1,1,0,0,0,0,0,0,0
2022-06-15,UK,Ukraine,4,3,0,0,1,0,1,1,0
2022-06-16,UK,Ukraine,4,4,0,0,0,0,0,0,0
2022-06-17,UK,Ukraine,3,2,0,0,1,0,1,1,0
2022-06-18,UK,Ukraine,3,3,0,0,0,0,0,0,0
2022-06-19,UK,Ukraine,1,1,0,0,0,0,0,0,0
2022-06-20,UK,Ukraine,3,3,0,0,0,0,0,0,0
2022-06-21,UK,Ukraine,6,5,0,0,1,1,0,1,0
2022-06-22,UK,Ukraine,0,0,0,0,0,0,0,0,0
2022-06-23,UK,Ukraine,1,0,0,0,1,0,1,1,0
2022-06-24,UK,Ukraine,3,3,0,0,0,0,0,0,0
2022-06-25,UK,Ukraine,4,4,0,0,0,0,0,0,0
2022-06-26,UK,Ukraine,1,1,0,0,0,0,0,0,0
2022-06-27,UK,Ukraine,3,3,0,0,0,0,0,0,0
2022-06-28,UK,Ukraine,0,0,0,0,0,0,0,0,0
2022-06-29,UK,Ukraine,3,3,0,0,0,0,0,0,0
2022-06-30,UK,Ukraine,4,3,0,0,1,1,0,1,0
2022-07-01,UK,Ukraine,6,5,0,0,1,0,1,1,0
2022-07-02,UK,Ukraine,2,2,0,0,0,0,0,0,0
2022-07-03,UK,Ukraine,0,0,0,0,0,0,0,0,0
2022-07-04,UK,Ukraine,1,1,0,0,0,0,0,0,0
2022-07-05,UK,Ukraine,3,2,0,0,1,1,0,1,0
2022-07-06,UK,Ukraine,1,1,0,0,0,0,0,0,0
2022-07-07,UK,Ukraine,7,5,0,0,2,1,1,2,0
2022-07-08,UK,Ukraine,2,2,0,0,0,0,0,0,0
2022-07-09,UK,Ukraine,5,5,0,0,0,0,0,0,0
2022-07-10,UK,Ukraine,5,5,0,0,0,0,0,0,0
2022-07-11,UK,Ukraine,1,1,0,0,0,0,0,0,0
2022-07-12,UK,Ukraine,2,2,0,0,0,0,0,0,0
2022-07-13,UK,Ukraine,4,4,0,0,0,0,0,0,0
2022-07-14,UK,Ukraine,0,0,0,0,0,0,0,0,0
2022-07-15,UK,Ukraine,1,1,0,0,0,0,0,0,0
2022-07-16,UK,Ukraine,1,1,0,0,0,0,0,0,0
2022-07-17,UK,Ukraine,2,2,0,0,0,0,0,0,0
2022-07-18,UK,Ukraine,3,3,0,0,0,0,0,0,0
2022-07-19,UK,Ukraine,2,2,0,0,0,0,0,0,0
2022-07-20,UK,Ukraine,4,2,0,0,2,1,1,2,0
2022-07-21,UK,Ukraine,0,0,0,0,0,0,0,0,0
2022-07-22,UK,Ukraine,1,1,0,0,0,0,0,0,0
2022-07-23,UK,Ukraine,1,1,0,0,0,0,0,0,0
2022-07-24,UK,Ukraine,2,2,0,0,0,0,0,0,0
2022-07-25,UK,Ukraine,3,3,0,0,0,0,0,0,0
2022-07-26,UK,Ukraine,3,1,0,0,2,1,1,2,0
2022-07-27,UK,Ukraine,2,1,0,0,1,0,1,1,0
2022-07-28,UK,Ukraine,5,5,0,0,0,0,0,0,0
2022-07-29,UK,Ukraine,4,4,0,0,0,0,0,0,0
2022-07-30,UK,Ukraine,3,3,0,0,0,0,0,0,0
2022-07-31,UK,Ukraine,2,2,0,0,0,0,0,0,0
2022-08-01,UK,Ukraine,8,8,0,0,0,0,0,0,0
2022-08-02,UK,Ukraine,4,4,0,0,0,0,0,0,0
2022-08-03,UK,Ukraine,3,3,0,0,0,0,0,0,0
2022-08-04,UK,Ukraine,4,4,0,0,0,0,0,0,0
2022-08-05,UK,Ukraine,5,4,0,0,1,1,0,1,0
2022-08-06,UK,Ukraine,2,2,0,0,0,0,0,0,0
2022-08-07,UK,Ukraine,2,2,0,0,0,0,0,0,0
2022-08-08,UK,Ukraine,2,2,0,0,0,0,0,0,0
2022-08-09,UK,Ukraine,2,2,0,0,0,0,0,0,0
2022-08-10,UK,Ukraine,1,1,0,0,0,0,0,0,0
2022-08-11,UK,Ukraine,3,3,0,0,0,0,0,0,0
2022-08-12,UK,Ukraine,2,2,0,0,0,0,0,0,0
2022-08-13,UK,Ukraine,0,0,0,0,0,0,0,0,0
2022-08-14,UK,Ukraine,1,1,0,0,0,0,0,0,0
2022-08-15,UK,Ukraine,3,3,0,0,0,0,0,0,0
2022-08-16,UK,Ukraine,1,1,0,0,0,0,0,0,0
2022-08-17,UK,Ukraine,0,0,0,0,0,0,0,0,0
2022-08-18,UK,Ukraine,1,1,0,0,0,0,0,0,0
2022-08-19,UK,Ukraine,0,0,0,0,0,0,0,0,0
2022-08-20,UK,Ukraine,1,1,0,0,0,0,0,0,0
2022-08-21,UK,Ukraine,0,0,0,0,0,0,0,0,0
2022-08-22,UK,Ukraine,2,2,0,0,0,0,0,0,0
2022-08-23,UK,Ukraine,3,3,0,0,0,0,0,0,0
2022-08-24,UK,Ukraine,3,3,0,0,0,0,0,0,0
2022-08-25,UK,Ukraine,3,3,0,0,0,0,0,0,0
2022-08-26,UK,Ukraine,3,3,0,0,0,0,0,0,0
2022-08-27,UK,Ukraine,1,1,0,0,0,0,0,0,0
2022-08-28,UK,Ukraine,1,1,0,0,0,0,0,0,0
2022-08-29,UK,Ukraine,3,3,0,0,0,0,0,0,0
2022-08-30,UK,Ukraine,4,2,0,0,2,0,2,2,0
2022-08-31,UK,Ukraine,12,11,0,0,1,1,0,1,0
2022-09-01,UK,Ukraine,1,1,0,0,0,0,0,0,0
2022-09-02,UK,Ukraine,14,14,0,0,0,0,0,0,0
2022-09-03,UK,Ukraine,1,1,0,0,0,0,0,0,0
2022-09-04,UK,Ukraine,0,0,0,0,0,0,0,0,0
2022-09-05,UK,Ukraine,4,4,0,0,0,0,0,0,0
2022-09-06,UK,Ukraine,3,3,0,0,0,0,0,0,0
2022-09-07,UK,Ukraine,3,3,0,0,0,0,0,0,0
2022-09-08,UK,Ukraine,1,1,0,0,0,0,0,0,0
2022-09-09,UK,Ukraine,1,1,0,0,0,0,0,0,0
2022-09-10,UK,Ukraine,0,0,0,0,0,0,0,0,0
2022-09-11,UK,Ukraine,2,2,0,0,0,0,0,0,0
2022-09-12,UK,Ukraine,1,1,0,0,0,0,0,0,0
2022-09-13,UK,Ukraine,3,2,0,0,1,0,1,1,0
2022-09-14,UK,Ukraine,1,1,0,0,0,0,0,0,0
2022-09-15,UK,Ukraine,1,1,0,0,0,0,0,0,0
2022-09-16,UK,Ukraine,3,2,0,0,1,1,0,1,0
2022-09-17,UK,Ukraine,1,1,0,0,0,0,0,0,0
2022-09-18,UK,Ukraine,1,1,0,0,0,0,0,0,0
2022-09-19,UK,Ukraine,0,0,0,0,0,0,0,0,0
2022-09-20,UK,Ukraine,0,0,0,0,0,0,0,0,0
2022-09-21,UK,Ukraine,2,2,0,0,0,0,0,0,0
2022-09-22,UK,Ukraine,0,0,0,0,0,0,0,0,0
2022-09-23,UK,Ukraine,0,0,0,0,0,0,0,0,0
2022-09-24,UK,Ukraine,0,0,0,0,0,0,0,0,0
2022-09-25,UK,Ukraine,3,3,0,0,0,0,0,0,0
2022-09-26,UK,Ukraine,3,3,0,0,0,0,0,0,0
2022-09-27,UK,Ukraine,0,0,0,0,0,0,0,0,0
2022-09-28,UK,Ukraine,3,3,0,0,0,0,0,0,0
2022-09-29,UK,Ukraine,2,2,0,0,0,0,0,0,0
2022-09-30,UK,Ukraine,2,2,0,0,0,0,0,0,0
2022-10-01,UK,Ukraine,3,3,0,0,0,0,0,0,0
2022-10-02,UK,Ukraine,3,2,0,0,1,1,0,1,0
2022-10-03,UK,Ukraine,2,1,0,0,1,1,0,1,0
2022-10-04,UK,Ukraine,2,2,0,0,0,0,0,0,0
2022-10-05,UK,Ukraine,0,0,0,0,0,0,0,0,0
2022-10-06,UK,Ukraine,3,3,0,0,0,0,0,0,0
2022-10-07,UK,Ukraine,2,2,0,0,0,0,0,0,0
2022-10-08,UK,Ukraine,5,5,0,0,0,0,0,0,0
2022-10-09,UK,Ukraine,5,5,0,0,0,0,0,0,0
2022-10-10,UK,Ukraine,1,0,0,0,1,0,1,1,0
2022-10-11,UK,Ukraine,0,-1,0,0,1,1,0,1,0
2022-10-12,UK,Ukraine,2,2,0,0,0,0,0,0,0
2022-10-13,UK,Ukraine,1,1,0,0,0,0,0,0,0
2022-10-14,UK,Ukraine,2,2,0,0,0,0,0,0,0
2022-10-15,UK,Ukraine,1,1,0,0,0,0,0,0,0
2022-10-16,UK,Ukraine,1,1,0,0,0,0,0,0,0
2022-10-17,UK,Ukraine,3,3,0,0,0,0,0,0,0
2022-10-18,UK,Ukraine,4,3,0,0,1,0,1,1,0
2022-10-19,UK,Ukraine,2,1,0,0,1,1,0,1,0
2022-10-20,UK,Ukraine,2,1,0,0,1,0,1,1,0
2022-10-21,UK,Ukraine,2,2,0,0,0,0,0,0,0
2022-10-22,UK,Ukraine,2,2,0,0,0,0,0,0,0
2022-10-23,UK,Ukraine,1,1,0,0,0,0,0,0,0
2022-10-24,UK,Ukraine,2,2,0,0,0,0,0,0,0
2022-10-25,UK,Ukraine,2,2,0,0,0,0,0,0,0
2022-10-26,UK,Ukraine,3,3,0,0,0,0,0,0,0
2022-10-27,UK,Ukraine,5,5,0,0,0,0,0,0,0
2022-10-28,UK,Ukraine,1,1,0,0,0,0,0,0,0
2022-10-29,UK,Ukraine,2,2,0,0,0,0,0,0,0
2022-10-30,UK,Ukraine,2,2,0,0,0,0,0,0,0
2022-10-31,UK,Ukraine,1,1,0,0,0,0,0,0,0
2022-11-01,UK,Ukraine,2,2,0,0,0,0,0,0,0
2022-11-02,UK,Ukraine,3,3,0,0,0,0,0,0,0
2022-11-03,UK,Ukraine,1,1,0,0,0,0,0,0,0
2022-11-04,UK,Ukraine,2,2,0,0,0,0,0,0,0
2022-11-05,UK,Ukraine,1,1,0,0,0,0,0,0,0
2022-11-06,UK,Ukraine,3,3,0,0,0,0,0,0,0
2022-11-07,UK,Ukraine,1,1,0,0,0,0,0,0,0
2022-11-08,UK,Ukraine,4,4,0,0,0,0,0,0,0
2022-11-09,UK,Ukraine,1,1,0,0,0,0,0,0,0
2022-11-10,UK,Ukraine,2,2,0,0,0,0,0,0,0
2022-11-11,UK,Ukraine,0,0,0,0,0,0,0,0,0
2022-11-12,UK,Ukraine,3,3,0,0,0,0,0,0,0
2022-11-13,UK,Ukraine,3,3,0,0,0,0,0,0,0
2022-11-14,UK,Ukraine,0,0,0,0,0,0,0,0,0
2022-11-15,UK,Ukraine,2,2,0,0,0,0,0,0,0
2022-11-16,UK,Ukraine,2,2,0,0,0,0,0,0,0
2022-11-17,UK,Ukraine,1,1,0,0,0,0,0,0,0
2022-11-18,UK,Ukraine,0,0,0,0,0,0,0,0,0
2022-11-19,UK,Ukraine,2,2,0,0,0,0,0,0,0
2022-11-20,UK,Ukraine,1,1,0,0,0,0,0,0,0
2022-11-21,UK,Ukraine,0,0,0,0,0,0,0,0,0
2022-11-22,UK,Ukraine,1,1,0,0,0,0,0,0,0
2022-11-23,UK,Ukraine,3,3,0,0,0,0,0,0,0
2022-11-24,UK,Ukraine,1,1,0,0,0,0,0,0,0
2022-11-25,UK,Ukraine,1,1,0,0,0,0,0,0,0
2022-11-26,UK,Ukraine,0,0,0,0,0,0,0,0,0
2022-11-27,UK,Ukraine,0,0,0,0,0,0,0,0,0
2022-11-28,UK,Ukraine,1,0,0,0,1,1,0,1,0
2022-11-29,UK,Ukraine,3,3,0,0,0,0,0,0,0
2022-11-30,UK,Ukraine,0,0,0,0,0,0,0,0,0
2022-12-01,UK,Ukraine,3,3,0,0,0,0,0,0,0
2022-12-02,UK,Ukraine,0,0,0,0,0,0,0,0,0
2022-12-03,UK,Ukraine,2,2,0,0,0,0,0,0,0
2022-12-04,UK,Ukraine,1,1,0,0,0,0,0,0,0
2022-12-05,UK,Ukraine,3,3,0,0,0,0,0,0,0
2022-12-06,UK,Ukraine,4,4,0,0,0,0,0,0,0
2022-12-07,UK,Ukraine,1,1,0,0,0,0,0,0,0
2022-12-08,UK,Ukraine,0,0,0,0,0,0,0,0,0
2022-12-09,UK,Ukraine,1,1,0,0,0,0,0,0,0
2022-12-10,UK,Ukraine,1,-1,0,0,2,1,1,2,0
2022-12-11,UK,Ukraine,1,1,0,0,0,0,0,0,0
2022-12-12,UK,Ukraine,2,2,0,0,0,0,0,0,0
2022-12-13,UK,Ukraine,1,1,0,0,0,0,0,0,0
2022-12-14,UK,Ukraine,1,1,0,0,0,0,0,0,0
2022-12-15,UK,Ukraine,3,3,0,0,0,0,0,0,0
2022-12-16,UK,Ukraine,2,2,0,0,0,0,0,0,0
2022-12-17,UK,Ukraine,3,3,0,0,0,0,0,0,0
2022-12-18,UK,Ukraine,3,3,0,0,0,0,0,0,0
2022-12-19,UK,Ukraine,2,2,0,0,0,0,0,0,0
2022-12-20,UK,Ukraine,1,1,0,0,0,0,0,0,0
2022-12-21,UK,Ukraine,1,0,1,1,1,0,0,0,0
2022-12-22,UK,Ukraine,1,1,0,0,0,0,0,0,0
2022-12-23,UK,Ukraine,0,0,0,0,0,0,0,0,0
2022-12-24,UK,Ukraine,1,1,0,0,0,0,0,0,0
2022-12-25,UK,Ukraine,0,0,0,0,0,0,0,0,0
2022-12-26,UK,Ukraine,0,0,0,0,0,0,0,0,0
2022-12-27,UK,Ukraine,3,3,0,0,0,0,0,0,0
2022-01-01,EG,United Kingdom,3514,1013,219,0,2501,1132,1150,2282,219
2022-01-02,EG,United Kingdom,4806,1121,510,2,3685,1574,1601,3175,508
2022-01-03,EG,United Kingdom,4885,1140,610,14,3745,1551,1584,3135,596
2022-01-04,EG,United Kingdom,4357,1044,591,14,3313,1355,1367,2722,577
2022-01-05,EG,United Kingdom,4247,1081,633,17,3166,1273,1260,2533,616
2022-01-06,EG,United Kingdom,4197,1084,638,12,3113,1244,1231,2475,626
2022-01-07,EG,United Kingdom,4542,1059,710,15,3483,1366,1407,2773,695
2022-01-08,EG,United Kingdom,4134,1118,359,1,3016,1333,1324,2657,358
2022-01-09,EG,United Kingdom,4528,1063,527,8,3465,1459,1479,2938,519
2022-01-10,EG,United Kingdom,3600,1012,610,25,2588,992,986,1978,585
2022-01-11,EG,United Kingdom,3075,888,550,28,2187,826,811,1637,522
2022-01-12,EG,United Kingdom,3122,969,582,35,2153,786,785,1571,547
2022-01-13,EG,United Kingdom,3384,957,647,34,2427,892,888,1780,613
2022-01-14,EG,United Kingdom,3747,995,687,13,2752,1030,1035,2065,674
2022-01-15,EG,United Kingdom,3321,1009,405,11,2312,946,961,1907,394
2022-01-16,EG,United Kingdom,3714,1033,531,15,2681,1071,1079,2150,516
2022-01-17,EG,United Kingdom,3334,924,625,13,2410,887,898,1785,612
2022-01-18,EG,United Kingdom,2902,865,536,26,2037,754,747,1501,510
2022-01-19,EG,United Kingdom,2935,851,573,33,2084,754,757,1511,540
2022-01-20,EG,United Kingdom,3298,890,635,34,2408,893,880,1773,601
2022-01-21,EG,United Kingdom,3756,955,695,18,2801,1049,1057,2106,677
2022-01-22,EG,United Kingdom,3412,1051,390,14,2361,990,981,1971,376
2022-01-23,EG,United Kingdom,3685,988,521,6,2697,1086,1090,2176,515
2022-01-24,EG,United Kingdom,3308,911,617,26,2397,891,889,1780,591
2022-01-25,EG,United Kingdom,2822,782,559,25,2040,730,751,1481,534
2022-01-26,EG,United Kingdom,2936,843,530,28,2093,794,769,1563,502
2022-01-27,EG,United Kingdom,3265,852,633,22,2413,889,891,1780,611
2022-01-28,EG,United Kingdom,3758,989,684,16,2769,1047,1038,2085,668
2022-01-29,EG,United Kingdom,3212,951,325,6,2261,963,973,1936,319
2022-01-30,EG,United Kingdom,3599,929,508,8,2670,1060,1102,2162,500
2022-01-31,EG,United Kingdom,3289,860,626,8,2429,916,887,1803,618
2022-02-01,EG,United Kingdom,3314,880,550,22,2434,933,951,1884,528
2022-02-02,EG,United Kingdom,3465,885,601,19,2580,1002,977,1979,582
2022-02-03,EG,United Kingdom,3805,957,661,17,2848,1102,1085,2187,644
2022-02-04,EG,United Kingdom,4211,973,720,18,3238,1251,1267,2518,702
2022-02-05,EG,United Kingdom,3834,1072,357,5,2762,1202,1203,2405,352
2022-02-06,EG,United Kingdom,4163,949,553,4,3214,1324,1337,2661,549
2022-02-07,EG,United Kingdom,3990,953,707,14,3037,1159,1171,2330,693
2022-02-08,EG,United Kingdom,3510,872,627,18,2638,1003,1008,2011,609
2022-02-09,EG,United Kingdom,3569,901,599,22,2668,1041,1028,2069,577
2022-02-10,EG,United Kingdom,4306,981,737,23,3325,1281,1307,2588,714
2022-02-11,EG,United Kingdom,5038,1049,802,16,3989,1582,1605,3187,786
2022-02-12,EG,United Kingdom,4711,1109,414,8,3602,1631,1557,3188,406
2022-02-13,EG,United Kingdom,4622,1085,531,5,3537,1498,1508,3006,526
2022-02-14,EG,United Kingdom,4439,1017,755,16,3422,1340,1327,2667,739
2022-02-15,EG,United Kingdom,3877,917,655,17,2960,1137,1168,2305,638
2022-02-16,EG,United Kingdom,3790,911,592,10,2879,1152,1135,2287,582
2022-02-17,EG,United Kingdom,4294,905,760,22,3389,1311,1318,2629,738
2022-02-18,EG,United Kingdom,3881,979,446,6,2902,1228,1228,2456,440
2022-02-19,EG,United Kingdom,4960,1141,511,13,3819,1629,1679,3308,498
2022-02-20,EG,United Kingdom,4748,1005,474,7,3743,1634,1635,3269,467
2022-02-21,EG,United Kingdom,4325,942,695,9,3383,1358,1330,2688,686
2022-02-22,EG,United Kingdom,3975,892,681,21,3083,1210,1192,2402,660
2022-02-23,EG,United Kingdom,3994,928,690,19,3066,1193,1183,2376,671
2022-02-24,EG,United Kingdom,4403,982,765,24,3421,1332,1324,2656,741
2022-02-25,EG,United Kingdom,4963,1100,816,34,3863,1519,1528,3047,782
2022-02-26,EG,United Kingdom,4359,1157,447,25,3202,1364,1391,2755,422
2022-02-27,EG,United Kingdom,4852,1098,599,15,3754,1573,1582,3155,584
2022-02-28,EG,United Kingdom,4697,1038,785,32,3659,1438,1436,2874,753
2022-03-01,EG,United Kingdom,4249,1006,642,31,3243,1318,1283,2601,611
2022-03-02,EG,United Kingdom,4339,1001,722,35,3338,1315,1301,2616,687
2022-03-03,EG,United Kingdom,4683,1042,785,31,3641,1422,1434,2856,754
2022-03-04,EG,United Kingdom,5193,1119,821,30,4074,1620,1633,3253,791
2022-03-05,EG,United Kingdom,4608,1171,445,16,3437,1502,1490,2992,429
2022-03-06,EG,United Kingdom,4940,1135,586,18,3805,1602,1617,3219,568
2022-03-07,EG,United Kingdom,4907,1114,781,22,3793,1508,1504,3012,759
2022-03-08,EG,United Kingdom,4423,1023,731,24,3400,1322,1347,2669,707
2022-03-09,EG,United Kingdom,4376,1009,689,24,3367,1337,1341,2678,665
2022-03-10,EG,United Kingdom,4876,1069,846,40,3807,1486,1475,2961,806
2022-03-11,EG,United Kingdom,5219,1108,813,29,4111,1639,1659,3298,784
2022-03-12,EG,United Kingdom,4564,1111,439,13,3453,1506,1508,3014,426
2022-03-13,EG,United Kingdom,5051,1130,605,15,3921,1658,1658,3316,590
2022-03-14,EG,United Kingdom,5016,1133,822,27,3883,1530,1531,3061,795
2022-03-15,EG,United Kingdom,4494,978,755,26,3516,1378,1383,2761,729
2022-03-16,EG,United Kingdom,4565,1064,727,27,3501,1403,1371,2774,700
2022-03-17,EG,United Kingdom,4891,1049,825,26,3842,1500,1517,3017,799
2022-03-18,EG,United Kingdom,5401,1162,837,21,4239,1708,1694,3402,816
2022-03-19,EG,United Kingdom,4755,1205,460,13,3550,1557,1533,3090,447
2022-03-20,EG,United Kingdom,5163,1250,588,10,3913,1657,1668,3325,578
2022-03-21,EG,United Kingdom,5008,1100,821,32,3908,1529,1558,3087,789
2022-03-22,EG,United Kingdom,4497,1024,769,27,3473,1357,1347,2704,742
2022-03-23,EG,United Kingdom,4616,1063,766,30,3553,1399,1388,2787,736
2022-03-24,EG,United Kingdom,4891,1078,808,31,3813,1489,1516,3005,777
2022-03-25,EG,United Kingdom,5382,1155,831,19,4227,1708,1688,3396,812
2022-03-26,EG,United Kingdom,4747,1174,506,15,3573,1539,1528,3067,491
2022-03-27,EG,United Kingdom,5752,1362,599,13,4390,1895,1896,3791,586
2022-03-28,EG,United Kingdom,6097,1349,894,31,4748,1913,1941,3854,863
2022-03-29,EG,United Kingdom,5880,1302,815,28,4578,1870,1893,3763,787
2022-03-30,EG,United Kingdom,5680,1283,730,17,4397,1836,1831,3667,713
2022-03-31,EG,United Kingdom,5936,1320,782,13,4616,1918,1916,3834,769
2022-04-01,EG,United Kingdom,6257,1341,846,16,4916,2041,2029,4070,830
2022-04-02,EG,United Kingdom,5746,1409,513,13,4337,1924,1900,3824,500
2022-04-03,EG,United Kingdom,5903,1379,617,17,4524,1957,1950,3907,600
2022-04-04,EG,United Kingdom,6167,1332,843,25,4835,1992,2000,3992,818
2022-04-05,EG,United Kingdom,5926,1344,781,24,4582,1899,1902,3801,757
2022-04-06,EG,United Kingdom,6086,1325,840,15,4761,1959,1962,3921,825
2022-04-07,EG,United Kingdom,6254,1380,847,16,4874,2027,2000,4027,831
2022-04-08,EG,United Kingdom,6565,1470,887,36,5095,2102,2106,4208,851
2022-04-09,EG,United Kingdom,6025,1507,520,14,4518,2001,1997,3998,506
2022-04-10,EG,United Kingdom,6237,1519,641,14,4718,2027,2050,4077,627
2022-04-11,EG,United Kingdom,6366,1410,902,25,4956,2024,2030,4054,877
2022-04-12,EG,United Kingdom,6156,1365,826,20,4791,1983,1982,3965,806
2022-04-13,EG,United Kingdom,6141,1389,848,29,4752,1944,1960,3904,819
2022-04-14,EG,United Kingdom,6457,1415,870,26,5042,2100,2072,4172,844
2022-04-15,EG,United Kingdom,6393,1498,779,14,4895,2061,2055,4116,765
2022-04-16,EG,United Kingdom,5797,1488,487,15,4309,1921,1901,3822,472
2022-04-17,EG,United Kingdom,5995,1445,579,15,4550,1976,1995,3971,564
2022-04-18,EG,United Kingdom,6388,1459,750,24,4929,2054,2125,4179,726
2022-04-19,EG,United Kingdom,6261,1341,810,17,4920,2049,2061,4110,793
2022-04-20,EG,United Kingdom,6260,1415,881,28,4845,1989,1975,3964,853
2022-04-21,EG,United Kingdom,6300,1406,829,31,4894,2046,2019,4065,798
2022-04-22,EG,United Kingdom,6539,1420,888,22,5119,2103,2128,4231,866
2022-04-23,EG,United Kingdom,5710,1444,517,7,4266,1875,1874,3749,510
2022-04-24,EG,United Kingdom,6216,1479,648,16,4737,2040,2049,4089,632
2022-04-25,EG,United Kingdom,6439,1483,902,19,4956,2023,2031,4054,883
2022-04-26,EG,United Kingdom,6272,1418,857,22,4854,2000,1997,3997,835
2022-04-27,EG,United Kingdom,6224,1394,831,21,4830,1997,2002,3999,810
2022-04-28,EG,United Kingdom,6489,1429,868,15,5060,2113,2079,4192,853
2022-04-29,EG,United Kingdom,6814,1463,950,26,5351,2201,2200,4401,924
2022-04-30,EG,United Kingdom,5822,1371,572,17,4451,1933,1946,3879,555
2022-05-01,EG,United Kingdom,6333,1463,653,9,4870,2111,2106,4217,644
2022-05-02,EG,United Kingdom,6769,1495,839,19,5274,2188,2247,4435,820
2022-05-03,EG,United Kingdom,6532,1401,812,25,5131,2142,2177,4319,787
2022-05-04,EG,United Kingdom,6500,1402,849,22,5098,2143,2106,4249,827
2022-05-05,EG,United Kingdom,6780,1392,925,22,5388,2230,2233,4463,903
2022-05-06,EG,United Kingdom,7075,1500,965,18,5575,2322,2288,4610,947
2022-05-07,EG,United Kingdom,6226,1551,553,14,4675,2076,2046,4122,539
2022-05-08,EG,United Kingdom,6692,1545,692,13,5147,2221,2234,4455,679
2022-05-09,EG,United Kingdom,6941,1539,928,27,5402,2232,2242,4474,901
2022-05-10,EG,United Kingdom,6692,1499,876,20,5193,2153,2164,4317,856
2022-05-11,EG,United Kingdom,6707,1480,829,21,5227,2183,2215,4398,808
2022-05-12,EG,United Kingdom,6872,1444,937,22,5428,2264,2227,4491,915
2022-05-13,EG,United Kingdom,7165,1529,963,22,5636,2334,2339,4673,941
2022-05-14,EG,United Kingdom,6359,1508,595,13,4851,2132,2124,4256,582
2022-05-15,EG,United Kingdom,6725,1556,677,12,5169,2233,2259,4492,665
2022-05-16,EG,United Kingdom,6901,1484,879,14,5417,2264,2274,4538,865
2022-05-17,EG,United Kingdom,6731,1437,830,18,5294,2236,2228,4464,812
2022-05-18,EG,United Kingdom,6829,1514,848,14,5315,2241,2226,4467,834
2022-05-19,EG,United Kingdom,7040,1500,958,20,5540,2288,2294,4582,938
2022-05-20,EG,United Kingdom,7223,1613,933,9,5610,2345,2332,4677,924
2022-05-21,EG,United Kingdom,6479,1550,601,7,4929,2171,2157,4328,594
2022-05-22,EG,United Kingdom,6949,1640,719,18,5309,2294,2296,4590,701
2022-05-23,EG,United Kingdom,7148,1576,959,19,5572,2303,2310,4613,940
2022-05-24,EG,United Kingdom,6873,1490,844,21,5383,2250,2289,4539,823
2022-05-25,EG,United Kingdom,6979,1449,874,22,5530,2320,2336,4656,852
2022-05-26,EG,United Kingdom,7321,1597,932,32,5724,2386,2406,4792,900
2022-05-27,EG,United Kingdom,7756,1626,997,24,6130,2569,2564,5133,973
2022-05-28,EG,United Kingdom,6956,1569,609,11,5387,2451,2327,4778,598
2022-05-29,EG,United Kingdom,7111,1665,664,10,5446,2389,2393,4782,654
2022-05-30,EG,United Kingdom,7456,1630,947,23,5826,2422,2457,4879,924
2022-05-31,EG,United Kingdom,7033,1511,855,14,5522,2320,2347,4667,841
2022-06-01,EG,United Kingdom,7338,1615,887,16,5723,2416,2420,4836,871
2022-06-02,EG,United Kingdom,7261,1626,825,21,5635,2418,2392,4810,804
2022-06-03,EG,United Kingdom,7252,1640,787,17,5612,2424,2401,4825,770
2022-06-04,EG,United Kingdom,6816,1639,587,10,5177,2286,2304,4590,577
2022-06-05,EG,United Kingdom,7298,1619,689,17,5679,2414,2576,4990,672
2022-06-06,EG,United Kingdom,7721,1751,1015,26,5970,2518,2437,4955,989
2022-06-07,EG,United Kingdom,7293,1594,873,19,5699,2411,2415,4826,854
2022-06-08,EG,United Kingdom,7267,1658,846,26,5609,2378,2385,4763,820
2022-06-09,EG,United Kingdom,7500,1618,990,30,5882,2454,2438,4892,960
2022-06-10,EG,United Kingdom,7634,1645,986,26,5989,2528,2475,5003,960
2022-06-11,EG,United Kingdom,6841,1636,602,11,5205,2291,2312,4603,591
2022-06-12,EG,United Kingdom,7271,1701,722,13,5570,2409,2439,4848,709
2022-06-13,EG,United Kingdom,7620,1707,984,26,5913,2457,2472,4929,958
2022-06-14,EG,United Kingdom,7371,1645,922,30,5726,2399,2405,4804,892
2022-06-15,EG,United Kingdom,7444,1707,883,38,5737,2417,2437,4854,845
2022-06-16,EG,United Kingdom,7469,1608,962,36,5861,2473,2426,4899,926
2022-06-17,EG,United Kingdom,7569,1671,982,24,5898,2473,2443,4916,958
2022-06-18,EG,United Kingdom,6752,1654,580,12,5098,2255,2263,4518,568
2022-06-19,EG,United Kingdom,7241,1705,734,12,5536,2404,2398,4802,722
2022-06-20,EG,United Kingdom,7583,1792,947,32,5791,2403,2441,4844,915
2022-06-21,EG,United Kingdom,7438,1706,933,28,5732,2413,2386,4799,905
2022-06-22,EG,United Kingdom,7330,1661,906,40,5669,2362,2401,4763,866
2022-06-23,EG,United Kingdom,7523,1731,962,30,5792,2417,2413,4830,932
2022-06-24,EG,United Kingdom,7596,1689,954,21,5907,2477,2476,4953,933
2022-06-25,EG,United Kingdom,6867,1723,599,4,5144,2263,2282,4545,595
2022-06-26,EG,United Kingdom,7192,1708,722,15,5484,2377,2385,4762,707
2022-06-27,EG,United Kingdom,7516,1678,955,22,5838,2450,2433,4883,933
2022-06-28,EG,United Kingdom,7382,1658,898,25,5724,2424,2402,4826,873
2022-06-29,EG,United Kingdom,7399,1638,918,26,5761,2388,2455,4843,892
2022-06-30,EG,United Kingdom,7438,1722,904,21,5716,2409,2403,4812,883
2022-07-01,EG,United Kingdom,7773,1745,963,7,6028,2541,2524,5065,956
2022-07-02,EG,United Kingdom,6936,1677,582,3,5259,2347,2330,4677,579
2022-07-03,EG,United Kingdom,7269,1683,708,4,5586,2439,2439,4878,704
2022-07-04,EG,United Kingdom,7609,1726,930,8,5883,2484,2469,4953,922
2022-07-05,EG,United Kingdom,7380,1647,862,19,5733,2429,2442,4871,843
2022-07-06,EG,United Kingdom,7516,1693,887,16,5823,2457,2479,4936,871
2022-07-07,EG,United Kingdom,7619,1712,942,27,5907,2481,2484,4965,915
2022-07-08,EG,United Kingdom,7810,1726,955,18,6084,2565,2564,5129,937
2022-07-09,EG,United Kingdom,7156,1733,590,11,5423,2420,2413,4833,579
2022-07-10,EG,United Kingdom,7309,1701,705,9,5608,2457,2446,4903,696
2022-07-11,EG,United Kingdom,7569,1721,914,21,5848,2479,2455,4934,893
2022-07-12,EG,United Kingdom,7442,1690,909,23,5752,2418,2425,4843,886
2022-07-13,EG,United Kingdom,7449,1687,937,15,5762,2399,2426,4825,922
2022-07-14,EG,United Kingdom,7442,1597,951,12,5845,2420,2474,4894,939
2022-07-15,EG,United Kingdom,7604,1638,962,11,5966,2501,2503,5004,951
2022-07-16,EG,United Kingdom,7013,1625,597,11,5388,2400,2391,4791,586
2022-07-17,EG,United Kingdom,7252,1700,740,8,5552,2414,2398,4812,732
2022-07-18,EG,United Kingdom,7556,1729,968,16,5827,2449,2410,4859,952
2022-07-19,EG,United Kingdom,7363,1747,880,20,5616,2375,2361,4736,860
2022-07-20,EG,United Kingdom,7355,1689,853,15,5666,2415,2398,4813,838
2022-07-21,EG,United Kingdom,7545,1726,934,25,5819,2465,2420,4885,909
2022-07-22,EG,United Kingdom,7598,1613,976,14,5985,2500,2509,5009,962
2022-07-23,EG,United Kingdom,7044,1669,562,5,5375,2421,2392,4813,557
2022-07-24,EG,United Kingdom,7182,1685,675,7,5497,2387,2435,4822,668
2022-07-25,EG,United Kingdom,7432,1707,932,15,5725,2401,2392,4793,917
2022-07-26,EG,United Kingdom,7253,1655,881,19,5598,2364,2353,4717,862
2022-07-27,EG,United Kingdom,7127,1600,868,15,5527,2326,2333,4659,853
2022-07-28,EG,United Kingdom,7402,1700,919,15,5702,2396,2387,4783,904
2022-07-29,EG,United Kingdom,7598,1708,954,17,5890,2466,2470,4936,937
2022-07-30,EG,United Kingdom,7001,1630,594,6,5371,2407,2370,4777,588
2022-07-31,EG,United Kingdom,7169,1679,707,8,5490,2373,2410,4783,699
2022-08-01,EG,United Kingdom,7359,1624,938,15,5735,2402,2395,4797,923
2022-08-02,EG,United Kingdom,7213,1651,818,21,5562,2368,2376,4744,797
2022-08-03,EG,United Kingdom,7250,1686,862,15,5564,2354,2348,4702,847
2022-08-04,EG,United Kingdom,7309,1701,898,24,5608,2359,2351,4710,874
2022-08-05,EG,United Kingdom,7467,1666,935,15,5801,2460,2406,4866,920
2022-08-06,EG,United Kingdom,7019,1713,574,9,5306,2364,2368,4732,565
2022-08-07,EG,United Kingdom,7173,1730,700,10,5443,2362,2381,4743,690
2022-08-08,EG,United Kingdom,7371,1709,909,23,5662,2385,2368,4753,886
2022-08-09,EG,United Kingdom,7176,1659,864,25,5517,2314,2339,4653,839
2022-08-10,EG,United Kingdom,7213,1692,874,23,5521,2326,2321,4647,851
2022-08-11,EG,United Kingdom,7316,1681,893,25,5635,2367,2375,4742,868
2022-08-12,EG,United Kingdom,7434,1665,924,15,5769,2421,2424,4845,909
2022-08-13,EG,United Kingdom,6941,1697,571,9,5244,2335,2338,4673,562
2022-08-14,EG,United Kingdom,7150,1702,697,17,5448,2386,2365,4751,680
2022-08-15,EG,United Kingdom,7354,1717,857,12,5637,2394,2386,4780,845
2022-08-16,EG,United Kingdom,7239,1627,884,14,5612,2348,2380,4728,870
2022-08-17,EG,United Kingdom,7005,1655,833,10,5350,2265,2252,4517,823
2022-08-18,EG,United Kingdom,7350,1710,870,26,5640,2364,2406,4770,844
2022-08-19,EG,United Kingdom,7490,1664,947,16,5826,2450,2429,4879,931
2022-08-20,EG,United Kingdom,6921,1618,567,3,5303,2382,2354,4736,564
2022-08-21,EG,United Kingdom,7102,1653,696,8,5449,2372,2381,4753,688
2022-08-22,EG,United Kingdom,7407,1705,912,18,5702,2398,2392,4790,894
2022-08-23,EG,United Kingdom,7131,1641,852,20,5490,2313,2325,4638,832
2022-08-24,EG,United Kingdom,7336,1661,888,20,5675,2389,2398,4787,868
2022-08-25,EG,United Kingdom,7313,1593,914,14,5720,2422,2384,4806,900
2022-08-26,EG,United Kingdom,7592,1671,963,22,5921,2478,2480,4958,941
2022-08-27,EG,United Kingdom,6946,1670,592,13,5276,2336,2348,4684,579
2022-08-28,EG,United Kingdom,7289,1744,700,3,5545,2421,2424,4845,697
2022-08-29,EG,United Kingdom,7403,1707,850,5,5696,2407,2439,4846,845
2022-08-30,EG,United Kingdom,7451,1678,884,13,5773,2440,2449,4889,871
2022-08-31,EG,United Kingdom,7377,1662,870,16,5715,2408,2437,4845,854
2022-09-01,EG,United Kingdom,7600,1719,919,14,5881,2503,2459,4962,905
2022-09-02,EG,United Kingdom,7511,1566,967,23,5945,2488,2490,4978,944
2022-09-03,EG,United Kingdom,6942,1599,585,6,5343,2370,2388,4758,579
2022-09-04,EG,United Kingdom,7273,1667,716,14,5606,2440,2450,4890,702
2022-09-05,EG,United Kingdom,7449,1623,951,14,5826,2444,2431,4875,937
2022-09-06,EG,United Kingdom,7258,1625,871,22,5633,2378,2384,4762,849
2022-09-07,EG,United Kingdom,7423,1726,887,16,5697,2399,2411,4810,871
2022-09-08,EG,United Kingdom,7263,1666,901,20,5597,2370,2326,4696,881
2022-09-09,EG,United Kingdom,7425,1642,884,12,5783,2452,2447,4899,872
2022-09-10,EG,United Kingdom,6758,1600,583,3,5158,2295,2280,4575,580
2022-09-11,EG,United Kingdom,7240,1705,713,7,5535,2397,2425,4822,706
2022-09-12,EG,United Kingdom,7508,1740,933,20,5768,2408,2427,4835,913
2022-09-13,EG,United Kingdom,7276,1637,881,24,5639,2391,2367,4758,857
2022-09-14,EG,United Kingdom,7333,1659,945,21,5674,2343,2386,4729,924
2022-09-15,EG,United Kingdom,7438,1626,947,20,5812,2456,2409,4865,927
2022-09-16,EG,United Kingdom,7111,1634,951,17,5477,2268,2258,4526,934
2022-09-17,EG,United Kingdom,6969,1712,608,11,5257,2318,2331,4649,597
2022-09-18,EG,United Kingdom,7217,1699,701,9,5518,2398,2419,4817,692
2022-09-19,EG,United Kingdom,6935,1680,710,6,5255,2297,2248,4545,704
2022-09-20,EG,United Kingdom,7137,1531,874,20,5606,2357,2375,4732,854
2022-09-21,EG,United Kingdom,7251,1628,924,22,5623,2348,2351,4699,902
2022-09-22,EG,United Kingdom,7485,1673,949,25,5812,2440,2423,4863,924
2022-09-23,EG,United Kingdom,7593,1675,975,18,5918,2472,2471,4943,957
2022-09-24,EG,United Kingdom,6693,1632,577,8,5061,2235,2249,4484,569
2022-09-25,EG,United Kingdom,7022,1575,711,5,5447,2352,2384,4736,706
2022-09-26,EG,United Kingdom,7295,1546,945,20,5749,2397,2407,4804,925
2022-09-27,EG,United Kingdom,6955,1464,904,20,5491,2307,2280,4587,884
2022-09-28,EG,United Kingdom,7049,1552,927,15,5497,2285,2285,4570,912
2022-09-29,EG,United Kingdom,7137,1620,944,18,5517,2280,2293,4573,926
2022-09-30,EG,United Kingdom,7253,1618,848,9,5635,2395,2392,4787,839
2022-10-01,EG,United Kingdom,6378,1445,592,5,4933,2174,2167,4341,587
2022-10-02,EG,United Kingdom,6880,1546,742,4,5334,2301,2291,4592,738
2022-10-03,EG,United Kingdom,7141,1551,927,11,5590,2331,2332,4663,916
2022-10-04,EG,United Kingdom,6781,1430,909,9,5351,2218,2224,4442,900
2022-10-05,EG,United Kingdom,6788,1496,897,11,5292,2194,2201,4395,886
2022-10-06,EG,United Kingdom,7003,1410,956,17,5593,2327,2310,4637,939
2022-10-07,EG,United Kingdom,7173,1512,911,10,5661,2366,2384,4750,901
2022-10-08,EG,United Kingdom,6397,1508,579,3,4889,2163,2147,4310,576
2022-10-09,EG,United Kingdom,6804,1571,693,7,5233,2242,2298,4540,686
2022-10-10,EG,United Kingdom,7003,1495,920,17,5508,2313,2275,4588,903
2022-10-11,EG,United Kingdom,6895,1518,888,11,5377,2228,2261,4489,877
2022-10-12,EG,United Kingdom,6840,1491,917,20,5349,2214,2218,4432,897
2022-10-13,EG,United Kingdom,6937,1458,882,19,5479,2308,2289,4597,863
2022-10-14,EG,United Kingdom,7175,1497,944,8,5678,2371,2363,4734,936
2022-10-15,EG,United Kingdom,6429,1526,572,3,4903,2186,2145,4331,569
2022-10-16,EG,United Kingdom,6829,1575,734,1,5254,2264,2256,4520,733
2022-10-17,EG,United Kingdom,6897,1487,910,20,5410,2257,2243,4500,890
2022-10-18,EG,United Kingdom,6719,1433,892,21,5286,2188,2206,4394,871
2022-10-19,EG,United Kingdom,6678,1443,918,12,5235,2170,2147,4317,906
2022-10-20,EG,United Kingdom,6948,1539,889,10,5409,2258,2262,4520,879
2022-10-21,EG,United Kingdom,6950,1531,902,16,5419,2268,2249,4517,886
2022-10-22,EG,United Kingdom,6478,1504,596,5,4974,2197,2181,4378,591
2022-10-23,EG,United Kingdom,6445,1562,600,6,4883,2140,2143,4283,594
2022-10-24,EG,United Kingdom,6971,1629,888,13,5342,2219,2235,4454,875
2022-10-25,EG,United Kingdom,6764,1458,872,14,5306,2227,2207,4434,858
2022-10-26,EG,United Kingdom,6687,1465,845,12,5222,2172,2205,4377,833
2022-10-27,EG,United Kingdom,6973,1457,946,15,5516,2279,2291,4570,931
2022-10-28,EG,United Kingdom,7175,1522,941,16,5653,2366,2346,4712,925
2022-10-29,EG,United Kingdom,6423,1514,580,3,4909,2150,2179,4329,577
2022-10-30,EG,United Kingdom,6460,1374,682,1,5086,2183,2221,4404,681
2022-10-31,EG,United Kingdom,6466,1333,916,16,5133,2115,2102,4217,900
2022-11-01,EG,United Kingdom,5706,1296,810,16,4410,1810,1790,3600,794
2022-11-02,EG,United Kingdom,5512,1207,790,25,4305,1777,1738,3515,765
2022-11-03,EG,United Kingdom,5979,1317,902,18,4662,1866,1894,3760,884
2022-11-04,EG,United Kingdom,6201,1324,899,20,4877,2001,1977,3978,879
2022-11-05,EG,United Kingdom,5249,1334,510,2,3915,1728,1677,3405,508
2022-11-06,EG,United Kingdom,5831,1335,616,5,4496,1935,1945,3880,611
2022-11-07,EG,United Kingdom,5922,1269,858,11,4653,1891,1904,3795,847
2022-11-08,EG,United Kingdom,5339,1187,801,20,4152,1675,1676,3351,781
2022-11-09,EG,United Kingdom,5315,1167,838,25,4148,1652,1658,3310,813
2022-11-10,EG,United Kingdom,5794,1263,897,20,4531,1810,1824,3634,877
2022-11-11,EG,United Kingdom,6055,1322,855,15,4733,1929,1949,3878,840
2022-11-12,EG,United Kingdom,5133,1323,529,14,3810,1657,1624,3281,515
2022-11-13,EG,United Kingdom,5772,1363,635,8,4409,1885,1889,3774,627
2022-11-14,EG,United Kingdom,5745,1291,831,8,4454,1816,1807,3623,823
2022-11-15,EG,United Kingdom,5275,1183,817,17,4092,1640,1635,3275,800
2022-11-16,EG,United Kingdom,5240,1236,793,16,4004,1615,1596,3211,777
2022-11-17,EG,United Kingdom,5495,1182,818,22,4313,1743,1752,3495,796
2022-11-18,EG,United Kingdom,6039,1335,862,13,4704,1928,1914,3842,849
2022-11-19,EG,United Kingdom,5009,1296,504,8,3713,1617,1592,3209,496
2022-11-20,EG,United Kingdom,5645,1293,645,8,4352,1838,1869,3707,637
2022-11-21,EG,United Kingdom,5700,1241,813,14,4459,1814,1832,3646,799
2022-11-22,EG,United Kingdom,5051,1152,789,24,3899,1567,1543,3110,765
2022-11-23,EG,United Kingdom,5055,1183,777,22,3872,1544,1551,3095,755
2022-11-24,EG,United Kingdom,5401,1175,807,12,4226,1692,1727,3419,795
2022-11-25,EG,United Kingdom,5861,1200,861,11,4661,1896,1904,3800,850
2022-11-26,EG,United Kingdom,4830,1279,436,5,3551,1571,1544,3115,431
2022-11-27,EG,United Kingdom,5542,1261,596,6,4281,1844,1841,3685,590
2022-11-28,EG,United Kingdom,5743,1257,815,18,4486,1831,1840,3671,797
2022-11-29,EG,United Kingdom,5122,1183,774,10,3939,1591,1574,3165,764
2022-11-30,EG,United Kingdom,5273,1199,795,7,4074,1620,1659,3279,788
2022-12-01,EG,United Kingdom,5512,1246,761,10,4266,1752,1753,3505,751
2022-12-02,EG,United Kingdom,6055,1288,875,12,4767,1954,1938,3892,863
2022-12-03,EG,United Kingdom,5011,1312,514,8,3699,1595,1590,3185,506
2022-12-04,EG,United Kingdom,5759,1348,624,6,4411,1902,1885,3787,618
2022-12-05,EG,United Kingdom,5893,1244,872,14,4649,1878,1899,3777,858
2022-12-06,EG,United Kingdom,5462,1187,892,23,4275,1681,1702,3383,869
2022-12-07,EG,United Kingdom,5469,1208,836,11,4261,1714,1711,3425,825
2022-12-08,EG,United Kingdom,5825,1245,873,21,4580,1852,1855,3707,852
2022-12-09,EG,United Kingdom,5934,1189,895,18,4745,1934,1916,3850,877
2022-12-10,EG,United Kingdom,5190,1319,492,10,3871,1700,1679,3379,482
2022-12-11,EG,United Kingdom,5102,1344,488,4,3758,1656,1614,3270,484
2022-12-12,EG,United Kingdom,5338,1203,719,9,4135,1679,1737,3416,710
2022-12-13,EG,United Kingdom,5380,1188,771,11,4192,1708,1713,3421,760
2022-12-14,EG,United Kingdom,5476,1171,765,11,4305,1791,1749,3540,754
2022-12-15,EG,United Kingdom,5762,1269,794,14,4493,1841,1858,3699,780
2022-12-16,EG,United Kingdom,6173,1281,833,14,4892,2027,2032,4059,819
2022-12-17,EG,United Kingdom,5725,1414,519,4,4311,1942,1850,3792,515
2022-12-18,EG,United Kingdom,5856,1417,602,5,4439,1917,1920,3837,597
2022-12-19,EG,United Kingdom,6097,1355,778,10,4742,1981,1983,3964,768
2022-12-20,EG,United Kingdom,5908,1307,876,24,4601,1863,1862,3725,852
2022-12-21,EG,United Kingdom,5645,1020,861,15,4625,1881,1883,3764,846
2022-12-22,EG,United Kingdom,6158,1364,827,13,4794,1989,1978,3967,814
2022-12-23,EG,United Kingdom,6201,1343,874,3,4858,1985,1999,3984,871
2022-12-24,EG,United Kingdom,4612,1129,394,3,3483,1541,1548,3089,391
2022-12-25,EG,United Kingdom,2211,759,39,0,1452,696,717,1413,39
2022-12-26,EG,United Kingdom,5355,1223,482,1,4132,1833,1817,3650,481
2022-12-27,EG,United Kingdom,5631,1216,694,2,4415,1871,1850,3721,692
