entry_date,country_icao_code,country_name,flt_daio,flt_o,flt_i,flt_c,flt_dai,flt_d,flt_a,flt_da,flt_i_excl_c
2023-01-01,LA,Albania,576,490,0,0,86,41,45,86,0
2023-01-02,LA,Albania,521,414,0,0,107,53,54,107,0
2023-01-03,LA,Albania,526,435,0,0,91,46,45,91,0
2023-01-04,LA,Albania,504,403,0,0,101,50,51,101,0
2023-01-05,LA,Albania,508,403,0,0,105,52,53,105,0
2023-01-06,LA,Albania,621,513,0,0,108,55,53,108,0
2023-01-07,LA,Albania,642,550,0,0,92,46,46,92,0
2023-01-08,LA,Albania,639,537,0,0,102,51,51,102,0
2023-01-09,LA,Albania,444,343,0,0,101,50,51,101,0
2023-01-10,LA,Albania,436,339,0,0,97,49,48,97,0
2023-01-11,LA,Albania,446,356,0,0,90,46,44,90,0
2023-01-12,LA,Albania,430,343,0,0,87,43,44,87,0
2023-01-13,LA,Albania,478,378,0,0,100,50,50,100,0
2023-01-14,LA,Albania,529,442,0,0,87,43,44,87,0
2023-01-15,LA,Albania,572,470,0,0,102,50,52,102,0
2023-01-16,LA,Albania,461,365,0,0,96,49,47,96,0
2023-01-17,LA,Albania,373,284,0,0,89,45,44,89,0
2023-01-18,LA,Albania,377,292,0,0,85,43,42,85,0
2023-01-19,LA,Albania,425,337,0,0,88,43,45,88,0
2023-01-20,LA,Albania,460,365,0,0,95,49,46,95,0
2023-01-21,LA,Albania,475,397,0,0,78,39,39,78,0
2023-01-22,LA,Albania,546,448,0,0,98,48,50,98,0
2023-01-23,LA,Albania,390,298,0,0,92,46,46,92,0
2023-01-24,LA,Albania,388,299,0,0,89,44,45,89,0
2023-01-25,LA,Albania,390,307,0,0,83,42,41,83,0
2023-01-26,LA,Albania,400,320,0,0,80,40,40,80,0
2023-01-27,LA,Albania,477,381,0,0,96,48,48,96,0
2023-01-28,LA,Albania,474,396,0,0,78,40,38,78,0
2023-01-29,LA,Albania,528,432,0,0,96,45,51,96,0
2023-01-30,LA,Albania,403,311,0,0,92,49,43,92,0
2023-01-31,LA,Albania,410,323,0,0,87,43,44,87,0
2023-02-01,LA,Albania,445,369,0,0,76,38,38,76,0
2023-02-02,LA,Albania,468,386,0,0,82,40,42,82,0
2023-02-03,LA,Albania,505,408,0,0,97,50,47,97,0
2023-02-04,LA,Albania,598,524,0,0,74,37,37,74,0
2023-02-05,LA,Albania,582,483,0,0,99,49,50,99,0
2023-02-06,LA,Albania,468,380,0,0,88,44,44,88,0
2023-02-07,LA,Albania,444,363,1,1,81,39,41,80,0
2023-02-08,LA,Albania,478,395,0,0,83,41,42,83,0
2023-02-09,LA,Albania,426,335,0,0,91,47,44,91,0
2023-02-10,LA,Albania,505,409,0,0,96,49,47,96,0
2023-02-11,LA,Albania,505,431,0,0,74,36,38,74,0
2023-02-12,LA,Albania,564,465,0,0,99,50,49,99,0
2023-02-13,LA,Albania,448,347,0,0,101,49,52,101,0
2023-02-14,LA,Albania,431,349,0,0,82,41,41,82,0
2023-02-15,LA,Albania,440,358,0,0,82,41,41,82,0
2023-02-16,LA,Albania,458,369,0,0,89,45,44,89,0
2023-02-17,LA,Albania,498,406,0,0,92,47,45,92,0
2023-02-18,LA,Albania,584,510,0,0,74,37,37,74,0
2023-02-19,LA,Albania,581,483,0,0,98,48,50,98,0
2023-02-20,LA,Albania,440,345,0,0,95,48,47,95,0
2023-02-21,LA,Albania,416,333,0,0,83,41,42,83,0
2023-02-22,LA,Albania,462,380,0,0,82,42,40,82,0
2023-02-23,LA,Albania,445,357,0,0,88,43,45,88,0
2023-02-24,LA,Albania,506,412,0,0,94,48,46,94,0
2023-02-25,LA,Albania,539,460,0,0,79,39,40,79,0
2023-02-26,LA,Albania,590,485,1,1,105,53,51,104,0
2023-02-27,LA,Albania,453,361,0,0,92,45,47,92,0
2023-02-28,LA,Albania,365,280,0,0,85,43,42,85,0
2023-03-01,LA,Albania,397,317,0,0,80,40,40,80,0
2023-03-02,LA,Albania,410,322,0,0,88,42,46,88,0
2023-03-03,LA,Albania,487,382,0,0,105,55,50,105,0
2023-03-04,LA,Albania,516,438,0,0,78,39,39,78,0
2023-03-05,LA,Albania,583,483,0,0,100,48,52,100,0
2023-03-06,LA,Albania,450,347,0,0,103,53,50,103,0
2023-03-07,LA,Albania,394,307,0,0,87,41,46,87,0
2023-03-08,LA,Albania,481,388,0,0,93,48,45,93,0
2023-03-09,LA,Albania,517,425,0,0,92,45,47,92,0
2023-03-10,LA,Albania,498,400,0,0,98,50,48,98,0
2023-03-11,LA,Albania,578,494,0,0,84,41,43,84,0
2023-03-12,LA,Albania,562,461,0,0,101,51,50,101,0
2023-03-13,LA,Albania,437,332,0,0,105,54,51,105,0
2023-03-14,LA,Albania,473,379,1,1,94,46,47,93,0
2023-03-15,LA,Albania,499,404,0,0,95,48,47,95,0
2023-03-16,LA,Albania,438,354,0,0,84,41,43,84,0
2023-03-17,LA,Albania,557,456,0,0,101,53,48,101,0
2023-03-18,LA,Albania,599,524,0,0,75,36,39,75,0
2023-03-19,LA,Albania,666,562,0,0,104,52,52,104,0
2023-03-20,LA,Albania,527,428,0,0,99,49,50,99,0
2023-03-21,LA,Albania,457,375,0,0,82,41,41,82,0
2023-03-22,LA,Albania,469,375,0,0,94,48,46,94,0
2023-03-23,LA,Albania,439,349,0,0,90,44,46,90,0
2023-03-24,LA,Albania,530,429,0,0,101,52,49,101,0
2023-03-25,LA,Albania,632,549,0,0,83,41,42,83,0
2023-03-26,LA,Albania,708,597,0,0,111,55,56,111,0
2023-03-27,LA,Albania,498,382,0,0,116,56,60,116,0
2023-03-28,LA,Albania,550,422,0,0,128,65,63,128,0
2023-03-29,LA,Albania,609,497,0,0,112,56,56,112,0
2023-03-30,LA,Albania,591,470,0,0,121,60,61,121,0
2023-03-31,LA,Albania,668,536,0,0,132,67,65,132,0
2023-04-01,LA,Albania,829,721,0,0,108,53,55,108,0
2023-04-02,LA,Albania,751,637,0,0,114,58,56,114,0
2023-04-03,LA,Albania,599,473,0,0,126,62,64,126,0
2023-04-04,LA,Albania,586,461,0,0,125,64,61,125,0
2023-04-05,LA,Albania,581,461,0,0,120,59,61,120,0
2023-04-06,LA,Albania,608,485,0,0,123,61,62,123,0
2023-04-07,LA,Albania,688,557,0,0,131,66,65,131,0
2023-04-08,LA,Albania,795,680,0,0,115,57,58,115,0
2023-04-09,LA,Albania,734,612,1,0,122,61,60,121,1
2023-04-10,LA,Albania,660,538,0,0,122,59,63,122,0
2023-04-11,LA,Albania,626,503,1,1,123,61,61,122,0
2023-04-12,LA,Albania,646,524,0,0,122,62,60,122,0
2023-04-13,LA,Albania,666,544,0,0,122,61,61,122,0
2023-04-14,LA,Albania,752,611,0,0,141,70,71,141,0
2023-04-15,LA,Albania,821,706,0,0,115,57,58,115,0
2023-04-16,LA,Albania,765,644,0,0,121,61,60,121,0
2023-04-17,LA,Albania,626,507,0,0,119,58,61,119,0
2023-04-18,LA,Albania,622,489,0,0,133,68,65,133,0
2023-04-19,LA,Albania,556,437,0,0,119,61,58,119,0
2023-04-20,LA,Albania,652,529,0,0,123,60,63,123,0
2023-04-21,LA,Albania,727,598,0,0,129,64,65,129,0
2023-04-22,LA,Albania,889,770,0,0,119,59,60,119,0
2023-04-23,LA,Albania,839,723,0,0,116,60,56,116,0
2023-04-24,LA,Albania,678,558,0,0,120,59,61,120,0
2023-04-25,LA,Albania,682,555,0,0,127,65,62,127,0
2023-04-26,LA,Albania,707,589,0,0,118,58,60,118,0
2023-04-27,LA,Albania,686,559,0,0,127,63,64,127,0
2023-04-28,LA,Albania,797,663,0,0,134,67,67,134,0
2023-04-29,LA,Albania,941,828,0,0,113,57,56,113,0
2023-04-30,LA,Albania,953,833,0,0,120,60,60,120,0
2023-05-01,LA,Albania,784,656,0,0,128,64,64,128,0
2023-05-02,LA,Albania,697,561,0,0,136,67,69,136,0
2023-05-03,LA,Albania,664,546,0,0,118,60,58,118,0
2023-05-04,LA,Albania,704,581,0,0,123,61,62,123,0
2023-05-05,LA,Albania,836,693,0,0,143,71,72,143,0
2023-05-06,LA,Albania,1007,892,0,0,115,58,57,115,0
2023-05-07,LA,Albania,941,821,0,0,120,60,60,120,0
2023-05-08,LA,Albania,787,655,0,0,132,65,67,132,0
2023-05-09,LA,Albania,725,592,0,0,133,66,67,133,0
2023-05-10,LA,Albania,718,591,0,0,127,63,64,127,0
2023-05-11,LA,Albania,683,557,0,0,126,64,62,126,0
2023-05-12,LA,Albania,834,692,0,0,142,70,72,142,0
2023-05-13,LA,Albania,986,865,0,0,121,61,60,121,0
2023-05-14,LA,Albania,922,796,0,0,126,64,62,126,0
2023-05-15,LA,Albania,834,695,0,0,139,67,72,139,0
2023-05-16,LA,Albania,792,654,0,0,138,70,68,138,0
2023-05-17,LA,Albania,771,641,0,0,130,65,65,130,0
2023-05-18,LA,Albania,776,651,0,0,125,62,63,125,0
2023-05-19,LA,Albania,917,786,0,0,131,64,67,131,0
2023-05-20,LA,Albania,1100,975,0,0,125,62,63,125,0
2023-05-21,LA,Albania,1039,905,0,0,134,69,65,134,0
2023-05-22,LA,Albania,914,773,0,0,141,70,71,141,0
2023-05-23,LA,Albania,857,715,0,0,142,71,71,142,0
2023-05-24,LA,Albania,940,811,0,0,129,65,64,129,0
2023-05-25,LA,Albania,897,761,0,0,136,67,69,136,0
2023-05-26,LA,Albania,1049,895,0,0,154,79,75,154,0
2023-05-27,LA,Albania,1143,1018,0,0,125,61,64,125,0
2023-05-28,LA,Albania,1089,955,0,0,134,69,65,134,0
2023-05-29,LA,Albania,933,783,0,0,150,74,76,150,0
2023-05-30,LA,Albania,912,778,0,0,134,66,68,134,0
2023-05-31,LA,Albania,903,769,0,0,134,68,66,134,0
2023-06-01,LA,Albania,956,812,0,0,144,70,74,144,0
2023-06-02,LA,Albania,1058,892,0,0,166,83,83,166,0
2023-06-03,LA,Albania,1198,1063,0,0,135,68,67,135,0
2023-06-04,LA,Albania,1073,941,0,0,132,67,65,132,0
2023-06-05,LA,Albania,1015,855,0,0,160,80,80,160,0
2023-06-06,LA,Albania,905,754,0,0,151,75,76,151,0
2023-06-07,LA,Albania,976,840,0,0,136,67,69,136,0
2023-06-08,LA,Albania,856,708,0,0,148,74,74,148,0
2023-06-09,LA,Albania,1028,863,0,0,165,83,82,165,0
2023-06-10,LA,Albania,1201,1056,0,0,145,72,73,145,0
2023-06-11,LA,Albania,1186,1033,0,0,153,78,75,153,0
2023-06-12,LA,Albania,1039,871,0,0,168,83,85,168,0
2023-06-13,LA,Albania,1009,858,1,0,151,74,76,150,1
2023-06-14,LA,Albania,1016,875,0,0,141,70,71,141,0
2023-06-15,LA,Albania,974,814,0,0,160,78,82,160,0
2023-06-16,LA,Albania,1000,825,0,0,175,89,86,175,0
2023-06-17,LA,Albania,1181,1034,0,0,147,75,72,147,0
2023-06-18,LA,Albania,1198,1053,0,0,145,75,70,145,0
2023-06-19,LA,Albania,1077,903,0,0,174,84,90,174,0
2023-06-20,LA,Albania,1022,858,0,0,164,81,83,164,0
2023-06-21,LA,Albania,1052,899,1,1,153,76,76,152,0
2023-06-22,LA,Albania,1022,866,0,0,156,78,78,156,0
2023-06-23,LA,Albania,1130,954,0,0,176,88,88,176,0
2023-06-24,LA,Albania,1330,1165,0,0,165,83,82,165,0
2023-06-25,LA,Albania,1214,1063,0,0,151,77,74,151,0
2023-06-26,LA,Albania,1162,979,0,0,183,89,94,183,0
2023-06-27,LA,Albania,1109,943,0,0,166,82,84,166,0
2023-06-28,LA,Albania,1128,969,0,0,159,81,78,159,0
2023-06-29,LA,Albania,1104,936,0,0,168,84,84,168,0
2023-06-30,LA,Albania,1194,1016,0,0,178,89,89,178,0
2023-07-01,LA,Albania,1327,1161,0,0,166,83,83,166,0
2023-07-02,LA,Albania,1287,1119,0,0,168,86,82,168,0
2023-07-03,LA,Albania,1176,973,0,0,203,98,105,203,0
2023-07-04,LA,Albania,1220,1045,0,0,175,88,87,175,0
2023-07-05,LA,Albania,1136,961,1,0,175,88,86,174,1
2023-07-06,LA,Albania,1187,1007,0,0,180,87,93,180,0
2023-07-07,LA,Albania,1217,1022,1,0,195,100,94,194,1
2023-07-08,LA,Albania,1373,1206,0,0,167,82,85,167,0
2023-07-09,LA,Albania,1361,1193,0,0,168,86,82,168,0
2023-07-10,LA,Albania,1258,1051,0,0,207,100,107,207,0
2023-07-11,LA,Albania,1247,1078,0,0,169,86,83,169,0
2023-07-12,LA,Albania,1222,1050,1,0,172,86,85,171,1
2023-07-13,LA,Albania,1242,1066,0,0,176,86,90,176,0
2023-07-14,LA,Albania,1308,1113,0,0,195,99,96,195,0
2023-07-15,LA,Albania,1453,1288,0,0,165,82,83,165,0
2023-07-16,LA,Albania,1426,1263,0,0,163,83,80,163,0
2023-07-17,LA,Albania,1201,990,0,0,211,105,106,211,0
2023-07-18,LA,Albania,1149,963,0,0,186,92,94,186,0
2023-07-19,LA,Albania,1160,983,2,0,177,89,86,175,2
2023-07-20,LA,Albania,1196,1018,0,0,178,86,92,178,0
2023-07-21,LA,Albania,1262,1057,0,0,205,106,99,205,0
2023-07-22,LA,Albania,1415,1250,0,0,165,82,83,165,0
2023-07-23,LA,Albania,1325,1160,0,0,165,82,83,165,0
2023-07-24,LA,Albania,1189,985,0,0,204,101,103,204,0
2023-07-25,LA,Albania,1251,1072,0,0,179,92,87,179,0
2023-07-26,LA,Albania,1261,1085,0,0,176,89,87,176,0
2023-07-27,LA,Albania,1201,1014,0,0,187,91,96,187,0
2023-07-28,LA,Albania,1270,1072,0,0,198,100,98,198,0
2023-07-29,LA,Albania,1409,1236,0,0,173,88,85,173,0
2023-07-30,LA,Albania,1394,1220,0,0,174,87,87,174,0
2023-07-31,LA,Albania,1241,1038,0,0,203,101,102,203,0
2023-08-01,LA,Albania,1217,1031,0,0,186,91,95,186,0
2023-08-02,LA,Albania,1255,1077,2,0,178,90,86,176,2
2023-08-03,LA,Albania,1181,995,0,0,186,88,98,186,0
2023-08-04,LA,Albania,1127,930,0,0,197,100,97,197,0
2023-08-05,LA,Albania,1424,1260,0,0,164,85,79,164,0
2023-08-06,LA,Albania,1309,1137,0,0,172,87,85,172,0
2023-08-07,LA,Albania,1222,1016,0,0,206,103,103,206,0
2023-08-08,LA,Albania,1196,1017,0,0,179,88,91,179,0
2023-08-09,LA,Albania,1194,1018,2,0,176,88,86,174,2
2023-08-10,LA,Albania,1256,1075,0,0,181,87,94,181,0
2023-08-11,LA,Albania,1265,1062,0,0,203,104,99,203,0
2023-08-12,LA,Albania,1390,1219,0,0,171,86,85,171,0
2023-08-13,LA,Albania,1317,1144,0,0,173,87,86,173,0
2023-08-14,LA,Albania,1203,1000,0,0,203,100,103,203,0
2023-08-15,LA,Albania,1249,1065,0,0,184,92,92,184,0
2023-08-16,LA,Albania,1205,1023,1,0,182,92,89,181,1
2023-08-17,LA,Albania,1180,1002,0,0,178,88,90,178,0
2023-08-18,LA,Albania,1297,1096,0,0,201,100,101,201,0
2023-08-19,LA,Albania,1408,1234,1,1,174,87,86,173,0
2023-08-20,LA,Albania,1358,1182,0,0,176,90,86,176,0
2023-08-21,LA,Albania,1273,1067,0,0,206,100,106,206,0
2023-08-22,LA,Albania,1228,1041,0,0,187,92,95,187,0
2023-08-23,LA,Albania,1265,1087,0,0,178,92,86,178,0
2023-08-24,LA,Albania,1156,976,0,0,180,86,94,180,0
2023-08-25,LA,Albania,1268,1065,0,0,203,105,98,203,0
2023-08-26,LA,Albania,1369,1199,0,0,170,87,83,170,0
2023-08-27,LA,Albania,1354,1179,0,0,175,88,87,175,0
2023-08-28,LA,Albania,1093,885,0,0,208,100,108,208,0
2023-08-29,LA,Albania,1259,1068,0,0,191,98,93,191,0
2023-08-30,LA,Albania,1148,969,0,0,179,90,89,179,0
2023-08-31,LA,Albania,1134,951,0,0,183,91,92,183,0
2023-09-01,LA,Albania,1201,1004,0,0,197,99,98,197,0
2023-09-02,LA,Albania,1398,1227,0,0,171,86,85,171,0
2023-09-03,LA,Albania,1308,1129,0,0,179,90,89,179,0
2023-09-04,LA,Albania,1176,975,0,0,201,99,102,201,0
2023-09-05,LA,Albania,1055,888,0,0,167,84,83,167,0
2023-09-06,LA,Albania,1125,961,0,0,164,82,82,164,0
2023-09-07,LA,Albania,1051,875,0,0,176,86,90,176,0
2023-09-08,LA,Albania,1159,962,0,0,197,100,97,197,0
2023-09-09,LA,Albania,1338,1176,0,0,162,83,79,162,0
2023-09-10,LA,Albania,1281,1113,0,0,168,84,84,168,0
2023-09-11,LA,Albania,1115,915,0,0,200,97,103,200,0
2023-09-12,LA,Albania,1063,892,0,0,171,87,84,171,0
2023-09-13,LA,Albania,1091,926,0,0,165,83,82,165,0
2023-09-14,LA,Albania,1032,864,0,0,168,83,85,168,0
2023-09-15,LA,Albania,1100,918,0,0,182,91,91,182,0
2023-09-16,LA,Albania,1269,1107,0,0,162,82,80,162,0
2023-09-17,LA,Albania,1163,1003,0,0,160,80,80,160,0
2023-09-18,LA,Albania,1032,853,0,0,179,89,90,179,0
2023-09-19,LA,Albania,1080,918,0,0,162,82,80,162,0
2023-09-20,LA,Albania,1089,951,0,0,138,71,67,138,0
2023-09-21,LA,Albania,942,812,0,0,130,66,64,130,0
2023-09-22,LA,Albania,1031,863,0,0,168,82,86,168,0
2023-09-23,LA,Albania,1205,1054,0,0,151,74,77,151,0
2023-09-24,LA,Albania,1152,997,1,1,155,79,75,154,0
2023-09-25,LA,Albania,927,763,0,0,164,81,83,164,0
2023-09-26,LA,Albania,1032,870,0,0,162,82,80,162,0
2023-09-27,LA,Albania,942,801,0,0,141,70,71,141,0
2023-09-28,LA,Albania,914,780,0,0,134,67,67,134,0
2023-09-29,LA,Albania,989,829,0,0,160,78,82,160,0
2023-09-30,LA,Albania,1223,1084,0,0,139,70,69,139,0
2023-10-01,LA,Albania,1143,997,0,0,146,75,71,146,0
2023-10-02,LA,Albania,956,793,0,0,163,80,83,163,0
2023-01-01,UD,Armenia,185,80,0,0,105,50,55,105,0
2023-01-02,UD,Armenia,207,97,0,0,110,56,54,110,0
2023-01-03,UD,Armenia,228,106,0,0,122,61,61,122,0
2023-01-04,UD,Armenia,204,103,0,0,101,50,51,101,0
2023-01-05,UD,Armenia,215,96,0,0,119,59,60,119,0
2023-01-06,UD,Armenia,225,104,0,0,121,60,61,121,0
2023-01-07,UD,Armenia,233,107,0,0,126,65,61,126,0
2023-01-08,UD,Armenia,250,101,0,0,149,71,78,149,0
2023-01-09,UD,Armenia,214,91,0,0,123,63,60,123,0
2023-01-10,UD,Armenia,219,100,0,0,119,60,59,119,0
2023-01-11,UD,Armenia,205,99,0,0,106,51,55,106,0
2023-01-12,UD,Armenia,193,80,0,0,113,55,58,113,0
2023-01-13,UD,Armenia,205,97,0,0,108,54,54,108,0
2023-01-14,UD,Armenia,226,98,0,0,128,66,62,128,0
2023-01-15,UD,Armenia,213,95,0,0,118,60,58,118,0
2023-01-16,UD,Armenia,178,80,0,0,98,48,50,98,0
2023-01-17,UD,Armenia,187,82,0,0,105,54,51,105,0
2023-01-18,UD,Armenia,185,91,0,0,94,46,48,94,0
2023-01-19,UD,Armenia,187,86,0,0,101,49,52,101,0
2023-01-20,UD,Armenia,194,92,0,0,102,52,50,102,0
2023-01-21,UD,Armenia,222,95,0,0,127,64,63,127,0
2023-01-22,UD,Armenia,188,86,0,0,102,51,51,102,0
2023-01-23,UD,Armenia,184,87,0,0,97,49,48,97,0
2023-01-24,UD,Armenia,185,85,0,0,100,50,50,100,0
2023-01-25,UD,Armenia,181,98,0,0,83,42,41,83,0
2023-01-26,UD,Armenia,182,87,0,0,95,47,48,95,0
2023-01-27,UD,Armenia,199,93,0,0,106,51,55,106,0
2023-01-28,UD,Armenia,230,106,0,0,124,61,63,124,0
2023-01-29,UD,Armenia,192,79,0,0,113,59,54,113,0
2023-01-30,UD,Armenia,194,93,0,0,101,50,51,101,0
2023-01-31,UD,Armenia,175,82,1,1,93,46,46,92,0
2023-02-01,UD,Armenia,181,96,0,0,85,42,43,85,0
2023-02-02,UD,Armenia,188,87,0,0,101,49,52,101,0
2023-02-03,UD,Armenia,200,103,0,0,97,51,46,97,0
2023-02-04,UD,Armenia,225,108,0,0,117,57,60,117,0
2023-02-05,UD,Armenia,195,92,0,0,103,51,52,103,0
2023-02-06,UD,Armenia,180,82,0,0,98,49,49,98,0
2023-02-07,UD,Armenia,176,82,0,0,94,49,45,94,0
2023-02-08,UD,Armenia,181,96,0,0,85,41,44,85,0
2023-02-09,UD,Armenia,204,105,1,1,99,49,49,98,0
2023-02-10,UD,Armenia,214,123,0,0,91,46,45,91,0
2023-02-11,UD,Armenia,242,124,0,0,118,60,58,118,0
2023-02-12,UD,Armenia,214,107,0,0,107,52,55,107,0
2023-02-13,UD,Armenia,190,103,0,0,87,45,42,87,0
2023-02-14,UD,Armenia,199,107,0,0,92,45,47,92,0
2023-02-15,UD,Armenia,200,116,0,0,84,43,41,84,0
2023-02-16,UD,Armenia,210,110,0,0,100,50,50,100,0
2023-02-17,UD,Armenia,212,109,0,0,103,51,52,103,0
2023-02-18,UD,Armenia,259,137,0,0,122,61,61,122,0
2023-02-19,UD,Armenia,209,102,0,0,107,53,54,107,0
2023-02-20,UD,Armenia,180,89,0,0,91,47,44,91,0
2023-02-21,UD,Armenia,192,96,0,0,96,47,49,96,0
2023-02-22,UD,Armenia,191,98,0,0,93,48,45,93,0
2023-02-23,UD,Armenia,188,84,0,0,104,52,52,104,0
2023-02-24,UD,Armenia,205,103,0,0,102,50,52,102,0
2023-02-25,UD,Armenia,241,111,0,0,130,66,64,130,0
2023-02-26,UD,Armenia,210,100,0,0,110,55,55,110,0
2023-02-27,UD,Armenia,180,86,0,0,94,47,47,94,0
2023-02-28,UD,Armenia,192,99,0,0,93,45,48,93,0
2023-03-01,UD,Armenia,212,116,0,0,96,49,47,96,0
2023-03-02,UD,Armenia,218,111,0,0,107,52,55,107,0
2023-03-03,UD,Armenia,207,102,0,0,105,54,51,105,0
2023-03-04,UD,Armenia,229,116,0,0,113,56,57,113,0
2023-03-05,UD,Armenia,209,98,1,1,111,55,55,110,0
2023-03-06,UD,Armenia,185,88,0,0,97,49,48,97,0
2023-03-07,UD,Armenia,190,95,0,0,95,48,47,95,0
2023-03-08,UD,Armenia,194,107,0,0,87,44,43,87,0
2023-03-09,UD,Armenia,199,97,0,0,102,49,53,102,0
2023-03-10,UD,Armenia,202,98,0,0,104,53,51,104,0
2023-03-11,UD,Armenia,230,108,0,0,122,59,63,122,0
2023-03-12,UD,Armenia,209,88,1,1,121,62,58,120,0
2023-03-13,UD,Armenia,193,88,1,1,105,52,52,104,0
2023-03-14,UD,Armenia,184,92,0,0,92,46,46,92,0
2023-03-15,UD,Armenia,197,110,0,0,87,43,44,87,0
2023-03-16,UD,Armenia,220,118,0,0,102,51,51,102,0
2023-03-17,UD,Armenia,208,111,0,0,97,49,48,97,0
2023-03-18,UD,Armenia,242,125,1,1,117,58,58,116,0
2023-03-19,UD,Armenia,223,107,0,0,116,58,58,116,0
2023-03-20,UD,Armenia,205,104,1,0,101,50,50,100,1
2023-03-21,UD,Armenia,203,115,0,0,88,45,43,88,0
2023-03-22,UD,Armenia,205,110,0,0,95,46,49,95,0
2023-03-23,UD,Armenia,212,104,0,0,108,53,55,108,0
2023-03-24,UD,Armenia,212,101,0,0,111,58,53,111,0
2023-03-25,UD,Armenia,259,133,0,0,126,65,61,126,0
2023-03-26,UD,Armenia,239,117,0,0,122,60,62,122,0
2023-03-27,UD,Armenia,181,90,0,0,91,46,45,91,0
2023-03-28,UD,Armenia,223,116,0,0,107,53,54,107,0
2023-03-29,UD,Armenia,230,129,0,0,101,51,50,101,0
2023-03-30,UD,Armenia,241,125,0,0,116,57,59,116,0
2023-03-31,UD,Armenia,244,144,0,0,100,51,49,100,0
2023-04-01,UD,Armenia,269,129,0,0,140,69,71,140,0
2023-04-02,UD,Armenia,240,114,0,0,126,62,64,126,0
2023-04-03,UD,Armenia,178,79,1,1,99,49,49,98,0
2023-04-04,UD,Armenia,216,107,0,0,109,53,56,109,0
2023-04-05,UD,Armenia,201,96,0,0,105,54,51,105,0
2023-04-06,UD,Armenia,218,108,0,0,110,52,58,110,0
2023-04-07,UD,Armenia,225,118,0,0,107,57,50,107,0
2023-04-08,UD,Armenia,239,115,0,0,124,59,65,124,0
2023-04-09,UD,Armenia,217,95,0,0,122,62,60,122,0
2023-04-10,UD,Armenia,183,85,0,0,98,48,50,98,0
2023-04-11,UD,Armenia,214,102,0,0,112,57,55,112,0
2023-04-12,UD,Armenia,205,103,1,1,102,52,49,101,0
2023-04-13,UD,Armenia,223,107,1,1,116,55,60,115,0
2023-04-14,UD,Armenia,219,108,0,0,111,57,54,111,0
2023-04-15,UD,Armenia,230,104,0,0,126,61,65,126,0
2023-04-16,UD,Armenia,214,99,0,0,115,59,56,115,0
2023-04-17,UD,Armenia,196,95,0,0,101,51,50,101,0
2023-04-18,UD,Armenia,220,106,0,0,114,56,58,114,0
2023-04-19,UD,Armenia,229,127,0,0,102,52,50,102,0
2023-04-20,UD,Armenia,263,146,0,0,117,55,62,117,0
2023-04-21,UD,Armenia,266,142,0,0,124,65,59,124,0
2023-04-22,UD,Armenia,261,117,0,0,144,70,74,144,0
2023-04-23,UD,Armenia,281,156,0,0,125,66,59,125,0
2023-04-24,UD,Armenia,243,134,0,0,109,53,56,109,0
2023-04-25,UD,Armenia,248,134,0,0,114,58,56,114,0
2023-04-26,UD,Armenia,249,136,0,0,113,56,57,113,0
2023-04-27,UD,Armenia,246,124,0,0,122,61,61,122,0
2023-04-28,UD,Armenia,263,140,0,0,123,60,63,123,0
2023-04-29,UD,Armenia,327,189,0,0,138,69,69,138,0
2023-04-30,UD,Armenia,334,208,0,0,126,65,61,126,0
2023-05-01,UD,Armenia,243,134,0,0,109,55,54,109,0
2023-05-02,UD,Armenia,271,153,0,0,118,58,60,118,0
2023-05-03,UD,Armenia,230,122,0,0,108,53,55,108,0
2023-05-04,UD,Armenia,217,98,0,0,119,59,60,119,0
2023-05-05,UD,Armenia,204,94,0,0,110,59,51,110,0
2023-05-06,UD,Armenia,221,94,0,0,127,61,66,127,0
2023-05-07,UD,Armenia,270,141,0,0,129,66,63,129,0
2023-05-08,UD,Armenia,200,89,0,0,111,55,56,111,0
2023-05-09,UD,Armenia,250,123,0,0,127,63,64,127,0
2023-05-10,UD,Armenia,219,97,0,0,122,61,61,122,0
2023-05-11,UD,Armenia,241,113,0,0,128,64,64,128,0
2023-05-12,UD,Armenia,237,128,0,0,109,55,54,109,0
2023-05-13,UD,Armenia,261,125,0,0,136,66,70,136,0
2023-05-14,UD,Armenia,261,135,0,0,126,64,62,126,0
2023-05-15,UD,Armenia,221,110,0,0,111,57,54,111,0
2023-05-16,UD,Armenia,256,135,0,0,121,60,61,121,0
2023-05-17,UD,Armenia,223,112,0,0,111,56,55,111,0
2023-05-18,UD,Armenia,245,122,0,0,123,57,66,123,0
2023-05-19,UD,Armenia,264,145,0,0,119,62,57,119,0
2023-05-20,UD,Armenia,254,122,0,0,132,63,69,132,0
2023-05-21,UD,Armenia,247,119,0,0,128,67,61,128,0
2023-05-22,UD,Armenia,222,115,0,0,107,53,54,107,0
2023-05-23,UD,Armenia,245,131,0,0,114,57,57,114,0
2023-05-24,UD,Armenia,244,132,0,0,112,57,55,112,0
2023-05-25,UD,Armenia,239,122,0,0,117,58,59,117,0
2023-05-26,UD,Armenia,258,145,0,0,113,57,56,113,0
2023-05-27,UD,Armenia,280,145,0,0,135,66,69,135,0
2023-05-28,UD,Armenia,271,145,0,0,126,63,63,126,0
2023-05-29,UD,Armenia,226,112,0,0,114,60,54,114,0
2023-05-30,UD,Armenia,269,145,0,0,124,59,65,124,0
2023-05-31,UD,Armenia,257,137,0,0,120,61,59,120,0
2023-06-01,UD,Armenia,278,153,0,0,125,60,65,125,0
2023-06-02,UD,Armenia,287,163,0,0,124,65,59,124,0
2023-06-03,UD,Armenia,352,200,1,1,152,75,76,151,0
2023-06-04,UD,Armenia,296,163,0,0,133,67,66,133,0
2023-06-05,UD,Armenia,280,146,0,0,134,69,65,134,0
2023-06-06,UD,Armenia,338,196,0,0,142,68,74,142,0
2023-06-07,UD,Armenia,292,161,0,0,131,67,64,131,0
2023-06-08,UD,Armenia,268,137,0,0,131,64,67,131,0
2023-06-09,UD,Armenia,268,142,0,0,126,64,62,126,0
2023-06-10,UD,Armenia,315,159,0,0,156,78,78,156,0
2023-06-11,UD,Armenia,273,147,0,0,126,65,61,126,0
2023-06-12,UD,Armenia,252,125,0,0,127,62,65,127,0
2023-06-13,UD,Armenia,326,182,0,0,144,70,74,144,0
2023-06-14,UD,Armenia,280,145,0,0,135,69,66,135,0
2023-06-15,UD,Armenia,289,159,0,0,130,65,65,130,0
2023-06-16,UD,Armenia,294,162,1,1,132,66,65,131,0
2023-06-17,UD,Armenia,308,156,0,0,152,75,77,152,0
2023-06-18,UD,Armenia,285,160,0,0,125,65,60,125,0
2023-06-19,UD,Armenia,297,171,0,0,126,61,65,126,0
2023-06-20,UD,Armenia,329,181,0,0,148,73,75,148,0
2023-06-21,UD,Armenia,271,146,0,0,125,62,63,125,0
2023-06-22,UD,Armenia,275,148,0,0,127,63,64,127,0
2023-06-23,UD,Armenia,293,162,0,0,131,67,64,131,0
2023-06-24,UD,Armenia,324,172,0,0,152,73,79,152,0
2023-06-25,UD,Armenia,288,157,0,0,131,68,63,131,0
2023-06-26,UD,Armenia,306,174,0,0,132,65,67,132,0
2023-06-27,UD,Armenia,340,185,0,0,155,76,79,155,0
2023-06-28,UD,Armenia,297,163,0,0,134,68,66,134,0
2023-06-29,UD,Armenia,299,166,0,0,133,67,66,133,0
2023-06-30,UD,Armenia,329,191,0,0,138,69,69,138,0
2023-07-01,UD,Armenia,334,179,0,0,155,77,78,155,0
2023-07-02,UD,Armenia,290,154,0,0,136,71,65,136,0
2023-07-03,UD,Armenia,295,154,0,0,141,67,74,141,0
2023-07-04,UD,Armenia,319,167,0,0,152,76,76,152,0
2023-07-05,UD,Armenia,271,136,0,0,135,68,67,135,0
2023-07-06,UD,Armenia,301,160,0,0,141,74,67,141,0
2023-07-07,UD,Armenia,314,171,0,0,143,71,72,143,0
2023-07-08,UD,Armenia,323,166,0,0,157,77,80,157,0
2023-07-09,UD,Armenia,284,153,0,0,131,66,65,131,0
2023-07-10,UD,Armenia,271,131,0,0,140,69,71,140,0
2023-07-11,UD,Armenia,304,153,0,0,151,75,76,151,0
2023-07-12,UD,Armenia,285,136,0,0,149,76,73,149,0
2023-07-13,UD,Armenia,293,152,0,0,141,70,71,141,0
2023-07-14,UD,Armenia,281,143,0,0,138,67,71,138,0
2023-07-15,UD,Armenia,331,156,0,0,175,88,87,175,0
2023-07-16,UD,Armenia,272,133,0,0,139,72,67,139,0
2023-07-17,UD,Armenia,280,129,0,0,151,74,77,151,0
2023-07-18,UD,Armenia,305,147,0,0,158,77,81,158,0
2023-07-19,UD,Armenia,300,150,0,0,150,77,73,150,0
2023-07-20,UD,Armenia,315,170,0,0,145,73,72,145,0
2023-07-21,UD,Armenia,304,153,0,0,151,74,77,151,0
2023-07-22,UD,Armenia,313,148,0,0,165,84,81,165,0
2023-07-23,UD,Armenia,281,141,0,0,140,70,70,140,0
2023-07-24,UD,Armenia,302,155,1,1,147,75,71,146,0
2023-07-25,UD,Armenia,316,150,1,1,166,76,89,165,0
2023-07-26,UD,Armenia,307,153,0,0,154,80,74,154,0
2023-07-27,UD,Armenia,314,168,0,0,146,74,72,146,0
2023-07-28,UD,Armenia,302,151,0,0,151,76,75,151,0
2023-07-29,UD,Armenia,347,179,0,0,168,80,88,168,0
2023-07-30,UD,Armenia,303,161,1,1,142,73,68,141,0
2023-07-31,UD,Armenia,284,136,0,0,148,74,74,148,0
2023-08-01,UD,Armenia,320,164,0,0,156,78,78,156,0
2023-08-02,UD,Armenia,340,191,0,0,149,76,73,149,0
2023-08-03,UD,Armenia,374,218,0,0,156,77,79,156,0
2023-08-04,UD,Armenia,389,233,0,0,156,79,77,156,0
2023-08-05,UD,Armenia,312,148,0,0,164,79,85,164,0
2023-08-06,UD,Armenia,308,171,0,0,137,71,66,137,0
2023-08-07,UD,Armenia,298,150,0,0,148,75,73,148,0
2023-08-08,UD,Armenia,325,171,0,0,154,75,79,154,0
2023-08-09,UD,Armenia,312,169,0,0,143,74,69,143,0
2023-08-10,UD,Armenia,345,190,0,0,155,76,79,155,0
2023-08-11,UD,Armenia,329,175,0,0,154,77,77,154,0
2023-08-12,UD,Armenia,336,173,0,0,163,78,85,163,0
2023-08-13,UD,Armenia,290,140,0,0,150,77,73,150,0
2023-08-14,UD,Armenia,300,149,0,0,151,76,75,151,0
2023-08-15,UD,Armenia,330,165,0,0,165,82,83,165,0
2023-08-16,UD,Armenia,299,159,0,0,140,71,69,140,0
2023-08-17,UD,Armenia,324,168,0,0,156,77,79,156,0
2023-08-18,UD,Armenia,316,172,0,0,144,72,72,144,0
2023-08-19,UD,Armenia,373,196,0,0,177,87,90,177,0
2023-08-20,UD,Armenia,294,147,0,0,147,76,71,147,0
2023-08-21,UD,Armenia,323,175,0,0,148,75,73,148,0
2023-08-22,UD,Armenia,332,174,0,0,158,77,81,158,0
2023-08-23,UD,Armenia,287,145,0,0,142,73,69,142,0
2023-08-24,UD,Armenia,317,162,0,0,155,72,83,155,0
2023-08-25,UD,Armenia,361,201,0,0,160,83,77,160,0
2023-08-26,UD,Armenia,317,150,0,0,167,79,88,167,0
2023-08-27,UD,Armenia,294,142,0,0,152,82,70,152,0
2023-08-28,UD,Armenia,295,152,0,0,143,70,73,143,0
2023-08-29,UD,Armenia,360,202,0,0,158,80,78,158,0
2023-08-30,UD,Armenia,273,143,0,0,130,65,65,130,0
2023-08-31,UD,Armenia,287,149,0,0,138,70,68,138,0
2023-09-01,UD,Armenia,334,181,0,0,153,77,76,153,0
2023-09-02,UD,Armenia,347,185,0,0,162,77,85,162,0
2023-09-03,UD,Armenia,345,205,0,0,140,73,67,140,0
2023-09-04,UD,Armenia,273,132,0,0,141,70,71,141,0
2023-09-05,UD,Armenia,300,146,0,0,154,75,79,154,0
2023-09-06,UD,Armenia,258,126,0,0,132,67,65,132,0
2023-09-07,UD,Armenia,330,186,0,0,144,72,72,144,0
2023-09-08,UD,Armenia,291,150,0,0,141,72,69,141,0
2023-09-09,UD,Armenia,331,160,1,1,171,83,87,170,0
2023-09-10,UD,Armenia,287,143,0,0,144,73,71,144,0
2023-09-11,UD,Armenia,262,129,0,0,133,68,65,133,0
2023-09-12,UD,Armenia,283,145,0,0,138,67,71,138,0
2023-09-13,UD,Armenia,272,138,0,0,134,67,67,134,0
2023-09-14,UD,Armenia,286,147,0,0,139,69,70,139,0
2023-09-15,UD,Armenia,279,141,0,0,138,69,69,138,0
2023-09-16,UD,Armenia,312,150,0,0,162,82,80,162,0
2023-09-17,UD,Armenia,256,122,0,0,134,65,69,134,0
2023-09-18,UD,Armenia,256,122,0,0,134,69,65,134,0
2023-09-19,UD,Armenia,212,79,0,0,133,65,68,133,0
2023-09-20,UD,Armenia,158,37,0,0,121,63,58,121,0
2023-09-21,UD,Armenia,186,46,0,0,140,68,72,140,0
2023-09-22,UD,Armenia,189,46,0,0,143,72,71,143,0
2023-09-23,UD,Armenia,220,62,0,0,158,77,81,158,0
2023-09-24,UD,Armenia,214,67,0,0,147,75,72,147,0
2023-09-25,UD,Armenia,181,54,0,0,127,63,64,127,0
2023-09-26,UD,Armenia,187,46,0,0,141,68,73,141,0
2023-09-27,UD,Armenia,194,65,0,0,129,68,61,129,0
2023-09-28,UD,Armenia,193,63,0,0,130,65,65,130,0
2023-09-29,UD,Armenia,196,63,0,0,133,66,67,133,0
2023-09-30,UD,Armenia,201,55,0,0,146,71,75,146,0
2023-10-01,UD,Armenia,233,83,0,0,150,76,74,150,0
2023-10-02,UD,Armenia,195,77,0,0,118,61,57,118,0
2023-01-01,LO,Austria,2742,2081,19,3,661,329,313,642,16
2023-01-02,LO,Austria,3130,2324,30,0,806,388,388,776,30
2023-01-03,LO,Austria,2916,2259,27,0,657,317,313,630,27
2023-01-04,LO,Austria,2987,2268,38,0,719,337,344,681,38
2023-01-05,LO,Austria,2920,2242,21,0,678,331,326,657,21
2023-01-06,LO,Austria,3181,2407,32,0,774,372,370,742,32
2023-01-07,LO,Austria,3269,2438,27,0,831,399,405,804,27
2023-01-08,LO,Austria,3323,2515,22,1,808,392,394,786,21
2023-01-09,LO,Austria,2908,2227,26,0,681,325,330,655,26
2023-01-10,LO,Austria,2514,1942,18,1,572,275,279,554,17
2023-01-11,LO,Austria,2600,1968,22,3,632,306,304,610,19
2023-01-12,LO,Austria,2704,2043,27,1,661,314,320,634,26
2023-01-13,LO,Austria,3045,2289,27,1,756,364,365,729,26
2023-01-14,LO,Austria,2927,2159,22,4,768,371,375,746,18
2023-01-15,LO,Austria,3029,2337,20,1,692,337,335,672,19
2023-01-16,LO,Austria,2806,2138,27,2,668,323,318,641,25
2023-01-17,LO,Austria,2534,1951,19,0,583,279,285,564,19
2023-01-18,LO,Austria,2575,1918,24,0,657,317,316,633,24
2023-01-19,LO,Austria,2791,2126,32,5,665,312,321,633,27
2023-01-20,LO,Austria,3099,2323,22,0,776,381,373,754,22
2023-01-21,LO,Austria,2822,2091,14,0,731,355,362,717,14
2023-01-22,LO,Austria,2847,2142,22,2,705,347,336,683,20
2023-01-23,LO,Austria,2754,2062,20,4,692,335,337,672,16
2023-01-24,LO,Austria,2389,1834,17,1,555,272,266,538,16
2023-01-25,LO,Austria,2485,1822,34,4,663,313,316,629,30
2023-01-26,LO,Austria,2649,2001,28,3,648,310,310,620,25
2023-01-27,LO,Austria,2875,2131,22,0,744,356,366,722,22
2023-01-28,LO,Austria,2860,2078,21,1,782,378,383,761,20
2023-01-29,LO,Austria,2857,2115,27,0,742,360,355,715,27
2023-01-30,LO,Austria,2667,1970,27,0,697,337,333,670,27
2023-01-31,LO,Austria,2367,1797,16,2,570,284,270,554,14
2023-02-01,LO,Austria,2542,1884,28,3,658,311,319,630,25
2023-02-02,LO,Austria,2557,1915,18,0,642,313,311,624,18
2023-02-03,LO,Austria,2957,2195,22,1,762,373,367,740,21
2023-02-04,LO,Austria,2954,2160,24,2,794,384,386,770,22
2023-02-05,LO,Austria,3039,2303,26,1,736,355,355,710,25
2023-02-06,LO,Austria,2731,2052,31,1,679,319,329,648,30
2023-02-07,LO,Austria,2549,1964,38,2,585,273,274,547,36
2023-02-08,LO,Austria,2586,1913,31,3,673,327,315,642,28
2023-02-09,LO,Austria,2739,2035,38,1,704,332,334,666,37
2023-02-10,LO,Austria,3173,2321,48,2,852,400,404,804,46
2023-02-11,LO,Austria,3105,2223,25,2,882,422,435,857,23
2023-02-12,LO,Austria,2947,2183,31,2,764,366,367,733,29
2023-02-13,LO,Austria,2843,2127,31,3,716,342,343,685,28
2023-02-14,LO,Austria,2440,1907,22,1,533,260,251,511,21
2023-02-15,LO,Austria,2699,2015,46,7,684,321,317,638,39
2023-02-16,LO,Austria,3029,2288,21,0,741,355,365,720,21
2023-02-17,LO,Austria,2683,1908,29,2,775,376,370,746,27
2023-02-18,LO,Austria,3319,2352,27,1,967,469,471,940,26
2023-02-19,LO,Austria,3220,2409,27,2,811,396,388,784,25
2023-02-20,LO,Austria,2947,2228,33,0,719,344,342,686,33
2023-02-21,LO,Austria,2639,2044,34,0,595,282,279,561,34
2023-02-22,LO,Austria,2787,2105,37,2,682,333,312,645,35
2023-02-23,LO,Austria,2925,2228,39,1,697,326,332,658,38
2023-02-24,LO,Austria,3304,2464,38,1,840,399,403,802,37
2023-02-25,LO,Austria,3235,2363,19,1,872,422,431,853,18
2023-02-26,LO,Austria,3234,2465,19,1,769,377,373,750,18
2023-02-27,LO,Austria,2998,2292,31,1,706,337,338,675,30
2023-02-28,LO,Austria,2677,2085,21,0,592,284,287,571,21
2023-03-01,LO,Austria,2925,2197,41,1,728,344,343,687,40
2023-03-02,LO,Austria,3036,2294,29,1,742,356,357,713,28
2023-03-03,LO,Austria,3331,2513,42,0,818,389,387,776,42
2023-03-04,LO,Austria,3243,2330,29,0,913,442,442,884,29
2023-03-05,LO,Austria,3236,2426,25,2,810,393,392,785,23
2023-03-06,LO,Austria,3009,2284,20,0,725,351,354,705,20
2023-03-07,LO,Austria,2656,2085,12,0,571,282,277,559,12
2023-03-08,LO,Austria,2902,2171,30,1,731,347,354,701,29
2023-03-09,LO,Austria,3003,2277,34,2,726,351,341,692,32
2023-03-10,LO,Austria,3342,2529,35,0,813,385,393,778,35
2023-03-11,LO,Austria,3279,2449,27,3,830,396,407,803,24
2023-03-12,LO,Austria,3373,2586,30,1,787,380,377,757,29
2023-03-13,LO,Austria,3007,2257,30,2,750,365,355,720,28
2023-03-14,LO,Austria,2790,2119,27,4,671,321,323,644,23
2023-03-15,LO,Austria,3086,2320,34,4,766,368,364,732,30
2023-03-16,LO,Austria,3012,2205,44,1,807,383,380,763,43
2023-03-17,LO,Austria,3207,2393,49,3,814,382,383,765,46
2023-03-18,LO,Austria,3233,2411,28,2,822,393,401,794,26
2023-03-19,LO,Austria,3341,2528,25,1,813,391,397,788,24
2023-03-20,LO,Austria,3213,2422,30,3,791,390,371,761,27
2023-03-21,LO,Austria,2830,2159,28,6,671,317,326,643,22
2023-03-22,LO,Austria,3019,2257,38,1,762,368,356,724,37
2023-03-23,LO,Austria,3138,2383,43,3,755,352,360,712,40
2023-03-24,LO,Austria,3459,2618,28,2,841,404,409,813,26
2023-03-25,LO,Austria,3175,2361,20,1,814,399,395,794,19
2023-03-26,LO,Austria,3462,2617,19,2,845,416,410,826,17
2023-03-27,LO,Austria,2861,2142,26,2,719,344,349,693,24
2023-03-28,LO,Austria,3460,2799,21,1,661,317,323,640,20
2023-03-29,LO,Austria,3637,2828,24,1,809,398,387,785,23
2023-03-30,LO,Austria,3807,2942,37,2,865,408,420,828,35
2023-03-31,LO,Austria,3890,3013,31,1,877,430,416,846,30
2023-04-01,LO,Austria,4084,3266,21,0,818,396,401,797,21
2023-04-02,LO,Austria,4011,3226,10,0,785,389,386,775,10
2023-04-03,LO,Austria,3987,3165,26,1,822,400,396,796,25
2023-04-04,LO,Austria,3844,3059,26,1,785,374,385,759,25
2023-04-05,LO,Austria,3957,3103,28,1,854,427,399,826,27
2023-04-06,LO,Austria,3996,3124,32,1,872,413,427,840,31
2023-04-07,LO,Austria,3878,3050,40,3,828,395,393,788,37
2023-04-08,LO,Austria,3832,3058,22,0,774,372,380,752,22
2023-04-09,LO,Austria,3711,2986,11,0,725,353,361,714,11
2023-04-10,LO,Austria,3753,2892,27,0,861,424,410,834,27
2023-04-11,LO,Austria,3702,2888,42,4,814,393,379,772,38
2023-04-12,LO,Austria,3660,2840,33,3,820,396,391,787,30
2023-04-13,LO,Austria,3995,3144,32,4,851,402,417,819,28
2023-04-14,LO,Austria,3931,3106,26,2,825,407,392,799,24
2023-04-15,LO,Austria,3883,3110,28,3,773,367,378,745,25
2023-04-16,LO,Austria,3969,3160,16,0,809,391,402,793,16
2023-04-17,LO,Austria,3761,2933,29,2,828,405,394,799,27
2023-04-18,LO,Austria,3687,2886,32,1,801,389,380,769,31
2023-04-19,LO,Austria,3795,2964,29,3,831,400,402,802,26
2023-04-20,LO,Austria,3752,2886,39,1,866,414,413,827,38
2023-04-21,LO,Austria,3843,2972,44,6,871,413,414,827,38
2023-04-22,LO,Austria,3942,3191,34,1,751,356,361,717,33
2023-04-23,LO,Austria,4043,3206,25,2,837,400,412,812,23
2023-04-24,LO,Austria,3764,2930,27,1,834,404,403,807,26
2023-04-25,LO,Austria,3605,2818,35,4,787,375,377,752,31
2023-04-26,LO,Austria,3701,2866,42,1,835,395,398,793,41
2023-04-27,LO,Austria,3923,3015,25,1,908,436,447,883,24
2023-04-28,LO,Austria,4126,3228,34,1,898,445,419,864,33
2023-04-29,LO,Austria,4017,3285,29,2,732,354,349,703,27
2023-04-30,LO,Austria,4046,3244,22,2,802,392,388,780,20
2023-05-01,LO,Austria,4194,3395,24,0,799,387,388,775,24
2023-05-02,LO,Austria,3977,3158,28,2,819,393,398,791,26
2023-05-03,LO,Austria,3979,3090,46,3,889,419,424,843,43
2023-05-04,LO,Austria,4140,3209,48,0,931,443,440,883,48
2023-05-05,LO,Austria,4171,3291,50,2,880,411,419,830,48
2023-05-06,LO,Austria,4120,3367,22,1,753,366,365,731,21
2023-05-07,LO,Austria,4237,3379,36,0,858,406,416,822,36
2023-05-08,LO,Austria,4200,3313,51,3,887,422,414,836,48
2023-05-09,LO,Austria,3995,3128,44,6,867,414,409,823,38
2023-05-10,LO,Austria,4063,3159,53,0,904,414,437,851,53
2023-05-11,LO,Austria,4096,3162,44,3,934,458,432,890,41
2023-05-12,LO,Austria,4327,3430,39,4,897,424,434,858,35
2023-05-13,LO,Austria,4313,3546,18,1,767,372,377,749,17
2023-05-14,LO,Austria,4407,3525,19,0,882,433,430,863,19
2023-05-15,LO,Austria,4310,3401,36,4,909,436,437,873,32
2023-05-16,LO,Austria,4063,3199,30,1,864,419,415,834,29
2023-05-17,LO,Austria,4379,3433,39,4,946,455,452,907,35
2023-05-18,LO,Austria,4330,3427,23,1,903,442,438,880,22
2023-05-19,LO,Austria,4168,3307,37,5,861,419,405,824,32
2023-05-20,LO,Austria,4476,3665,33,0,811,386,392,778,33
2023-05-21,LO,Austria,4621,3653,32,0,968,462,474,936,32
2023-05-22,LO,Austria,4269,3363,56,1,906,432,418,850,55
2023-05-23,LO,Austria,4122,3271,19,0,851,417,415,832,19
2023-05-24,LO,Austria,4448,3534,42,3,914,433,439,872,39
2023-05-25,LO,Austria,4518,3544,53,1,974,462,459,921,52
2023-05-26,LO,Austria,4766,3788,38,0,978,471,469,940,38
2023-05-27,LO,Austria,4728,3866,30,0,862,419,413,832,30
2023-05-28,LO,Austria,4586,3747,20,1,839,411,408,819,19
2023-05-29,LO,Austria,4625,3701,37,2,924,429,458,887,35
2023-05-30,LO,Austria,4435,3552,33,1,883,430,420,850,32
2023-05-31,LO,Austria,4491,3566,43,2,925,444,438,882,41
2023-06-01,LO,Austria,4634,3720,40,2,914,440,434,874,38
2023-06-02,LO,Austria,4756,3793,33,1,963,468,462,930,32
2023-06-03,LO,Austria,4713,3850,23,0,863,421,419,840,23
2023-06-04,LO,Austria,4767,3830,33,1,937,445,459,904,32
2023-06-05,LO,Austria,4575,3663,35,0,912,437,440,877,35
2023-06-06,LO,Austria,4770,3885,35,3,885,420,430,850,32
2023-06-07,LO,Austria,4754,3780,38,2,974,483,453,936,36
2023-06-08,LO,Austria,4677,3797,28,4,880,434,418,852,24
2023-06-09,LO,Austria,4725,3830,27,2,895,433,435,868,25
2023-06-10,LO,Austria,4716,3851,24,2,865,417,424,841,22
2023-06-11,LO,Austria,5010,4021,28,0,989,462,499,961,28
2023-06-12,LO,Austria,4695,3749,36,2,946,464,446,910,34
2023-06-13,LO,Austria,4602,3694,42,2,908,440,426,866,40
2023-06-14,LO,Austria,4663,3694,46,2,969,461,462,923,44
2023-06-15,LO,Austria,4796,3841,30,1,955,467,458,925,29
2023-06-16,LO,Austria,4794,3818,40,2,976,469,467,936,38
2023-06-17,LO,Austria,4836,3935,29,2,901,434,438,872,27
2023-06-18,LO,Austria,4947,3999,31,1,948,457,460,917,30
2023-06-19,LO,Austria,4784,3829,42,1,955,460,453,913,41
2023-06-20,LO,Austria,4488,3582,36,2,906,435,435,870,34
2023-06-21,LO,Austria,4643,3697,34,2,946,456,456,912,32
2023-06-22,LO,Austria,4691,3720,50,6,971,461,460,921,44
2023-06-23,LO,Austria,4918,3963,40,2,955,461,454,915,38
2023-06-24,LO,Austria,4936,4059,19,1,877,428,430,858,18
2023-06-25,LO,Austria,5057,4083,38,2,974,455,481,936,36
2023-06-26,LO,Austria,4788,3825,44,1,963,461,458,919,43
2023-06-27,LO,Austria,4749,3827,41,0,922,436,445,881,41
2023-06-28,LO,Austria,4729,3756,37,1,973,468,468,936,36
2023-06-29,LO,Austria,4929,3895,43,1,1034,499,492,991,42
2023-06-30,LO,Austria,4927,3892,47,1,1035,490,498,988,46
2023-07-01,LO,Austria,5041,4099,27,0,942,456,459,915,27
2023-07-02,LO,Austria,5205,4140,29,0,1065,523,513,1036,29
2023-07-03,LO,Austria,4989,4029,18,1,960,482,460,942,17
2023-07-04,LO,Austria,4810,3885,23,1,925,445,457,902,22
2023-07-05,LO,Austria,4778,3824,30,0,954,460,464,924,30
2023-07-06,LO,Austria,4952,3960,35,2,992,476,481,957,33
2023-07-07,LO,Austria,4997,4012,32,4,985,483,470,953,28
2023-07-08,LO,Austria,4964,4060,17,0,904,440,447,887,17
2023-07-09,LO,Austria,5204,4235,31,0,969,471,467,938,31
2023-07-10,LO,Austria,4895,3966,30,6,929,453,446,899,24
2023-07-11,LO,Austria,4823,3929,27,1,894,434,433,867,26
2023-07-12,LO,Austria,4861,3918,29,1,943,451,463,914,28
2023-07-13,LO,Austria,4951,4019,27,6,932,459,446,905,21
2023-07-14,LO,Austria,5092,4095,42,4,997,474,481,955,38
2023-07-15,LO,Austria,4761,3851,23,0,910,442,445,887,23
2023-07-16,LO,Austria,5112,4137,21,1,975,470,484,954,20
2023-07-17,LO,Austria,4881,3973,29,1,908,446,433,879,28
2023-07-18,LO,Austria,4759,3857,40,2,902,428,434,862,38
2023-07-19,LO,Austria,4777,3814,30,2,963,471,462,933,28
2023-07-20,LO,Austria,5002,4036,40,3,966,468,458,926,37
2023-07-21,LO,Austria,4872,3927,31,1,945,458,456,914,30
2023-07-22,LO,Austria,5035,4160,21,1,875,421,433,854,20
2023-07-23,LO,Austria,5196,4227,21,1,969,470,478,948,20
2023-07-24,LO,Austria,4818,3923,22,4,895,436,437,873,18
2023-07-25,LO,Austria,4565,3663,22,0,902,443,437,880,22
2023-07-26,LO,Austria,4911,3931,40,5,980,467,473,940,35
2023-07-27,LO,Austria,4926,3971,27,1,955,465,463,928,26
2023-07-28,LO,Austria,5140,4139,27,2,1001,487,487,974,25
2023-07-29,LO,Austria,4908,4039,21,1,869,427,421,848,20
2023-07-30,LO,Austria,4997,4061,24,0,936,454,458,912,24
2023-07-31,LO,Austria,4833,3904,34,1,929,447,448,895,33
2023-08-01,LO,Austria,4737,3863,25,5,874,428,421,849,20
2023-08-02,LO,Austria,4909,3950,35,1,959,463,461,924,34
2023-08-03,LO,Austria,4972,4054,24,3,918,448,446,894,21
2023-08-04,LO,Austria,4890,3936,32,3,954,456,466,922,29
2023-08-05,LO,Austria,4937,4064,17,0,873,430,426,856,17
2023-08-06,LO,Austria,4892,3989,20,0,903,440,443,883,20
2023-08-07,LO,Austria,4776,3862,33,3,914,446,435,881,30
2023-08-08,LO,Austria,4754,3848,33,0,906,435,438,873,33
2023-08-09,LO,Austria,4866,3902,39,2,964,460,465,925,37
2023-08-10,LO,Austria,4954,4000,39,0,954,456,459,915,39
2023-08-11,LO,Austria,5007,4054,30,3,953,467,456,923,27
2023-08-12,LO,Austria,5020,4127,24,5,893,432,437,869,19
2023-08-13,LO,Austria,5038,4097,25,0,941,463,453,916,25
2023-08-14,LO,Austria,4728,3824,25,1,904,436,443,879,24
2023-08-15,LO,Austria,4582,3683,28,2,899,428,443,871,26
2023-08-16,LO,Austria,4732,3793,23,0,939,460,456,916,23
2023-08-17,LO,Austria,4810,3853,28,3,957,455,474,929,25
2023-08-18,LO,Austria,4905,3959,28,2,946,469,449,918,26
2023-08-19,LO,Austria,4990,4115,21,2,875,422,432,854,19
2023-08-20,LO,Austria,5086,4102,30,1,984,473,481,954,29
2023-08-21,LO,Austria,4809,3886,23,1,923,454,446,900,22
2023-08-22,LO,Austria,4881,3988,32,1,893,431,430,861,31
2023-08-23,LO,Austria,4740,3790,30,1,950,457,463,920,29
2023-08-24,LO,Austria,4745,3806,36,3,939,448,455,903,33
2023-08-25,LO,Austria,4846,3880,38,2,966,468,460,928,36
2023-08-26,LO,Austria,4897,4036,21,0,861,420,420,840,21
2023-08-27,LO,Austria,5147,4205,30,1,942,450,462,912,29
2023-08-28,LO,Austria,4554,3653,18,2,901,440,443,883,16
2023-08-29,LO,Austria,4768,3896,26,5,872,428,418,846,21
2023-08-30,LO,Austria,4884,3922,39,4,962,458,465,923,35
2023-08-31,LO,Austria,4885,3933,29,2,952,465,458,923,27
2023-09-01,LO,Austria,4886,3913,33,0,973,472,468,940,33
2023-09-02,LO,Austria,5038,4155,22,1,883,427,434,861,21
2023-09-03,LO,Austria,5041,4104,24,1,937,458,455,913,23
2023-09-04,LO,Austria,4773,3845,50,1,928,438,440,878,49
2023-09-05,LO,Austria,4742,3818,35,2,924,445,444,889,33
2023-09-06,LO,Austria,4830,3855,33,3,975,466,476,942,30
2023-09-07,LO,Austria,4942,3977,30,3,965,468,467,935,27
2023-09-08,LO,Austria,4819,3851,35,0,968,469,464,933,35
2023-09-09,LO,Austria,4941,4057,23,0,884,423,438,861,23
2023-09-10,LO,Austria,5072,4099,22,1,973,481,470,951,21
2023-09-11,LO,Austria,4766,3809,39,0,957,464,454,918,39
2023-09-12,LO,Austria,4663,3769,34,0,894,433,427,860,34
2023-09-13,LO,Austria,4681,3763,31,0,918,436,451,887,31
2023-09-14,LO,Austria,4911,3942,39,1,969,461,469,930,38
2023-09-15,LO,Austria,4881,3883,35,1,998,479,484,963,34
2023-09-16,LO,Austria,4874,4024,24,1,850,415,411,826,23
2023-09-17,LO,Austria,4922,3993,24,2,929,449,456,905,22
2023-09-18,LO,Austria,4698,3763,31,1,935,460,444,904,30
2023-09-19,LO,Austria,4773,3847,39,4,926,441,446,887,35
2023-09-20,LO,Austria,4902,3873,63,5,1029,479,487,966,58
2023-09-21,LO,Austria,4880,3875,36,0,1005,495,474,969,36
2023-09-22,LO,Austria,4868,3904,39,2,964,462,463,925,37
2023-09-23,LO,Austria,4753,3910,26,0,843,407,410,817,26
2023-09-24,LO,Austria,4882,3957,23,0,925,441,461,902,23
2023-09-25,LO,Austria,4638,3676,48,2,962,456,458,914,46
2023-09-26,LO,Austria,4430,3531,30,2,899,445,424,869,28
2023-09-27,LO,Austria,4744,3764,45,2,980,466,469,935,43
2023-09-28,LO,Austria,4773,3823,38,2,950,456,456,912,36
2023-09-29,LO,Austria,4762,3795,41,3,967,462,464,926,38
2023-09-30,LO,Austria,4755,3917,43,0,838,394,401,795,43
2023-10-01,LO,Austria,4907,3977,34,2,930,445,451,896,32
2023-10-02,LO,Austria,4566,3641,35,2,925,443,447,890,33
2023-01-01,EB,Belgium and Luxembourg,2374,1666,4,1,708,354,350,704,3
2023-01-02,EB,Belgium and Luxembourg,2654,1789,17,9,865,410,438,848,8
2023-01-03,EB,Belgium and Luxembourg,2530,1694,25,12,836,402,409,811,13
2023-01-04,EB,Belgium and Luxembourg,2583,1734,12,6,849,420,417,837,6
2023-01-05,EB,Belgium and Luxembourg,2647,1731,20,9,916,452,444,896,11
2023-01-06,EB,Belgium and Luxembourg,2780,1846,28,13,934,462,444,906,15
2023-01-07,EB,Belgium and Luxembourg,2651,1897,14,5,754,365,375,740,9
2023-01-08,EB,Belgium and Luxembourg,2739,1878,6,0,861,430,425,855,6
2023-01-09,EB,Belgium and Luxembourg,2492,1633,9,5,859,412,438,850,4
2023-01-10,EB,Belgium and Luxembourg,2343,1553,15,9,790,391,384,775,6
2023-01-11,EB,Belgium and Luxembourg,2309,1493,17,12,816,401,398,799,5
2023-01-12,EB,Belgium and Luxembourg,2522,1623,12,3,899,446,441,887,9
2023-01-13,EB,Belgium and Luxembourg,2638,1721,10,3,917,466,441,907,7
2023-01-14,EB,Belgium and Luxembourg,2328,1669,2,0,659,328,329,657,2
2023-01-15,EB,Belgium and Luxembourg,2524,1670,4,0,854,420,430,850,4
2023-01-16,EB,Belgium and Luxembourg,2448,1612,7,2,836,391,438,829,5
2023-01-17,EB,Belgium and Luxembourg,2273,1463,16,6,810,402,392,794,10
2023-01-18,EB,Belgium and Luxembourg,2369,1503,18,7,866,430,418,848,11
2023-01-19,EB,Belgium and Luxembourg,2493,1561,11,4,932,465,456,921,7
2023-01-20,EB,Belgium and Luxembourg,2648,1727,5,2,921,470,446,916,3
2023-01-21,EB,Belgium and Luxembourg,2264,1598,5,3,666,315,346,661,2
2023-01-22,EB,Belgium and Luxembourg,2487,1613,12,0,874,437,425,862,12
2023-01-23,EB,Belgium and Luxembourg,2422,1556,9,2,866,420,437,857,7
2023-01-24,EB,Belgium and Luxembourg,2159,1413,8,6,746,367,371,738,2
2023-01-25,EB,Belgium and Luxembourg,2283,1513,6,1,770,382,382,764,5
2023-01-26,EB,Belgium and Luxembourg,2418,1544,12,3,874,432,430,862,9
2023-01-27,EB,Belgium and Luxembourg,2564,1680,10,2,884,458,416,874,8
2023-01-28,EB,Belgium and Luxembourg,2307,1632,13,8,675,326,336,662,5
2023-01-29,EB,Belgium and Luxembourg,2536,1705,8,5,831,403,420,823,3
2023-01-30,EB,Belgium and Luxembourg,2412,1579,22,14,833,395,416,811,8
2023-01-31,EB,Belgium and Luxembourg,2230,1442,21,7,788,379,388,767,14
2023-02-01,EB,Belgium and Luxembourg,2443,1593,15,8,850,425,410,835,7
2023-02-02,EB,Belgium and Luxembourg,2525,1627,21,12,898,444,433,877,9
2023-02-03,EB,Belgium and Luxembourg,2675,1755,20,13,920,463,437,900,7
2023-02-04,EB,Belgium and Luxembourg,2506,1822,10,5,684,331,343,674,5
2023-02-05,EB,Belgium and Luxembourg,2605,1736,8,0,869,431,430,861,8
2023-02-06,EB,Belgium and Luxembourg,2546,1647,16,8,899,424,459,883,8
2023-02-07,EB,Belgium and Luxembourg,2365,1555,22,11,810,398,390,788,11
2023-02-08,EB,Belgium and Luxembourg,2525,1635,23,8,890,431,436,867,15
2023-02-09,EB,Belgium and Luxembourg,2645,1690,19,12,955,457,479,936,7
2023-02-10,EB,Belgium and Luxembourg,2898,1898,18,8,1000,523,459,982,10
2023-02-11,EB,Belgium and Luxembourg,2814,2076,7,1,738,365,366,731,6
2023-02-12,EB,Belgium and Luxembourg,2720,1836,5,1,884,429,450,879,4
2023-02-13,EB,Belgium and Luxembourg,2678,1756,22,13,922,440,460,900,9
2023-02-14,EB,Belgium and Luxembourg,2386,1517,16,11,869,422,431,853,5
2023-02-15,EB,Belgium and Luxembourg,2621,1696,18,10,925,457,450,907,8
2023-02-16,EB,Belgium and Luxembourg,2859,1881,29,14,978,481,468,949,15
2023-02-17,EB,Belgium and Luxembourg,2703,1743,12,1,960,487,461,948,11
2023-02-18,EB,Belgium and Luxembourg,2754,1941,18,6,813,399,396,795,12
2023-02-19,EB,Belgium and Luxembourg,2966,2009,6,1,957,467,484,951,5
2023-02-20,EB,Belgium and Luxembourg,2819,1885,13,8,934,447,474,921,5
2023-02-21,EB,Belgium and Luxembourg,2532,1664,16,4,868,430,422,852,12
2023-02-22,EB,Belgium and Luxembourg,2667,1758,23,8,909,447,439,886,15
2023-02-23,EB,Belgium and Luxembourg,2797,1846,10,8,951,472,469,941,2
2023-02-24,EB,Belgium and Luxembourg,3015,2000,10,7,1015,516,489,1005,3
2023-02-25,EB,Belgium and Luxembourg,2713,1922,7,3,791,386,398,784,4
2023-02-26,EB,Belgium and Luxembourg,2900,1931,9,4,969,476,484,960,5
2023-02-27,EB,Belgium and Luxembourg,2760,1795,18,7,965,457,490,947,11
2023-02-28,EB,Belgium and Luxembourg,2562,1703,12,9,859,430,417,847,3
2023-03-01,EB,Belgium and Luxembourg,2733,1815,23,12,918,450,445,895,11
2023-03-02,EB,Belgium and Luxembourg,2870,1881,22,9,989,489,478,967,13
2023-03-03,EB,Belgium and Luxembourg,3075,2035,8,4,1040,524,508,1032,4
2023-03-04,EB,Belgium and Luxembourg,2705,1947,6,0,758,378,374,752,6
2023-03-05,EB,Belgium and Luxembourg,2928,1991,12,3,937,458,467,925,9
2023-03-06,EB,Belgium and Luxembourg,2775,1850,14,5,925,446,465,911,9
2023-03-07,EB,Belgium and Luxembourg,2597,1741,10,3,856,427,419,846,7
2023-03-08,EB,Belgium and Luxembourg,2704,1810,12,4,894,439,443,882,8
2023-03-09,EB,Belgium and Luxembourg,2917,1921,12,6,996,500,484,984,6
2023-03-10,EB,Belgium and Luxembourg,2926,1959,4,0,967,495,468,963,4
2023-03-11,EB,Belgium and Luxembourg,2825,2069,18,7,756,367,371,738,11
2023-03-12,EB,Belgium and Luxembourg,3123,2236,13,2,887,432,442,874,11
2023-03-13,EB,Belgium and Luxembourg,2737,1822,7,1,915,439,469,908,6
2023-03-14,EB,Belgium and Luxembourg,2627,1717,12,2,910,456,442,898,10
2023-03-15,EB,Belgium and Luxembourg,2888,1957,19,12,931,464,448,912,7
2023-03-16,EB,Belgium and Luxembourg,2763,1772,23,13,991,481,487,968,10
2023-03-17,EB,Belgium and Luxembourg,2912,1882,15,10,1030,518,497,1015,5
2023-03-18,EB,Belgium and Luxembourg,2640,1907,8,6,733,361,364,725,2
2023-03-19,EB,Belgium and Luxembourg,2962,2053,9,1,909,444,456,900,8
2023-03-20,EB,Belgium and Luxembourg,3141,2166,17,9,975,465,493,958,8
2023-03-21,EB,Belgium and Luxembourg,2759,1854,20,10,905,443,442,885,10
2023-03-22,EB,Belgium and Luxembourg,2851,1894,8,3,957,473,476,949,5
2023-03-23,EB,Belgium and Luxembourg,2955,1957,18,8,998,487,493,980,10
2023-03-24,EB,Belgium and Luxembourg,3181,2181,14,4,1000,517,469,986,10
2023-03-25,EB,Belgium and Luxembourg,2745,1983,7,1,762,371,384,755,6
2023-03-26,EB,Belgium and Luxembourg,3082,2164,7,3,918,449,462,911,4
2023-03-27,EB,Belgium and Luxembourg,2804,1808,18,7,996,471,507,978,11
2023-03-28,EB,Belgium and Luxembourg,3050,2050,32,15,1000,485,483,968,17
2023-03-29,EB,Belgium and Luxembourg,3229,2164,25,11,1065,529,511,1040,14
2023-03-30,EB,Belgium and Luxembourg,3348,2296,11,3,1052,520,521,1041,8
2023-03-31,EB,Belgium and Luxembourg,3405,2319,7,2,1086,554,525,1079,5
2023-04-01,EB,Belgium and Luxembourg,3238,2374,9,3,864,429,426,855,6
2023-04-02,EB,Belgium and Luxembourg,3351,2388,10,7,963,474,479,953,3
2023-04-03,EB,Belgium and Luxembourg,3377,2324,23,17,1053,500,530,1030,6
2023-04-04,EB,Belgium and Luxembourg,3278,2168,33,22,1110,536,541,1077,11
2023-04-05,EB,Belgium and Luxembourg,3322,2233,23,13,1089,539,527,1066,10
2023-04-06,EB,Belgium and Luxembourg,3408,2345,9,2,1063,527,527,1054,7
2023-04-07,EB,Belgium and Luxembourg,3338,2295,15,9,1043,522,506,1028,6
2023-04-08,EB,Belgium and Luxembourg,3096,2241,9,6,855,425,421,846,3
2023-04-09,EB,Belgium and Luxembourg,3174,2233,9,1,941,464,468,932,8
2023-04-10,EB,Belgium and Luxembourg,3242,2273,1,1,969,471,497,968,0
2023-04-11,EB,Belgium and Luxembourg,3193,2154,16,8,1039,517,506,1023,8
2023-04-12,EB,Belgium and Luxembourg,3125,2100,10,3,1025,510,505,1015,7
2023-04-13,EB,Belgium and Luxembourg,3212,2137,14,5,1075,532,529,1061,9
2023-04-14,EB,Belgium and Luxembourg,3376,2284,16,12,1092,554,522,1076,4
2023-04-15,EB,Belgium and Luxembourg,3108,2252,14,10,856,413,429,842,4
2023-04-16,EB,Belgium and Luxembourg,3365,2384,11,3,981,483,487,970,8
2023-04-17,EB,Belgium and Luxembourg,3222,2144,23,9,1078,515,540,1055,14
2023-04-18,EB,Belgium and Luxembourg,3176,2082,27,17,1094,536,531,1067,10
2023-04-19,EB,Belgium and Luxembourg,3276,2178,16,12,1098,536,546,1082,4
2023-04-20,EB,Belgium and Luxembourg,3156,1995,16,5,1161,574,571,1145,11
2023-04-21,EB,Belgium and Luxembourg,3231,2124,25,12,1107,553,529,1082,13
2023-04-22,EB,Belgium and Luxembourg,3067,2192,16,12,875,431,428,859,4
2023-04-23,EB,Belgium and Luxembourg,3308,2292,17,8,1016,494,505,999,9
2023-04-24,EB,Belgium and Luxembourg,3047,1943,21,11,1104,527,556,1083,10
2023-04-25,EB,Belgium and Luxembourg,3077,1981,24,11,1096,541,531,1072,13
2023-04-26,EB,Belgium and Luxembourg,3211,2060,31,18,1151,564,556,1120,13
2023-04-27,EB,Belgium and Luxembourg,3269,2083,20,13,1186,581,585,1166,7
2023-04-28,EB,Belgium and Luxembourg,3441,2266,16,11,1175,597,562,1159,5
2023-04-29,EB,Belgium and Luxembourg,3165,2225,16,6,940,456,468,924,10
2023-04-30,EB,Belgium and Luxembourg,3301,2288,9,2,1013,502,502,1004,7
2023-05-01,EB,Belgium and Luxembourg,3320,2290,3,0,1030,494,533,1027,3
2023-05-02,EB,Belgium and Luxembourg,3223,2138,16,8,1085,543,526,1069,8
2023-05-03,EB,Belgium and Luxembourg,3310,2190,24,10,1120,550,546,1096,14
2023-05-04,EB,Belgium and Luxembourg,3325,2186,29,15,1139,558,552,1110,14
2023-05-05,EB,Belgium and Luxembourg,3371,2287,15,4,1084,547,522,1069,11
2023-05-06,EB,Belgium and Luxembourg,3156,2252,11,7,904,442,451,893,4
2023-05-07,EB,Belgium and Luxembourg,3292,2287,4,2,1005,497,504,1001,2
2023-05-08,EB,Belgium and Luxembourg,3312,2234,11,5,1078,528,539,1067,6
2023-05-09,EB,Belgium and Luxembourg,3322,2206,18,7,1116,548,550,1098,11
2023-05-10,EB,Belgium and Luxembourg,3339,2242,12,6,1097,546,539,1085,6
2023-05-11,EB,Belgium and Luxembourg,3387,2223,11,5,1164,580,573,1153,6
2023-05-12,EB,Belgium and Luxembourg,3519,2371,17,7,1148,574,557,1131,10
2023-05-13,EB,Belgium and Luxembourg,3281,2331,7,5,950,462,481,943,2
2023-05-14,EB,Belgium and Luxembourg,3385,2329,13,3,1056,522,521,1043,10
2023-05-15,EB,Belgium and Luxembourg,3397,2231,24,13,1166,558,584,1142,11
2023-05-16,EB,Belgium and Luxembourg,3392,2239,18,5,1153,562,573,1135,13
2023-05-17,EB,Belgium and Luxembourg,3500,2321,17,11,1179,592,570,1162,6
2023-05-18,EB,Belgium and Luxembourg,3431,2316,11,1,1115,558,546,1104,10
2023-05-19,EB,Belgium and Luxembourg,3387,2313,21,11,1074,533,520,1053,10
2023-05-20,EB,Belgium and Luxembourg,3210,2310,12,7,900,442,446,888,5
2023-05-21,EB,Belgium and Luxembourg,3575,2471,10,3,1104,539,555,1094,7
2023-05-22,EB,Belgium and Luxembourg,3415,2261,21,9,1154,554,579,1133,12
2023-05-23,EB,Belgium and Luxembourg,3386,2228,25,10,1158,572,561,1133,15
2023-05-24,EB,Belgium and Luxembourg,3423,2289,15,8,1134,561,558,1119,7
2023-05-25,EB,Belgium and Luxembourg,3596,2410,19,8,1186,586,581,1167,11
2023-05-26,EB,Belgium and Luxembourg,3651,2462,25,11,1189,598,566,1164,14
2023-05-27,EB,Belgium and Luxembourg,3403,2456,15,11,947,470,462,932,4
2023-05-28,EB,Belgium and Luxembourg,3429,2405,15,10,1024,502,507,1009,5
2023-05-29,EB,Belgium and Luxembourg,3549,2445,12,4,1104,522,570,1092,8
2023-05-30,EB,Belgium and Luxembourg,3490,2339,27,11,1151,567,557,1124,16
2023-05-31,EB,Belgium and Luxembourg,3399,2278,24,13,1121,552,545,1097,11
2023-06-01,EB,Belgium and Luxembourg,3606,2423,30,14,1183,585,568,1153,16
2023-06-02,EB,Belgium and Luxembourg,3508,2398,21,8,1110,559,530,1089,13
2023-06-03,EB,Belgium and Luxembourg,3251,2320,16,7,931,452,463,915,9
2023-06-04,EB,Belgium and Luxembourg,3619,2544,9,2,1075,524,542,1066,7
2023-06-05,EB,Belgium and Luxembourg,3503,2368,15,8,1135,543,577,1120,7
2023-06-06,EB,Belgium and Luxembourg,3480,2408,17,8,1072,531,524,1055,9
2023-06-07,EB,Belgium and Luxembourg,3610,2477,14,5,1133,567,552,1119,9
2023-06-08,EB,Belgium and Luxembourg,3603,2440,23,9,1163,575,565,1140,14
2023-06-09,EB,Belgium and Luxembourg,3579,2456,15,10,1123,568,540,1108,5
2023-06-10,EB,Belgium and Luxembourg,3366,2410,16,5,956,463,477,940,11
2023-06-11,EB,Belgium and Luxembourg,3655,2568,8,4,1087,535,544,1079,4
2023-06-12,EB,Belgium and Luxembourg,3501,2353,8,6,1148,560,580,1140,2
2023-06-13,EB,Belgium and Luxembourg,3512,2346,20,9,1166,565,581,1146,11
2023-06-14,EB,Belgium and Luxembourg,3554,2383,27,11,1171,568,576,1144,16
2023-06-15,EB,Belgium and Luxembourg,3607,2368,18,9,1239,615,606,1221,9
2023-06-16,EB,Belgium and Luxembourg,3686,2469,18,7,1217,618,581,1199,11
2023-06-17,EB,Belgium and Luxembourg,3303,2358,16,5,945,456,473,929,11
2023-06-18,EB,Belgium and Luxembourg,3435,2319,11,4,1116,558,547,1105,7
2023-06-19,EB,Belgium and Luxembourg,3548,2346,31,18,1202,559,612,1171,13
2023-06-20,EB,Belgium and Luxembourg,3418,2245,20,7,1173,587,566,1153,13
2023-06-21,EB,Belgium and Luxembourg,3554,2362,19,12,1192,595,578,1173,7
2023-06-22,EB,Belgium and Luxembourg,3552,2396,20,4,1156,569,567,1136,16
2023-06-23,EB,Belgium and Luxembourg,3798,2632,10,4,1166,589,567,1156,6
2023-06-24,EB,Belgium and Luxembourg,3378,2438,10,5,940,459,471,930,5
2023-06-25,EB,Belgium and Luxembourg,3614,2528,16,8,1086,537,533,1070,8
2023-06-26,EB,Belgium and Luxembourg,3678,2468,15,7,1210,582,613,1195,8
2023-06-27,EB,Belgium and Luxembourg,3639,2428,27,14,1211,589,595,1184,13
2023-06-28,EB,Belgium and Luxembourg,3673,2410,19,9,1263,616,628,1244,10
2023-06-29,EB,Belgium and Luxembourg,3719,2438,16,6,1281,632,633,1265,10
2023-06-30,EB,Belgium and Luxembourg,3819,2551,16,9,1268,646,606,1252,7
2023-07-01,EB,Belgium and Luxembourg,3537,2510,13,4,1027,506,508,1014,9
2023-07-02,EB,Belgium and Luxembourg,3735,2588,8,2,1147,572,567,1139,6
2023-07-03,EB,Belgium and Luxembourg,3663,2496,12,4,1167,569,586,1155,8
2023-07-04,EB,Belgium and Luxembourg,3596,2419,24,11,1177,572,581,1153,13
2023-07-05,EB,Belgium and Luxembourg,3510,2281,19,8,1229,603,607,1210,11
2023-07-06,EB,Belgium and Luxembourg,3688,2448,30,12,1240,612,598,1210,18
2023-07-07,EB,Belgium and Luxembourg,3802,2591,11,9,1211,618,582,1200,2
2023-07-08,EB,Belgium and Luxembourg,3434,2418,11,6,1016,500,505,1005,5
2023-07-09,EB,Belgium and Luxembourg,3500,2393,4,1,1107,550,553,1103,3
2023-07-10,EB,Belgium and Luxembourg,3603,2410,26,12,1193,568,599,1167,14
2023-07-11,EB,Belgium and Luxembourg,3594,2424,12,5,1170,585,573,1158,7
2023-07-12,EB,Belgium and Luxembourg,3545,2353,10,5,1192,595,587,1182,5
2023-07-13,EB,Belgium and Luxembourg,3604,2396,14,11,1208,598,596,1194,3
2023-07-14,EB,Belgium and Luxembourg,3719,2516,17,4,1203,605,581,1186,13
2023-07-15,EB,Belgium and Luxembourg,3336,2416,5,2,920,455,460,915,3
2023-07-16,EB,Belgium and Luxembourg,3590,2544,11,2,1046,512,523,1035,9
2023-07-17,EB,Belgium and Luxembourg,3593,2407,19,7,1186,567,600,1167,12
2023-07-18,EB,Belgium and Luxembourg,3603,2417,17,11,1186,597,572,1169,6
2023-07-19,EB,Belgium and Luxembourg,3576,2392,12,4,1184,589,583,1172,8
2023-07-20,EB,Belgium and Luxembourg,3709,2506,19,8,1203,588,596,1184,11
2023-07-21,EB,Belgium and Luxembourg,3800,2624,12,4,1176,592,572,1164,8
2023-07-22,EB,Belgium and Luxembourg,3536,2527,13,9,1009,493,503,996,4
2023-07-23,EB,Belgium and Luxembourg,3682,2571,3,1,1111,554,554,1108,2
2023-07-24,EB,Belgium and Luxembourg,3560,2403,7,6,1157,562,588,1150,1
2023-07-25,EB,Belgium and Luxembourg,3495,2350,16,6,1145,566,563,1129,10
2023-07-26,EB,Belgium and Luxembourg,3623,2417,15,4,1206,601,590,1191,11
2023-07-27,EB,Belgium and Luxembourg,3579,2377,11,3,1202,584,607,1191,8
2023-07-28,EB,Belgium and Luxembourg,3768,2565,11,4,1203,604,588,1192,7
2023-07-29,EB,Belgium and Luxembourg,3503,2526,6,2,977,476,495,971,4
2023-07-30,EB,Belgium and Luxembourg,3701,2560,8,0,1141,574,559,1133,8
2023-07-31,EB,Belgium and Luxembourg,3577,2380,18,4,1197,583,596,1179,14
2023-08-01,EB,Belgium and Luxembourg,3432,2294,12,9,1138,562,564,1126,3
2023-08-02,EB,Belgium and Luxembourg,3520,2394,5,2,1126,566,555,1121,3
2023-08-03,EB,Belgium and Luxembourg,3494,2378,13,7,1116,559,544,1103,6
2023-08-04,EB,Belgium and Luxembourg,3639,2492,16,9,1147,578,553,1131,7
2023-08-05,EB,Belgium and Luxembourg,3428,2455,9,5,973,479,485,964,4
2023-08-06,EB,Belgium and Luxembourg,3491,2406,0,0,1085,543,542,1085,0
2023-08-07,EB,Belgium and Luxembourg,3460,2340,8,4,1120,533,579,1112,4
2023-08-08,EB,Belgium and Luxembourg,3428,2317,16,9,1111,552,543,1095,7
2023-08-09,EB,Belgium and Luxembourg,3434,2306,11,5,1128,561,556,1117,6
2023-08-10,EB,Belgium and Luxembourg,3503,2363,16,9,1140,565,559,1124,7
2023-08-11,EB,Belgium and Luxembourg,3636,2453,22,7,1183,585,576,1161,15
2023-08-12,EB,Belgium and Luxembourg,3398,2383,17,7,1015,504,494,998,10
2023-08-13,EB,Belgium and Luxembourg,3575,2473,11,2,1102,545,546,1091,9
2023-08-14,EB,Belgium and Luxembourg,3430,2364,15,7,1066,509,542,1051,8
2023-08-15,EB,Belgium and Luxembourg,3389,2332,8,0,1057,523,526,1049,8
2023-08-16,EB,Belgium and Luxembourg,3365,2203,20,8,1162,572,570,1142,12
2023-08-17,EB,Belgium and Luxembourg,3404,2272,14,6,1132,567,551,1118,8
2023-08-18,EB,Belgium and Luxembourg,3565,2438,15,6,1127,563,549,1112,9
2023-08-19,EB,Belgium and Luxembourg,3418,2433,6,1,985,485,494,979,5
2023-08-20,EB,Belgium and Luxembourg,3605,2494,10,3,1111,545,556,1101,7
2023-08-21,EB,Belgium and Luxembourg,3446,2317,23,13,1129,539,567,1106,10
2023-08-22,EB,Belgium and Luxembourg,3446,2328,15,8,1118,551,552,1103,7
2023-08-23,EB,Belgium and Luxembourg,3496,2320,21,12,1176,586,569,1155,9
2023-08-24,EB,Belgium and Luxembourg,3109,1950,15,9,1159,570,574,1144,6
2023-08-25,EB,Belgium and Luxembourg,3545,2406,15,6,1139,575,549,1124,9
2023-08-26,EB,Belgium and Luxembourg,3484,2497,11,4,987,483,493,976,7
2023-08-27,EB,Belgium and Luxembourg,3622,2534,8,3,1088,539,541,1080,5
2023-08-28,EB,Belgium and Luxembourg,3306,2212,11,6,1094,533,550,1083,5
2023-08-29,EB,Belgium and Luxembourg,3469,2337,19,6,1132,557,556,1113,13
2023-08-30,EB,Belgium and Luxembourg,3533,2350,9,4,1183,593,581,1174,5
2023-08-31,EB,Belgium and Luxembourg,3552,2428,12,8,1124,555,557,1112,4
2023-09-01,EB,Belgium and Luxembourg,3690,2492,10,3,1198,613,575,1188,7
2023-09-02,EB,Belgium and Luxembourg,3390,2427,6,2,963,476,481,957,4
2023-09-03,EB,Belgium and Luxembourg,3592,2478,5,1,1114,552,557,1109,4
2023-09-04,EB,Belgium and Luxembourg,3510,2367,28,14,1143,550,565,1115,14
2023-09-05,EB,Belgium and Luxembourg,3448,2329,13,5,1119,546,560,1106,8
2023-09-06,EB,Belgium and Luxembourg,3496,2345,16,10,1151,576,559,1135,6
2023-09-07,EB,Belgium and Luxembourg,3676,2479,24,8,1197,583,590,1173,16
2023-09-08,EB,Belgium and Luxembourg,3675,2513,14,5,1162,581,567,1148,9
2023-09-09,EB,Belgium and Luxembourg,3399,2439,10,2,960,472,478,950,8
2023-09-10,EB,Belgium and Luxembourg,3609,2506,9,2,1103,547,547,1094,7
2023-09-11,EB,Belgium and Luxembourg,3590,2383,22,8,1207,582,603,1185,14
2023-09-12,EB,Belgium and Luxembourg,3526,2360,18,6,1166,579,569,1148,12
2023-09-13,EB,Belgium and Luxembourg,3653,2475,22,8,1178,585,571,1156,14
2023-09-14,EB,Belgium and Luxembourg,3665,2510,13,5,1155,563,579,1142,8
2023-09-15,EB,Belgium and Luxembourg,3764,2591,17,8,1173,590,566,1156,9
2023-09-16,EB,Belgium and Luxembourg,3523,2593,11,1,930,454,465,919,10
2023-09-17,EB,Belgium and Luxembourg,3630,2511,6,1,1119,555,558,1113,5
2023-09-18,EB,Belgium and Luxembourg,3545,2377,15,6,1168,562,591,1153,9
2023-09-19,EB,Belgium and Luxembourg,3638,2476,14,4,1162,572,576,1148,10
2023-09-20,EB,Belgium and Luxembourg,3761,2533,23,6,1228,606,599,1205,17
2023-09-21,EB,Belgium and Luxembourg,3648,2454,16,4,1194,592,586,1178,12
2023-09-22,EB,Belgium and Luxembourg,3778,2593,14,3,1185,604,567,1171,11
2023-09-23,EB,Belgium and Luxembourg,3340,2415,9,3,925,453,463,916,6
2023-09-24,EB,Belgium and Luxembourg,3677,2543,18,7,1134,554,562,1116,11
2023-09-25,EB,Belgium and Luxembourg,3570,2376,21,7,1194,569,604,1173,14
2023-09-26,EB,Belgium and Luxembourg,3310,2202,17,12,1108,549,542,1091,5
2023-09-27,EB,Belgium and Luxembourg,3561,2398,25,13,1163,574,564,1138,12
2023-09-28,EB,Belgium and Luxembourg,3736,2515,16,8,1221,601,604,1205,8
2023-09-29,EB,Belgium and Luxembourg,3772,2612,18,4,1160,592,550,1142,14
2023-09-30,EB,Belgium and Luxembourg,3448,2505,9,1,943,464,470,934,8
2023-10-01,EB,Belgium and Luxembourg,3605,2488,14,2,1117,544,559,1103,12
2023-10-02,EB,Belgium and Luxembourg,3500,2319,20,12,1181,565,596,1161,8
2023-01-01,LQ,Bosnia-Herzegovina,942,895,0,0,47,23,24,47,0
2023-01-02,LQ,Bosnia-Herzegovina,996,941,0,0,55,27,28,55,0
2023-01-03,LQ,Bosnia-Herzegovina,847,798,0,0,49,25,24,49,0
2023-01-04,LQ,Bosnia-Herzegovina,917,875,1,1,42,21,20,41,0
2023-01-05,LQ,Bosnia-Herzegovina,944,895,0,0,49,23,26,49,0
2023-01-06,LQ,Bosnia-Herzegovina,1033,969,0,0,64,33,31,64,0
2023-01-07,LQ,Bosnia-Herzegovina,953,925,0,0,28,15,13,28,0
2023-01-08,LQ,Bosnia-Herzegovina,1066,998,0,0,68,32,36,68,0
2023-01-09,LQ,Bosnia-Herzegovina,901,841,4,0,60,28,28,56,4
2023-01-10,LQ,Bosnia-Herzegovina,724,684,0,0,40,20,20,40,0
2023-01-11,LQ,Bosnia-Herzegovina,757,722,0,0,35,18,17,35,0
2023-01-12,LQ,Bosnia-Herzegovina,831,776,3,0,55,26,26,52,3
2023-01-13,LQ,Bosnia-Herzegovina,934,865,0,0,69,35,34,69,0
2023-01-14,LQ,Bosnia-Herzegovina,911,875,0,0,36,18,18,36,0
2023-01-15,LQ,Bosnia-Herzegovina,956,901,2,0,55,27,26,53,2
2023-01-16,LQ,Bosnia-Herzegovina,792,736,0,0,56,27,29,56,0
2023-01-17,LQ,Bosnia-Herzegovina,710,675,0,0,35,18,17,35,0
2023-01-18,LQ,Bosnia-Herzegovina,696,661,0,0,35,18,17,35,0
2023-01-19,LQ,Bosnia-Herzegovina,718,677,0,0,41,20,21,41,0
2023-01-20,LQ,Bosnia-Herzegovina,896,829,0,0,67,33,34,67,0
2023-01-21,LQ,Bosnia-Herzegovina,826,797,0,0,29,15,14,29,0
2023-01-22,LQ,Bosnia-Herzegovina,893,848,0,0,45,22,23,45,0
2023-01-23,LQ,Bosnia-Herzegovina,783,719,1,0,64,31,32,63,1
2023-01-24,LQ,Bosnia-Herzegovina,700,667,0,0,33,17,16,33,0
2023-01-25,LQ,Bosnia-Herzegovina,773,735,0,0,38,20,18,38,0
2023-01-26,LQ,Bosnia-Herzegovina,760,719,0,0,41,20,21,41,0
2023-01-27,LQ,Bosnia-Herzegovina,858,790,0,0,68,34,34,68,0
2023-01-28,LQ,Bosnia-Herzegovina,889,855,0,0,34,17,17,34,0
2023-01-29,LQ,Bosnia-Herzegovina,1022,970,0,0,52,26,26,52,0
2023-01-30,LQ,Bosnia-Herzegovina,843,784,1,0,59,29,29,58,1
2023-01-31,LQ,Bosnia-Herzegovina,764,727,0,0,37,18,19,37,0
2023-02-01,LQ,Bosnia-Herzegovina,762,722,0,0,40,21,19,40,0
2023-02-02,LQ,Bosnia-Herzegovina,831,791,0,0,40,19,21,40,0
2023-02-03,LQ,Bosnia-Herzegovina,979,918,0,0,61,31,30,61,0
2023-02-04,LQ,Bosnia-Herzegovina,917,888,0,0,29,15,14,29,0
2023-02-05,LQ,Bosnia-Herzegovina,975,926,0,0,49,24,25,49,0
2023-02-06,LQ,Bosnia-Herzegovina,891,839,0,0,52,25,27,52,0
2023-02-07,LQ,Bosnia-Herzegovina,810,771,0,0,39,20,19,39,0
2023-02-08,LQ,Bosnia-Herzegovina,808,772,0,0,36,19,17,36,0
2023-02-09,LQ,Bosnia-Herzegovina,826,791,2,0,35,16,17,33,2
2023-02-10,LQ,Bosnia-Herzegovina,1011,939,0,0,72,36,36,72,0
2023-02-11,LQ,Bosnia-Herzegovina,927,892,0,0,35,18,17,35,0
2023-02-12,LQ,Bosnia-Herzegovina,995,943,0,0,52,25,27,52,0
2023-02-13,LQ,Bosnia-Herzegovina,871,805,0,0,66,33,33,66,0
2023-02-14,LQ,Bosnia-Herzegovina,708,664,0,0,44,22,22,44,0
2023-02-15,LQ,Bosnia-Herzegovina,775,739,0,0,36,19,17,36,0
2023-02-16,LQ,Bosnia-Herzegovina,807,772,0,0,35,17,18,35,0
2023-02-17,LQ,Bosnia-Herzegovina,839,779,2,0,60,29,29,58,2
2023-02-18,LQ,Bosnia-Herzegovina,933,897,0,0,36,18,18,36,0
2023-02-19,LQ,Bosnia-Herzegovina,995,943,0,0,52,26,26,52,0
2023-02-20,LQ,Bosnia-Herzegovina,875,821,0,0,54,26,28,54,0
2023-02-21,LQ,Bosnia-Herzegovina,683,650,0,0,33,17,16,33,0
2023-02-22,LQ,Bosnia-Herzegovina,764,723,0,0,41,21,20,41,0
2023-02-23,LQ,Bosnia-Herzegovina,807,767,0,0,40,19,21,40,0
2023-02-24,LQ,Bosnia-Herzegovina,990,920,0,0,70,35,35,70,0
2023-02-25,LQ,Bosnia-Herzegovina,925,888,0,0,37,19,18,37,0
2023-02-26,LQ,Bosnia-Herzegovina,979,939,0,0,40,20,20,40,0
2023-02-27,LQ,Bosnia-Herzegovina,880,825,2,0,55,26,27,53,2
2023-02-28,LQ,Bosnia-Herzegovina,802,760,0,0,42,21,21,42,0
2023-03-01,LQ,Bosnia-Herzegovina,836,805,0,0,31,16,15,31,0
2023-03-02,LQ,Bosnia-Herzegovina,842,801,1,0,41,21,19,40,1
2023-03-03,LQ,Bosnia-Herzegovina,987,929,1,0,58,28,29,57,1
2023-03-04,LQ,Bosnia-Herzegovina,945,909,0,0,36,18,18,36,0
2023-03-05,LQ,Bosnia-Herzegovina,1044,990,0,0,54,27,27,54,0
2023-03-06,LQ,Bosnia-Herzegovina,886,831,0,0,55,26,29,55,0
2023-03-07,LQ,Bosnia-Herzegovina,770,727,0,0,43,22,21,43,0
2023-03-08,LQ,Bosnia-Herzegovina,857,818,0,0,39,20,19,39,0
2023-03-09,LQ,Bosnia-Herzegovina,862,818,0,0,44,21,23,44,0
2023-03-10,LQ,Bosnia-Herzegovina,917,847,0,0,70,36,34,70,0
2023-03-11,LQ,Bosnia-Herzegovina,908,872,0,0,36,18,18,36,0
2023-03-12,LQ,Bosnia-Herzegovina,1032,980,0,0,52,26,26,52,0
2023-03-13,LQ,Bosnia-Herzegovina,938,880,2,0,58,27,29,56,2
2023-03-14,LQ,Bosnia-Herzegovina,848,798,1,1,50,24,25,49,0
2023-03-15,LQ,Bosnia-Herzegovina,874,831,0,0,43,23,20,43,0
2023-03-16,LQ,Bosnia-Herzegovina,807,765,0,0,42,19,23,42,0
2023-03-17,LQ,Bosnia-Herzegovina,1109,1042,0,0,67,34,33,67,0
2023-03-18,LQ,Bosnia-Herzegovina,1024,987,0,0,37,19,18,37,0
2023-03-19,LQ,Bosnia-Herzegovina,1065,1013,0,0,52,25,27,52,0
2023-03-20,LQ,Bosnia-Herzegovina,1015,961,0,0,54,27,27,54,0
2023-03-21,LQ,Bosnia-Herzegovina,891,839,2,0,52,25,25,50,2
2023-03-22,LQ,Bosnia-Herzegovina,909,861,0,0,48,25,23,48,0
2023-03-23,LQ,Bosnia-Herzegovina,901,853,1,1,48,23,24,47,0
2023-03-24,LQ,Bosnia-Herzegovina,1011,952,0,0,59,30,29,59,0
2023-03-25,LQ,Bosnia-Herzegovina,1034,993,0,0,41,20,21,41,0
2023-03-26,LQ,Bosnia-Herzegovina,1157,1097,0,0,60,30,30,60,0
2023-03-27,LQ,Bosnia-Herzegovina,975,922,0,0,53,27,26,53,0
2023-03-28,LQ,Bosnia-Herzegovina,1072,1012,0,0,60,29,31,60,0
2023-03-29,LQ,Bosnia-Herzegovina,1148,1095,0,0,53,27,26,53,0
2023-03-30,LQ,Bosnia-Herzegovina,1173,1111,2,0,62,29,31,60,2
2023-03-31,LQ,Bosnia-Herzegovina,1275,1219,0,0,56,29,27,56,0
2023-04-01,LQ,Bosnia-Herzegovina,1424,1369,0,0,55,27,28,55,0
2023-04-02,LQ,Bosnia-Herzegovina,1351,1302,0,0,49,25,24,49,0
2023-04-03,LQ,Bosnia-Herzegovina,1246,1173,0,0,73,36,37,73,0
2023-04-04,LQ,Bosnia-Herzegovina,1226,1174,0,0,52,26,26,52,0
2023-04-05,LQ,Bosnia-Herzegovina,1287,1234,0,0,53,27,26,53,0
2023-04-06,LQ,Bosnia-Herzegovina,1178,1125,0,0,53,26,27,53,0
2023-04-07,LQ,Bosnia-Herzegovina,1363,1302,0,0,61,31,30,61,0
2023-04-08,LQ,Bosnia-Herzegovina,1407,1355,0,0,52,26,26,52,0
2023-04-09,LQ,Bosnia-Herzegovina,1286,1234,0,0,52,26,26,52,0
2023-04-10,LQ,Bosnia-Herzegovina,1285,1226,0,0,59,29,30,59,0
2023-04-11,LQ,Bosnia-Herzegovina,1215,1156,0,0,59,29,30,59,0
2023-04-12,LQ,Bosnia-Herzegovina,1291,1233,0,0,58,30,28,58,0
2023-04-13,LQ,Bosnia-Herzegovina,1218,1158,0,0,60,30,30,60,0
2023-04-14,LQ,Bosnia-Herzegovina,1322,1264,0,0,58,29,29,58,0
2023-04-15,LQ,Bosnia-Herzegovina,1445,1388,0,0,57,28,29,57,0
2023-04-16,LQ,Bosnia-Herzegovina,1381,1331,0,0,50,25,25,50,0
2023-04-17,LQ,Bosnia-Herzegovina,1301,1230,0,0,71,35,36,71,0
2023-04-18,LQ,Bosnia-Herzegovina,1170,1102,0,0,68,33,35,68,0
2023-04-19,LQ,Bosnia-Herzegovina,1183,1111,2,1,72,36,34,70,1
2023-04-20,LQ,Bosnia-Herzegovina,1212,1141,2,1,71,35,34,69,1
2023-04-21,LQ,Bosnia-Herzegovina,1340,1271,2,1,69,34,33,67,1
2023-04-22,LQ,Bosnia-Herzegovina,1460,1396,1,1,64,32,31,63,0
2023-04-23,LQ,Bosnia-Herzegovina,1397,1343,0,0,54,27,27,54,0
2023-04-24,LQ,Bosnia-Herzegovina,1250,1187,1,1,63,29,33,62,0
2023-04-25,LQ,Bosnia-Herzegovina,1174,1105,0,0,69,35,34,69,0
2023-04-26,LQ,Bosnia-Herzegovina,1259,1193,0,0,66,34,32,66,0
2023-04-27,LQ,Bosnia-Herzegovina,1290,1221,1,1,69,34,34,68,0
2023-04-28,LQ,Bosnia-Herzegovina,1453,1387,1,1,66,33,32,65,0
2023-04-29,LQ,Bosnia-Herzegovina,1519,1461,0,0,58,29,29,58,0
2023-04-30,LQ,Bosnia-Herzegovina,1490,1444,0,0,46,23,23,46,0
2023-05-01,LQ,Bosnia-Herzegovina,1327,1263,0,0,64,31,33,64,0
2023-05-02,LQ,Bosnia-Herzegovina,1329,1258,0,0,71,36,35,71,0
2023-05-03,LQ,Bosnia-Herzegovina,1384,1319,1,0,65,32,32,64,1
2023-05-04,LQ,Bosnia-Herzegovina,1353,1295,0,0,58,28,30,58,0
2023-05-05,LQ,Bosnia-Herzegovina,1431,1369,0,0,62,32,30,62,0
2023-05-06,LQ,Bosnia-Herzegovina,1589,1527,0,0,62,31,31,62,0
2023-05-07,LQ,Bosnia-Herzegovina,1508,1455,0,0,53,27,26,53,0
2023-05-08,LQ,Bosnia-Herzegovina,1376,1310,1,1,66,33,32,65,0
2023-05-09,LQ,Bosnia-Herzegovina,1333,1265,0,0,68,34,34,68,0
2023-05-10,LQ,Bosnia-Herzegovina,1332,1273,0,0,59,30,29,59,0
2023-05-11,LQ,Bosnia-Herzegovina,1304,1246,0,0,58,28,30,58,0
2023-05-12,LQ,Bosnia-Herzegovina,1508,1439,0,0,69,35,34,69,0
2023-05-13,LQ,Bosnia-Herzegovina,1643,1583,0,0,60,30,30,60,0
2023-05-14,LQ,Bosnia-Herzegovina,1523,1473,0,0,50,25,25,50,0
2023-05-15,LQ,Bosnia-Herzegovina,1477,1414,0,0,63,31,32,63,0
2023-05-16,LQ,Bosnia-Herzegovina,1388,1323,3,0,65,30,32,62,3
2023-05-17,LQ,Bosnia-Herzegovina,1446,1375,3,1,71,35,33,68,2
2023-05-18,LQ,Bosnia-Herzegovina,1494,1432,0,0,62,30,32,62,0
2023-05-19,LQ,Bosnia-Herzegovina,1573,1506,0,0,67,35,32,67,0
2023-05-20,LQ,Bosnia-Herzegovina,1747,1684,0,0,63,31,32,63,0
2023-05-21,LQ,Bosnia-Herzegovina,1651,1594,0,0,57,29,28,57,0
2023-05-22,LQ,Bosnia-Herzegovina,1564,1496,0,0,68,33,35,68,0
2023-05-23,LQ,Bosnia-Herzegovina,1515,1457,1,1,58,29,28,57,0
2023-05-24,LQ,Bosnia-Herzegovina,1536,1473,0,0,63,32,31,63,0
2023-05-25,LQ,Bosnia-Herzegovina,1475,1397,0,0,78,39,39,78,0
2023-05-26,LQ,Bosnia-Herzegovina,1575,1515,0,0,60,31,29,60,0
2023-05-27,LQ,Bosnia-Herzegovina,1741,1686,0,0,55,27,28,55,0
2023-05-28,LQ,Bosnia-Herzegovina,1646,1589,0,0,57,29,28,57,0
2023-05-29,LQ,Bosnia-Herzegovina,1632,1572,0,0,60,29,31,60,0
2023-05-30,LQ,Bosnia-Herzegovina,1454,1385,1,1,69,33,35,68,0
2023-05-31,LQ,Bosnia-Herzegovina,1591,1522,1,1,69,36,32,68,0
2023-06-01,LQ,Bosnia-Herzegovina,1601,1535,0,0,66,32,34,66,0
2023-06-02,LQ,Bosnia-Herzegovina,1699,1631,1,0,68,34,33,67,1
2023-06-03,LQ,Bosnia-Herzegovina,1680,1611,0,0,69,34,35,69,0
2023-06-04,LQ,Bosnia-Herzegovina,1580,1530,0,0,50,25,25,50,0
2023-06-05,LQ,Bosnia-Herzegovina,1603,1535,0,0,68,34,34,68,0
2023-06-06,LQ,Bosnia-Herzegovina,1611,1548,0,0,63,31,32,63,0
2023-06-07,LQ,Bosnia-Herzegovina,1587,1519,0,0,68,35,33,68,0
2023-06-08,LQ,Bosnia-Herzegovina,1699,1638,0,0,61,29,32,61,0
2023-06-09,LQ,Bosnia-Herzegovina,1753,1678,0,0,75,38,37,75,0
2023-06-10,LQ,Bosnia-Herzegovina,1810,1743,0,0,67,33,34,67,0
2023-06-11,LQ,Bosnia-Herzegovina,1774,1719,0,0,55,27,28,55,0
2023-06-12,LQ,Bosnia-Herzegovina,1673,1596,0,0,77,39,38,77,0
2023-06-13,LQ,Bosnia-Herzegovina,1679,1603,0,0,76,38,38,76,0
2023-06-14,LQ,Bosnia-Herzegovina,1767,1696,0,0,71,36,35,71,0
2023-06-15,LQ,Bosnia-Herzegovina,1679,1602,0,0,77,37,40,77,0
2023-06-16,LQ,Bosnia-Herzegovina,1702,1617,1,0,85,43,41,84,1
2023-06-17,LQ,Bosnia-Herzegovina,1888,1812,0,0,76,38,38,76,0
2023-06-18,LQ,Bosnia-Herzegovina,1826,1762,0,0,64,32,32,64,0
2023-06-19,LQ,Bosnia-Herzegovina,1782,1712,0,0,70,36,34,70,0
2023-06-20,LQ,Bosnia-Herzegovina,1668,1596,0,0,72,35,37,72,0
2023-06-21,LQ,Bosnia-Herzegovina,1714,1633,0,0,81,40,41,81,0
2023-06-22,LQ,Bosnia-Herzegovina,1585,1515,1,0,70,33,36,69,1
2023-06-23,LQ,Bosnia-Herzegovina,1679,1588,1,0,91,46,44,90,1
2023-06-24,LQ,Bosnia-Herzegovina,1853,1774,2,2,79,39,38,77,0
2023-06-25,LQ,Bosnia-Herzegovina,1764,1695,0,0,69,34,35,69,0
2023-06-26,LQ,Bosnia-Herzegovina,1772,1692,0,0,80,42,38,80,0
2023-06-27,LQ,Bosnia-Herzegovina,1721,1646,0,0,75,36,39,75,0
2023-06-28,LQ,Bosnia-Herzegovina,1718,1638,3,0,80,40,37,77,3
2023-06-29,LQ,Bosnia-Herzegovina,1736,1668,0,0,68,33,35,68,0
2023-06-30,LQ,Bosnia-Herzegovina,1776,1688,2,0,88,44,42,86,2
2023-07-01,LQ,Bosnia-Herzegovina,1801,1726,0,0,75,37,38,75,0
2023-07-02,LQ,Bosnia-Herzegovina,1821,1755,0,0,66,33,33,66,0
2023-07-03,LQ,Bosnia-Herzegovina,1769,1686,0,0,83,42,41,83,0
2023-07-04,LQ,Bosnia-Herzegovina,1677,1596,0,0,81,40,41,81,0
2023-07-05,LQ,Bosnia-Herzegovina,1670,1591,0,0,79,40,39,79,0
2023-07-06,LQ,Bosnia-Herzegovina,1809,1733,1,0,76,36,39,75,1
2023-07-07,LQ,Bosnia-Herzegovina,1897,1809,0,0,88,45,43,88,0
2023-07-08,LQ,Bosnia-Herzegovina,1996,1911,0,0,85,42,43,85,0
2023-07-09,LQ,Bosnia-Herzegovina,1947,1873,0,0,74,38,36,74,0
2023-07-10,LQ,Bosnia-Herzegovina,1854,1772,0,0,82,41,41,82,0
2023-07-11,LQ,Bosnia-Herzegovina,1834,1750,3,0,84,39,42,81,3
2023-07-12,LQ,Bosnia-Herzegovina,1877,1797,2,0,80,40,38,78,2
2023-07-13,LQ,Bosnia-Herzegovina,1740,1669,0,0,71,35,36,71,0
2023-07-14,LQ,Bosnia-Herzegovina,1936,1844,0,0,92,47,45,92,0
2023-07-15,LQ,Bosnia-Herzegovina,2008,1930,0,0,78,39,39,78,0
2023-07-16,LQ,Bosnia-Herzegovina,1899,1824,0,0,75,38,37,75,0
2023-07-17,LQ,Bosnia-Herzegovina,1836,1749,0,0,87,42,45,87,0
2023-07-18,LQ,Bosnia-Herzegovina,1633,1553,1,0,80,41,38,79,1
2023-07-19,LQ,Bosnia-Herzegovina,1700,1620,1,0,80,39,40,79,1
2023-07-20,LQ,Bosnia-Herzegovina,1775,1705,0,0,70,34,36,70,0
2023-07-21,LQ,Bosnia-Herzegovina,1875,1786,1,1,89,46,42,88,0
2023-07-22,LQ,Bosnia-Herzegovina,1960,1877,0,0,83,41,42,83,0
2023-07-23,LQ,Bosnia-Herzegovina,1933,1862,0,0,71,36,35,71,0
2023-07-24,LQ,Bosnia-Herzegovina,1850,1755,2,0,95,46,47,93,2
2023-07-25,LQ,Bosnia-Herzegovina,1692,1606,0,0,86,44,42,86,0
2023-07-26,LQ,Bosnia-Herzegovina,1764,1684,1,1,80,38,41,79,0
2023-07-27,LQ,Bosnia-Herzegovina,1898,1814,1,0,84,40,43,83,1
2023-07-28,LQ,Bosnia-Herzegovina,1900,1807,0,0,93,49,44,93,0
2023-07-29,LQ,Bosnia-Herzegovina,2052,1971,0,0,81,39,42,81,0
2023-07-30,LQ,Bosnia-Herzegovina,1832,1755,0,0,77,39,38,77,0
2023-07-31,LQ,Bosnia-Herzegovina,1916,1817,0,0,99,50,49,99,0
2023-08-01,LQ,Bosnia-Herzegovina,1887,1793,0,0,94,47,47,94,0
2023-08-02,LQ,Bosnia-Herzegovina,1886,1807,0,0,79,39,40,79,0
2023-08-03,LQ,Bosnia-Herzegovina,1812,1729,0,0,83,40,43,83,0
2023-08-04,LQ,Bosnia-Herzegovina,1665,1573,0,0,92,48,44,92,0
2023-08-05,LQ,Bosnia-Herzegovina,1854,1766,0,0,88,43,45,88,0
2023-08-06,LQ,Bosnia-Herzegovina,1801,1726,0,0,75,39,36,75,0
2023-08-07,LQ,Bosnia-Herzegovina,1766,1658,0,0,108,54,54,108,0
2023-08-08,LQ,Bosnia-Herzegovina,1813,1723,0,0,90,45,45,90,0
2023-08-09,LQ,Bosnia-Herzegovina,1807,1728,0,0,79,39,40,79,0
2023-08-10,LQ,Bosnia-Herzegovina,1823,1739,0,0,84,41,43,84,0
2023-08-11,LQ,Bosnia-Herzegovina,1923,1819,0,0,104,54,50,104,0
2023-08-12,LQ,Bosnia-Herzegovina,1999,1910,0,0,89,43,46,89,0
2023-08-13,LQ,Bosnia-Herzegovina,1907,1825,0,0,82,41,41,82,0
2023-08-14,LQ,Bosnia-Herzegovina,1835,1742,0,0,93,47,46,93,0
2023-08-15,LQ,Bosnia-Herzegovina,1830,1743,0,0,87,44,43,87,0
2023-08-16,LQ,Bosnia-Herzegovina,1780,1699,0,0,81,41,40,81,0
2023-08-17,LQ,Bosnia-Herzegovina,1778,1693,0,0,85,41,44,85,0
2023-08-18,LQ,Bosnia-Herzegovina,1876,1771,0,0,105,52,53,105,0
2023-08-19,LQ,Bosnia-Herzegovina,1799,1714,0,0,85,43,42,85,0
2023-08-20,LQ,Bosnia-Herzegovina,1928,1838,0,0,90,46,44,90,0
2023-08-21,LQ,Bosnia-Herzegovina,1842,1741,2,0,101,48,51,99,2
2023-08-22,LQ,Bosnia-Herzegovina,1860,1767,0,0,93,47,46,93,0
2023-08-23,LQ,Bosnia-Herzegovina,1750,1658,0,0,92,47,45,92,0
2023-08-24,LQ,Bosnia-Herzegovina,1695,1608,0,0,87,42,45,87,0
2023-08-25,LQ,Bosnia-Herzegovina,1815,1714,1,0,101,52,48,100,1
2023-08-26,LQ,Bosnia-Herzegovina,1908,1829,0,0,79,39,40,79,0
2023-08-27,LQ,Bosnia-Herzegovina,1931,1857,0,0,74,37,37,74,0
2023-08-28,LQ,Bosnia-Herzegovina,1561,1473,0,0,88,44,44,88,0
2023-08-29,LQ,Bosnia-Herzegovina,1798,1700,0,0,98,48,50,98,0
2023-08-30,LQ,Bosnia-Herzegovina,1778,1687,0,0,91,47,44,91,0
2023-08-31,LQ,Bosnia-Herzegovina,1734,1648,1,0,86,42,43,85,1
2023-09-01,LQ,Bosnia-Herzegovina,1857,1768,0,0,89,45,44,89,0
2023-09-02,LQ,Bosnia-Herzegovina,1967,1903,0,0,64,32,32,64,0
2023-09-03,LQ,Bosnia-Herzegovina,1873,1815,0,0,58,29,29,58,0
2023-09-04,LQ,Bosnia-Herzegovina,1833,1749,0,0,84,41,43,84,0
2023-09-05,LQ,Bosnia-Herzegovina,1738,1663,0,0,75,37,38,75,0
2023-09-06,LQ,Bosnia-Herzegovina,1779,1698,1,1,81,41,39,80,0
2023-09-07,LQ,Bosnia-Herzegovina,1793,1720,1,0,73,34,38,72,1
2023-09-08,LQ,Bosnia-Herzegovina,1851,1771,0,0,80,41,39,80,0
2023-09-09,LQ,Bosnia-Herzegovina,2020,1947,0,0,73,37,36,73,0
2023-09-10,LQ,Bosnia-Herzegovina,1837,1782,0,0,55,28,27,55,0
2023-09-11,LQ,Bosnia-Herzegovina,1804,1729,0,0,75,37,38,75,0
2023-09-12,LQ,Bosnia-Herzegovina,1728,1661,0,0,67,34,33,67,0
2023-09-13,LQ,Bosnia-Herzegovina,1690,1620,1,0,70,35,34,69,1
2023-09-14,LQ,Bosnia-Herzegovina,1682,1622,0,0,60,29,31,60,0
2023-09-15,LQ,Bosnia-Herzegovina,1647,1582,0,0,65,34,31,65,0
2023-09-16,LQ,Bosnia-Herzegovina,1834,1775,0,0,59,28,31,59,0
2023-09-17,LQ,Bosnia-Herzegovina,1727,1682,0,0,45,23,22,45,0
2023-09-18,LQ,Bosnia-Herzegovina,1678,1619,0,0,59,29,30,59,0
2023-09-19,LQ,Bosnia-Herzegovina,1671,1605,1,1,66,33,32,65,0
2023-09-20,LQ,Bosnia-Herzegovina,1740,1680,1,0,60,29,30,59,1
2023-09-21,LQ,Bosnia-Herzegovina,1635,1576,1,1,59,28,30,58,0
2023-09-22,LQ,Bosnia-Herzegovina,1723,1658,0,0,65,34,31,65,0
2023-09-23,LQ,Bosnia-Herzegovina,1685,1629,1,0,56,27,28,55,1
2023-09-24,LQ,Bosnia-Herzegovina,1732,1682,1,0,50,24,25,49,1
2023-09-25,LQ,Bosnia-Herzegovina,1557,1488,4,1,69,32,33,65,3
2023-09-26,LQ,Bosnia-Herzegovina,1644,1585,2,2,59,29,28,57,0
2023-09-27,LQ,Bosnia-Herzegovina,1609,1554,4,1,55,26,25,51,3
2023-09-28,LQ,Bosnia-Herzegovina,1623,1560,1,1,63,30,32,62,0
2023-09-29,LQ,Bosnia-Herzegovina,1750,1683,0,0,67,35,32,67,0
2023-09-30,LQ,Bosnia-Herzegovina,1885,1825,0,0,60,30,30,60,0
2023-10-01,LQ,Bosnia-Herzegovina,1752,1710,0,0,42,21,21,42,0
2023-10-02,LQ,Bosnia-Herzegovina,1634,1569,0,0,65,33,32,65,0
2023-01-01,LB,Bulgaria,1890,1755,2,0,135,65,68,133,2
2023-01-02,LB,Bulgaria,1967,1715,6,0,252,116,130,246,6
2023-01-03,LB,Bulgaria,1958,1775,6,0,183,89,88,177,6
2023-01-04,LB,Bulgaria,1948,1760,7,0,188,85,96,181,7
2023-01-05,LB,Bulgaria,1968,1785,5,0,183,90,88,178,5
2023-01-06,LB,Bulgaria,2064,1869,10,0,195,92,93,185,10
2023-01-07,LB,Bulgaria,2147,1945,4,0,202,101,97,198,4
2023-01-08,LB,Bulgaria,2167,1977,5,1,190,93,92,185,4
2023-01-09,LB,Bulgaria,1933,1757,6,2,176,80,90,170,4
2023-01-10,LB,Bulgaria,1846,1699,8,3,147,71,68,139,5
2023-01-11,LB,Bulgaria,1881,1722,21,13,159,67,71,138,8
2023-01-12,LB,Bulgaria,1888,1721,15,6,167,77,75,152,9
2023-01-13,LB,Bulgaria,1936,1757,6,0,179,85,88,173,6
2023-01-14,LB,Bulgaria,2006,1824,2,0,182,92,88,180,2
2023-01-15,LB,Bulgaria,2004,1825,4,0,179,87,88,175,4
2023-01-16,LB,Bulgaria,1806,1634,10,2,172,82,80,162,8
2023-01-17,LB,Bulgaria,1787,1658,5,0,129,61,63,124,5
2023-01-18,LB,Bulgaria,1855,1711,7,0,144,67,70,137,7
2023-01-19,LB,Bulgaria,1902,1754,5,1,148,72,71,143,4
2023-01-20,LB,Bulgaria,1977,1793,11,4,184,90,83,173,7
2023-01-21,LB,Bulgaria,2039,1859,3,1,180,89,88,177,2
2023-01-22,LB,Bulgaria,2019,1833,5,0,186,87,94,181,5
2023-01-23,LB,Bulgaria,1814,1657,10,2,157,73,74,147,8
2023-01-24,LB,Bulgaria,1656,1534,6,0,122,59,57,116,6
2023-01-25,LB,Bulgaria,1736,1578,10,1,158,72,76,148,9
2023-01-26,LB,Bulgaria,1895,1739,7,2,156,78,71,149,5
2023-01-27,LB,Bulgaria,1895,1721,9,1,174,85,80,165,8
2023-01-28,LB,Bulgaria,1996,1807,4,1,189,94,91,185,3
2023-01-29,LB,Bulgaria,1976,1792,5,0,184,90,89,179,5
2023-01-30,LB,Bulgaria,1753,1587,13,1,166,73,80,153,12
2023-01-31,LB,Bulgaria,1610,1482,9,1,128,61,58,119,8
2023-02-01,LB,Bulgaria,1695,1543,4,0,152,72,76,148,4
2023-02-02,LB,Bulgaria,1774,1624,6,0,150,73,71,144,6
2023-02-03,LB,Bulgaria,1840,1660,8,1,180,87,85,172,7
2023-02-04,LB,Bulgaria,1927,1750,4,1,177,86,87,173,3
2023-02-05,LB,Bulgaria,1873,1683,5,0,190,90,95,185,5
2023-02-06,LB,Bulgaria,1637,1472,9,0,165,80,76,156,9
2023-02-07,LB,Bulgaria,1587,1456,5,1,131,61,65,126,4
2023-02-08,LB,Bulgaria,1646,1499,6,2,147,70,71,141,4
2023-02-09,LB,Bulgaria,1773,1599,6,0,174,83,85,168,6
2023-02-10,LB,Bulgaria,1900,1700,10,1,200,99,91,190,9
2023-02-11,LB,Bulgaria,2040,1863,3,1,177,88,86,174,2
2023-02-12,LB,Bulgaria,2071,1872,4,0,199,97,98,195,4
2023-02-13,LB,Bulgaria,1789,1623,5,1,166,78,83,161,4
2023-02-14,LB,Bulgaria,1732,1579,9,2,153,72,72,144,7
2023-02-15,LB,Bulgaria,1829,1672,12,2,157,74,71,145,10
2023-02-16,LB,Bulgaria,1884,1723,9,2,161,77,75,152,7
2023-02-17,LB,Bulgaria,1794,1617,8,2,177,88,81,169,6
2023-02-18,LB,Bulgaria,2168,1973,2,0,195,94,99,193,2
2023-02-19,LB,Bulgaria,2153,1958,6,0,195,91,98,189,6
2023-02-20,LB,Bulgaria,1887,1711,6,0,176,85,85,170,6
2023-02-21,LB,Bulgaria,1768,1635,12,2,133,62,59,121,10
2023-02-22,LB,Bulgaria,1847,1693,10,2,154,71,73,144,8
2023-02-23,LB,Bulgaria,1894,1720,10,6,174,82,82,164,4
2023-02-24,LB,Bulgaria,1976,1778,9,0,198,93,96,189,9
2023-02-25,LB,Bulgaria,2118,1928,7,1,190,95,88,183,6
2023-02-26,LB,Bulgaria,2112,1925,5,0,187,91,91,182,5
2023-02-27,LB,Bulgaria,1902,1748,7,1,154,75,72,147,6
2023-02-28,LB,Bulgaria,1781,1637,18,11,144,63,63,126,7
2023-03-01,LB,Bulgaria,1898,1729,14,4,169,77,78,155,10
2023-03-02,LB,Bulgaria,1971,1794,5,1,177,88,84,172,4
2023-03-03,LB,Bulgaria,2047,1866,7,0,181,87,87,174,7
2023-03-04,LB,Bulgaria,2164,1976,3,0,188,92,93,185,3
2023-03-05,LB,Bulgaria,2124,1936,5,0,188,89,94,183,5
2023-03-06,LB,Bulgaria,1914,1744,9,0,170,79,82,161,9
2023-03-07,LB,Bulgaria,1769,1619,17,3,150,67,66,133,14
2023-03-08,LB,Bulgaria,1829,1670,13,1,159,76,70,146,12
2023-03-09,LB,Bulgaria,1954,1762,10,1,192,90,92,182,9
2023-03-10,LB,Bulgaria,2022,1843,8,0,179,86,85,171,8
2023-03-11,LB,Bulgaria,2177,1989,3,1,188,94,91,185,2
2023-03-12,LB,Bulgaria,2136,1944,5,0,192,91,96,187,5
2023-03-13,LB,Bulgaria,1841,1667,15,4,174,80,79,159,11
2023-03-14,LB,Bulgaria,1815,1666,16,3,149,66,67,133,13
2023-03-15,LB,Bulgaria,1869,1696,12,0,173,80,81,161,12
2023-03-16,LB,Bulgaria,1931,1743,12,3,188,87,89,176,9
2023-03-17,LB,Bulgaria,1900,1717,8,0,183,91,84,175,8
2023-03-18,LB,Bulgaria,1996,1814,3,1,182,91,88,179,2
2023-03-19,LB,Bulgaria,2018,1831,5,0,187,90,92,182,5
2023-03-20,LB,Bulgaria,1821,1646,17,4,175,77,81,158,13
2023-03-21,LB,Bulgaria,1787,1635,19,9,152,64,69,133,10
2023-03-22,LB,Bulgaria,1886,1715,17,6,171,78,76,154,11
2023-03-23,LB,Bulgaria,1951,1771,9,1,180,89,82,171,8
2023-03-24,LB,Bulgaria,2014,1811,12,1,203,96,95,191,11
2023-03-25,LB,Bulgaria,2080,1908,2,0,172,86,84,170,2
2023-03-26,LB,Bulgaria,2143,1949,8,0,194,92,94,186,8
2023-03-27,LB,Bulgaria,1733,1581,4,0,152,74,74,148,4
2023-03-28,LB,Bulgaria,2159,1978,5,0,181,87,89,176,5
2023-03-29,LB,Bulgaria,2042,1838,17,5,204,92,95,187,12
2023-03-30,LB,Bulgaria,2057,1852,13,2,205,99,93,192,11
2023-03-31,LB,Bulgaria,2148,1958,17,1,190,87,86,173,16
2023-04-01,LB,Bulgaria,2426,2245,2,0,181,93,86,179,2
2023-04-02,LB,Bulgaria,2435,2246,6,0,189,90,93,183,6
2023-04-03,LB,Bulgaria,2209,2028,5,0,181,88,88,176,5
2023-04-04,LB,Bulgaria,2259,2077,5,1,182,89,88,177,4
2023-04-05,LB,Bulgaria,2283,2096,6,0,187,91,90,181,6
2023-04-06,LB,Bulgaria,2368,2169,10,3,199,96,93,189,7
2023-04-07,LB,Bulgaria,2427,2211,9,2,216,102,105,207,7
2023-04-08,LB,Bulgaria,2544,2350,2,0,194,99,93,192,2
2023-04-09,LB,Bulgaria,2460,2264,7,0,196,95,94,189,7
2023-04-10,LB,Bulgaria,2232,2043,10,1,189,88,91,179,9
2023-04-11,LB,Bulgaria,2198,2012,6,2,186,92,88,180,4
2023-04-12,LB,Bulgaria,2165,1968,6,0,197,93,98,191,6
2023-04-13,LB,Bulgaria,2437,2226,6,0,211,103,102,205,6
2023-04-14,LB,Bulgaria,2482,2281,9,2,201,98,94,192,7
2023-04-15,LB,Bulgaria,2621,2431,2,0,190,93,95,188,2
2023-04-16,LB,Bulgaria,2527,2318,9,0,209,97,103,200,9
2023-04-17,LB,Bulgaria,2271,2073,8,0,198,94,96,190,8
2023-04-18,LB,Bulgaria,2318,2116,6,0,202,97,99,196,6
2023-04-19,LB,Bulgaria,2385,2181,14,0,204,96,94,190,14
2023-04-20,LB,Bulgaria,2410,2211,15,2,199,93,91,184,13
2023-04-21,LB,Bulgaria,2417,2214,14,1,203,93,96,189,13
2023-04-22,LB,Bulgaria,2656,2468,5,3,188,92,91,183,2
2023-04-23,LB,Bulgaria,2666,2457,8,1,209,99,102,201,7
2023-04-24,LB,Bulgaria,2333,2136,11,1,197,90,96,186,10
2023-04-25,LB,Bulgaria,2372,2164,7,1,208,105,96,201,6
2023-04-26,LB,Bulgaria,2391,2177,14,0,214,99,101,200,14
2023-04-27,LB,Bulgaria,2502,2291,15,1,211,97,99,196,14
2023-04-28,LB,Bulgaria,2564,2347,10,3,217,107,100,207,7
2023-04-29,LB,Bulgaria,2751,2555,5,1,196,97,94,191,4
2023-04-30,LB,Bulgaria,2727,2520,7,0,207,98,102,200,7
2023-05-01,LB,Bulgaria,2544,2351,8,0,193,88,97,185,8
2023-05-02,LB,Bulgaria,2458,2248,16,0,210,100,94,194,16
2023-05-03,LB,Bulgaria,2476,2280,12,1,196,91,93,184,11
2023-05-04,LB,Bulgaria,2598,2394,7,1,204,101,96,197,6
2023-05-05,LB,Bulgaria,2611,2381,19,12,230,104,107,211,7
2023-05-06,LB,Bulgaria,2795,2588,16,8,207,98,93,191,8
2023-05-07,LB,Bulgaria,2831,2626,7,0,205,98,100,198,7
2023-05-08,LB,Bulgaria,2457,2254,6,0,203,98,99,197,6
2023-05-09,LB,Bulgaria,2447,2245,8,1,202,96,98,194,7
2023-05-10,LB,Bulgaria,2542,2354,9,0,188,91,88,179,9
2023-05-11,LB,Bulgaria,2629,2423,9,1,206,100,97,197,8
2023-05-12,LB,Bulgaria,2700,2482,9,0,218,105,104,209,9
2023-05-13,LB,Bulgaria,2998,2800,2,0,198,96,100,196,2
2023-05-14,LB,Bulgaria,2941,2719,10,3,222,109,103,212,7
2023-05-15,LB,Bulgaria,2529,2313,10,0,216,98,108,206,10
2023-05-16,LB,Bulgaria,2502,2284,13,2,218,103,102,205,11
2023-05-17,LB,Bulgaria,2622,2414,9,1,208,100,99,199,8
2023-05-18,LB,Bulgaria,2714,2470,16,2,244,114,114,228,14
2023-05-19,LB,Bulgaria,2647,2405,11,2,242,116,115,231,9
2023-05-20,LB,Bulgaria,2861,2660,2,0,201,101,98,199,2
2023-05-21,LB,Bulgaria,2925,2718,6,0,207,102,99,201,6
2023-05-22,LB,Bulgaria,2608,2405,11,1,203,97,95,192,10
2023-05-23,LB,Bulgaria,2551,2323,8,0,228,108,112,220,8
2023-05-24,LB,Bulgaria,2679,2460,9,0,219,103,107,210,9
2023-05-25,LB,Bulgaria,2749,2501,12,2,248,117,119,236,10
2023-05-26,LB,Bulgaria,2915,2646,13,1,269,129,127,256,12
2023-05-27,LB,Bulgaria,3118,2903,4,1,215,108,103,211,3
2023-05-28,LB,Bulgaria,3017,2774,8,3,243,114,121,235,5
2023-05-29,LB,Bulgaria,2733,2486,16,4,247,114,117,231,12
2023-05-30,LB,Bulgaria,2704,2457,14,3,247,120,113,233,11
2023-05-31,LB,Bulgaria,2762,2516,18,4,246,113,115,228,14
2023-06-01,LB,Bulgaria,2952,2678,11,1,274,132,131,263,10
2023-06-02,LB,Bulgaria,3026,2699,10,1,327,160,157,317,9
2023-06-03,LB,Bulgaria,3250,3002,5,0,248,123,120,243,5
2023-06-04,LB,Bulgaria,3213,2940,16,0,273,130,127,257,16
2023-06-05,LB,Bulgaria,2875,2618,6,0,257,126,125,251,6
2023-06-06,LB,Bulgaria,2887,2569,24,8,318,143,151,294,16
2023-06-07,LB,Bulgaria,2965,2706,9,0,259,128,122,250,9
2023-06-08,LB,Bulgaria,3115,2847,11,0,268,128,129,257,11
2023-06-09,LB,Bulgaria,3195,2846,12,0,349,167,170,337,12
2023-06-10,LB,Bulgaria,3393,3142,4,0,251,125,122,247,4
2023-06-11,LB,Bulgaria,3394,3104,10,0,290,138,142,280,10
2023-06-12,LB,Bulgaria,2935,2664,10,0,271,133,128,261,10
2023-06-13,LB,Bulgaria,2930,2608,8,0,322,154,160,314,8
2023-06-14,LB,Bulgaria,3023,2737,20,1,286,132,134,266,19
2023-06-15,LB,Bulgaria,3105,2822,14,1,283,136,133,269,13
2023-06-16,LB,Bulgaria,3231,2839,17,0,392,187,188,375,17
2023-06-17,LB,Bulgaria,3471,3202,6,0,269,131,132,263,6
2023-06-18,LB,Bulgaria,3334,3035,9,2,299,141,149,290,7
2023-06-19,LB,Bulgaria,2989,2687,7,0,302,148,147,295,7
2023-06-20,LB,Bulgaria,3050,2698,15,3,352,168,169,337,12
2023-06-21,LB,Bulgaria,3155,2839,20,8,316,148,148,296,12
2023-06-22,LB,Bulgaria,3193,2891,17,1,302,145,140,285,16
2023-06-23,LB,Bulgaria,3380,2981,10,0,399,195,194,389,10
2023-06-24,LB,Bulgaria,3565,3285,9,1,280,134,137,271,8
2023-06-25,LB,Bulgaria,3520,3214,12,0,306,152,142,294,12
2023-06-26,LB,Bulgaria,3144,2837,11,1,307,146,150,296,10
2023-06-27,LB,Bulgaria,3198,2817,21,2,381,179,181,360,19
2023-06-28,LB,Bulgaria,3291,2961,23,2,330,151,156,307,21
2023-06-29,LB,Bulgaria,3225,2911,22,2,314,144,148,292,20
2023-06-30,LB,Bulgaria,3472,3032,18,0,440,216,206,422,18
2023-07-01,LB,Bulgaria,3627,3325,10,1,302,147,145,292,9
2023-07-02,LB,Bulgaria,3554,3224,13,0,330,158,159,317,13
2023-07-03,LB,Bulgaria,3289,2972,17,3,317,145,155,300,14
2023-07-04,LB,Bulgaria,3407,2990,13,1,417,203,201,404,12
2023-07-05,LB,Bulgaria,3516,3184,17,0,332,158,157,315,17
2023-07-06,LB,Bulgaria,3462,3150,13,2,312,150,149,299,11
2023-07-07,LB,Bulgaria,3582,3167,12,2,415,202,201,403,10
2023-07-08,LB,Bulgaria,3636,3350,7,0,286,141,138,279,7
2023-07-09,LB,Bulgaria,3552,3221,15,0,331,157,159,316,15
2023-07-10,LB,Bulgaria,3305,2962,18,2,343,164,161,325,16
2023-07-11,LB,Bulgaria,3389,2963,25,2,426,199,202,401,23
2023-07-12,LB,Bulgaria,3480,3128,26,1,352,167,159,326,25
2023-07-13,LB,Bulgaria,3330,3029,12,0,301,145,144,289,12
2023-07-14,LB,Bulgaria,3486,3080,9,0,406,198,199,397,9
2023-07-15,LB,Bulgaria,3538,3238,8,0,300,146,146,292,8
2023-07-16,LB,Bulgaria,3564,3248,11,0,316,152,153,305,11
2023-07-17,LB,Bulgaria,3284,2954,18,1,330,154,158,312,17
2023-07-18,LB,Bulgaria,3468,3043,18,2,425,202,205,407,16
2023-07-19,LB,Bulgaria,3450,3099,16,2,351,165,170,335,14
2023-07-20,LB,Bulgaria,3389,3069,16,1,320,155,149,304,15
2023-07-21,LB,Bulgaria,3477,3051,13,2,426,206,207,413,11
2023-07-22,LB,Bulgaria,3595,3299,7,0,296,144,145,289,7
2023-07-23,LB,Bulgaria,3646,3325,12,1,321,155,154,309,11
2023-07-24,LB,Bulgaria,3353,3011,15,1,342,166,161,327,14
2023-07-25,LB,Bulgaria,3451,3026,13,0,425,204,208,412,13
2023-07-26,LB,Bulgaria,3474,3138,18,4,336,159,159,318,14
2023-07-27,LB,Bulgaria,3500,3174,20,3,326,152,154,306,17
2023-07-28,LB,Bulgaria,3625,3191,16,3,434,210,208,418,13
2023-07-29,LB,Bulgaria,3682,3363,15,4,319,153,151,304,11
2023-07-30,LB,Bulgaria,3571,3245,13,0,326,155,158,313,13
2023-07-31,LB,Bulgaria,3334,2994,10,0,340,164,166,330,10
2023-08-01,LB,Bulgaria,3499,3091,10,1,408,201,197,398,9
2023-08-02,LB,Bulgaria,3518,3159,26,1,359,168,165,333,25
2023-08-03,LB,Bulgaria,3488,3170,17,0,318,150,151,301,17
2023-08-04,LB,Bulgaria,3576,3164,8,0,412,201,203,404,8
2023-08-05,LB,Bulgaria,3584,3289,7,0,295,147,141,288,7
2023-08-06,LB,Bulgaria,3790,3469,12,0,321,151,158,309,12
2023-08-07,LB,Bulgaria,3497,3152,12,0,345,167,166,333,12
2023-08-08,LB,Bulgaria,3524,3110,14,1,414,200,200,400,13
2023-08-09,LB,Bulgaria,3553,3215,22,3,338,153,163,316,19
2023-08-10,LB,Bulgaria,3527,3215,14,0,312,151,147,298,14
2023-08-11,LB,Bulgaria,3575,3144,15,0,431,205,211,416,15
2023-08-12,LB,Bulgaria,3613,3298,8,0,315,155,152,307,8
2023-08-13,LB,Bulgaria,3631,3313,11,0,318,157,150,307,11
2023-08-14,LB,Bulgaria,3390,3057,15,2,333,159,159,318,13
2023-08-15,LB,Bulgaria,3474,3073,10,1,401,193,198,391,9
2023-08-16,LB,Bulgaria,3459,3137,16,1,322,153,153,306,15
2023-08-17,LB,Bulgaria,3484,3165,17,2,319,150,152,302,15
2023-08-18,LB,Bulgaria,3619,3195,15,1,424,207,202,409,14
2023-08-19,LB,Bulgaria,3688,3394,7,0,294,146,141,287,7
2023-08-20,LB,Bulgaria,3645,3313,15,0,332,156,161,317,15
2023-08-21,LB,Bulgaria,3337,3002,16,1,335,158,161,319,15
2023-08-22,LB,Bulgaria,3467,3070,14,2,397,194,189,383,12
2023-08-23,LB,Bulgaria,3451,3149,13,1,302,142,147,289,12
2023-08-24,LB,Bulgaria,3386,3084,11,0,302,145,146,291,11
2023-08-25,LB,Bulgaria,3542,3118,11,1,424,207,206,413,10
2023-08-26,LB,Bulgaria,3698,3408,10,1,290,141,139,280,9
2023-08-27,LB,Bulgaria,3548,3228,12,0,320,152,156,308,12
2023-08-28,LB,Bulgaria,3275,2952,19,3,323,148,156,304,16
2023-08-29,LB,Bulgaria,3470,3061,16,0,409,201,192,393,16
2023-08-30,LB,Bulgaria,3449,3131,11,1,318,153,154,307,10
2023-08-31,LB,Bulgaria,3472,3137,21,3,335,156,158,314,18
2023-09-01,LB,Bulgaria,3499,3063,12,1,436,214,210,424,11
2023-09-02,LB,Bulgaria,3604,3307,8,0,297,148,141,289,8
2023-09-03,LB,Bulgaria,3592,3240,12,1,352,164,176,340,11
2023-09-04,LB,Bulgaria,3219,2922,7,1,297,145,145,290,6
2023-09-05,LB,Bulgaria,3322,2951,10,0,371,181,180,361,10
2023-09-06,LB,Bulgaria,3431,3128,12,0,303,147,144,291,12
2023-09-07,LB,Bulgaria,3357,3058,15,3,299,139,145,284,12
2023-09-08,LB,Bulgaria,3415,3016,11,2,399,195,193,388,9
2023-09-09,LB,Bulgaria,3563,3278,9,1,285,137,139,276,8
2023-09-10,LB,Bulgaria,3493,3172,15,3,321,155,151,306,12
2023-09-11,LB,Bulgaria,3176,2887,14,2,289,136,139,275,12
2023-09-12,LB,Bulgaria,3272,2906,13,2,366,175,178,353,11
2023-09-13,LB,Bulgaria,3378,3078,21,5,300,140,139,279,16
2023-09-14,LB,Bulgaria,3270,2980,15,2,290,139,136,275,13
2023-09-15,LB,Bulgaria,3434,3077,9,0,357,174,174,348,9
2023-09-16,LB,Bulgaria,3533,3260,6,0,273,134,133,267,6
2023-09-17,LB,Bulgaria,3388,3107,8,1,281,138,135,273,7
2023-09-18,LB,Bulgaria,3159,2893,16,2,266,124,126,250,14
2023-09-19,LB,Bulgaria,3149,2827,14,2,322,153,155,308,12
2023-09-20,LB,Bulgaria,3201,2938,12,2,263,126,125,251,10
2023-09-21,LB,Bulgaria,3251,2979,10,1,272,133,129,262,9
2023-09-22,LB,Bulgaria,3336,3008,10,1,328,158,160,318,9
2023-09-23,LB,Bulgaria,3462,3219,3,0,243,121,119,240,3
2023-09-24,LB,Bulgaria,3329,3067,6,0,262,125,131,256,6
2023-09-25,LB,Bulgaria,3038,2797,7,1,241,120,114,234,6
2023-09-26,LB,Bulgaria,2903,2636,16,3,267,125,126,251,13
2023-09-27,LB,Bulgaria,3248,2996,14,2,252,120,118,238,12
2023-09-28,LB,Bulgaria,3204,2948,12,1,256,121,123,244,11
2023-09-29,LB,Bulgaria,3302,3016,7,0,286,139,140,279,7
2023-09-30,LB,Bulgaria,3492,3244,5,0,248,123,120,243,5
2023-10-01,LB,Bulgaria,3316,3074,6,0,242,114,122,236,6
2023-10-02,LB,Bulgaria,2982,2766,11,3,216,100,105,205,8
2023-01-01,LD,Croatia,1467,1347,17,0,120,51,52,103,17
2023-01-02,LD,Croatia,1545,1386,27,0,159,67,65,132,27
2023-01-03,LD,Croatia,1379,1249,22,0,130,54,54,108,22
2023-01-04,LD,Croatia,1425,1302,17,0,123,56,50,106,17
2023-01-05,LD,Croatia,1472,1345,21,0,127,51,55,106,21
2023-01-06,LD,Croatia,1600,1446,30,1,154,60,64,124,29
2023-01-07,LD,Croatia,1520,1402,16,1,118,52,50,102,15
2023-01-08,LD,Croatia,1648,1517,17,0,131,57,57,114,17
2023-01-09,LD,Croatia,1340,1196,24,0,144,60,60,120,24
2023-01-10,LD,Croatia,1153,1032,25,0,121,49,47,96,25
2023-01-11,LD,Croatia,1197,1070,25,1,127,51,51,102,24
2023-01-12,LD,Croatia,1242,1110,29,0,132,51,52,103,29
2023-01-13,LD,Croatia,1434,1284,26,0,150,63,61,124,26
2023-01-14,LD,Croatia,1414,1299,15,0,115,51,49,100,15
2023-01-15,LD,Croatia,1486,1360,18,1,126,49,59,108,17
2023-01-16,LD,Croatia,1226,1086,26,0,140,58,56,114,26
2023-01-17,LD,Croatia,1087,971,22,0,116,50,44,94,22
2023-01-18,LD,Croatia,1098,976,17,0,122,54,51,105,17
2023-01-19,LD,Croatia,1171,1053,22,0,118,47,49,96,22
2023-01-20,LD,Croatia,1382,1230,25,0,152,64,63,127,25
2023-01-21,LD,Croatia,1282,1181,13,0,101,43,45,88,13
2023-01-22,LD,Croatia,1403,1292,17,0,111,46,48,94,17
2023-01-23,LD,Croatia,1242,1103,25,1,139,58,56,114,24
2023-01-24,LD,Croatia,1093,975,24,0,118,47,47,94,24
2023-01-25,LD,Croatia,1178,1066,20,2,112,47,45,92,18
2023-01-26,LD,Croatia,1196,1082,22,0,114,46,46,92,22
2023-01-27,LD,Croatia,1382,1226,23,1,156,67,66,133,22
2023-01-28,LD,Croatia,1356,1263,13,0,93,39,41,80,13
2023-01-29,LD,Croatia,1527,1408,18,0,119,51,50,101,18
2023-01-30,LD,Croatia,1327,1186,27,0,141,57,57,114,27
2023-01-31,LD,Croatia,1153,1041,24,1,112,44,44,88,23
2023-02-01,LD,Croatia,1206,1089,18,1,117,49,50,99,17
2023-02-02,LD,Croatia,1268,1146,26,0,122,47,49,96,26
2023-02-03,LD,Croatia,1500,1350,24,0,150,61,65,126,24
2023-02-04,LD,Croatia,1402,1294,12,1,108,50,46,96,11
2023-02-05,LD,Croatia,1502,1385,17,0,117,49,51,100,17
2023-02-06,LD,Croatia,1384,1245,26,0,139,57,56,113,26
2023-02-07,LD,Croatia,1245,1115,26,2,130,53,51,104,24
2023-02-08,LD,Croatia,1242,1143,16,0,99,42,41,83,16
2023-02-09,LD,Croatia,1295,1174,25,1,121,47,49,96,24
2023-02-10,LD,Croatia,1538,1385,24,0,153,64,65,129,24
2023-02-11,LD,Croatia,1408,1302,15,0,106,45,46,91,15
2023-02-12,LD,Croatia,1543,1414,20,0,129,55,54,109,20
2023-02-13,LD,Croatia,1373,1227,26,0,146,58,62,120,26
2023-02-14,LD,Croatia,1173,1057,22,0,116,49,45,94,22
2023-02-15,LD,Croatia,1254,1126,19,0,128,54,55,109,19
2023-02-16,LD,Croatia,1287,1152,24,0,135,57,54,111,24
2023-02-17,LD,Croatia,1357,1215,26,1,142,56,60,116,25
2023-02-18,LD,Croatia,1532,1407,17,3,125,57,51,108,14
2023-02-19,LD,Croatia,1590,1455,18,1,135,56,61,117,17
2023-02-20,LD,Croatia,1402,1249,24,0,153,66,63,129,24
2023-02-21,LD,Croatia,1169,1050,25,0,119,47,47,94,25
2023-02-22,LD,Croatia,1241,1113,21,1,128,54,53,107,20
2023-02-23,LD,Croatia,1301,1171,23,0,130,54,53,107,23
2023-02-24,LD,Croatia,1544,1377,24,0,167,73,70,143,24
2023-02-25,LD,Croatia,1462,1341,17,3,121,51,53,104,14
2023-02-26,LD,Croatia,1561,1431,19,2,130,55,56,111,17
2023-02-27,LD,Croatia,1400,1260,25,0,140,56,59,115,25
2023-02-28,LD,Croatia,1232,1089,27,0,143,59,57,116,27
2023-03-01,LD,Croatia,1268,1145,22,2,123,52,49,101,20
2023-03-02,LD,Croatia,1325,1199,22,0,126,51,53,104,22
2023-03-03,LD,Croatia,1562,1397,24,0,165,70,71,141,24
2023-03-04,LD,Croatia,1511,1382,18,2,129,56,55,111,16
2023-03-05,LD,Croatia,1640,1492,21,2,148,63,64,127,19
2023-03-06,LD,Croatia,1416,1262,26,1,154,64,64,128,25
2023-03-07,LD,Croatia,1203,1071,24,0,132,55,53,108,24
2023-03-08,LD,Croatia,1318,1186,21,0,132,54,57,111,21
2023-03-09,LD,Croatia,1370,1222,26,1,148,60,62,122,25
2023-03-10,LD,Croatia,1462,1302,27,0,160,66,67,133,27
2023-03-11,LD,Croatia,1484,1349,18,3,135,59,58,117,15
2023-03-12,LD,Croatia,1625,1473,25,3,152,63,64,127,22
2023-03-13,LD,Croatia,1482,1311,32,4,171,74,65,139,28
2023-03-14,LD,Croatia,1306,1169,23,0,137,56,58,114,23
2023-03-15,LD,Croatia,1383,1241,20,0,142,60,62,122,20
2023-03-16,LD,Croatia,1312,1166,28,0,146,58,60,118,28
2023-03-17,LD,Croatia,1670,1511,28,0,159,67,64,131,28
2023-03-18,LD,Croatia,1570,1432,17,1,138,60,61,121,16
2023-03-19,LD,Croatia,1719,1578,20,0,141,61,60,121,20
2023-03-20,LD,Croatia,1600,1415,32,3,185,76,77,153,29
2023-03-21,LD,Croatia,1363,1219,27,4,144,61,56,117,23
2023-03-22,LD,Croatia,1409,1258,30,6,151,59,62,121,24
2023-03-23,LD,Croatia,1399,1260,24,1,139,56,59,115,23
2023-03-24,LD,Croatia,1620,1448,28,0,172,68,76,144,28
2023-03-25,LD,Croatia,1630,1497,15,1,133,57,61,118,14
2023-03-26,LD,Croatia,1834,1625,32,0,209,92,85,177,32
2023-03-27,LD,Croatia,1571,1406,30,1,165,68,67,135,29
2023-03-28,LD,Croatia,1673,1472,31,0,201,88,82,170,31
2023-03-29,LD,Croatia,1762,1561,22,1,201,91,88,179,21
2023-03-30,LD,Croatia,1806,1611,27,0,195,83,85,168,27
2023-03-31,LD,Croatia,2037,1835,26,0,202,87,89,176,26
2023-04-01,LD,Croatia,2243,2023,20,0,220,100,100,200,20
2023-04-02,LD,Croatia,2139,1914,33,0,225,94,98,192,33
2023-04-03,LD,Croatia,1980,1775,25,0,205,90,90,180,25
2023-04-04,LD,Croatia,1958,1732,25,0,226,98,103,201,25
2023-04-05,LD,Croatia,1967,1723,26,1,244,109,109,218,25
2023-04-06,LD,Croatia,1932,1696,29,1,236,96,111,207,28
2023-04-07,LD,Croatia,2192,1957,35,1,235,96,104,200,34
2023-04-08,LD,Croatia,2286,2037,26,0,249,113,110,223,26
2023-04-09,LD,Croatia,2114,1876,29,0,238,108,101,209,29
2023-04-10,LD,Croatia,2117,1860,38,1,257,112,107,219,37
2023-04-11,LD,Croatia,2001,1739,37,0,262,114,111,225,37
2023-04-12,LD,Croatia,1993,1756,28,0,237,106,103,209,28
2023-04-13,LD,Croatia,1983,1749,30,0,234,101,103,204,30
2023-04-14,LD,Croatia,2150,1912,34,0,238,98,106,204,34
2023-04-15,LD,Croatia,2365,2106,28,0,259,118,113,231,28
2023-04-16,LD,Croatia,2217,1962,30,0,255,114,111,225,30
2023-04-17,LD,Croatia,2047,1806,29,0,241,105,107,212,29
2023-04-18,LD,Croatia,1913,1684,29,2,229,103,97,200,27
2023-04-19,LD,Croatia,1894,1662,21,0,232,103,108,211,21
2023-04-20,LD,Croatia,1977,1719,35,3,258,112,111,223,32
2023-04-21,LD,Croatia,2124,1873,37,3,251,103,111,214,34
2023-04-22,LD,Croatia,2378,2088,33,3,290,129,128,257,30
2023-04-23,LD,Croatia,2286,1983,38,3,303,134,131,265,35
2023-04-24,LD,Croatia,2061,1809,36,0,252,106,110,216,36
2023-04-25,LD,Croatia,1972,1726,31,3,246,109,106,215,28
2023-04-26,LD,Croatia,2012,1774,21,0,238,109,108,217,21
2023-04-27,LD,Croatia,2068,1788,32,1,280,122,126,248,31
2023-04-28,LD,Croatia,2319,2048,34,1,271,114,123,237,33
2023-04-29,LD,Croatia,2487,2160,28,0,327,149,150,299,28
2023-04-30,LD,Croatia,2367,2068,33,0,299,133,133,266,33
2023-05-01,LD,Croatia,2182,1912,24,1,270,128,118,246,23
2023-05-02,LD,Croatia,2109,1830,28,0,279,123,128,251,28
2023-05-03,LD,Croatia,2172,1918,20,0,254,117,117,234,20
2023-05-04,LD,Croatia,2231,1921,32,1,310,138,140,278,31
2023-05-05,LD,Croatia,2383,2078,38,1,305,131,136,267,37
2023-05-06,LD,Croatia,2613,2251,29,0,362,168,165,333,29
2023-05-07,LD,Croatia,2511,2171,37,0,340,153,150,303,37
2023-05-08,LD,Croatia,2279,1975,34,0,304,136,134,270,34
2023-05-09,LD,Croatia,2190,1888,35,3,302,134,133,267,32
2023-05-10,LD,Croatia,2171,1882,23,1,289,138,128,266,22
2023-05-11,LD,Croatia,2150,1849,26,0,301,135,140,275,26
2023-05-12,LD,Croatia,2461,2152,28,0,309,141,140,281,28
2023-05-13,LD,Croatia,2803,2383,28,0,420,195,197,392,28
2023-05-14,LD,Croatia,2576,2219,35,3,357,164,158,322,32
2023-05-15,LD,Croatia,2390,2093,36,2,297,130,131,261,34
2023-05-16,LD,Croatia,2282,1984,27,0,298,138,133,271,27
2023-05-17,LD,Croatia,2382,2095,18,0,287,127,142,269,18
2023-05-18,LD,Croatia,2448,2102,29,1,346,155,162,317,28
2023-05-19,LD,Croatia,2581,2248,41,1,333,142,150,292,40
2023-05-20,LD,Croatia,2855,2430,26,0,425,201,198,399,26
2023-05-21,LD,Croatia,2785,2360,37,0,425,201,187,388,37
2023-05-22,LD,Croatia,2552,2225,34,0,327,148,145,293,34
2023-05-23,LD,Croatia,2453,2118,34,0,335,151,150,301,34
2023-05-24,LD,Croatia,2471,2152,22,0,319,145,152,297,22
2023-05-25,LD,Croatia,2448,2094,28,0,354,161,165,326,28
2023-05-26,LD,Croatia,2720,2341,37,1,379,164,178,342,36
2023-05-27,LD,Croatia,2964,2471,32,2,493,226,235,461,30
2023-05-28,LD,Croatia,2852,2434,37,0,418,193,188,381,37
2023-05-29,LD,Croatia,2719,2330,38,2,389,181,170,351,36
2023-05-30,LD,Croatia,2558,2182,34,0,376,175,167,342,34
2023-05-31,LD,Croatia,2627,2294,21,0,333,157,155,312,21
2023-06-01,LD,Croatia,2729,2313,35,3,416,188,193,381,32
2023-06-02,LD,Croatia,2794,2382,41,1,412,184,187,371,40
2023-06-03,LD,Croatia,3019,2492,24,0,527,255,248,503,24
2023-06-04,LD,Croatia,2858,2381,31,2,477,230,216,446,29
2023-06-05,LD,Croatia,2651,2272,32,1,379,173,174,347,31
2023-06-06,LD,Croatia,2666,2278,31,1,388,180,177,357,30
2023-06-07,LD,Croatia,2703,2313,25,1,390,181,184,365,24
2023-06-08,LD,Croatia,2897,2496,31,1,401,176,194,370,30
2023-06-09,LD,Croatia,2944,2556,36,0,388,175,177,352,36
2023-06-10,LD,Croatia,3143,2592,30,2,551,259,262,521,28
2023-06-11,LD,Croatia,3208,2685,38,0,523,252,233,485,38
2023-06-12,LD,Croatia,2761,2356,38,3,405,185,182,367,35
2023-06-13,LD,Croatia,2719,2296,36,1,423,192,195,387,35
2023-06-14,LD,Croatia,2726,2340,22,1,386,181,183,364,21
2023-06-15,LD,Croatia,2779,2344,39,3,435,199,197,396,36
2023-06-16,LD,Croatia,2857,2413,34,2,444,196,214,410,32
2023-06-17,LD,Croatia,3163,2575,24,0,588,281,283,564,24
2023-06-18,LD,Croatia,3115,2574,39,0,541,259,243,502,39
2023-06-19,LD,Croatia,2860,2428,27,2,432,198,207,405,25
2023-06-20,LD,Croatia,2728,2285,29,1,443,207,207,414,28
2023-06-21,LD,Croatia,2799,2388,21,1,411,195,195,390,20
2023-06-22,LD,Croatia,2749,2300,34,0,449,210,205,415,34
2023-06-23,LD,Croatia,3023,2563,44,0,460,198,218,416,44
2023-06-24,LD,Croatia,3228,2611,23,0,617,294,300,594,23
2023-06-25,LD,Croatia,3149,2577,43,0,572,275,254,529,43
2023-06-26,LD,Croatia,2957,2480,34,0,477,218,225,443,34
2023-06-27,LD,Croatia,2877,2405,32,0,472,222,218,440,32
2023-06-28,LD,Croatia,2825,2365,21,1,460,219,220,439,20
2023-06-29,LD,Croatia,2927,2413,35,0,514,242,237,479,35
2023-06-30,LD,Croatia,3009,2494,32,0,515,232,251,483,32
2023-07-01,LD,Croatia,3282,2593,30,0,689,328,331,659,30
2023-07-02,LD,Croatia,3334,2715,36,0,619,290,293,583,36
2023-07-03,LD,Croatia,3023,2489,39,0,534,249,246,495,39
2023-07-04,LD,Croatia,2888,2357,35,0,531,248,248,496,35
2023-07-05,LD,Croatia,2867,2385,22,1,482,227,233,460,21
2023-07-06,LD,Croatia,3128,2584,40,2,544,256,248,504,38
2023-07-07,LD,Croatia,3155,2610,37,0,545,245,263,508,37
2023-07-08,LD,Croatia,3426,2750,26,0,676,327,323,650,26
2023-07-09,LD,Croatia,3464,2813,46,0,651,308,297,605,46
2023-07-10,LD,Croatia,3203,2667,34,0,536,252,250,502,34
2023-07-11,LD,Croatia,3067,2532,37,0,535,253,245,498,37
2023-07-12,LD,Croatia,3116,2604,22,1,512,243,247,490,21
2023-07-13,LD,Croatia,3164,2604,37,1,560,262,261,523,36
2023-07-14,LD,Croatia,3324,2749,42,0,575,263,270,533,42
2023-07-15,LD,Croatia,3466,2770,27,0,696,328,341,669,27
2023-07-16,LD,Croatia,3502,2862,39,0,640,307,294,601,39
2023-07-17,LD,Croatia,3155,2633,33,0,522,245,244,489,33
2023-07-18,LD,Croatia,2953,2417,33,1,536,254,249,503,32
2023-07-19,LD,Croatia,2868,2337,26,1,531,247,258,505,25
2023-07-20,LD,Croatia,3068,2498,38,1,570,266,266,532,37
2023-07-21,LD,Croatia,3151,2620,33,2,531,251,247,498,31
2023-07-22,LD,Croatia,3401,2728,34,1,673,309,330,639,33
2023-07-23,LD,Croatia,3423,2785,43,1,638,304,291,595,42
2023-07-24,LD,Croatia,3092,2531,35,0,561,266,260,526,35
2023-07-25,LD,Croatia,3100,2537,36,1,563,264,263,527,35
2023-07-26,LD,Croatia,3020,2499,23,0,521,252,246,498,23
2023-07-27,LD,Croatia,3191,2615,39,0,576,266,271,537,39
2023-07-28,LD,Croatia,3218,2653,39,2,565,257,269,526,37
2023-07-29,LD,Croatia,3519,2823,33,2,696,331,332,663,31
2023-07-30,LD,Croatia,3349,2747,34,0,602,295,273,568,34
2023-07-31,LD,Croatia,3201,2663,33,0,538,256,249,505,33
2023-08-01,LD,Croatia,3146,2584,37,1,562,262,263,525,36
2023-08-02,LD,Croatia,3146,2597,26,1,549,259,264,523,25
2023-08-03,LD,Croatia,3106,2523,41,0,583,267,275,542,41
2023-08-04,LD,Croatia,2849,2303,36,2,546,252,258,510,34
2023-08-05,LD,Croatia,3451,2752,35,0,699,331,333,664,35
2023-08-06,LD,Croatia,3206,2587,37,0,619,296,286,582,37
2023-08-07,LD,Croatia,3050,2535,35,0,515,239,241,480,35
2023-08-08,LD,Croatia,3035,2480,37,0,555,261,257,518,37
2023-08-09,LD,Croatia,3011,2478,28,0,533,253,252,505,28
2023-08-10,LD,Croatia,3034,2495,35,0,539,252,252,504,35
2023-08-11,LD,Croatia,3276,2705,37,0,571,261,273,534,37
2023-08-12,LD,Croatia,3458,2778,29,0,680,325,326,651,29
2023-08-13,LD,Croatia,3348,2730,40,0,618,294,284,578,40
2023-08-14,LD,Croatia,3061,2545,43,1,516,235,238,473,42
2023-08-15,LD,Croatia,3147,2605,37,0,542,258,247,505,37
2023-08-16,LD,Croatia,3037,2534,19,0,503,241,243,484,19
2023-08-17,LD,Croatia,3066,2550,36,2,516,235,245,480,34
2023-08-18,LD,Croatia,3221,2670,34,2,551,258,259,517,32
2023-08-19,LD,Croatia,3516,2855,30,0,661,310,321,631,30
2023-08-20,LD,Croatia,3392,2771,43,0,621,296,282,578,43
2023-08-21,LD,Croatia,3106,2588,44,2,518,237,237,474,42
2023-08-22,LD,Croatia,3137,2587,36,1,550,261,253,514,35
2023-08-23,LD,Croatia,3117,2595,32,2,522,244,246,490,30
2023-08-24,LD,Croatia,2903,2371,43,1,532,242,247,489,42
2023-08-25,LD,Croatia,3118,2581,39,1,537,244,254,498,38
2023-08-26,LD,Croatia,3330,2684,33,0,646,308,305,613,33
2023-08-27,LD,Croatia,3339,2749,36,1,590,281,273,554,35
2023-08-28,LD,Croatia,2798,2338,37,1,460,215,208,423,36
2023-08-29,LD,Croatia,3168,2642,35,0,526,251,240,491,35
2023-08-30,LD,Croatia,3046,2560,20,0,486,234,232,466,20
2023-08-31,LD,Croatia,2927,2423,34,0,504,232,238,470,34
2023-09-01,LD,Croatia,3085,2587,39,1,498,225,234,459,38
2023-09-02,LD,Croatia,3428,2775,33,2,653,305,315,620,31
2023-09-03,LD,Croatia,3257,2678,42,1,579,276,261,537,41
2023-09-04,LD,Croatia,2929,2500,38,0,429,194,197,391,38
2023-09-05,LD,Croatia,2817,2397,36,0,420,196,188,384,36
2023-09-06,LD,Croatia,2855,2418,21,0,437,206,210,416,21
2023-09-07,LD,Croatia,2892,2442,36,0,450,205,209,414,36
2023-09-08,LD,Croatia,2973,2531,34,0,442,199,209,408,34
2023-09-09,LD,Croatia,3298,2735,27,1,563,274,262,536,26
2023-09-10,LD,Croatia,3199,2658,36,0,541,262,243,505,36
2023-09-11,LD,Croatia,2833,2416,40,1,417,186,191,377,39
2023-09-12,LD,Croatia,2821,2384,38,4,437,201,198,399,34
2023-09-13,LD,Croatia,2784,2368,24,3,416,195,197,392,21
2023-09-14,LD,Croatia,2833,2403,33,0,430,197,200,397,33
2023-09-15,LD,Croatia,2806,2362,41,0,444,194,209,403,41
2023-09-16,LD,Croatia,3180,2602,33,0,578,266,279,545,33
2023-09-17,LD,Croatia,3027,2454,46,2,573,278,249,527,44
2023-09-18,LD,Croatia,2731,2322,38,2,409,185,186,371,36
2023-09-19,LD,Croatia,2747,2322,35,0,425,196,194,390,35
2023-09-20,LD,Croatia,2788,2379,22,2,409,193,194,387,20
2023-09-21,LD,Croatia,2679,2234,33,0,445,203,209,412,33
2023-09-22,LD,Croatia,2798,2365,40,0,433,200,193,393,40
2023-09-23,LD,Croatia,2996,2486,29,0,510,238,243,481,29
2023-09-24,LD,Croatia,2973,2472,34,1,501,237,230,467,33
2023-09-25,LD,Croatia,2614,2224,35,1,390,179,176,355,34
2023-09-26,LD,Croatia,2675,2278,32,1,397,184,181,365,31
2023-09-27,LD,Croatia,2634,2239,26,0,395,182,187,369,26
2023-09-28,LD,Croatia,2699,2296,36,2,403,185,182,367,34
2023-09-29,LD,Croatia,2797,2389,38,2,408,179,191,370,36
2023-09-30,LD,Croatia,3188,2683,27,1,505,235,243,478,26
2023-10-01,LD,Croatia,2996,2546,38,2,450,210,202,412,36
2023-10-02,LD,Croatia,2622,2293,33,1,329,147,149,296,32
2023-01-01,LC,Cyprus,975,841,4,4,134,64,66,130,0
2023-01-02,LC,Cyprus,1012,855,4,4,157,79,74,153,0
2023-01-03,LC,Cyprus,969,828,7,7,141,66,68,134,0
2023-01-04,LC,Cyprus,1005,848,7,7,157,77,73,150,0
2023-01-05,LC,Cyprus,993,846,4,4,147,70,73,143,0
2023-01-06,LC,Cyprus,1013,848,6,6,165,78,81,159,0
2023-01-07,LC,Cyprus,1022,866,2,2,156,76,78,154,0
2023-01-08,LC,Cyprus,1092,925,4,4,167,80,83,163,0
2023-01-09,LC,Cyprus,915,764,4,4,151,71,76,147,0
2023-01-10,LC,Cyprus,877,749,8,7,128,61,59,120,1
2023-01-11,LC,Cyprus,900,753,6,6,147,71,70,141,0
2023-01-12,LC,Cyprus,1026,888,1,1,138,70,67,137,0
2023-01-13,LC,Cyprus,945,793,1,1,152,75,76,151,0
2023-01-14,LC,Cyprus,969,840,1,1,129,66,62,128,0
2023-01-15,LC,Cyprus,1018,864,6,6,154,73,75,148,0
2023-01-16,LC,Cyprus,904,752,8,5,152,70,74,144,3
2023-01-17,LC,Cyprus,816,701,7,7,115,57,51,108,0
2023-01-18,LC,Cyprus,832,687,6,6,145,67,72,139,0
2023-01-19,LC,Cyprus,927,788,6,6,139,68,65,133,0
2023-01-20,LC,Cyprus,942,788,2,2,154,77,75,152,0
2023-01-21,LC,Cyprus,955,829,2,2,126,61,63,124,0
2023-01-22,LC,Cyprus,1078,931,4,4,147,72,71,143,0
2023-01-23,LC,Cyprus,861,704,7,5,157,73,77,150,2
2023-01-24,LC,Cyprus,842,736,7,7,106,52,47,99,0
2023-01-25,LC,Cyprus,858,721,9,9,137,64,64,128,0
2023-01-26,LC,Cyprus,918,781,3,2,137,67,67,134,1
2023-01-27,LC,Cyprus,843,692,1,1,151,75,75,150,0
2023-01-28,LC,Cyprus,935,806,1,1,129,65,63,128,0
2023-01-29,LC,Cyprus,1001,854,2,2,147,70,75,145,0
2023-01-30,LC,Cyprus,906,760,2,2,146,72,72,144,0
2023-01-31,LC,Cyprus,898,780,7,6,118,54,57,111,1
2023-02-01,LC,Cyprus,946,802,6,4,144,72,66,138,2
2023-02-02,LC,Cyprus,1065,926,4,4,139,69,66,135,0
2023-02-03,LC,Cyprus,997,839,6,5,158,70,82,152,1
2023-02-04,LC,Cyprus,1087,951,0,0,136,69,67,136,0
2023-02-05,LC,Cyprus,1097,937,2,0,160,80,78,158,2
2023-02-06,LC,Cyprus,991,839,1,1,152,75,76,151,0
2023-02-07,LC,Cyprus,1033,911,5,4,122,61,56,117,1
2023-02-08,LC,Cyprus,1028,896,5,3,132,65,62,127,2
2023-02-09,LC,Cyprus,1057,920,4,4,137,68,65,133,0
2023-02-10,LC,Cyprus,982,819,4,3,163,78,81,159,1
2023-02-11,LC,Cyprus,1019,871,1,1,148,73,74,147,0
2023-02-12,LC,Cyprus,1045,884,2,2,161,80,79,159,0
2023-02-13,LC,Cyprus,888,728,2,2,160,78,80,158,0
2023-02-14,LC,Cyprus,864,724,5,5,140,68,67,135,0
2023-02-15,LC,Cyprus,981,822,6,6,159,77,76,153,0
2023-02-16,LC,Cyprus,1037,886,4,4,151,74,73,147,0
2023-02-17,LC,Cyprus,892,718,1,1,174,87,86,173,0
2023-02-18,LC,Cyprus,984,819,2,1,165,81,82,163,1
2023-02-19,LC,Cyprus,1048,876,0,0,172,87,85,172,0
2023-02-20,LC,Cyprus,895,728,7,7,167,81,79,160,0
2023-02-21,LC,Cyprus,851,723,10,9,128,56,62,118,1
2023-02-22,LC,Cyprus,941,793,7,6,148,72,69,141,1
2023-02-23,LC,Cyprus,995,838,9,9,157,73,75,148,0
2023-02-24,LC,Cyprus,937,764,3,3,173,81,89,170,0
2023-02-25,LC,Cyprus,992,830,2,2,162,82,78,160,0
2023-02-26,LC,Cyprus,1083,906,5,5,177,87,85,172,0
2023-02-27,LC,Cyprus,908,736,6,6,172,82,84,166,0
2023-02-28,LC,Cyprus,876,726,9,9,150,71,70,141,0
2023-03-01,LC,Cyprus,1040,847,8,6,193,94,91,185,2
2023-03-02,LC,Cyprus,1048,893,6,6,155,74,75,149,0
2023-03-03,LC,Cyprus,951,788,4,4,163,80,79,159,0
2023-03-04,LC,Cyprus,982,816,2,0,166,83,81,164,2
2023-03-05,LC,Cyprus,1085,905,4,4,180,87,89,176,0
2023-03-06,LC,Cyprus,940,781,6,5,159,75,78,153,1
2023-03-07,LC,Cyprus,867,730,11,11,137,64,62,126,0
2023-03-08,LC,Cyprus,1026,845,4,4,181,87,90,177,0
2023-03-09,LC,Cyprus,1065,897,8,6,168,80,80,160,2
2023-03-10,LC,Cyprus,940,760,11,11,180,85,84,169,0
2023-03-11,LC,Cyprus,1029,874,2,2,155,79,74,153,0
2023-03-12,LC,Cyprus,1145,967,9,8,178,87,82,169,1
2023-03-13,LC,Cyprus,934,781,5,5,153,73,75,148,0
2023-03-14,LC,Cyprus,969,839,6,6,130,63,61,124,0
2023-03-15,LC,Cyprus,1110,940,5,5,170,82,83,165,0
2023-03-16,LC,Cyprus,1059,930,1,1,129,66,62,128,0
2023-03-17,LC,Cyprus,1022,846,1,1,176,84,91,175,0
2023-03-18,LC,Cyprus,1124,956,3,3,168,84,81,165,0
2023-03-19,LC,Cyprus,1233,1056,4,4,177,86,87,173,0
2023-03-20,LC,Cyprus,1108,941,4,4,167,80,83,163,0
2023-03-21,LC,Cyprus,1062,902,9,8,160,79,72,151,1
2023-03-22,LC,Cyprus,1084,900,7,7,184,86,91,177,0
2023-03-23,LC,Cyprus,1019,857,6,6,162,79,77,156,0
2023-03-24,LC,Cyprus,913,746,4,4,167,78,85,163,0
2023-03-25,LC,Cyprus,1012,853,0,0,159,80,79,159,0
2023-03-26,LC,Cyprus,1184,965,6,4,219,107,106,213,2
2023-03-27,LC,Cyprus,896,712,5,5,184,90,89,179,0
2023-03-28,LC,Cyprus,994,790,7,7,204,97,100,197,0
2023-03-29,LC,Cyprus,1096,879,6,5,217,105,106,211,1
2023-03-30,LC,Cyprus,1180,956,8,7,224,108,108,216,1
2023-03-31,LC,Cyprus,1116,919,1,1,197,98,98,196,0
2023-04-01,LC,Cyprus,1130,876,2,2,254,126,126,252,0
2023-04-02,LC,Cyprus,1145,911,5,4,234,112,117,229,1
2023-04-03,LC,Cyprus,1112,869,7,7,243,114,122,236,0
2023-04-04,LC,Cyprus,1197,945,6,6,252,125,121,246,0
2023-04-05,LC,Cyprus,1139,860,8,6,279,137,134,271,2
2023-04-06,LC,Cyprus,1093,871,6,6,222,108,108,216,0
2023-04-07,LC,Cyprus,1156,902,4,4,254,127,123,250,0
2023-04-08,LC,Cyprus,1081,829,2,2,252,125,125,250,0
2023-04-09,LC,Cyprus,1161,930,3,1,231,114,114,228,2
2023-04-10,LC,Cyprus,1182,926,6,6,256,123,127,250,0
2023-04-11,LC,Cyprus,1195,958,6,5,237,118,113,231,1
2023-04-12,LC,Cyprus,1203,940,7,6,263,129,127,256,1
2023-04-13,LC,Cyprus,1282,1038,6,6,244,121,117,238,0
2023-04-14,LC,Cyprus,1155,926,6,6,229,109,114,223,0
2023-04-15,LC,Cyprus,1154,896,3,1,258,133,122,255,2
2023-04-16,LC,Cyprus,1230,1006,1,1,224,110,113,223,0
2023-04-17,LC,Cyprus,1105,860,6,6,245,117,122,239,0
2023-04-18,LC,Cyprus,1040,808,6,5,232,111,115,226,1
2023-04-19,LC,Cyprus,1168,887,8,6,281,132,141,273,2
2023-04-20,LC,Cyprus,1301,1053,6,6,248,124,118,242,0
2023-04-21,LC,Cyprus,1145,916,2,2,229,108,119,227,0
2023-04-22,LC,Cyprus,1172,908,2,2,264,137,125,262,0
2023-04-23,LC,Cyprus,1325,1081,3,2,244,121,120,241,1
2023-04-24,LC,Cyprus,1264,996,3,2,268,129,136,265,1
2023-04-25,LC,Cyprus,1254,1014,5,4,240,119,116,235,1
2023-04-26,LC,Cyprus,1293,998,16,8,295,137,142,279,8
2023-04-27,LC,Cyprus,1343,1073,8,4,270,135,127,262,4
2023-04-28,LC,Cyprus,1320,1056,8,2,264,129,127,256,6
2023-04-29,LC,Cyprus,1331,1036,5,1,295,146,144,290,4
2023-04-30,LC,Cyprus,1383,1119,4,2,264,126,134,260,2
2023-05-01,LC,Cyprus,1169,896,4,3,273,136,133,269,1
2023-05-02,LC,Cyprus,1047,802,10,6,245,118,117,235,4
2023-05-03,LC,Cyprus,1158,861,5,3,297,149,143,292,2
2023-05-04,LC,Cyprus,1163,892,7,5,271,130,134,264,2
2023-05-05,LC,Cyprus,1082,843,2,2,239,123,114,237,0
2023-05-06,LC,Cyprus,1149,871,1,1,278,138,139,277,0
2023-05-07,LC,Cyprus,1225,946,4,3,279,134,141,275,1
2023-05-08,LC,Cyprus,1167,898,4,4,269,136,129,265,0
2023-05-09,LC,Cyprus,1069,841,7,6,228,110,111,221,1
2023-05-10,LC,Cyprus,1135,847,5,4,288,143,140,283,1
2023-05-11,LC,Cyprus,1157,900,8,6,257,124,125,249,2
2023-05-12,LC,Cyprus,1120,883,4,4,237,114,119,233,0
2023-05-13,LC,Cyprus,1095,805,2,2,290,143,145,288,0
2023-05-14,LC,Cyprus,1180,915,4,3,265,131,130,261,1
2023-05-15,LC,Cyprus,1121,841,7,7,280,138,135,273,0
2023-05-16,LC,Cyprus,1058,825,8,8,233,115,110,225,0
2023-05-17,LC,Cyprus,1175,879,6,6,296,141,149,290,0
2023-05-18,LC,Cyprus,1191,936,8,5,255,120,127,247,3
2023-05-19,LC,Cyprus,1131,881,5,5,250,125,120,245,0
2023-05-20,LC,Cyprus,1214,915,2,1,299,149,148,297,1
2023-05-21,LC,Cyprus,1237,954,3,2,283,139,141,280,1
2023-05-22,LC,Cyprus,1108,838,4,4,270,133,133,266,0
2023-05-23,LC,Cyprus,1107,856,7,7,251,122,122,244,0
2023-05-24,LC,Cyprus,1261,928,8,8,333,166,159,325,0
2023-05-25,LC,Cyprus,1210,932,5,4,278,137,136,273,1
2023-05-26,LC,Cyprus,1007,754,5,5,253,123,125,248,0
2023-05-27,LC,Cyprus,1089,787,2,1,302,150,150,300,1
2023-05-28,LC,Cyprus,1232,932,3,2,300,150,147,297,1
2023-05-29,LC,Cyprus,1172,881,2,2,291,145,144,289,0
2023-05-30,LC,Cyprus,1154,884,10,8,270,128,132,260,2
2023-05-31,LC,Cyprus,1213,902,6,6,311,154,151,305,0
2023-06-01,LC,Cyprus,1254,962,6,5,292,140,146,286,1
2023-06-02,LC,Cyprus,1163,889,7,6,274,131,136,267,1
2023-06-03,LC,Cyprus,1170,853,2,2,317,161,154,315,0
2023-06-04,LC,Cyprus,1304,1008,3,2,296,148,145,293,1
2023-06-05,LC,Cyprus,1217,937,6,6,280,138,136,274,0
2023-06-06,LC,Cyprus,1194,925,5,5,269,130,134,264,0
2023-06-07,LC,Cyprus,1254,927,9,9,327,159,159,318,0
2023-06-08,LC,Cyprus,1293,990,8,7,303,147,148,295,1
2023-06-09,LC,Cyprus,1251,991,6,4,260,129,125,254,2
2023-06-10,LC,Cyprus,1178,875,0,0,303,152,151,303,0
2023-06-11,LC,Cyprus,1352,1041,4,3,311,152,155,307,1
2023-06-12,LC,Cyprus,1293,985,5,4,308,152,151,303,1
2023-06-13,LC,Cyprus,1223,942,8,6,281,136,137,273,2
2023-06-14,LC,Cyprus,1364,1041,6,6,323,161,156,317,0
2023-06-15,LC,Cyprus,1357,1066,5,3,291,139,147,286,2
2023-06-16,LC,Cyprus,1277,987,7,5,290,141,142,283,2
2023-06-17,LC,Cyprus,1192,881,1,1,311,158,152,310,0
2023-06-18,LC,Cyprus,1366,1059,2,1,307,149,156,305,1
2023-06-19,LC,Cyprus,1300,998,9,8,302,146,147,293,1
2023-06-20,LC,Cyprus,1239,954,6,5,285,142,137,279,1
2023-06-21,LC,Cyprus,1318,996,8,6,322,157,157,314,2
2023-06-22,LC,Cyprus,1318,1010,6,5,308,146,156,302,1
2023-06-23,LC,Cyprus,1250,952,5,5,298,150,143,293,0
2023-06-24,LC,Cyprus,1232,916,1,1,316,157,158,315,0
2023-06-25,LC,Cyprus,1416,1102,2,1,314,157,155,312,1
2023-06-26,LC,Cyprus,1347,1028,4,4,319,160,155,315,0
2023-06-27,LC,Cyprus,1333,1037,6,5,296,144,146,290,1
2023-06-28,LC,Cyprus,1364,1025,5,5,339,167,167,334,0
2023-06-29,LC,Cyprus,1381,1073,5,4,308,148,155,303,1
2023-06-30,LC,Cyprus,1348,1059,4,4,289,145,140,285,0
2023-07-01,LC,Cyprus,1310,990,2,2,320,160,158,318,0
2023-07-02,LC,Cyprus,1455,1111,3,2,344,168,173,341,1
2023-07-03,LC,Cyprus,1436,1116,6,6,320,157,157,314,0
2023-07-04,LC,Cyprus,1438,1125,5,4,313,156,152,308,1
2023-07-05,LC,Cyprus,1482,1143,6,6,339,167,166,333,0
2023-07-06,LC,Cyprus,1497,1190,7,6,307,148,152,300,1
2023-07-07,LC,Cyprus,1396,1079,5,4,317,158,154,312,1
2023-07-08,LC,Cyprus,1332,999,1,1,333,165,167,332,0
2023-07-09,LC,Cyprus,1482,1139,3,2,343,173,167,340,1
2023-07-10,LC,Cyprus,1416,1085,6,6,331,164,161,325,0
2023-07-11,LC,Cyprus,1381,1081,2,2,300,149,149,298,0
2023-07-12,LC,Cyprus,1445,1098,2,2,347,173,172,345,0
2023-07-13,LC,Cyprus,1426,1118,5,3,308,152,151,303,2
2023-07-14,LC,Cyprus,1368,1064,5,5,304,148,151,299,0
2023-07-15,LC,Cyprus,1308,986,1,1,322,156,165,321,0
2023-07-16,LC,Cyprus,1497,1149,3,2,348,177,168,345,1
2023-07-17,LC,Cyprus,1384,1079,3,3,305,151,151,302,0
2023-07-18,LC,Cyprus,1364,1066,7,6,298,146,145,291,1
2023-07-19,LC,Cyprus,1402,1052,9,8,350,170,171,341,1
2023-07-20,LC,Cyprus,1456,1132,7,6,324,158,159,317,1
2023-07-21,LC,Cyprus,1310,1005,5,5,305,150,150,300,0
2023-07-22,LC,Cyprus,1292,973,0,0,319,160,159,319,0
2023-07-23,LC,Cyprus,1398,1056,3,2,342,168,171,339,1
2023-07-24,LC,Cyprus,1334,1020,5,5,314,155,154,309,0
2023-07-25,LC,Cyprus,1335,1045,4,4,290,141,145,286,0
2023-07-26,LC,Cyprus,1425,1084,5,5,341,166,170,336,0
2023-07-27,LC,Cyprus,1408,1089,7,6,319,155,157,312,1
2023-07-28,LC,Cyprus,1271,964,5,5,307,151,151,302,0
2023-07-29,LC,Cyprus,1271,951,0,0,320,164,156,320,0
2023-07-30,LC,Cyprus,1438,1090,3,2,348,171,174,345,1
2023-07-31,LC,Cyprus,1347,1031,6,6,316,159,151,310,0
2023-08-01,LC,Cyprus,1397,1081,6,5,316,151,159,310,1
2023-08-02,LC,Cyprus,1420,1079,6,6,341,167,168,335,0
2023-08-03,LC,Cyprus,1399,1083,5,4,316,153,158,311,1
2023-08-04,LC,Cyprus,1332,1020,6,6,312,155,151,306,0
2023-08-05,LC,Cyprus,1300,982,1,1,318,159,158,317,0
2023-08-06,LC,Cyprus,1447,1110,3,2,337,167,167,334,1
2023-08-07,LC,Cyprus,1396,1071,4,4,325,159,162,321,0
2023-08-08,LC,Cyprus,1378,1060,4,4,318,155,159,314,0
2023-08-09,LC,Cyprus,1436,1084,3,3,352,176,173,349,0
2023-08-10,LC,Cyprus,1443,1113,6,4,330,160,164,324,2
2023-08-11,LC,Cyprus,1338,1017,10,8,321,158,153,311,2
2023-08-12,LC,Cyprus,1310,974,1,1,336,172,163,335,0
2023-08-13,LC,Cyprus,1445,1114,4,3,331,163,164,327,1
2023-08-14,LC,Cyprus,1351,1045,4,4,306,151,151,302,0
2023-08-15,LC,Cyprus,1383,1085,6,6,298,142,150,292,0
2023-08-16,LC,Cyprus,1409,1074,6,6,335,165,164,329,0
2023-08-17,LC,Cyprus,1448,1133,6,4,315,153,156,309,2
2023-08-18,LC,Cyprus,1338,1035,5,5,303,150,148,298,0
2023-08-19,LC,Cyprus,1364,1021,2,1,343,168,173,341,1
2023-08-20,LC,Cyprus,1487,1134,4,2,353,174,175,349,2
2023-08-21,LC,Cyprus,1381,1059,7,7,322,160,155,315,0
2023-08-22,LC,Cyprus,1418,1106,4,4,312,151,157,308,0
2023-08-23,LC,Cyprus,1469,1111,4,4,358,177,177,354,0
2023-08-24,LC,Cyprus,1445,1127,6,5,318,161,151,312,1
2023-08-25,LC,Cyprus,1374,1054,5,5,320,156,159,315,0
2023-08-26,LC,Cyprus,1333,992,0,0,341,169,172,341,0
2023-08-27,LC,Cyprus,1462,1118,5,4,344,170,169,339,1
2023-08-28,LC,Cyprus,1359,1067,5,5,292,147,140,287,0
2023-08-29,LC,Cyprus,1377,1064,5,5,313,154,154,308,0
2023-08-30,LC,Cyprus,1436,1095,7,7,341,165,169,334,0
2023-08-31,LC,Cyprus,1431,1095,8,6,336,161,167,328,2
2023-09-01,LC,Cyprus,1290,997,6,6,293,146,141,287,0
2023-09-02,LC,Cyprus,1295,963,4,2,332,165,163,328,2
2023-09-03,LC,Cyprus,1417,1063,6,4,354,169,179,348,2
2023-09-04,LC,Cyprus,1318,998,5,5,320,160,155,315,0
2023-09-05,LC,Cyprus,1265,987,5,5,278,137,136,273,0
2023-09-06,LC,Cyprus,1340,1018,6,6,322,159,157,316,0
2023-09-07,LC,Cyprus,1406,1084,12,7,322,156,154,310,5
2023-09-08,LC,Cyprus,1192,895,4,4,297,146,147,293,0
2023-09-09,LC,Cyprus,1282,955,1,1,327,165,161,326,0
2023-09-10,LC,Cyprus,1406,1065,2,1,341,164,175,339,1
2023-09-11,LC,Cyprus,1313,1002,4,4,311,156,151,307,0
2023-09-12,LC,Cyprus,1301,1027,6,5,274,133,135,268,1
2023-09-13,LC,Cyprus,1390,1060,5,5,330,165,160,325,0
2023-09-14,LC,Cyprus,1370,1064,6,5,306,147,153,300,1
2023-09-15,LC,Cyprus,1197,915,3,3,282,143,136,279,0
2023-09-16,LC,Cyprus,1201,885,2,2,316,158,156,314,0
2023-09-17,LC,Cyprus,1245,915,5,3,330,161,164,325,2
2023-09-18,LC,Cyprus,1304,981,2,2,323,159,162,321,0
2023-09-19,LC,Cyprus,1324,1039,6,6,285,145,134,279,0
2023-09-20,LC,Cyprus,1323,1002,5,5,321,160,156,316,0
2023-09-21,LC,Cyprus,1297,987,6,5,310,147,157,304,1
2023-09-22,LC,Cyprus,1269,966,5,4,303,147,151,298,1
2023-09-23,LC,Cyprus,1247,904,1,1,343,174,168,342,0
2023-09-24,LC,Cyprus,1078,767,2,1,311,156,153,309,1
2023-09-25,LC,Cyprus,833,551,6,5,282,138,138,276,1
2023-09-26,LC,Cyprus,1276,971,5,5,305,149,151,300,0
2023-09-27,LC,Cyprus,1373,1036,6,5,337,166,165,331,1
2023-09-28,LC,Cyprus,1358,1043,6,5,315,154,155,309,1
2023-09-29,LC,Cyprus,1279,993,5,5,286,139,142,281,0
2023-09-30,LC,Cyprus,1292,954,1,1,338,169,168,337,0
2023-10-01,LC,Cyprus,1384,1053,3,1,331,167,161,328,2
2023-10-02,LC,Cyprus,1285,982,3,3,303,151,149,300,0
2023-01-01,LK,Czech Republic,1243,1019,2,0,224,107,115,222,2
2023-01-02,LK,Czech Republic,1521,1199,11,6,322,157,154,311,5
2023-01-03,LK,Czech Republic,1410,1165,10,9,245,113,122,235,1
2023-01-04,LK,Czech Republic,1438,1202,11,6,236,114,111,225,5
2023-01-05,LK,Czech Republic,1369,1123,19,6,246,116,111,227,13
2023-01-06,LK,Czech Republic,1496,1222,16,10,274,129,129,258,6
2023-01-07,LK,Czech Republic,1422,1205,8,5,217,100,109,209,3
2023-01-08,LK,Czech Republic,1464,1217,9,3,247,117,121,238,6
2023-01-09,LK,Czech Republic,1397,1145,7,2,252,120,125,245,5
2023-01-10,LK,Czech Republic,1217,1001,17,14,216,99,100,199,3
2023-01-11,LK,Czech Republic,1281,1059,17,5,222,105,100,205,12
2023-01-12,LK,Czech Republic,1291,1057,17,11,234,107,110,217,6
2023-01-13,LK,Czech Republic,1442,1173,13,7,269,134,122,256,6
2023-01-14,LK,Czech Republic,1308,1130,11,6,178,84,83,167,5
2023-01-15,LK,Czech Republic,1382,1150,0,0,232,110,122,232,0
2023-01-16,LK,Czech Republic,1368,1105,19,13,263,123,121,244,6
2023-01-17,LK,Czech Republic,1285,1027,31,14,258,110,117,227,17
2023-01-18,LK,Czech Republic,1242,1041,8,2,201,101,92,193,6
2023-01-19,LK,Czech Republic,1295,1036,17,9,259,123,119,242,8
2023-01-20,LK,Czech Republic,1540,1243,16,8,297,144,137,281,8
2023-01-21,LK,Czech Republic,1308,1154,3,1,154,76,75,151,2
2023-01-22,LK,Czech Republic,1414,1166,4,3,248,116,128,244,1
2023-01-23,LK,Czech Republic,1367,1117,9,4,250,121,120,241,5
2023-01-24,LK,Czech Republic,1176,965,15,8,211,98,98,196,7
2023-01-25,LK,Czech Republic,1149,942,10,3,207,95,102,197,7
2023-01-26,LK,Czech Republic,1355,1087,14,4,268,128,126,254,10
2023-01-27,LK,Czech Republic,1465,1188,5,2,277,139,133,272,3
2023-01-28,LK,Czech Republic,1289,1125,5,1,164,83,76,159,4
2023-01-29,LK,Czech Republic,1347,1096,13,6,251,111,127,238,7
2023-01-30,LK,Czech Republic,1295,1040,6,2,255,125,124,249,4
2023-01-31,LK,Czech Republic,1197,1000,9,7,197,96,92,188,2
2023-02-01,LK,Czech Republic,1251,1047,17,3,204,93,94,187,14
2023-02-02,LK,Czech Republic,1318,1046,10,5,272,136,126,262,5
2023-02-03,LK,Czech Republic,1390,1128,4,2,262,132,126,258,2
2023-02-04,LK,Czech Republic,1295,1113,6,4,182,88,88,176,2
2023-02-05,LK,Czech Republic,1400,1131,14,9,269,123,132,255,5
2023-02-06,LK,Czech Republic,1292,1019,22,11,273,127,124,251,11
2023-02-07,LK,Czech Republic,1159,937,13,5,222,100,109,209,8
2023-02-08,LK,Czech Republic,1237,974,29,16,263,122,112,234,13
2023-02-09,LK,Czech Republic,1294,998,23,9,296,138,135,273,14
2023-02-10,LK,Czech Republic,1511,1196,17,10,315,152,146,298,7
2023-02-11,LK,Czech Republic,1377,1184,7,2,193,97,89,186,5
2023-02-12,LK,Czech Republic,1376,1114,1,0,262,123,138,261,1
2023-02-13,LK,Czech Republic,1366,1098,9,4,268,130,129,259,5
2023-02-14,LK,Czech Republic,1212,972,14,9,240,108,118,226,5
2023-02-15,LK,Czech Republic,1341,1086,15,2,255,125,115,240,13
2023-02-16,LK,Czech Republic,1382,1098,6,2,284,136,142,278,4
2023-02-17,LK,Czech Republic,1347,1034,11,2,313,160,142,302,9
2023-02-18,LK,Czech Republic,1395,1188,2,0,207,104,101,205,2
2023-02-19,LK,Czech Republic,1425,1153,2,1,272,130,140,270,1
2023-02-20,LK,Czech Republic,1455,1156,13,6,299,142,144,286,7
2023-02-21,LK,Czech Republic,1269,1038,14,10,231,110,107,217,4
2023-02-22,LK,Czech Republic,1338,1072,20,11,266,123,123,246,9
2023-02-23,LK,Czech Republic,1411,1121,22,12,290,131,137,268,10
2023-02-24,LK,Czech Republic,1537,1218,12,9,319,158,149,307,3
2023-02-25,LK,Czech Republic,1370,1186,4,0,184,93,87,180,4
2023-02-26,LK,Czech Republic,1472,1182,6,0,290,129,155,284,6
2023-02-27,LK,Czech Republic,1420,1122,17,12,298,141,140,281,5
2023-02-28,LK,Czech Republic,1305,1052,16,11,253,122,115,237,5
2023-03-01,LK,Czech Republic,1387,1116,8,5,271,138,125,263,3
2023-03-02,LK,Czech Republic,1479,1183,15,10,296,141,140,281,5
2023-03-03,LK,Czech Republic,1603,1255,18,10,348,164,166,330,8
2023-03-04,LK,Czech Republic,1432,1218,5,2,214,106,103,209,3
2023-03-05,LK,Czech Republic,1504,1205,7,5,299,136,156,292,2
2023-03-06,LK,Czech Republic,1458,1168,8,6,290,141,141,282,2
2023-03-07,LK,Czech Republic,1294,1047,8,7,247,124,115,239,1
2023-03-08,LK,Czech Republic,1373,1107,5,4,266,129,132,261,1
2023-03-09,LK,Czech Republic,1457,1180,11,4,277,133,133,266,7
2023-03-10,LK,Czech Republic,1644,1296,22,7,348,165,161,326,15
2023-03-11,LK,Czech Republic,1470,1263,4,1,207,107,96,203,3
2023-03-12,LK,Czech Republic,1572,1250,18,9,322,150,154,304,9
2023-03-13,LK,Czech Republic,1394,1088,10,6,306,145,151,296,4
2023-03-14,LK,Czech Republic,1354,1086,17,7,268,123,128,251,10
2023-03-15,LK,Czech Republic,1400,1118,9,4,282,137,136,273,5
2023-03-16,LK,Czech Republic,1540,1220,25,14,320,152,143,295,11
2023-03-17,LK,Czech Republic,1575,1237,20,11,338,165,153,318,9
2023-03-18,LK,Czech Republic,1385,1148,14,4,237,105,118,223,10
2023-03-19,LK,Czech Republic,1514,1210,11,3,304,138,155,293,8
2023-03-20,LK,Czech Republic,1452,1129,15,9,323,156,152,308,6
2023-03-21,LK,Czech Republic,1358,1072,22,13,286,137,127,264,9
2023-03-22,LK,Czech Republic,1475,1154,21,11,321,142,158,300,10
2023-03-23,LK,Czech Republic,1545,1210,23,10,335,165,147,312,13
2023-03-24,LK,Czech Republic,1592,1268,10,8,324,155,159,314,2
2023-03-25,LK,Czech Republic,1402,1189,7,3,213,106,100,206,4
2023-03-26,LK,Czech Republic,1656,1332,17,5,324,145,162,307,12
2023-03-27,LK,Czech Republic,1425,1096,4,0,329,165,160,325,4
2023-03-28,LK,Czech Republic,1665,1360,9,1,305,145,151,296,8
2023-03-29,LK,Czech Republic,1673,1337,20,8,336,159,157,316,12
2023-03-30,LK,Czech Republic,1735,1397,14,7,338,161,163,324,7
2023-03-31,LK,Czech Republic,1771,1398,11,9,373,184,178,362,2
2023-04-01,LK,Czech Republic,1625,1374,5,3,251,129,117,246,2
2023-04-02,LK,Czech Republic,1784,1468,4,0,316,145,167,312,4
2023-04-03,LK,Czech Republic,1793,1428,21,8,365,178,166,344,13
2023-04-04,LK,Czech Republic,1751,1426,11,4,325,157,157,314,7
2023-04-05,LK,Czech Republic,1843,1467,13,10,376,182,181,363,3
2023-04-06,LK,Czech Republic,1925,1485,27,12,440,215,198,413,15
2023-04-07,LK,Czech Republic,1764,1427,9,7,337,169,159,328,2
2023-04-08,LK,Czech Republic,1575,1322,1,0,253,123,129,252,1
2023-04-09,LK,Czech Republic,1722,1414,3,3,308,146,159,305,0
2023-04-10,LK,Czech Republic,1812,1456,11,6,356,164,181,345,5
2023-04-11,LK,Czech Republic,1730,1429,7,0,301,149,145,294,7
2023-04-12,LK,Czech Republic,1714,1384,16,10,330,159,155,314,6
2023-04-13,LK,Czech Republic,1845,1505,14,7,340,162,164,326,7
2023-04-14,LK,Czech Republic,1818,1442,11,1,376,188,177,365,10
2023-04-15,LK,Czech Republic,1668,1391,7,3,277,135,135,270,4
2023-04-16,LK,Czech Republic,1842,1490,8,7,352,163,181,344,1
2023-04-17,LK,Czech Republic,1771,1412,16,8,359,174,169,343,8
2023-04-18,LK,Czech Republic,1785,1454,9,5,331,162,160,322,4
2023-04-19,LK,Czech Republic,1849,1486,13,6,363,179,171,350,7
2023-04-20,LK,Czech Republic,1848,1480,24,7,368,170,174,344,17
2023-04-21,LK,Czech Republic,1865,1479,22,16,386,191,173,364,6
2023-04-22,LK,Czech Republic,1747,1483,5,3,264,129,130,259,2
2023-04-23,LK,Czech Republic,1907,1563,7,4,344,158,179,337,3
2023-04-24,LK,Czech Republic,1815,1448,11,4,367,177,179,356,7
2023-04-25,LK,Czech Republic,1812,1471,19,7,341,160,162,322,12
2023-04-26,LK,Czech Republic,1860,1484,18,10,376,183,175,358,8
2023-04-27,LK,Czech Republic,2077,1647,25,10,430,201,204,405,15
2023-04-28,LK,Czech Republic,1994,1587,19,12,407,201,187,388,7
2023-04-29,LK,Czech Republic,1777,1481,11,5,296,148,137,285,6
2023-04-30,LK,Czech Republic,1899,1556,21,11,343,158,164,322,10
2023-05-01,LK,Czech Republic,1920,1558,18,9,362,165,179,344,9
2023-05-02,LK,Czech Republic,1839,1513,18,14,326,147,161,308,4
2023-05-03,LK,Czech Republic,1873,1505,23,14,368,172,173,345,9
2023-05-04,LK,Czech Republic,2059,1647,24,11,412,199,189,388,13
2023-05-05,LK,Czech Republic,1992,1584,18,8,408,201,189,390,10
2023-05-06,LK,Czech Republic,1807,1516,6,4,291,147,138,285,2
2023-05-07,LK,Czech Republic,1985,1640,12,6,345,164,169,333,6
2023-05-08,LK,Czech Republic,1970,1580,20,13,390,173,197,370,7
2023-05-09,LK,Czech Republic,1834,1468,20,8,366,176,170,346,12
2023-05-10,LK,Czech Republic,1957,1557,19,6,400,192,189,381,13
2023-05-11,LK,Czech Republic,2004,1627,20,11,377,183,174,357,9
2023-05-12,LK,Czech Republic,2077,1650,14,8,427,207,206,413,6
2023-05-13,LK,Czech Republic,1927,1619,6,1,308,148,154,302,5
2023-05-14,LK,Czech Republic,2020,1667,10,2,353,166,177,343,8
2023-05-15,LK,Czech Republic,1958,1582,9,5,376,185,182,367,4
2023-05-16,LK,Czech Republic,1882,1563,11,8,319,153,155,308,3
2023-05-17,LK,Czech Republic,1977,1595,13,8,382,186,183,369,5
2023-05-18,LK,Czech Republic,1969,1572,19,10,397,192,186,378,9
2023-05-19,LK,Czech Republic,1930,1519,23,10,411,195,193,388,13
2023-05-20,LK,Czech Republic,1907,1592,9,5,315,154,152,306,4
2023-05-21,LK,Czech Republic,2133,1756,6,3,377,178,193,371,3
2023-05-22,LK,Czech Republic,2044,1651,10,5,393,198,185,383,5
2023-05-23,LK,Czech Republic,1813,1462,13,6,351,170,168,338,7
2023-05-24,LK,Czech Republic,2015,1616,15,10,399,197,187,384,5
2023-05-25,LK,Czech Republic,2083,1678,16,10,405,193,196,389,6
2023-05-26,LK,Czech Republic,2136,1715,15,10,421,209,197,406,5
2023-05-27,LK,Czech Republic,2013,1679,14,5,334,160,160,320,9
2023-05-28,LK,Czech Republic,2101,1714,8,5,387,181,198,379,3
2023-05-29,LK,Czech Republic,2078,1662,16,8,416,201,199,400,8
2023-05-30,LK,Czech Republic,1993,1618,20,8,375,176,179,355,12
2023-05-31,LK,Czech Republic,2059,1622,28,16,437,205,204,409,12
2023-06-01,LK,Czech Republic,2256,1789,18,7,467,217,232,449,11
2023-06-02,LK,Czech Republic,2316,1810,15,5,506,253,238,491,10
2023-06-03,LK,Czech Republic,2112,1714,7,1,398,197,194,391,6
2023-06-04,LK,Czech Republic,2256,1804,12,4,452,209,231,440,8
2023-06-05,LK,Czech Republic,2157,1708,10,7,449,227,212,439,3
2023-06-06,LK,Czech Republic,2102,1676,11,7,426,200,215,415,4
2023-06-07,LK,Czech Republic,2227,1730,19,11,497,239,239,478,8
2023-06-08,LK,Czech Republic,2341,1804,29,15,537,264,244,508,14
2023-06-09,LK,Czech Republic,2258,1756,17,10,502,247,238,485,7
2023-06-10,LK,Czech Republic,2197,1789,19,9,408,193,196,389,10
2023-06-11,LK,Czech Republic,2321,1853,21,7,468,211,236,447,14
2023-06-12,LK,Czech Republic,2175,1690,19,10,485,240,226,466,9
2023-06-13,LK,Czech Republic,2076,1651,26,16,425,193,206,399,10
2023-06-14,LK,Czech Republic,2211,1727,19,9,484,231,234,465,10
2023-06-15,LK,Czech Republic,2337,1824,31,11,513,243,239,482,20
2023-06-16,LK,Czech Republic,2347,1814,23,8,533,256,254,510,15
2023-06-17,LK,Czech Republic,2144,1743,9,4,401,195,197,392,5
2023-06-18,LK,Czech Republic,2383,1899,22,2,484,227,235,462,20
2023-06-19,LK,Czech Republic,2286,1796,22,15,490,237,231,468,7
2023-06-20,LK,Czech Republic,2205,1746,23,12,459,215,221,436,11
2023-06-21,LK,Czech Republic,2296,1806,25,8,490,236,229,465,17
2023-06-22,LK,Czech Republic,2393,1888,19,9,505,242,244,486,10
2023-06-23,LK,Czech Republic,2637,2124,20,6,513,253,240,493,14
2023-06-24,LK,Czech Republic,2287,1868,14,8,419,206,199,405,6
2023-06-25,LK,Czech Republic,2427,1940,16,5,487,223,248,471,11
2023-06-26,LK,Czech Republic,2384,1892,14,6,492,237,241,478,8
2023-06-27,LK,Czech Republic,2251,1779,26,13,472,224,222,446,13
2023-06-28,LK,Czech Republic,2371,1851,18,11,520,255,247,502,7
2023-06-29,LK,Czech Republic,2488,1961,17,4,527,249,261,510,13
2023-06-30,LK,Czech Republic,2576,1999,28,10,577,278,271,549,18
2023-07-01,LK,Czech Republic,2433,1944,16,4,489,246,227,473,12
2023-07-02,LK,Czech Republic,2517,1994,13,2,523,251,259,510,11
2023-07-03,LK,Czech Republic,2419,1912,21,12,507,244,242,486,9
2023-07-04,LK,Czech Republic,2340,1861,23,17,479,227,229,456,6
2023-07-05,LK,Czech Republic,2449,1970,19,7,479,234,226,460,12
2023-07-06,LK,Czech Republic,2430,1977,14,7,453,224,215,439,7
2023-07-07,LK,Czech Republic,2568,2043,19,10,525,250,256,506,9
2023-07-08,LK,Czech Republic,2396,1962,6,4,434,213,215,428,2
2023-07-09,LK,Czech Republic,2488,1979,15,2,509,232,262,494,13
2023-07-10,LK,Czech Republic,2478,1973,8,2,505,246,251,497,6
2023-07-11,LK,Czech Republic,2460,2001,22,8,459,218,219,437,14
2023-07-12,LK,Czech Republic,2758,2237,14,8,521,258,249,507,6
2023-07-13,LK,Czech Republic,2589,2063,21,12,526,256,249,505,9
2023-07-14,LK,Czech Republic,2539,1983,17,7,556,277,262,539,10
2023-07-15,LK,Czech Republic,2371,1936,12,3,435,213,210,423,9
2023-07-16,LK,Czech Republic,2517,2017,17,3,500,234,249,483,14
2023-07-17,LK,Czech Republic,2536,2009,15,9,527,259,253,512,6
2023-07-18,LK,Czech Republic,2475,2002,30,12,473,217,226,443,18
2023-07-19,LK,Czech Republic,2519,1980,29,16,539,256,254,510,13
2023-07-20,LK,Czech Republic,2597,2035,32,16,562,265,265,530,16
2023-07-21,LK,Czech Republic,2503,1974,25,12,529,259,245,504,13
2023-07-22,LK,Czech Republic,2376,1932,15,8,444,216,213,429,7
2023-07-23,LK,Czech Republic,2511,2000,11,3,511,238,262,500,8
2023-07-24,LK,Czech Republic,2628,2128,13,7,500,244,243,487,6
2023-07-25,LK,Czech Republic,2428,1949,29,8,479,227,223,450,21
2023-07-26,LK,Czech Republic,2498,1984,20,5,514,249,245,494,15
2023-07-27,LK,Czech Republic,2507,1996,25,12,511,246,240,486,13
2023-07-28,LK,Czech Republic,2513,2015,11,7,498,243,244,487,4
2023-07-29,LK,Czech Republic,2475,2028,14,4,447,215,218,433,10
2023-07-30,LK,Czech Republic,2510,2027,13,3,483,228,242,470,10
2023-07-31,LK,Czech Republic,2392,1908,14,9,484,236,234,470,5
2023-08-01,LK,Czech Republic,2339,1872,11,3,467,230,226,456,8
2023-08-02,LK,Czech Republic,2358,1856,20,8,502,244,238,482,12
2023-08-03,LK,Czech Republic,2482,2001,20,10,481,233,228,461,10
2023-08-04,LK,Czech Republic,2521,2002,17,10,519,250,252,502,7
2023-08-05,LK,Czech Republic,2366,1958,3,1,408,205,200,405,2
2023-08-06,LK,Czech Republic,2558,2063,16,4,495,229,250,479,12
2023-08-07,LK,Czech Republic,2481,1985,14,6,496,236,246,482,8
2023-08-08,LK,Czech Republic,2367,1902,17,11,465,226,222,448,6
2023-08-09,LK,Czech Republic,2462,1970,18,6,492,234,240,474,12
2023-08-10,LK,Czech Republic,2494,1971,31,15,523,247,245,492,16
2023-08-11,LK,Czech Republic,2410,1897,19,12,513,254,240,494,7
2023-08-12,LK,Czech Republic,2384,1965,14,7,419,206,199,405,7
2023-08-13,LK,Czech Republic,2548,2052,31,12,496,229,236,465,19
2023-08-14,LK,Czech Republic,2339,1864,16,11,475,229,230,459,5
2023-08-15,LK,Czech Republic,2406,1945,20,11,461,217,224,441,9
2023-08-16,LK,Czech Republic,2375,1864,21,12,511,251,239,490,9
2023-08-17,LK,Czech Republic,2488,2025,20,5,463,221,222,443,15
2023-08-18,LK,Czech Republic,2446,1935,21,10,511,245,245,490,11
2023-08-19,LK,Czech Republic,2303,1871,19,8,432,209,204,413,11
2023-08-20,LK,Czech Republic,2472,1958,21,8,514,240,253,493,13
2023-08-21,LK,Czech Republic,2325,1841,11,6,484,237,236,473,5
2023-08-22,LK,Czech Republic,2229,1773,23,14,456,218,215,433,9
2023-08-23,LK,Czech Republic,2500,1993,29,12,507,242,236,478,17
2023-08-24,LK,Czech Republic,2559,2037,31,17,522,241,250,491,14
2023-08-25,LK,Czech Republic,2570,2052,15,6,518,262,241,503,9
2023-08-26,LK,Czech Republic,2465,2041,15,5,424,208,201,409,10
2023-08-27,LK,Czech Republic,2438,1939,18,1,499,235,246,481,17
2023-08-28,LK,Czech Republic,2375,1922,6,2,453,222,225,447,4
2023-08-29,LK,Czech Republic,2241,1809,7,1,432,209,216,425,6
2023-08-30,LK,Czech Republic,2417,1916,22,7,501,243,236,479,15
2023-08-31,LK,Czech Republic,2576,2056,29,9,520,246,245,491,20
2023-09-01,LK,Czech Republic,2430,1887,27,7,543,263,253,516,20
2023-09-02,LK,Czech Republic,2247,1817,11,5,430,210,209,419,6
2023-09-03,LK,Czech Republic,2440,1929,16,4,511,234,261,495,12
2023-09-04,LK,Czech Republic,2296,1790,20,12,506,243,243,486,8
2023-09-05,LK,Czech Republic,2228,1758,26,10,470,218,226,444,16
2023-09-06,LK,Czech Republic,2290,1770,32,14,520,250,238,488,18
2023-09-07,LK,Czech Republic,2434,1916,20,8,518,247,251,498,12
2023-09-08,LK,Czech Republic,2423,1884,27,14,539,263,249,512,13
2023-09-09,LK,Czech Republic,2250,1812,12,6,438,218,208,426,6
2023-09-10,LK,Czech Republic,2451,1942,16,4,509,238,255,493,12
2023-09-11,LK,Czech Republic,2297,1811,16,8,486,234,236,470,8
2023-09-12,LK,Czech Republic,2282,1813,21,9,469,220,228,448,12
2023-09-13,LK,Czech Republic,2400,1874,19,10,526,251,256,507,9
2023-09-14,LK,Czech Republic,2429,1888,19,9,541,255,267,522,10
2023-09-15,LK,Czech Republic,2449,1900,28,8,549,258,263,521,20
2023-09-16,LK,Czech Republic,2234,1830,16,4,404,195,193,388,12
2023-09-17,LK,Czech Republic,2430,1948,13,2,482,225,244,469,11
2023-09-18,LK,Czech Republic,2368,1843,11,6,525,275,239,514,5
2023-09-19,LK,Czech Republic,2175,1735,15,4,440,207,218,425,11
2023-09-20,LK,Czech Republic,2320,1798,18,8,522,255,249,504,10
2023-09-21,LK,Czech Republic,2460,1967,16,8,493,237,240,477,8
2023-09-22,LK,Czech Republic,2367,1842,18,8,525,262,245,507,10
2023-09-23,LK,Czech Republic,2234,1848,5,1,386,196,185,381,4
2023-09-24,LK,Czech Republic,2411,1935,8,2,476,225,243,468,6
2023-09-25,LK,Czech Republic,2307,1804,24,11,503,234,245,479,13
2023-09-26,LK,Czech Republic,2106,1656,22,8,450,215,213,428,14
2023-09-27,LK,Czech Republic,2344,1773,26,10,571,287,258,545,16
2023-09-28,LK,Czech Republic,2442,1954,11,3,488,246,231,477,8
2023-09-29,LK,Czech Republic,2365,1880,13,6,485,240,232,472,7
2023-09-30,LK,Czech Republic,2212,1835,6,1,377,183,188,371,5
2023-10-01,LK,Czech Republic,2417,1901,10,2,516,230,276,506,8
2023-10-02,LK,Czech Republic,2210,1742,20,11,468,232,216,448,9
2023-01-01,EK,Denmark,1198,603,53,1,595,270,272,542,52
2023-01-02,EK,Denmark,1387,654,101,4,733,321,311,632,97
2023-01-03,EK,Denmark,1272,629,92,13,643,276,275,551,79
2023-01-04,EK,Denmark,1233,570,94,11,663,281,288,569,83
2023-01-05,EK,Denmark,1215,566,80,4,649,287,282,569,76
2023-01-06,EK,Denmark,1301,597,94,6,704,302,308,610,88
2023-01-07,EK,Denmark,1084,569,36,2,515,237,242,479,34
2023-01-08,EK,Denmark,1332,679,62,2,653,297,294,591,60
2023-01-09,EK,Denmark,1327,629,103,8,698,302,293,595,95
2023-01-10,EK,Denmark,1156,545,101,19,611,249,261,510,82
2023-01-11,EK,Denmark,1190,558,98,17,632,269,265,534,81
2023-01-12,EK,Denmark,1278,599,118,16,679,283,278,561,102
2023-01-13,EK,Denmark,1366,633,111,10,733,312,310,622,101
2023-01-14,EK,Denmark,1070,590,37,2,480,217,226,443,35
2023-01-15,EK,Denmark,1185,598,47,0,587,271,269,540,47
2023-01-16,EK,Denmark,1310,599,93,13,711,308,310,618,80
2023-01-17,EK,Denmark,1104,519,65,0,585,260,260,520,65
2023-01-18,EK,Denmark,1206,567,99,15,639,271,269,540,84
2023-01-19,EK,Denmark,1186,551,80,2,635,275,280,555,78
2023-01-20,EK,Denmark,1329,628,83,7,701,309,309,618,76
2023-01-21,EK,Denmark,1059,566,45,4,493,222,226,448,41
2023-01-22,EK,Denmark,1216,594,73,3,622,271,278,549,70
2023-01-23,EK,Denmark,1308,579,97,13,729,322,310,632,84
2023-01-24,EK,Denmark,1104,482,109,18,622,251,262,513,91
2023-01-25,EK,Denmark,1167,518,109,13,649,275,265,540,96
2023-01-26,EK,Denmark,1251,558,112,8,693,291,290,581,104
2023-01-27,EK,Denmark,1375,622,119,13,753,318,316,634,106
2023-01-28,EK,Denmark,1062,545,42,0,517,235,240,475,42
2023-01-29,EK,Denmark,1267,632,63,3,635,286,286,572,60
2023-01-30,EK,Denmark,1298,561,104,11,737,317,316,633,93
2023-01-31,EK,Denmark,1153,516,112,7,637,266,259,525,105
2023-02-01,EK,Denmark,1205,533,96,8,672,281,295,576,88
2023-02-02,EK,Denmark,1245,535,116,21,710,302,292,594,95
2023-02-03,EK,Denmark,1338,582,105,10,756,326,325,651,95
2023-02-04,EK,Denmark,1098,563,54,12,535,236,245,481,42
2023-02-05,EK,Denmark,1175,553,67,3,622,279,276,555,64
2023-02-06,EK,Denmark,1281,563,95,6,718,312,311,623,89
2023-02-07,EK,Denmark,1145,497,100,12,648,272,276,548,88
2023-02-08,EK,Denmark,1241,524,121,16,717,303,293,596,105
2023-02-09,EK,Denmark,1292,566,112,14,726,310,304,614,98
2023-02-10,EK,Denmark,1438,632,119,8,806,340,347,687,111
2023-02-11,EK,Denmark,1209,606,42,4,603,280,281,561,38
2023-02-12,EK,Denmark,1286,613,64,4,673,307,302,609,60
2023-02-13,EK,Denmark,1349,586,100,10,763,331,332,663,90
2023-02-14,EK,Denmark,1164,533,71,3,631,277,283,560,68
2023-02-15,EK,Denmark,1211,552,57,2,659,297,305,602,55
2023-02-16,EK,Denmark,1353,614,105,10,739,319,315,634,95
2023-02-17,EK,Denmark,1203,603,75,8,600,252,273,525,67
2023-02-18,EK,Denmark,1320,644,60,1,676,312,304,616,59
2023-02-19,EK,Denmark,1333,635,67,4,698,320,311,631,63
2023-02-20,EK,Denmark,1419,653,101,7,766,332,333,665,94
2023-02-21,EK,Denmark,1273,575,115,18,698,293,290,583,97
2023-02-22,EK,Denmark,1337,593,122,23,744,310,312,622,99
2023-02-23,EK,Denmark,1383,630,103,5,753,325,325,650,98
2023-02-24,EK,Denmark,1443,637,103,8,806,356,347,703,95
2023-02-25,EK,Denmark,1266,671,37,1,595,280,278,558,36
2023-02-26,EK,Denmark,1346,644,64,6,702,314,324,638,58
2023-02-27,EK,Denmark,1418,606,123,21,812,346,343,689,102
2023-02-28,EK,Denmark,1267,576,107,17,691,295,289,584,90
2023-03-01,EK,Denmark,1326,563,134,13,763,314,315,629,121
2023-03-02,EK,Denmark,1357,576,122,17,781,336,323,659,105
2023-03-03,EK,Denmark,1461,643,119,11,818,353,346,699,108
2023-03-04,EK,Denmark,1228,644,43,3,584,268,273,541,40
2023-03-05,EK,Denmark,1376,681,73,7,695,306,316,622,66
2023-03-06,EK,Denmark,1475,668,111,9,807,350,346,696,102
2023-03-07,EK,Denmark,1220,580,74,4,640,279,287,566,70
2023-03-08,EK,Denmark,1392,624,114,16,768,330,324,654,98
2023-03-09,EK,Denmark,1390,611,112,13,779,331,336,667,99
2023-03-10,EK,Denmark,1451,662,94,9,789,352,343,695,85
2023-03-11,EK,Denmark,1214,644,40,4,570,261,269,530,36
2023-03-12,EK,Denmark,1392,694,63,3,698,318,317,635,60
2023-03-13,EK,Denmark,1392,614,108,7,778,336,334,670,101
2023-03-14,EK,Denmark,1300,610,90,10,690,296,304,600,80
2023-03-15,EK,Denmark,1328,604,106,16,724,312,306,618,90
2023-03-16,EK,Denmark,1386,591,116,12,795,337,342,679,104
2023-03-17,EK,Denmark,1468,635,124,22,833,351,358,709,102
2023-03-18,EK,Denmark,1237,660,45,7,577,266,266,532,38
2023-03-19,EK,Denmark,1374,686,55,2,688,316,317,633,53
2023-03-20,EK,Denmark,1470,639,145,16,831,343,343,686,129
2023-03-21,EK,Denmark,1285,595,89,7,690,302,299,601,82
2023-03-22,EK,Denmark,1404,609,160,22,795,319,316,635,138
2023-03-23,EK,Denmark,1440,633,133,16,807,336,338,674,117
2023-03-24,EK,Denmark,1502,670,125,11,832,357,350,707,114
2023-03-25,EK,Denmark,1169,605,54,7,564,254,256,510,47
2023-03-26,EK,Denmark,1414,637,65,8,777,350,362,712,57
2023-03-27,EK,Denmark,1416,575,120,16,841,364,357,721,104
2023-03-28,EK,Denmark,1519,675,119,16,844,365,360,725,103
2023-03-29,EK,Denmark,1541,671,139,25,870,371,360,731,114
2023-03-30,EK,Denmark,1626,688,126,17,938,399,413,812,109
2023-03-31,EK,Denmark,1662,704,155,10,958,404,399,803,145
2023-04-01,EK,Denmark,1365,662,76,9,703,314,313,627,67
2023-04-02,EK,Denmark,1504,696,68,4,808,366,374,740,64
2023-04-03,EK,Denmark,1582,681,118,25,901,396,387,783,93
2023-04-04,EK,Denmark,1432,660,91,11,772,338,343,681,80
2023-04-05,EK,Denmark,1557,736,103,11,821,361,357,718,92
2023-04-06,EK,Denmark,1480,674,77,10,806,368,361,729,67
2023-04-07,EK,Denmark,1358,659,60,4,699,317,322,639,56
2023-04-08,EK,Denmark,1288,683,41,5,605,279,285,564,36
2023-04-09,EK,Denmark,1453,692,58,5,761,348,355,703,53
2023-04-10,EK,Denmark,1589,732,88,3,857,387,382,769,85
2023-04-11,EK,Denmark,1576,706,119,12,870,373,378,751,107
2023-04-12,EK,Denmark,1630,750,124,21,880,382,374,756,103
2023-04-13,EK,Denmark,1634,732,117,9,902,386,399,785,108
2023-04-14,EK,Denmark,1674,731,140,19,943,404,399,803,121
2023-04-15,EK,Denmark,1343,697,49,4,646,301,296,597,45
2023-04-16,EK,Denmark,1504,684,69,3,820,370,381,751,66
2023-04-17,EK,Denmark,1601,683,116,17,918,407,395,802,99
2023-04-18,EK,Denmark,1507,640,121,17,867,370,376,746,104
2023-04-19,EK,Denmark,1545,657,122,12,888,385,381,766,110
2023-04-20,EK,Denmark,1581,676,112,11,905,395,398,793,101
2023-04-21,EK,Denmark,1556,663,102,9,893,396,395,791,93
2023-04-22,EK,Denmark,1264,602,45,4,662,303,314,617,41
2023-04-23,EK,Denmark,1466,670,63,3,796,369,364,733,60
2023-04-24,EK,Denmark,1582,683,125,9,899,388,386,774,116
2023-04-25,EK,Denmark,1569,708,114,8,861,373,374,747,106
2023-04-26,EK,Denmark,1594,704,120,14,890,383,387,770,106
2023-04-27,EK,Denmark,1668,701,148,21,967,415,404,819,127
2023-04-28,EK,Denmark,1677,718,142,12,959,410,407,817,130
2023-04-29,EK,Denmark,1260,609,43,3,651,301,307,608,40
2023-04-30,EK,Denmark,1420,628,78,3,792,353,361,714,75
2023-05-01,EK,Denmark,1537,670,130,22,867,373,364,737,108
2023-05-02,EK,Denmark,1587,683,119,12,904,394,391,785,107
2023-05-03,EK,Denmark,1575,679,117,14,896,391,388,779,103
2023-05-04,EK,Denmark,1593,655,132,14,938,401,405,806,118
2023-05-05,EK,Denmark,1540,697,71,0,843,390,382,772,71
2023-05-06,EK,Denmark,1342,676,39,1,666,307,320,627,38
2023-05-07,EK,Denmark,1553,719,77,6,834,375,382,757,71
2023-05-08,EK,Denmark,1631,698,125,14,933,410,398,808,111
2023-05-09,EK,Denmark,1639,739,117,21,900,397,386,783,96
2023-05-10,EK,Denmark,1640,721,117,19,919,396,406,802,98
2023-05-11,EK,Denmark,1664,690,118,17,974,428,428,856,101
2023-05-12,EK,Denmark,1717,727,148,22,990,427,415,842,126
2023-05-13,EK,Denmark,1417,681,53,7,736,331,352,683,46
2023-05-14,EK,Denmark,1580,691,80,3,889,399,410,809,77
2023-05-15,EK,Denmark,1679,728,129,9,951,414,408,822,120
2023-05-16,EK,Denmark,1634,737,135,20,897,387,375,762,115
2023-05-17,EK,Denmark,1619,686,144,14,933,391,398,789,130
2023-05-18,EK,Denmark,1602,736,82,4,866,389,395,784,78
2023-05-19,EK,Denmark,1436,643,85,7,793,358,350,708,78
2023-05-20,EK,Denmark,1354,642,52,3,712,329,331,660,49
2023-05-21,EK,Denmark,1639,733,81,3,906,411,414,825,78
2023-05-22,EK,Denmark,1697,736,135,18,961,418,408,826,117
2023-05-23,EK,Denmark,1655,719,141,22,936,397,398,795,119
2023-05-24,EK,Denmark,1687,732,144,19,955,408,403,811,125
2023-05-25,EK,Denmark,1726,730,143,21,996,421,432,853,122
2023-05-26,EK,Denmark,1677,737,123,16,940,406,411,817,107
2023-05-27,EK,Denmark,1399,657,57,6,742,341,344,685,51
2023-05-28,EK,Denmark,1506,673,72,0,833,376,385,761,72
2023-05-29,EK,Denmark,1640,744,92,6,896,405,399,804,86
2023-05-30,EK,Denmark,1680,734,138,21,946,401,407,808,117
2023-05-31,EK,Denmark,1751,773,149,25,978,418,411,829,124
2023-06-01,EK,Denmark,1728,739,139,15,989,430,420,850,124
2023-06-02,EK,Denmark,1740,749,137,12,991,424,430,854,125
2023-06-03,EK,Denmark,1416,689,58,5,727,330,339,669,53
2023-06-04,EK,Denmark,1629,732,82,2,897,410,405,815,80
2023-06-05,EK,Denmark,1661,723,124,10,938,406,408,814,114
2023-06-06,EK,Denmark,1663,726,139,18,937,407,391,798,121
2023-06-07,EK,Denmark,1739,750,156,17,989,413,420,833,139
2023-06-08,EK,Denmark,1705,726,134,18,979,417,428,845,116
2023-06-09,EK,Denmark,1707,736,134,15,971,414,423,837,119
2023-06-10,EK,Denmark,1434,692,59,10,742,344,339,683,49
2023-06-11,EK,Denmark,1663,756,74,4,907,415,418,833,70
2023-06-12,EK,Denmark,1732,757,129,14,975,423,423,846,115
2023-06-13,EK,Denmark,1695,762,130,15,933,405,398,803,115
2023-06-14,EK,Denmark,1722,766,144,11,956,408,404,812,133
2023-06-15,EK,Denmark,1800,768,179,19,1032,423,430,853,160
2023-06-16,EK,Denmark,1844,804,166,17,1040,436,438,874,149
2023-06-17,EK,Denmark,1579,786,93,5,793,347,353,700,88
2023-06-18,EK,Denmark,1677,773,87,1,904,410,407,817,86
2023-06-19,EK,Denmark,1749,762,132,13,987,429,426,855,119
2023-06-20,EK,Denmark,1712,767,136,13,945,406,403,809,123
2023-06-21,EK,Denmark,1749,785,150,19,964,410,404,814,131
2023-06-22,EK,Denmark,1794,801,117,9,993,436,440,876,108
2023-06-23,EK,Denmark,1769,790,104,7,979,436,439,875,97
2023-06-24,EK,Denmark,1505,728,45,2,777,364,368,732,43
2023-06-25,EK,Denmark,1695,801,72,4,894,419,403,822,68
2023-06-26,EK,Denmark,1856,887,111,6,969,427,431,858,105
2023-06-27,EK,Denmark,1751,822,105,12,929,409,415,824,93
2023-06-28,EK,Denmark,1750,784,112,6,966,423,431,854,106
2023-06-29,EK,Denmark,1784,782,124,4,1002,440,438,878,120
2023-06-30,EK,Denmark,1797,817,109,11,980,435,436,871,98
2023-07-01,EK,Denmark,1632,829,52,1,803,374,377,751,51
2023-07-02,EK,Denmark,1761,866,65,0,895,417,413,830,65
2023-07-03,EK,Denmark,1815,858,86,5,957,432,439,871,81
2023-07-04,EK,Denmark,1753,863,80,5,890,407,403,810,75
2023-07-05,EK,Denmark,1778,862,105,10,916,402,409,811,95
2023-07-06,EK,Denmark,1852,871,103,8,981,439,439,878,95
2023-07-07,EK,Denmark,1836,860,97,13,976,438,441,879,84
2023-07-08,EK,Denmark,1650,841,47,3,809,381,381,762,44
2023-07-09,EK,Denmark,1758,841,72,2,917,422,423,845,70
2023-07-10,EK,Denmark,1842,885,93,12,957,436,428,864,81
2023-07-11,EK,Denmark,1740,844,97,8,896,397,402,799,89
2023-07-12,EK,Denmark,1728,845,83,6,883,396,404,800,77
2023-07-13,EK,Denmark,1819,871,111,14,948,417,420,837,97
2023-07-14,EK,Denmark,1803,830,97,13,973,435,441,876,84
2023-07-15,EK,Denmark,1578,801,44,4,777,369,364,733,40
2023-07-16,EK,Denmark,1741,847,67,3,894,414,413,827,64
2023-07-17,EK,Denmark,1787,860,88,6,927,423,416,839,82
2023-07-18,EK,Denmark,1699,840,88,13,859,384,387,771,75
2023-07-19,EK,Denmark,1718,835,91,18,883,397,395,792,73
2023-07-20,EK,Denmark,1755,830,101,7,925,413,411,824,94
2023-07-21,EK,Denmark,1776,837,96,12,939,428,415,843,84
2023-07-22,EK,Denmark,1584,794,52,1,790,367,371,738,51
2023-07-23,EK,Denmark,1720,812,86,0,908,412,410,822,86
2023-07-24,EK,Denmark,1794,844,99,11,950,424,427,851,88
2023-07-25,EK,Denmark,1710,837,77,7,873,399,397,796,70
2023-07-26,EK,Denmark,1774,872,93,8,902,400,409,809,85
2023-07-27,EK,Denmark,1809,883,100,12,926,415,411,826,88
2023-07-28,EK,Denmark,1776,835,89,7,941,426,426,852,82
2023-07-29,EK,Denmark,1603,829,42,2,774,362,370,732,40
2023-07-30,EK,Denmark,1755,865,64,0,890,412,414,826,64
2023-07-31,EK,Denmark,1816,864,90,7,952,427,435,862,83
2023-08-01,EK,Denmark,1752,868,91,11,884,396,397,793,80
2023-08-02,EK,Denmark,1719,834,87,16,885,399,399,798,71
2023-08-03,EK,Denmark,1803,863,97,6,940,426,417,843,91
2023-08-04,EK,Denmark,1765,829,99,14,936,423,414,837,85
2023-08-05,EK,Denmark,1620,831,45,2,789,365,379,744,43
2023-08-06,EK,Denmark,1802,909,66,1,893,408,419,827,65
2023-08-07,EK,Denmark,1874,932,93,7,942,427,422,849,86
2023-08-08,EK,Denmark,1733,886,85,1,847,383,379,762,84
2023-08-09,EK,Denmark,1656,783,111,18,873,381,381,762,93
2023-08-10,EK,Denmark,1711,804,104,10,907,403,400,803,94
2023-08-11,EK,Denmark,1772,847,113,12,925,410,402,812,101
2023-08-12,EK,Denmark,1556,802,45,2,754,349,360,709,43
2023-08-13,EK,Denmark,1711,803,75,3,908,417,416,833,72
2023-08-14,EK,Denmark,1737,787,118,13,950,416,416,832,105
2023-08-15,EK,Denmark,1681,777,118,18,904,393,393,786,100
2023-08-16,EK,Denmark,1683,770,120,12,913,400,393,793,108
2023-08-17,EK,Denmark,1688,736,130,18,952,407,415,822,112
2023-08-18,EK,Denmark,1759,788,112,11,971,422,437,859,101
2023-08-19,EK,Denmark,1446,708,54,2,738,339,345,684,52
2023-08-20,EK,Denmark,1727,799,88,1,928,422,418,840,87
2023-08-21,EK,Denmark,1802,774,138,19,1028,444,446,890,119
2023-08-22,EK,Denmark,1725,791,126,12,934,404,404,808,114
2023-08-23,EK,Denmark,1745,810,130,15,935,402,403,805,115
2023-08-24,EK,Denmark,1770,783,129,11,987,435,423,858,118
2023-08-25,EK,Denmark,1746,763,125,13,983,429,429,858,112
2023-08-26,EK,Denmark,1501,763,52,1,738,338,348,686,51
2023-08-27,EK,Denmark,1694,812,73,3,882,408,401,809,70
2023-08-28,EK,Denmark,1807,839,133,19,968,414,421,835,114
2023-08-29,EK,Denmark,1806,832,133,15,974,417,424,841,118
2023-08-30,EK,Denmark,1762,802,132,22,960,418,410,828,110
2023-08-31,EK,Denmark,1859,866,121,7,993,438,434,872,114
2023-09-01,EK,Denmark,1814,809,119,12,1005,445,441,886,107
2023-09-02,EK,Denmark,1464,730,44,1,734,341,349,690,43
2023-09-03,EK,Denmark,1746,830,77,4,916,418,421,839,73
2023-09-04,EK,Denmark,1827,789,114,12,1038,466,458,924,102
2023-09-05,EK,Denmark,1755,796,117,13,959,422,420,842,104
2023-09-06,EK,Denmark,1745,789,119,4,956,416,421,837,115
2023-09-07,EK,Denmark,1787,768,126,14,1019,447,446,893,112
2023-09-08,EK,Denmark,1813,800,124,13,1013,452,437,889,111
2023-09-09,EK,Denmark,1458,706,51,1,752,346,355,701,50
2023-09-10,EK,Denmark,1688,778,70,3,910,419,421,840,67
2023-09-11,EK,Denmark,1805,790,119,9,1015,446,450,896,110
2023-09-12,EK,Denmark,1735,767,132,13,968,420,416,836,119
2023-09-13,EK,Denmark,1776,773,134,18,1003,435,434,869,116
2023-09-14,EK,Denmark,1821,809,112,7,1012,445,455,900,105
2023-09-15,EK,Denmark,1861,811,127,18,1050,463,460,923,109
2023-09-16,EK,Denmark,1459,716,41,0,743,349,353,702,41
2023-09-17,EK,Denmark,1705,800,75,4,905,414,416,830,71
2023-09-18,EK,Denmark,1866,829,116,7,1037,467,454,921,109
2023-09-19,EK,Denmark,1739,774,120,4,965,424,421,845,116
2023-09-20,EK,Denmark,1810,813,138,20,997,431,428,859,118
2023-09-21,EK,Denmark,1855,816,124,17,1039,453,462,915,107
2023-09-22,EK,Denmark,1858,824,139,20,1034,449,446,895,119
2023-09-23,EK,Denmark,1466,713,49,1,753,348,356,704,48
2023-09-24,EK,Denmark,1688,788,77,1,900,412,411,823,76
2023-09-25,EK,Denmark,1816,777,126,18,1039,461,452,913,108
2023-09-26,EK,Denmark,1724,731,137,22,993,420,436,856,115
2023-09-27,EK,Denmark,1739,762,133,11,977,422,422,844,122
2023-09-28,EK,Denmark,1806,790,113,8,1016,455,448,903,105
2023-09-29,EK,Denmark,1872,828,118,9,1044,464,462,926,109
2023-09-30,EK,Denmark,1544,780,52,3,764,351,361,712,49
2023-10-01,EK,Denmark,1672,758,73,2,914,418,423,841,71
2023-10-02,EK,Denmark,1790,766,147,17,1024,439,438,877,130
2023-01-01,EE,Estonia,301,229,4,0,72,32,36,68,4
2023-01-02,EE,Estonia,347,262,9,3,85,36,40,76,6
2023-01-03,EE,Estonia,312,233,9,1,79,36,34,70,8
2023-01-04,EE,Estonia,342,255,10,2,87,39,38,77,8
2023-01-05,EE,Estonia,321,244,8,0,77,34,35,69,8
2023-01-06,EE,Estonia,336,248,9,1,88,39,40,79,8
2023-01-07,EE,Estonia,365,280,7,1,85,40,38,78,6
2023-01-08,EE,Estonia,330,249,4,0,81,38,39,77,4
2023-01-09,EE,Estonia,316,235,8,0,81,37,36,73,8
2023-01-10,EE,Estonia,292,205,8,0,87,40,39,79,8
2023-01-11,EE,Estonia,320,230,12,4,90,38,40,78,8
2023-01-12,EE,Estonia,307,223,10,2,84,38,36,74,8
2023-01-13,EE,Estonia,324,229,10,4,95,42,43,85,6
2023-01-14,EE,Estonia,304,233,5,1,71,33,33,66,4
2023-01-15,EE,Estonia,315,231,5,1,84,38,41,79,4
2023-01-16,EE,Estonia,296,213,9,1,83,38,36,74,8
2023-01-17,EE,Estonia,266,181,11,3,85,38,36,74,8
2023-01-18,EE,Estonia,298,206,11,4,92,43,38,81,7
2023-01-19,EE,Estonia,284,207,8,2,77,35,34,69,6
2023-01-20,EE,Estonia,321,216,16,8,105,45,44,89,8
2023-01-21,EE,Estonia,277,215,7,3,62,27,28,55,4
2023-01-22,EE,Estonia,285,208,1,1,77,37,39,76,0
2023-01-23,EE,Estonia,300,217,6,0,83,40,37,77,6
2023-01-24,EE,Estonia,267,186,9,1,81,37,35,72,8
2023-01-25,EE,Estonia,295,210,6,1,85,38,41,79,5
2023-01-26,EE,Estonia,279,196,7,1,83,40,36,76,6
2023-01-27,EE,Estonia,318,203,14,3,115,48,53,101,11
2023-01-28,EE,Estonia,290,217,7,3,73,34,32,66,4
2023-01-29,EE,Estonia,301,219,5,1,82,38,39,77,4
2023-01-30,EE,Estonia,304,210,12,4,94,40,42,82,8
2023-01-31,EE,Estonia,265,182,11,3,83,38,34,72,8
2023-02-01,EE,Estonia,277,194,7,1,83,38,38,76,6
2023-02-02,EE,Estonia,267,185,11,3,82,35,36,71,8
2023-02-03,EE,Estonia,307,214,10,2,93,41,42,83,8
2023-02-04,EE,Estonia,280,208,6,2,72,32,34,66,4
2023-02-05,EE,Estonia,296,216,4,0,80,39,37,76,4
2023-02-06,EE,Estonia,294,204,11,3,90,41,38,79,8
2023-02-07,EE,Estonia,266,184,10,2,82,36,36,72,8
2023-02-08,EE,Estonia,316,223,10,2,93,41,42,83,8
2023-02-09,EE,Estonia,301,218,11,3,83,34,38,72,8
2023-02-10,EE,Estonia,322,218,10,2,104,48,46,94,8
2023-02-11,EE,Estonia,294,224,5,1,70,32,33,65,4
2023-02-12,EE,Estonia,318,233,5,1,85,39,41,80,4
2023-02-13,EE,Estonia,313,227,10,2,86,39,37,76,8
2023-02-14,EE,Estonia,271,184,14,6,87,36,37,73,8
2023-02-15,EE,Estonia,312,229,8,2,83,37,38,75,6
2023-02-16,EE,Estonia,294,210,9,1,84,36,39,75,8
2023-02-17,EE,Estonia,299,201,8,0,98,47,43,90,8
2023-02-18,EE,Estonia,299,226,4,2,73,34,35,69,2
2023-02-19,EE,Estonia,312,227,4,0,85,40,41,81,4
2023-02-20,EE,Estonia,305,219,9,2,86,39,38,77,7
2023-02-21,EE,Estonia,264,182,8,0,82,38,36,74,8
2023-02-22,EE,Estonia,342,237,13,5,105,46,46,92,8
2023-02-23,EE,Estonia,329,228,14,5,101,41,46,87,9
2023-02-24,EE,Estonia,330,228,7,1,102,48,47,95,6
2023-02-25,EE,Estonia,333,251,5,1,82,39,38,77,4
2023-02-26,EE,Estonia,329,241,4,0,88,42,42,84,4
2023-02-27,EE,Estonia,332,233,17,8,99,42,40,82,9
2023-02-28,EE,Estonia,294,206,13,5,88,37,38,75,8
2023-03-01,EE,Estonia,338,238,20,10,100,39,41,80,10
2023-03-02,EE,Estonia,330,222,20,10,108,44,44,88,10
2023-03-03,EE,Estonia,325,226,12,4,99,43,44,87,8
2023-03-04,EE,Estonia,314,234,2,0,80,37,41,78,2
2023-03-05,EE,Estonia,319,228,6,2,91,44,41,85,4
2023-03-06,EE,Estonia,317,225,10,2,92,40,42,82,8
2023-03-07,EE,Estonia,282,196,10,2,86,40,36,76,8
2023-03-08,EE,Estonia,306,212,8,0,94,41,45,86,8
2023-03-09,EE,Estonia,335,230,13,5,105,48,44,92,8
2023-03-10,EE,Estonia,331,232,14,6,99,43,42,85,8
2023-03-11,EE,Estonia,315,238,5,1,77,35,37,72,4
2023-03-12,EE,Estonia,323,227,8,4,96,44,44,88,4
2023-03-13,EE,Estonia,321,237,10,2,84,38,36,74,8
2023-03-14,EE,Estonia,293,206,9,1,87,39,39,78,8
2023-03-15,EE,Estonia,313,215,13,2,98,41,44,85,11
2023-03-16,EE,Estonia,326,227,14,6,99,43,42,85,8
2023-03-17,EE,Estonia,332,230,12,4,102,45,45,90,8
2023-03-18,EE,Estonia,323,240,11,7,83,34,38,72,4
2023-03-19,EE,Estonia,318,224,9,3,94,42,43,85,6
2023-03-20,EE,Estonia,320,223,11,5,97,45,41,86,6
2023-03-21,EE,Estonia,300,211,14,4,89,38,37,75,10
2023-03-22,EE,Estonia,340,240,9,3,100,43,48,91,6
2023-03-23,EE,Estonia,334,228,15,5,106,47,44,91,10
2023-03-24,EE,Estonia,344,240,15,7,104,44,45,89,8
2023-03-25,EE,Estonia,305,228,5,1,77,36,36,72,4
2023-03-26,EE,Estonia,326,246,8,4,80,36,36,72,4
2023-03-27,EE,Estonia,305,222,11,3,83,37,35,72,8
2023-03-28,EE,Estonia,342,235,13,5,107,47,47,94,8
2023-03-29,EE,Estonia,370,265,18,10,105,44,43,87,8
2023-03-30,EE,Estonia,354,245,13,4,109,48,48,96,9
2023-03-31,EE,Estonia,375,271,11,3,104,49,44,93,8
2023-04-01,EE,Estonia,348,271,7,3,77,34,36,70,4
2023-04-02,EE,Estonia,366,281,5,0,85,42,38,80,5
2023-04-03,EE,Estonia,355,263,13,5,92,41,38,79,8
2023-04-04,EE,Estonia,344,248,10,2,96,42,44,86,8
2023-04-05,EE,Estonia,351,264,10,2,87,39,38,77,8
2023-04-06,EE,Estonia,358,261,15,7,97,40,42,82,8
2023-04-07,EE,Estonia,368,285,12,2,83,34,37,71,10
2023-04-08,EE,Estonia,356,274,8,4,82,37,37,74,4
2023-04-09,EE,Estonia,363,284,7,3,79,36,36,72,4
2023-04-10,EE,Estonia,374,279,12,4,95,41,42,83,8
2023-04-11,EE,Estonia,351,255,13,5,96,43,40,83,8
2023-04-12,EE,Estonia,364,262,14,6,102,43,45,88,8
2023-04-13,EE,Estonia,365,268,14,5,97,41,42,83,9
2023-04-14,EE,Estonia,385,283,12,3,102,45,45,90,9
2023-04-15,EE,Estonia,362,284,7,3,78,35,36,71,4
2023-04-16,EE,Estonia,374,288,5,1,86,42,39,81,4
2023-04-17,EE,Estonia,372,280,11,3,92,39,42,81,8
2023-04-18,EE,Estonia,354,258,12,4,96,44,40,84,8
2023-04-19,EE,Estonia,371,270,14,6,101,41,46,87,8
2023-04-20,EE,Estonia,400,292,12,4,108,47,49,96,8
2023-04-21,EE,Estonia,443,322,15,7,121,52,54,106,8
2023-04-22,EE,Estonia,391,309,4,0,82,42,36,78,4
2023-04-23,EE,Estonia,404,317,6,2,87,39,42,81,4
2023-04-24,EE,Estonia,399,303,12,4,96,42,42,84,8
2023-04-25,EE,Estonia,375,267,15,6,108,45,48,93,9
2023-04-26,EE,Estonia,371,267,13,5,104,47,44,91,8
2023-04-27,EE,Estonia,403,301,16,8,102,44,42,86,8
2023-04-28,EE,Estonia,424,317,13,5,107,47,47,94,8
2023-04-29,EE,Estonia,408,323,8,4,85,37,40,77,4
2023-04-30,EE,Estonia,413,334,5,1,79,36,38,74,4
2023-05-01,EE,Estonia,438,338,13,5,100,45,42,87,8
2023-05-02,EE,Estonia,433,311,11,3,122,55,56,111,8
2023-05-03,EE,Estonia,410,302,15,4,108,46,47,93,11
2023-05-04,EE,Estonia,439,320,13,2,119,54,52,106,11
2023-05-05,EE,Estonia,428,320,10,2,108,49,49,98,8
2023-05-06,EE,Estonia,436,347,6,2,89,41,42,83,4
2023-05-07,EE,Estonia,451,355,6,2,96,46,44,90,4
2023-05-08,EE,Estonia,458,349,13,3,109,48,48,96,10
2023-05-09,EE,Estonia,460,336,14,5,124,55,55,110,9
2023-05-10,EE,Estonia,456,334,12,4,122,54,56,110,8
2023-05-11,EE,Estonia,470,345,11,3,125,52,62,114,8
2023-05-12,EE,Estonia,474,343,20,12,131,57,54,111,8
2023-05-13,EE,Estonia,452,356,8,4,96,44,44,88,4
2023-05-14,EE,Estonia,455,346,5,1,109,52,52,104,4
2023-05-15,EE,Estonia,455,329,13,5,126,61,52,113,8
2023-05-16,EE,Estonia,415,302,12,4,113,51,50,101,8
2023-05-17,EE,Estonia,454,334,18,8,120,51,51,102,10
2023-05-18,EE,Estonia,450,342,11,3,108,48,49,97,8
2023-05-19,EE,Estonia,470,348,14,4,122,51,57,108,10
2023-05-20,EE,Estonia,471,369,9,4,102,46,47,93,5
2023-05-21,EE,Estonia,466,373,8,1,93,44,41,85,7
2023-05-22,EE,Estonia,451,337,12,4,114,53,49,102,8
2023-05-23,EE,Estonia,428,323,12,4,105,45,48,93,8
2023-05-24,EE,Estonia,447,327,16,7,120,55,49,104,9
2023-05-25,EE,Estonia,477,362,11,3,115,52,52,104,8
2023-05-26,EE,Estonia,487,362,11,3,125,57,57,114,8
2023-05-27,EE,Estonia,468,375,7,2,93,43,43,86,5
2023-05-28,EE,Estonia,491,387,8,2,104,45,51,96,6
2023-05-29,EE,Estonia,450,349,9,0,101,49,43,92,9
2023-05-30,EE,Estonia,435,322,12,4,113,49,52,101,8
2023-05-31,EE,Estonia,452,344,11,5,108,50,47,97,6
2023-06-01,EE,Estonia,475,361,15,6,114,49,50,99,9
2023-06-02,EE,Estonia,469,351,14,6,118,52,52,104,8
2023-06-03,EE,Estonia,479,379,7,3,100,48,45,93,4
2023-06-04,EE,Estonia,462,363,8,4,99,45,46,91,4
2023-06-05,EE,Estonia,487,373,17,8,114,49,48,97,9
2023-06-06,EE,Estonia,435,324,14,6,111,48,49,97,8
2023-06-07,EE,Estonia,474,359,15,7,115,49,51,100,8
2023-06-08,EE,Estonia,489,374,13,4,115,52,50,102,9
2023-06-09,EE,Estonia,499,376,13,7,123,53,57,110,6
2023-06-10,EE,Estonia,461,371,2,0,90,45,43,88,2
2023-06-11,EE,Estonia,483,378,4,0,105,54,47,101,4
2023-06-12,EE,Estonia,482,364,14,6,118,46,58,104,8
2023-06-13,EE,Estonia,461,349,13,5,112,54,45,99,8
2023-06-14,EE,Estonia,478,366,12,4,112,50,50,100,8
2023-06-15,EE,Estonia,494,379,15,7,115,49,51,100,8
2023-06-16,EE,Estonia,501,384,9,0,117,55,53,108,9
2023-06-17,EE,Estonia,477,382,9,4,95,42,44,86,5
2023-06-18,EE,Estonia,479,379,6,2,100,46,48,94,4
2023-06-19,EE,Estonia,488,373,12,3,115,53,50,103,9
2023-06-20,EE,Estonia,435,330,11,3,105,47,47,94,8
2023-06-21,EE,Estonia,476,359,12,4,117,54,51,105,8
2023-06-22,EE,Estonia,447,351,11,3,96,42,43,85,8
2023-06-23,EE,Estonia,475,371,14,4,104,45,45,90,10
2023-06-24,EE,Estonia,454,368,5,1,86,39,42,81,4
2023-06-25,EE,Estonia,458,362,7,0,96,44,45,89,7
2023-06-26,EE,Estonia,468,358,11,2,110,50,49,99,9
2023-06-27,EE,Estonia,450,336,17,8,114,49,48,97,9
2023-06-28,EE,Estonia,478,357,16,7,121,51,54,105,9
2023-06-29,EE,Estonia,485,371,15,5,114,50,49,99,10
2023-06-30,EE,Estonia,478,366,11,2,112,50,51,101,9
2023-07-01,EE,Estonia,479,382,6,2,97,48,43,91,4
2023-07-02,EE,Estonia,469,378,5,1,91,43,43,86,4
2023-07-03,EE,Estonia,474,378,11,3,96,44,41,85,8
2023-07-04,EE,Estonia,442,344,11,1,98,42,45,87,10
2023-07-05,EE,Estonia,462,354,9,1,108,50,49,99,8
2023-07-06,EE,Estonia,475,368,15,4,107,46,46,92,11
2023-07-07,EE,Estonia,486,375,14,3,111,49,48,97,11
2023-07-08,EE,Estonia,472,382,7,2,90,40,43,83,5
2023-07-09,EE,Estonia,470,376,4,0,94,45,45,90,4
2023-07-10,EE,Estonia,484,379,12,4,105,47,46,93,8
2023-07-11,EE,Estonia,429,340,9,1,89,41,39,80,8
2023-07-12,EE,Estonia,484,373,12,3,111,49,50,99,9
2023-07-13,EE,Estonia,466,370,10,2,96,42,44,86,8
2023-07-14,EE,Estonia,492,383,12,3,109,49,48,97,9
2023-07-15,EE,Estonia,470,388,6,2,82,39,37,76,4
2023-07-16,EE,Estonia,483,388,5,1,95,45,45,90,4
2023-07-17,EE,Estonia,489,380,15,7,109,47,47,94,8
2023-07-18,EE,Estonia,447,347,12,4,100,44,44,88,8
2023-07-19,EE,Estonia,478,367,13,5,111,48,50,98,8
2023-07-20,EE,Estonia,489,381,17,9,108,45,46,91,8
2023-07-21,EE,Estonia,510,389,16,6,121,52,53,105,10
2023-07-22,EE,Estonia,471,380,8,4,91,42,41,83,4
2023-07-23,EE,Estonia,502,396,8,2,106,50,48,98,6
2023-07-24,EE,Estonia,485,384,9,1,101,45,47,92,8
2023-07-25,EE,Estonia,463,363,12,2,100,44,44,88,10
2023-07-26,EE,Estonia,483,377,14,6,106,47,45,92,8
2023-07-27,EE,Estonia,483,371,16,6,112,47,49,96,10
2023-07-28,EE,Estonia,496,386,15,7,110,44,51,95,8
2023-07-29,EE,Estonia,483,386,11,7,97,44,42,86,4
2023-07-30,EE,Estonia,510,408,7,1,102,48,47,95,6
2023-07-31,EE,Estonia,502,390,19,9,112,50,43,93,10
2023-08-01,EE,Estonia,479,381,15,7,98,41,42,83,8
2023-08-02,EE,Estonia,486,372,16,6,114,48,50,98,10
2023-08-03,EE,Estonia,498,392,15,5,106,46,45,91,10
2023-08-04,EE,Estonia,511,392,16,4,119,48,55,103,12
2023-08-05,EE,Estonia,477,383,6,2,94,44,44,88,4
2023-08-06,EE,Estonia,516,417,7,1,99,45,47,92,6
2023-08-07,EE,Estonia,502,393,15,6,109,50,44,94,9
2023-08-08,EE,Estonia,477,378,10,1,99,44,45,89,9
2023-08-09,EE,Estonia,489,374,13,5,115,52,50,102,8
2023-08-10,EE,Estonia,484,374,18,8,110,45,47,92,10
2023-08-11,EE,Estonia,512,392,20,5,120,49,51,100,15
2023-08-12,EE,Estonia,503,415,6,0,88,41,41,82,6
2023-08-13,EE,Estonia,502,406,8,0,96,47,41,88,8
2023-08-14,EE,Estonia,486,374,13,4,112,49,50,99,9
2023-08-15,EE,Estonia,506,388,20,11,118,48,50,98,9
2023-08-16,EE,Estonia,511,393,16,8,118,51,51,102,8
2023-08-17,EE,Estonia,504,388,20,8,116,46,50,96,12
2023-08-18,EE,Estonia,533,410,17,6,123,52,54,106,11
2023-08-19,EE,Estonia,496,394,6,0,102,50,46,96,6
2023-08-20,EE,Estonia,501,401,4,0,100,48,48,96,4
2023-08-21,EE,Estonia,516,398,17,7,118,51,50,101,10
2023-08-22,EE,Estonia,472,369,14,6,103,44,45,89,8
2023-08-23,EE,Estonia,500,387,16,7,113,49,48,97,9
2023-08-24,EE,Estonia,513,403,18,6,110,47,45,92,12
2023-08-25,EE,Estonia,509,390,13,4,119,53,53,106,9
2023-08-26,EE,Estonia,487,398,5,0,89,42,42,84,5
2023-08-27,EE,Estonia,518,411,14,2,107,47,46,93,12
2023-08-28,EE,Estonia,484,381,10,2,103,45,48,93,8
2023-08-29,EE,Estonia,510,399,17,9,111,48,46,94,8
2023-08-30,EE,Estonia,499,383,15,7,116,50,51,101,8
2023-08-31,EE,Estonia,500,399,10,2,101,45,46,91,8
2023-09-01,EE,Estonia,516,400,17,7,116,50,49,99,10
2023-09-02,EE,Estonia,501,405,5,0,96,47,44,91,5
2023-09-03,EE,Estonia,493,396,5,0,97,46,46,92,5
2023-09-04,EE,Estonia,491,389,13,5,102,43,46,89,8
2023-09-05,EE,Estonia,485,364,16,8,121,52,53,105,8
2023-09-06,EE,Estonia,490,372,12,4,118,55,51,106,8
2023-09-07,EE,Estonia,496,389,12,4,107,46,49,95,8
2023-09-08,EE,Estonia,518,397,14,6,121,54,53,107,8
2023-09-09,EE,Estonia,479,389,7,3,90,41,42,83,4
2023-09-10,EE,Estonia,493,397,6,2,96,44,46,90,4
2023-09-11,EE,Estonia,489,384,9,4,105,49,47,96,5
2023-09-12,EE,Estonia,485,373,20,9,112,47,45,92,11
2023-09-13,EE,Estonia,488,368,18,10,120,49,53,102,8
2023-09-14,EE,Estonia,483,372,15,7,111,47,49,96,8
2023-09-15,EE,Estonia,512,383,17,6,129,57,55,112,11
2023-09-16,EE,Estonia,455,361,9,3,94,42,43,85,6
2023-09-17,EE,Estonia,492,389,9,4,103,48,46,94,5
2023-09-18,EE,Estonia,484,383,13,2,101,43,45,88,11
2023-09-19,EE,Estonia,441,335,19,7,106,44,43,87,12
2023-09-20,EE,Estonia,483,362,10,2,121,55,56,111,8
2023-09-21,EE,Estonia,482,373,13,5,109,51,45,96,8
2023-09-22,EE,Estonia,510,388,15,5,122,53,54,107,10
2023-09-23,EE,Estonia,471,379,5,1,92,43,44,87,4
2023-09-24,EE,Estonia,466,371,4,0,95,47,44,91,4
2023-09-25,EE,Estonia,478,380,10,4,98,43,45,88,6
2023-09-26,EE,Estonia,436,328,14,4,108,46,48,94,10
2023-09-27,EE,Estonia,489,372,12,2,117,54,51,105,10
2023-09-28,EE,Estonia,488,372,16,10,116,52,48,100,6
2023-09-29,EE,Estonia,504,389,14,4,115,50,51,101,10
2023-09-30,EE,Estonia,460,363,8,1,97,43,46,89,7
2023-10-01,EE,Estonia,453,354,5,1,99,48,46,94,4
2023-10-02,EE,Estonia,457,357,11,3,100,45,44,89,8
2023-01-01,EF,Finland,550,130,83,1,420,167,170,337,82
2023-01-02,EF,Finland,629,155,95,0,474,193,186,379,95
2023-01-03,EF,Finland,561,140,79,0,421,171,171,342,79
2023-01-04,EF,Finland,594,148,91,1,446,176,179,355,90
2023-01-05,EF,Finland,588,151,103,0,437,169,165,334,103
2023-01-06,EF,Finland,576,159,80,0,417,166,171,337,80
2023-01-07,EF,Finland,532,126,69,1,406,168,169,337,68
2023-01-08,EF,Finland,605,157,85,1,448,180,183,363,84
2023-01-09,EF,Finland,612,159,107,1,453,175,171,346,106
2023-01-10,EF,Finland,522,102,103,0,420,156,161,317,103
2023-01-11,EF,Finland,567,121,109,0,446,166,171,337,109
2023-01-12,EF,Finland,575,130,113,0,445,167,165,332,113
2023-01-13,EF,Finland,589,131,115,1,458,170,173,343,114
2023-01-14,EF,Finland,475,92,67,0,383,156,160,316,67
2023-01-15,EF,Finland,580,140,86,1,440,180,174,354,85
2023-01-16,EF,Finland,610,138,121,0,472,177,174,351,121
2023-01-17,EF,Finland,520,91,110,0,429,161,158,319,110
2023-01-18,EF,Finland,574,127,111,0,447,167,169,336,111
2023-01-19,EF,Finland,576,133,119,0,443,162,162,324,119
2023-01-20,EF,Finland,599,133,115,0,466,175,176,351,115
2023-01-21,EF,Finland,474,82,66,0,392,164,162,326,66
2023-01-22,EF,Finland,550,120,84,0,430,173,173,346,84
2023-01-23,EF,Finland,577,123,115,1,454,170,169,339,114
2023-01-24,EF,Finland,539,107,118,1,432,161,153,314,117
2023-01-25,EF,Finland,556,111,102,1,445,169,174,343,101
2023-01-26,EF,Finland,563,114,116,0,449,165,168,333,116
2023-01-27,EF,Finland,597,138,118,0,459,168,173,341,118
2023-01-28,EF,Finland,469,74,68,0,395,163,164,327,68
2023-01-29,EF,Finland,563,121,83,0,442,180,179,359,83
2023-01-30,EF,Finland,600,132,123,0,468,176,169,345,123
2023-01-31,EF,Finland,536,112,111,0,424,159,154,313,111
2023-02-01,EF,Finland,577,134,105,0,443,167,171,338,105
2023-02-02,EF,Finland,551,116,117,0,435,160,158,318,117
2023-02-03,EF,Finland,590,143,113,1,447,167,167,334,112
2023-02-04,EF,Finland,501,97,77,0,404,164,163,327,77
2023-02-05,EF,Finland,569,127,90,0,442,174,178,352,90
2023-02-06,EF,Finland,602,137,120,0,465,172,173,345,120
2023-02-07,EF,Finland,550,120,116,1,430,159,155,314,115
2023-02-08,EF,Finland,549,120,96,0,429,164,169,333,96
2023-02-09,EF,Finland,556,125,112,0,431,161,158,319,112
2023-02-10,EF,Finland,602,128,116,1,474,178,180,358,115
2023-02-11,EF,Finland,494,85,81,0,409,162,166,328,81
2023-02-12,EF,Finland,566,129,87,0,437,176,174,350,87
2023-02-13,EF,Finland,584,119,117,0,465,177,171,348,117
2023-02-14,EF,Finland,544,111,116,0,433,159,158,317,116
2023-02-15,EF,Finland,617,144,116,0,473,175,182,357,116
2023-02-16,EF,Finland,599,138,127,0,461,169,165,334,127
2023-02-17,EF,Finland,585,136,118,0,449,167,164,331,118
2023-02-18,EF,Finland,521,86,87,0,435,172,176,348,87
2023-02-19,EF,Finland,613,151,87,0,462,186,189,375,87
2023-02-20,EF,Finland,605,141,117,1,464,173,174,347,116
2023-02-21,EF,Finland,542,111,110,0,431,163,158,321,110
2023-02-22,EF,Finland,607,144,108,2,463,177,178,355,106
2023-02-23,EF,Finland,573,131,107,0,442,167,168,335,107
2023-02-24,EF,Finland,602,137,121,0,465,172,172,344,121
2023-02-25,EF,Finland,536,87,86,0,449,182,181,363,86
2023-02-26,EF,Finland,605,146,97,0,459,182,180,362,97
2023-02-27,EF,Finland,592,130,106,1,462,180,176,356,105
2023-02-28,EF,Finland,539,118,105,0,421,160,156,316,105
2023-03-01,EF,Finland,582,134,102,0,448,170,176,346,102
2023-03-02,EF,Finland,582,137,112,0,445,169,164,333,112
2023-03-03,EF,Finland,610,137,135,0,473,168,170,338,135
2023-03-04,EF,Finland,501,87,81,0,414,167,166,333,81
2023-03-05,EF,Finland,579,140,87,0,439,172,180,352,87
2023-03-06,EF,Finland,619,135,118,0,484,181,185,366,118
2023-03-07,EF,Finland,552,119,112,0,433,161,160,321,112
2023-03-08,EF,Finland,594,136,108,0,458,177,173,350,108
2023-03-09,EF,Finland,610,135,126,0,475,176,173,349,126
2023-03-10,EF,Finland,629,142,135,0,487,173,179,352,135
2023-03-11,EF,Finland,507,93,84,0,414,163,167,330,84
2023-03-12,EF,Finland,585,142,88,0,443,176,179,355,88
2023-03-13,EF,Finland,597,137,122,0,460,171,167,338,122
2023-03-14,EF,Finland,574,114,120,1,460,174,166,340,119
2023-03-15,EF,Finland,596,129,114,0,467,175,178,353,114
2023-03-16,EF,Finland,594,135,126,2,459,168,165,333,124
2023-03-17,EF,Finland,625,140,130,0,485,175,180,355,130
2023-03-18,EF,Finland,481,91,85,2,390,157,148,305,83
2023-03-19,EF,Finland,563,135,92,0,428,166,170,336,92
2023-03-20,EF,Finland,600,132,125,0,468,171,172,343,125
2023-03-21,EF,Finland,566,106,135,0,460,164,161,325,135
2023-03-22,EF,Finland,598,126,122,0,472,173,177,350,122
2023-03-23,EF,Finland,584,124,120,0,460,172,168,340,120
2023-03-24,EF,Finland,623,140,132,0,483,173,178,351,132
2023-03-25,EF,Finland,434,82,76,0,352,138,138,276,76
2023-03-26,EF,Finland,545,150,70,1,395,161,164,325,69
2023-03-27,EF,Finland,579,142,105,0,437,166,166,332,105
2023-03-28,EF,Finland,589,124,105,2,465,183,177,360,103
2023-03-29,EF,Finland,621,148,108,0,473,181,184,365,108
2023-03-30,EF,Finland,622,147,121,1,475,180,174,354,120
2023-03-31,EF,Finland,624,158,111,1,466,177,178,355,110
2023-04-01,EF,Finland,472,114,64,1,358,149,145,294,63
2023-04-02,EF,Finland,558,160,69,0,398,161,168,329,69
2023-04-03,EF,Finland,598,124,117,0,474,178,179,357,117
2023-04-04,EF,Finland,566,119,100,1,447,172,175,347,99
2023-04-05,EF,Finland,626,145,111,0,481,186,184,370,111
2023-04-06,EF,Finland,579,118,121,0,461,175,165,340,121
2023-04-07,EF,Finland,488,123,56,0,365,157,152,309,56
2023-04-08,EF,Finland,421,90,49,1,331,142,140,282,48
2023-04-09,EF,Finland,507,142,52,0,365,154,159,313,52
2023-04-10,EF,Finland,520,125,61,0,395,167,167,334,61
2023-04-11,EF,Finland,587,134,108,0,453,172,173,345,108
2023-04-12,EF,Finland,602,143,96,1,459,179,184,363,95
2023-04-13,EF,Finland,606,142,112,2,464,178,174,352,110
2023-04-14,EF,Finland,609,161,106,0,448,170,172,342,106
2023-04-15,EF,Finland,465,101,55,1,364,155,154,309,54
2023-04-16,EF,Finland,564,155,69,1,409,166,174,340,68
2023-04-17,EF,Finland,608,156,98,0,452,181,173,354,98
2023-04-18,EF,Finland,603,134,111,0,469,181,177,358,111
2023-04-19,EF,Finland,601,147,97,0,454,175,182,357,97
2023-04-20,EF,Finland,629,149,107,0,480,187,186,373,107
2023-04-21,EF,Finland,646,163,111,0,483,188,184,372,111
2023-04-22,EF,Finland,461,124,44,2,337,146,147,293,42
2023-04-23,EF,Finland,556,147,62,0,409,171,176,347,62
2023-04-24,EF,Finland,614,146,102,1,468,185,181,366,101
2023-04-25,EF,Finland,570,137,94,0,433,169,170,339,94
2023-04-26,EF,Finland,625,168,117,3,457,172,168,340,114
2023-04-27,EF,Finland,642,172,107,0,470,181,182,363,107
2023-04-28,EF,Finland,651,186,105,1,465,181,179,360,104
2023-04-29,EF,Finland,505,151,49,0,354,152,153,305,49
2023-04-30,EF,Finland,556,176,48,0,380,166,166,332,48
2023-05-01,EF,Finland,572,176,58,0,396,165,173,338,58
2023-05-02,EF,Finland,660,171,103,0,489,196,190,386,103
2023-05-03,EF,Finland,653,166,104,0,487,190,193,383,104
2023-05-04,EF,Finland,677,176,108,1,501,197,196,393,107
2023-05-05,EF,Finland,659,180,113,1,479,185,181,366,112
2023-05-06,EF,Finland,517,144,49,0,373,162,162,324,49
2023-05-07,EF,Finland,597,175,57,0,422,176,189,365,57
2023-05-08,EF,Finland,661,180,76,1,481,203,202,405,75
2023-05-09,EF,Finland,647,166,100,0,481,189,192,381,100
2023-05-10,EF,Finland,653,183,87,1,470,194,189,383,86
2023-05-11,EF,Finland,671,175,104,3,496,196,196,392,101
2023-05-12,EF,Finland,662,176,100,1,486,192,194,386,99
2023-05-13,EF,Finland,513,136,50,0,377,167,160,327,50
2023-05-14,EF,Finland,606,194,52,0,412,175,185,360,52
2023-05-15,EF,Finland,677,179,104,1,498,197,197,394,103
2023-05-16,EF,Finland,623,150,89,2,473,191,193,384,87
2023-05-17,EF,Finland,633,152,101,2,481,190,190,380,99
2023-05-18,EF,Finland,587,158,53,0,429,190,186,376,53
2023-05-19,EF,Finland,599,159,76,0,440,185,179,364,76
2023-05-20,EF,Finland,517,145,46,2,372,164,162,326,44
2023-05-21,EF,Finland,610,187,62,2,423,174,187,361,60
2023-05-22,EF,Finland,664,175,93,2,489,198,198,396,91
2023-05-23,EF,Finland,631,162,86,1,469,194,189,383,85
2023-05-24,EF,Finland,666,170,80,0,496,195,221,416,80
2023-05-25,EF,Finland,672,171,95,1,501,206,200,406,94
2023-05-26,EF,Finland,699,182,100,0,517,211,206,417,100
2023-05-27,EF,Finland,573,149,55,1,424,184,185,369,54
2023-05-28,EF,Finland,643,195,56,0,448,188,204,392,56
2023-05-29,EF,Finland,665,176,92,0,489,206,191,397,92
2023-05-30,EF,Finland,634,160,90,0,474,191,193,384,90
2023-05-31,EF,Finland,655,166,93,0,489,196,200,396,93
2023-06-01,EF,Finland,681,191,98,0,490,194,198,392,98
2023-06-02,EF,Finland,677,185,104,0,492,196,192,388,104
2023-06-03,EF,Finland,548,162,51,0,386,169,166,335,51
2023-06-04,EF,Finland,612,177,60,0,435,182,193,375,60
2023-06-05,EF,Finland,685,179,95,2,506,207,204,411,93
2023-06-06,EF,Finland,628,154,93,2,474,191,190,381,91
2023-06-07,EF,Finland,710,188,99,3,522,211,212,423,96
2023-06-08,EF,Finland,697,197,88,1,500,209,203,412,87
2023-06-09,EF,Finland,701,189,104,0,512,208,200,408,104
2023-06-10,EF,Finland,568,177,48,0,391,172,171,343,48
2023-06-11,EF,Finland,626,192,56,1,434,186,192,378,55
2023-06-12,EF,Finland,698,209,94,1,489,204,191,395,93
2023-06-13,EF,Finland,661,173,101,3,488,193,194,387,98
2023-06-14,EF,Finland,693,180,109,3,513,199,205,404,106
2023-06-15,EF,Finland,713,197,103,1,516,207,206,413,102
2023-06-16,EF,Finland,701,182,101,2,519,207,211,418,99
2023-06-17,EF,Finland,578,172,56,1,406,177,173,350,55
2023-06-18,EF,Finland,629,189,57,1,440,186,197,383,56
2023-06-19,EF,Finland,692,186,84,2,506,214,208,422,82
2023-06-20,EF,Finland,652,174,90,2,478,197,191,388,88
2023-06-21,EF,Finland,699,194,98,3,505,203,204,407,95
2023-06-22,EF,Finland,679,194,82,0,485,205,198,403,82
2023-06-23,EF,Finland,560,158,44,1,402,179,179,358,43
2023-06-24,EF,Finland,530,179,29,0,351,164,158,322,29
2023-06-25,EF,Finland,593,191,44,0,402,175,183,358,44
2023-06-26,EF,Finland,663,182,79,1,481,206,196,402,78
2023-06-27,EF,Finland,644,178,80,1,466,192,194,386,79
2023-06-28,EF,Finland,660,204,78,0,456,188,190,378,78
2023-06-29,EF,Finland,704,211,84,0,493,203,206,409,84
2023-06-30,EF,Finland,658,191,85,1,467,194,188,382,84
2023-07-01,EF,Finland,575,188,40,0,387,177,170,347,40
2023-07-02,EF,Finland,588,182,58,0,406,171,177,348,58
2023-07-03,EF,Finland,650,185,85,0,465,193,187,380,85
2023-07-04,EF,Finland,605,185,78,2,420,172,170,342,76
2023-07-05,EF,Finland,618,183,73,1,435,178,184,362,72
2023-07-06,EF,Finland,645,183,85,1,462,191,186,377,84
2023-07-07,EF,Finland,659,195,80,1,464,190,194,384,79
2023-07-08,EF,Finland,566,172,43,2,394,177,174,351,41
2023-07-09,EF,Finland,624,201,54,2,423,180,189,369,52
2023-07-10,EF,Finland,659,193,86,5,466,191,189,380,81
2023-07-11,EF,Finland,602,184,78,3,418,170,170,340,75
2023-07-12,EF,Finland,658,197,69,3,461,193,199,392,66
2023-07-13,EF,Finland,662,187,81,3,475,201,193,394,78
2023-07-14,EF,Finland,648,185,82,2,463,190,191,381,80
2023-07-15,EF,Finland,576,185,41,0,391,174,176,350,41
2023-07-16,EF,Finland,601,187,54,2,414,177,183,360,52
2023-07-17,EF,Finland,648,196,71,0,452,193,188,381,71
2023-07-18,EF,Finland,600,188,70,0,412,172,170,342,70
2023-07-19,EF,Finland,619,193,65,0,426,181,180,361,65
2023-07-20,EF,Finland,646,193,71,0,453,189,193,382,71
2023-07-21,EF,Finland,644,193,77,1,451,189,185,374,76
2023-07-22,EF,Finland,560,184,43,1,376,165,168,333,42
2023-07-23,EF,Finland,620,212,47,1,408,180,181,361,46
2023-07-24,EF,Finland,655,198,80,1,457,191,186,377,79
2023-07-25,EF,Finland,609,193,72,2,416,171,173,344,70
2023-07-26,EF,Finland,634,202,69,0,432,182,181,363,69
2023-07-27,EF,Finland,643,197,83,2,446,179,184,363,81
2023-07-28,EF,Finland,652,209,72,1,443,184,187,371,71
2023-07-29,EF,Finland,570,184,47,0,386,173,166,339,47
2023-07-30,EF,Finland,640,211,58,1,429,184,187,371,57
2023-07-31,EF,Finland,649,194,81,0,455,189,185,374,81
2023-08-01,EF,Finland,616,205,78,0,411,168,165,333,78
2023-08-02,EF,Finland,656,210,89,0,446,174,183,357,89
2023-08-03,EF,Finland,668,207,85,1,461,185,191,376,84
2023-08-04,EF,Finland,647,203,79,3,444,187,178,365,76
2023-08-05,EF,Finland,579,180,55,2,399,170,174,344,53
2023-08-06,EF,Finland,638,212,57,1,426,181,188,369,56
2023-08-07,EF,Finland,658,201,90,5,457,184,183,367,85
2023-08-08,EF,Finland,609,189,83,4,420,172,165,337,79
2023-08-09,EF,Finland,651,214,86,2,437,173,178,351,84
2023-08-10,EF,Finland,666,199,106,5,467,181,180,361,101
2023-08-11,EF,Finland,663,199,98,3,464,187,179,366,95
2023-08-12,EF,Finland,570,185,50,1,385,168,167,335,49
2023-08-13,EF,Finland,641,219,57,2,422,177,188,365,55
2023-08-14,EF,Finland,657,196,85,0,461,190,186,376,85
2023-08-15,EF,Finland,646,198,88,3,448,182,178,360,85
2023-08-16,EF,Finland,659,203,92,2,456,180,184,364,90
2023-08-17,EF,Finland,683,206,104,1,477,186,187,373,103
2023-08-18,EF,Finland,680,202,92,6,478,193,193,386,86
2023-08-19,EF,Finland,574,196,48,2,378,167,163,330,46
2023-08-20,EF,Finland,645,229,53,3,416,178,185,363,50
2023-08-21,EF,Finland,701,206,83,0,495,206,206,412,83
2023-08-22,EF,Finland,666,218,79,1,448,182,187,369,78
2023-08-23,EF,Finland,700,224,90,0,476,191,195,386,90
2023-08-24,EF,Finland,711,208,102,2,503,201,200,401,100
2023-08-25,EF,Finland,711,226,93,3,485,198,194,392,90
2023-08-26,EF,Finland,579,199,52,4,380,166,162,328,48
2023-08-27,EF,Finland,698,237,65,6,461,188,208,396,59
2023-08-28,EF,Finland,692,209,98,0,483,196,189,385,98
2023-08-29,EF,Finland,695,217,97,0,478,193,188,381,97
2023-08-30,EF,Finland,700,233,90,2,467,188,189,377,88
2023-08-31,EF,Finland,696,212,92,1,484,197,195,392,91
2023-09-01,EF,Finland,726,221,100,0,505,202,203,405,100
2023-09-02,EF,Finland,594,211,54,0,383,167,162,329,54
2023-09-03,EF,Finland,672,235,60,0,437,182,195,377,60
2023-09-04,EF,Finland,711,209,99,1,502,203,200,403,98
2023-09-05,EF,Finland,661,189,95,0,472,192,185,377,95
2023-09-06,EF,Finland,701,210,97,8,491,196,198,394,89
2023-09-07,EF,Finland,719,213,108,4,506,200,198,398,104
2023-09-08,EF,Finland,727,217,102,2,510,205,203,408,100
2023-09-09,EF,Finland,563,177,52,3,386,167,167,334,49
2023-09-10,EF,Finland,665,223,60,0,442,187,195,382,60
2023-09-11,EF,Finland,696,190,103,3,506,206,197,403,100
2023-09-12,EF,Finland,656,193,86,0,463,187,190,377,86
2023-09-13,EF,Finland,705,203,107,2,502,199,196,395,105
2023-09-14,EF,Finland,716,206,107,0,510,200,203,403,107
2023-09-15,EF,Finland,693,193,99,0,500,205,196,401,99
2023-09-16,EF,Finland,569,188,46,0,381,165,170,335,46
2023-09-17,EF,Finland,636,197,61,0,439,187,191,378,61
2023-09-18,EF,Finland,684,191,102,2,493,195,196,391,100
2023-09-19,EF,Finland,610,179,88,0,431,169,174,343,88
2023-09-20,EF,Finland,679,196,105,1,483,188,190,378,104
2023-09-21,EF,Finland,720,204,121,1,516,203,192,395,120
2023-09-22,EF,Finland,700,208,97,0,492,195,200,395,97
2023-09-23,EF,Finland,562,180,47,0,382,169,166,335,47
2023-09-24,EF,Finland,630,194,65,1,436,182,189,371,64
2023-09-25,EF,Finland,699,202,105,2,497,197,195,392,103
2023-09-26,EF,Finland,654,159,115,0,495,194,186,380,115
2023-09-27,EF,Finland,645,196,79,1,449,184,186,370,78
2023-09-28,EF,Finland,686,205,87,0,481,196,198,394,87
2023-09-29,EF,Finland,664,193,83,2,471,195,193,388,81
2023-09-30,EF,Finland,537,154,51,0,383,169,163,332,51
2023-10-01,EF,Finland,615,198,55,0,417,179,183,362,55
2023-10-02,EF,Finland,653,184,95,0,469,188,186,374,95
2023-01-01,LF,France,6746,3692,531,0,3054,1258,1265,2523,531
2023-01-02,LF,France,7798,4080,838,10,3718,1435,1445,2880,828
2023-01-03,LF,France,7219,3716,865,22,3503,1328,1310,2638,843
2023-01-04,LF,France,6872,3565,841,31,3307,1230,1236,2466,810
2023-01-05,LF,France,7312,3821,960,66,3491,1270,1261,2531,894
2023-01-06,LF,France,7624,4011,962,40,3613,1316,1335,2651,922
2023-01-07,LF,France,7275,4244,434,11,3031,1304,1293,2597,423
2023-01-08,LF,France,7380,4224,511,7,3156,1330,1315,2645,504
2023-01-09,LF,France,6884,3622,782,30,3262,1225,1255,2480,752
2023-01-10,LF,France,6101,2992,949,33,3109,1066,1094,2160,916
2023-01-11,LF,France,5843,2883,919,38,2960,1023,1018,2041,881
2023-01-12,LF,France,6420,3234,953,41,3186,1124,1109,2233,912
2023-01-13,LF,France,6953,3526,918,25,3427,1243,1266,2509,893
2023-01-14,LF,France,6451,3716,433,17,2735,1160,1142,2302,416
2023-01-15,LF,France,6837,3852,553,4,2985,1228,1204,2432,549
2023-01-16,LF,France,6491,3433,730,22,3058,1149,1179,2328,708
2023-01-17,LF,France,5495,2762,736,42,2733,989,1008,1997,694
2023-01-18,LF,France,5753,2778,902,45,2975,1031,1042,2073,857
2023-01-19,LF,France,5660,2951,673,35,2709,1005,1031,2036,638
2023-01-20,LF,France,7260,3661,971,29,3599,1313,1315,2628,942
2023-01-21,LF,France,6470,3696,445,23,2774,1166,1163,2329,422
2023-01-22,LF,France,6832,3801,584,13,3031,1247,1200,2447,571
2023-01-23,LF,France,6584,3319,896,33,3265,1171,1198,2369,863
2023-01-24,LF,France,5812,2763,957,29,3049,1036,1056,2092,928
2023-01-25,LF,France,5838,2808,938,29,3030,1045,1047,2092,909
2023-01-26,LF,France,6277,3187,895,32,3090,1114,1081,2195,863
2023-01-27,LF,France,6996,3546,939,21,3450,1249,1262,2511,918
2023-01-28,LF,France,6448,3690,466,13,2758,1162,1130,2292,453
2023-01-29,LF,France,6964,3937,599,11,3027,1232,1196,2428,588
2023-01-30,LF,France,6668,3407,915,29,3261,1160,1186,2346,886
2023-01-31,LF,France,5292,2687,651,19,2605,969,985,1954,632
2023-02-01,LF,France,6028,2866,998,46,3162,1080,1084,2164,952
2023-02-02,LF,France,6606,3279,1034,48,3327,1150,1143,2293,986
2023-02-03,LF,France,7473,3743,1074,45,3730,1311,1345,2656,1029
2023-02-04,LF,France,6692,3849,441,16,2843,1217,1185,2402,425
2023-02-05,LF,France,7139,3958,601,7,3181,1290,1290,2580,594
2023-02-06,LF,France,6917,3512,947,20,3405,1227,1231,2458,927
2023-02-07,LF,France,5627,2811,740,9,2816,1035,1041,2076,731
2023-02-08,LF,France,6292,3080,981,42,3212,1107,1124,2231,939
2023-02-09,LF,France,7030,3491,1050,45,3539,1241,1248,2489,1005
2023-02-10,LF,France,8068,4118,1029,32,3950,1467,1454,2921,997
2023-02-11,LF,France,7197,4230,434,18,2967,1267,1266,2533,416
2023-02-12,LF,France,7699,4230,663,8,3469,1407,1399,2806,655
2023-02-13,LF,France,7317,3745,937,24,3572,1296,1339,2635,913
2023-02-14,LF,France,6523,3192,947,51,3331,1191,1193,2384,896
2023-02-15,LF,France,6739,3267,963,34,3472,1273,1236,2509,929
2023-02-16,LF,France,6453,3244,750,47,3209,1222,1237,2459,703
2023-02-17,LF,France,7767,3898,1056,29,3869,1383,1430,2813,1027
2023-02-18,LF,France,7768,4447,529,4,3321,1404,1388,2792,525
2023-02-19,LF,France,7931,4451,654,9,3480,1444,1382,2826,645
2023-02-20,LF,France,7665,3967,988,25,3698,1345,1365,2710,963
2023-02-21,LF,France,6599,3278,894,62,3321,1204,1223,2427,832
2023-02-22,LF,France,6750,3342,925,49,3408,1237,1246,2483,876
2023-02-23,LF,France,7300,3676,999,26,3624,1312,1313,2625,973
2023-02-24,LF,France,8027,4123,1026,34,3904,1425,1453,2878,992
2023-02-25,LF,France,7550,4276,547,21,3274,1369,1358,2727,526
2023-02-26,LF,France,7814,4362,662,12,3452,1411,1379,2790,650
2023-02-27,LF,France,7616,3894,1008,36,3722,1349,1365,2714,972
2023-02-28,LF,France,6786,3391,934,53,3395,1224,1237,2461,881
2023-03-01,LF,France,6976,3479,967,42,3497,1265,1265,2530,925
2023-03-02,LF,France,7445,3756,1023,30,3689,1325,1341,2666,993
2023-03-03,LF,France,8188,4282,992,26,3906,1452,1462,2914,966
2023-03-04,LF,France,7513,4282,495,12,3231,1360,1376,2736,483
2023-03-05,LF,France,7800,4341,630,12,3459,1426,1403,2829,618
2023-03-06,LF,France,7614,3861,1020,31,3753,1369,1364,2733,989
2023-03-07,LF,France,5628,3049,563,42,2579,1007,1009,2016,521
2023-03-08,LF,France,5855,3099,662,25,2756,1041,1053,2094,637
2023-03-09,LF,France,6649,3533,771,27,3116,1166,1179,2345,744
2023-03-10,LF,France,6913,3827,663,24,3086,1202,1221,2423,639
2023-03-11,LF,France,6816,3903,408,13,2913,1254,1251,2505,395
2023-03-12,LF,France,7358,4096,591,14,3262,1341,1330,2671,577
2023-03-13,LF,France,7573,3821,987,51,3752,1364,1401,2765,936
2023-03-14,LF,France,6856,3421,901,28,3435,1263,1271,2534,873
2023-03-15,LF,France,6557,3176,900,51,3381,1233,1248,2481,849
2023-03-16,LF,France,7559,3803,1058,39,3756,1352,1346,2698,1019
2023-03-17,LF,France,8143,4123,1070,35,4020,1492,1458,2950,1035
2023-03-18,LF,France,7307,4200,446,10,3107,1332,1329,2661,436
2023-03-19,LF,France,7701,4290,627,11,3411,1410,1374,2784,616
2023-03-20,LF,France,7525,3990,898,66,3535,1306,1331,2637,832
2023-03-21,LF,France,6744,3420,888,54,3324,1209,1227,2436,834
2023-03-22,LF,France,6639,3373,826,33,3266,1225,1215,2440,793
2023-03-23,LF,France,6753,3523,771,42,3230,1227,1232,2459,729
2023-03-24,LF,France,7409,3922,821,29,3487,1330,1336,2666,792
2023-03-25,LF,France,6860,3967,416,20,2893,1251,1226,2477,396
2023-03-26,LF,France,7387,4267,506,3,3120,1301,1313,2614,503
2023-03-27,LF,France,7303,3796,959,43,3507,1274,1274,2548,916
2023-03-28,LF,France,7186,3874,798,37,3312,1267,1247,2514,761
2023-03-29,LF,France,7537,3938,976,45,3599,1310,1313,2623,931
2023-03-30,LF,France,7997,4276,953,33,3721,1373,1395,2768,920
2023-03-31,LF,France,8211,4581,769,16,3630,1421,1440,2861,753
2023-04-01,LF,France,8053,4828,441,9,3225,1390,1394,2784,432
2023-04-02,LF,France,7929,4605,559,2,3324,1390,1375,2765,557
2023-04-03,LF,France,8243,4379,1011,31,3864,1418,1435,2853,980
2023-04-04,LF,France,7935,4246,937,34,3689,1379,1373,2752,903
2023-04-05,LF,France,8279,4353,1033,72,3926,1430,1463,2893,961
2023-04-06,LF,France,8584,4666,920,36,3918,1486,1512,2998,884
2023-04-07,LF,France,9104,4876,1093,51,4228,1555,1580,3135,1042
2023-04-08,LF,France,8589,5131,563,14,3458,1447,1448,2895,549
2023-04-09,LF,France,8492,4970,586,10,3522,1476,1460,2936,576
2023-04-10,LF,France,8868,5027,803,12,3841,1517,1521,3038,791
2023-04-11,LF,France,8687,4659,1065,41,4028,1480,1483,2963,1024
2023-04-12,LF,France,8397,4522,962,38,3875,1464,1449,2913,924
2023-04-13,LF,France,8284,4402,884,34,3882,1492,1506,2998,850
2023-04-14,LF,France,9312,4952,1029,33,4360,1674,1657,3331,996
2023-04-15,LF,France,8937,5226,632,18,3711,1548,1531,3079,614
2023-04-16,LF,France,9122,5189,732,5,3933,1612,1589,3201,727
2023-04-17,LF,France,8944,4690,1051,42,4254,1595,1608,3203,1009
2023-04-18,LF,France,8691,4581,1029,60,4110,1550,1531,3081,969
2023-04-19,LF,France,8656,4574,964,39,4082,1557,1561,3118,925
2023-04-20,LF,France,9055,4744,1034,40,4311,1629,1648,3277,994
2023-04-21,LF,France,9319,4964,1032,32,4355,1648,1675,3323,1000
2023-04-22,LF,France,8753,5113,634,11,3640,1519,1487,3006,623
2023-04-23,LF,France,9085,5105,715,2,3980,1645,1620,3265,713
2023-04-24,LF,France,9017,4759,1032,33,4258,1602,1624,3226,999
2023-04-25,LF,France,8656,4564,970,44,4092,1559,1563,3122,926
2023-04-26,LF,France,8819,4590,1033,36,4229,1604,1592,3196,997
2023-04-27,LF,France,9195,4772,1060,24,4423,1681,1682,3363,1036
2023-04-28,LF,France,9800,5210,1121,28,4590,1709,1760,3469,1093
2023-04-29,LF,France,9054,5263,680,18,3791,1554,1557,3111,662
2023-04-30,LF,France,9093,5164,714,16,3929,1622,1593,3215,698
2023-05-01,LF,France,7724,4681,548,13,3043,1241,1254,2495,535
2023-05-02,LF,France,8859,4787,891,29,4072,1590,1591,3181,862
2023-05-03,LF,France,8992,4787,1014,34,4205,1600,1591,3191,980
2023-05-04,LF,France,9454,4966,1099,44,4488,1678,1711,3389,1055
2023-05-05,LF,France,9770,5182,1116,26,4588,1730,1742,3472,1090
2023-05-06,LF,France,9197,5374,697,13,3823,1579,1547,3126,684
2023-05-07,LF,France,9274,5326,691,7,3948,1640,1617,3257,684
2023-05-08,LF,France,9402,5184,846,17,4218,1653,1719,3372,829
2023-05-09,LF,France,9272,4940,1090,72,4332,1647,1595,3242,1018
2023-05-10,LF,France,9135,4837,1044,54,4298,1611,1643,3254,990
2023-05-11,LF,France,9557,5049,1067,38,4508,1693,1748,3441,1029
2023-05-12,LF,France,9817,5247,1111,46,4570,1719,1740,3459,1065
2023-05-13,LF,France,9302,5428,725,24,3874,1579,1570,3149,701
2023-05-14,LF,France,9671,5431,769,7,4240,1755,1716,3471,762
2023-05-15,LF,France,9612,5171,1064,29,4441,1693,1684,3377,1035
2023-05-16,LF,France,9315,5074,982,30,4241,1630,1629,3259,952
2023-05-17,LF,France,9643,5026,1162,33,4617,1717,1738,3455,1129
2023-05-18,LF,France,9513,5367,790,22,4146,1672,1684,3356,768
2023-05-19,LF,France,9327,5223,837,23,4104,1613,1654,3267,814
2023-05-20,LF,France,9580,5722,705,8,3858,1586,1567,3153,697
2023-05-21,LF,France,10120,5661,872,12,4459,1800,1787,3587,860
2023-05-22,LF,France,9900,5343,1079,38,4557,1740,1738,3478,1041
2023-05-23,LF,France,9627,5174,1109,61,4453,1656,1688,3344,1048
2023-05-24,LF,France,9662,5107,1118,33,4555,1712,1725,3437,1085
2023-05-25,LF,France,10161,5360,1135,32,4801,1794,1872,3666,1103
2023-05-26,LF,France,10750,5641,1251,23,5109,1892,1966,3858,1228
2023-05-27,LF,France,10026,5872,741,12,4154,1723,1690,3413,729
2023-05-28,LF,France,9840,5667,724,12,4173,1750,1699,3449,712
2023-05-29,LF,France,10264,5540,939,20,4724,1906,1879,3785,919
2023-05-30,LF,France,9785,5222,1080,34,4563,1763,1720,3483,1046
2023-05-31,LF,France,9652,5234,1067,39,4418,1665,1686,3351,1028
2023-06-01,LF,France,10184,5475,1192,45,4709,1727,1790,3517,1147
2023-06-02,LF,France,10246,5496,1140,25,4750,1785,1825,3610,1115
2023-06-03,LF,France,9823,5863,695,16,3960,1646,1619,3265,679
2023-06-04,LF,France,10131,5724,782,16,4407,1838,1787,3625,766
2023-06-05,LF,France,10161,5461,1157,35,4700,1762,1781,3543,1122
2023-06-06,LF,France,8583,4817,793,30,3766,1482,1491,2973,763
2023-06-07,LF,France,9961,5292,1142,28,4669,1758,1769,3527,1114
2023-06-08,LF,France,10446,5638,1180,24,4808,1787,1841,3628,1156
2023-06-09,LF,France,10500,5685,1160,44,4815,1809,1846,3655,1116
2023-06-10,LF,France,10059,5911,704,11,4148,1734,1710,3444,693
2023-06-11,LF,France,10346,5809,856,7,4537,1864,1817,3681,849
2023-06-12,LF,France,10393,5542,1143,27,4851,1868,1840,3708,1116
2023-06-13,LF,France,10033,5527,1039,44,4506,1737,1730,3467,995
2023-06-14,LF,France,10026,5469,1082,43,4557,1744,1731,3475,1039
2023-06-15,LF,France,10710,5798,1220,50,4912,1823,1869,3692,1170
2023-06-16,LF,France,11003,5902,1244,41,5101,1914,1943,3857,1203
2023-06-17,LF,France,10149,5993,692,23,4156,1738,1726,3464,669
2023-06-18,LF,France,9971,5668,763,11,4303,1759,1781,3540,752
2023-06-19,LF,France,10589,5779,1156,47,4810,1809,1845,3654,1109
2023-06-20,LF,France,10132,5577,1049,39,4555,1749,1757,3506,1010
2023-06-21,LF,France,10425,5641,1127,62,4784,1827,1830,3657,1065
2023-06-22,LF,France,10666,5844,1108,48,4822,1856,1858,3714,1060
2023-06-23,LF,France,11000,5861,1228,51,5139,1970,1941,3911,1177
2023-06-24,LF,France,10415,6193,719,16,4222,1763,1740,3503,703
2023-06-25,LF,France,10583,6067,797,8,4516,1887,1832,3719,789
2023-06-26,LF,France,10728,5755,1188,35,4973,1891,1894,3785,1153
2023-06-27,LF,France,10444,5644,1159,44,4800,1820,1821,3641,1115
2023-06-28,LF,France,10413,5612,1112,54,4801,1840,1849,3689,1058
2023-06-29,LF,France,10482,5746,1048,28,4736,1832,1856,3688,1020
2023-06-30,LF,France,10920,5840,1159,33,5080,1957,1964,3921,1126
2023-07-01,LF,France,10900,6392,795,17,4508,1861,1852,3713,778
2023-07-02,LF,France,10918,6265,831,15,4653,1927,1895,3822,816
2023-07-03,LF,France,10846,5826,1214,42,5020,1881,1925,3806,1172
2023-07-04,LF,France,10438,5743,1067,37,4695,1823,1805,3628,1030
2023-07-05,LF,France,10613,5759,1138,40,4854,1864,1852,3716,1098
2023-07-06,LF,France,11095,6005,1246,54,5090,1913,1931,3844,1192
2023-07-07,LF,France,11213,6081,1122,23,5132,2001,2009,4010,1099
2023-07-08,LF,France,10746,6292,776,9,4454,1858,1820,3678,767
2023-07-09,LF,France,10790,6296,773,6,4494,1876,1845,3721,767
2023-07-10,LF,France,10864,5970,1071,31,4894,1904,1919,3823,1040
2023-07-11,LF,France,10376,5764,968,37,4612,1818,1826,3644,931
2023-07-12,LF,France,10692,5912,1086,53,4780,1844,1850,3694,1033
2023-07-13,LF,France,11033,6028,1089,35,5005,1951,1965,3916,1054
2023-07-14,LF,France,10840,6134,813,17,4706,1936,1957,3893,796
2023-07-15,LF,France,10532,6119,711,13,4413,1869,1833,3702,698
2023-07-16,LF,France,10893,6268,857,9,4625,1899,1869,3768,848
2023-07-17,LF,France,10935,6013,1055,42,4922,1914,1953,3867,1013
2023-07-18,LF,France,10655,5923,1041,63,4732,1853,1838,3691,978
2023-07-19,LF,France,10634,5833,1076,29,4801,1851,1874,3725,1047
2023-07-20,LF,France,11012,6056,1086,49,4956,1940,1930,3870,1037
2023-07-21,LF,France,11096,6183,1052,33,4913,1918,1943,3861,1019
2023-07-22,LF,France,10910,6457,742,8,4453,1875,1836,3711,734
2023-07-23,LF,France,10796,6208,805,12,4588,1899,1884,3783,793
2023-07-24,LF,France,10665,5976,992,34,4689,1849,1848,3697,958
2023-07-25,LF,France,10465,5952,905,41,4513,1799,1809,3608,864
2023-07-26,LF,France,10591,5964,973,42,4627,1828,1826,3654,931
2023-07-27,LF,France,10727,5938,1036,51,4789,1891,1862,3753,985
2023-07-28,LF,France,11040,6094,1046,25,4946,1940,1960,3900,1021
2023-07-29,LF,France,10892,6370,746,16,4522,1884,1892,3776,730
2023-07-30,LF,France,10923,6365,780,14,4558,1910,1868,3778,766
2023-07-31,LF,France,10744,6039,917,18,4705,1880,1908,3788,899
2023-08-01,LF,France,10468,5991,840,29,4477,1807,1830,3637,811
2023-08-02,LF,France,10390,5964,811,28,4426,1814,1801,3615,783
2023-08-03,LF,France,10450,5906,815,24,4544,1854,1875,3729,791
2023-08-04,LF,France,10821,6098,880,29,4723,1910,1933,3843,851
2023-08-05,LF,France,10895,6452,736,8,4443,1868,1839,3707,728
2023-08-06,LF,France,10639,6327,676,5,4312,1839,1797,3636,671
2023-08-07,LF,France,10610,6015,892,28,4595,1844,1859,3703,864
2023-08-08,LF,France,10163,5756,834,25,4407,1781,1792,3573,809
2023-08-09,LF,France,10218,5799,857,35,4419,1783,1779,3562,822
2023-08-10,LF,France,10539,5992,872,48,4547,1817,1858,3675,824
2023-08-11,LF,France,10723,6042,891,25,4681,1900,1890,3790,866
2023-08-12,LF,France,10863,6412,790,14,4451,1832,1829,3661,776
2023-08-13,LF,France,10554,6180,712,22,4374,1843,1819,3662,690
2023-08-14,LF,France,10217,5905,707,19,4312,1787,1818,3605,688
2023-08-15,LF,France,10015,5849,651,22,4166,1760,1755,3515,629
2023-08-16,LF,France,10055,5739,751,35,4316,1787,1778,3565,716
2023-08-17,LF,France,10352,5894,806,26,4458,1808,1844,3652,780
2023-08-18,LF,France,10594,5993,867,34,4601,1853,1881,3734,833
2023-08-19,LF,France,10808,6378,768,22,4430,1846,1816,3662,746
2023-08-20,LF,France,10862,6309,762,18,4553,1906,1885,3791,744
2023-08-21,LF,France,10509,5841,964,35,4668,1835,1869,3704,929
2023-08-22,LF,France,10173,5701,883,30,4472,1800,1789,3589,853
2023-08-23,LF,France,10367,5760,909,25,4607,1830,1868,3698,884
2023-08-24,LF,France,10284,5747,888,29,4537,1823,1826,3649,859
2023-08-25,LF,France,10721,5980,941,29,4741,1883,1917,3800,912
2023-08-26,LF,France,10575,6229,733,6,4346,1839,1774,3613,727
2023-08-27,LF,France,10311,5892,761,6,4419,1832,1826,3658,755
2023-08-28,LF,France,9774,5291,988,52,4483,1739,1756,3495,936
2023-08-29,LF,France,10760,6014,1051,38,4746,1845,1850,3695,1013
2023-08-30,LF,France,10791,5988,1060,39,4803,1877,1866,3743,1021
2023-08-31,LF,France,10853,5938,1097,36,4915,1905,1913,3818,1061
2023-09-01,LF,France,11060,6087,1097,33,4973,1924,1952,3876,1064
2023-09-02,LF,France,10555,6173,708,14,4382,1851,1823,3674,694
2023-09-03,LF,France,10900,6336,793,8,4564,1892,1879,3771,785
2023-09-04,LF,France,10621,5910,996,13,4711,1846,1869,3715,983
2023-09-05,LF,France,10158,5645,1017,31,4513,1763,1733,3496,986
2023-09-06,LF,France,10207,5687,1015,29,4520,1746,1759,3505,986
2023-09-07,LF,France,10546,5807,1064,31,4739,1828,1847,3675,1033
2023-09-08,LF,France,10741,5843,1063,14,4898,1886,1949,3835,1049
2023-09-09,LF,France,10328,6118,686,8,4210,1781,1743,3524,678
2023-09-10,LF,France,10617,6083,769,11,4534,1896,1869,3765,758
2023-09-11,LF,France,10530,5699,1109,21,4831,1853,1869,3722,1088
2023-09-12,LF,France,10207,5714,1038,45,4493,1728,1727,3455,993
2023-09-13,LF,France,10189,5596,1095,40,4593,1759,1739,3498,1055
2023-09-14,LF,France,10545,5768,1099,43,4777,1826,1852,3678,1056
2023-09-15,LF,France,10771,5823,1140,38,4948,1892,1916,3808,1102
2023-09-16,LF,France,10093,6024,687,13,4069,1700,1682,3382,674
2023-09-17,LF,France,10343,5937,810,15,4406,1830,1766,3596,795
2023-09-18,LF,France,10220,5602,1038,36,4618,1783,1797,3580,1002
2023-09-19,LF,France,10000,5496,1109,45,4504,1684,1711,3395,1064
2023-09-20,LF,France,10119,5577,1048,37,4542,1744,1750,3494,1011
2023-09-21,LF,France,10322,5726,1081,41,4596,1750,1765,3515,1040
2023-09-22,LF,France,10685,5828,1093,37,4857,1861,1903,3764,1056
2023-09-23,LF,France,10146,6090,669,10,4056,1685,1702,3387,659
2023-09-24,LF,France,10448,6014,800,13,4434,1843,1791,3634,787
2023-09-25,LF,France,10428,5660,1167,51,4768,1783,1818,3601,1116
2023-09-26,LF,France,9798,5182,1151,55,4616,1727,1738,3465,1096
2023-09-27,LF,France,10283,5544,1171,51,4739,1769,1799,3568,1120
2023-09-28,LF,France,10509,5670,1171,45,4839,1824,1844,3668,1126
2023-09-29,LF,France,10726,5738,1232,38,4988,1861,1895,3756,1194
2023-09-30,LF,France,10164,5984,700,15,4180,1750,1730,3480,685
2023-10-01,LF,France,10331,5896,797,10,4435,1857,1781,3638,787
2023-10-02,LF,France,10309,5571,1153,34,4738,1790,1795,3585,1119
2023-01-01,UG,Georgia,401,296,2,0,105,50,53,103,2
2023-01-02,UG,Georgia,470,361,2,0,109,55,52,107,2
2023-01-03,UG,Georgia,463,351,2,0,112,52,58,110,2
2023-01-04,UG,Georgia,478,381,2,0,97,50,45,95,2
2023-01-05,UG,Georgia,471,355,0,0,116,57,59,116,0
2023-01-06,UG,Georgia,500,385,2,0,115,56,57,113,2
2023-01-07,UG,Georgia,501,402,1,1,99,50,48,98,0
2023-01-08,UG,Georgia,499,386,0,0,113,57,56,113,0
2023-01-09,UG,Georgia,463,373,0,0,90,45,45,90,0
2023-01-10,UG,Georgia,456,354,2,0,102,48,52,100,2
2023-01-11,UG,Georgia,460,382,2,0,78,38,38,76,2
2023-01-12,UG,Georgia,463,360,2,0,103,52,49,101,2
2023-01-13,UG,Georgia,473,361,1,0,112,54,57,111,1
2023-01-14,UG,Georgia,497,399,4,0,98,48,46,94,4
2023-01-15,UG,Georgia,492,384,2,0,108,52,54,106,2
2023-01-16,UG,Georgia,448,359,2,0,89,45,42,87,2
2023-01-17,UG,Georgia,466,361,4,0,105,52,49,101,4
2023-01-18,UG,Georgia,444,363,3,0,81,38,40,78,3
2023-01-19,UG,Georgia,461,347,3,0,114,54,57,111,3
2023-01-20,UG,Georgia,482,381,2,0,101,49,50,99,2
2023-01-21,UG,Georgia,476,380,2,0,96,48,46,94,2
2023-01-22,UG,Georgia,466,364,2,0,102,50,50,100,2
2023-01-23,UG,Georgia,433,347,2,0,86,43,41,84,2
2023-01-24,UG,Georgia,429,330,4,0,99,48,47,95,4
2023-01-25,UG,Georgia,425,347,2,0,78,36,40,76,2
2023-01-26,UG,Georgia,419,314,3,1,105,52,50,102,2
2023-01-27,UG,Georgia,456,353,3,0,103,50,50,100,3
2023-01-28,UG,Georgia,461,362,2,0,99,47,50,97,2
2023-01-29,UG,Georgia,476,365,2,0,111,56,53,109,2
2023-01-30,UG,Georgia,419,329,3,0,90,44,43,87,3
2023-01-31,UG,Georgia,434,338,0,0,96,49,47,96,0
2023-02-01,UG,Georgia,432,337,3,0,95,42,50,92,3
2023-02-02,UG,Georgia,438,335,0,0,103,54,49,103,0
2023-02-03,UG,Georgia,452,352,1,0,100,48,51,99,1
2023-02-04,UG,Georgia,465,370,0,0,95,48,47,95,0
2023-02-05,UG,Georgia,454,351,2,0,103,53,48,101,2
2023-02-06,UG,Georgia,423,337,2,0,86,42,42,84,2
2023-02-07,UG,Georgia,407,315,2,0,92,45,45,90,2
2023-02-08,UG,Georgia,412,330,2,0,82,39,41,80,2
2023-02-09,UG,Georgia,434,331,2,0,103,48,53,101,2
2023-02-10,UG,Georgia,450,342,2,0,108,53,53,106,2
2023-02-11,UG,Georgia,471,370,1,1,101,52,48,100,0
2023-02-12,UG,Georgia,455,342,2,0,113,57,54,111,2
2023-02-13,UG,Georgia,397,308,2,0,89,44,43,87,2
2023-02-14,UG,Georgia,421,326,2,0,95,46,47,93,2
2023-02-15,UG,Georgia,404,328,2,0,76,36,38,74,2
2023-02-16,UG,Georgia,424,320,0,0,104,53,51,104,0
2023-02-17,UG,Georgia,429,319,3,0,110,54,53,107,3
2023-02-18,UG,Georgia,483,379,0,0,104,53,51,104,0
2023-02-19,UG,Georgia,473,367,2,0,106,48,56,104,2
2023-02-20,UG,Georgia,423,332,2,0,91,45,44,89,2
2023-02-21,UG,Georgia,460,362,2,0,98,49,47,96,2
2023-02-22,UG,Georgia,460,376,2,0,84,41,41,82,2
2023-02-23,UG,Georgia,452,348,3,1,104,51,50,101,2
2023-02-24,UG,Georgia,488,377,2,0,111,51,58,109,2
2023-02-25,UG,Georgia,521,413,2,0,108,56,50,106,2
2023-02-26,UG,Georgia,501,393,2,0,108,54,52,106,2
2023-02-27,UG,Georgia,453,362,2,0,91,45,44,89,2
2023-02-28,UG,Georgia,468,367,2,0,101,48,51,99,2
2023-03-01,UG,Georgia,463,377,3,0,86,41,42,83,3
2023-03-02,UG,Georgia,488,374,2,0,114,57,55,112,2
2023-03-03,UG,Georgia,521,409,2,0,112,55,55,110,2
2023-03-04,UG,Georgia,507,409,0,0,98,50,48,98,0
2023-03-05,UG,Georgia,491,384,2,0,107,53,52,105,2
2023-03-06,UG,Georgia,430,346,2,0,84,41,41,82,2
2023-03-07,UG,Georgia,455,348,2,0,107,50,55,105,2
2023-03-08,UG,Georgia,450,362,2,0,88,43,43,86,2
2023-03-09,UG,Georgia,459,354,2,0,105,52,51,103,2
2023-03-10,UG,Georgia,511,396,3,0,115,55,57,112,3
2023-03-11,UG,Georgia,509,412,2,0,97,48,47,95,2
2023-03-12,UG,Georgia,495,393,2,0,102,53,47,100,2
2023-03-13,UG,Georgia,443,351,2,0,92,44,46,90,2
2023-03-14,UG,Georgia,469,367,2,0,102,49,51,100,2
2023-03-15,UG,Georgia,443,360,2,0,83,42,39,81,2
2023-03-16,UG,Georgia,496,377,2,0,119,55,62,117,2
2023-03-17,UG,Georgia,505,389,2,0,116,58,56,114,2
2023-03-18,UG,Georgia,508,403,0,0,105,52,53,105,0
2023-03-19,UG,Georgia,505,399,2,0,106,54,50,104,2
2023-03-20,UG,Georgia,482,381,2,0,101,49,50,99,2
2023-03-21,UG,Georgia,479,365,2,0,114,55,57,112,2
2023-03-22,UG,Georgia,471,373,2,0,98,48,48,96,2
2023-03-23,UG,Georgia,499,376,2,0,123,59,62,121,2
2023-03-24,UG,Georgia,503,388,4,0,115,56,55,111,4
2023-03-25,UG,Georgia,527,417,0,0,110,54,56,110,0
2023-03-26,UG,Georgia,539,407,2,0,132,68,62,130,2
2023-03-27,UG,Georgia,443,340,4,0,103,50,49,99,4
2023-03-28,UG,Georgia,523,406,8,1,117,56,53,109,7
2023-03-29,UG,Georgia,489,377,8,0,112,50,54,104,8
2023-03-30,UG,Georgia,536,400,4,0,136,63,69,132,4
2023-03-31,UG,Georgia,517,406,2,0,111,56,53,109,2
2023-04-01,UG,Georgia,531,416,2,0,115,58,55,113,2
2023-04-02,UG,Georgia,532,406,2,0,126,62,62,124,2
2023-04-03,UG,Georgia,510,397,2,0,113,55,56,111,2
2023-04-04,UG,Georgia,518,398,2,0,120,59,59,118,2
2023-04-05,UG,Georgia,513,402,5,0,111,51,55,106,5
2023-04-06,UG,Georgia,513,392,2,0,121,59,60,119,2
2023-04-07,UG,Georgia,539,421,3,0,118,58,57,115,3
2023-04-08,UG,Georgia,552,440,0,0,112,59,53,112,0
2023-04-09,UG,Georgia,539,420,2,0,119,56,61,117,2
2023-04-10,UG,Georgia,508,400,2,0,108,54,52,106,2
2023-04-11,UG,Georgia,495,391,2,0,104,51,51,102,2
2023-04-12,UG,Georgia,485,382,1,1,103,48,54,102,0
2023-04-13,UG,Georgia,533,407,2,0,126,65,59,124,2
2023-04-14,UG,Georgia,554,436,3,1,118,56,59,115,2
2023-04-15,UG,Georgia,553,438,4,0,115,57,54,111,4
2023-04-16,UG,Georgia,530,413,2,0,117,57,58,115,2
2023-04-17,UG,Georgia,531,426,2,0,105,51,52,103,2
2023-04-18,UG,Georgia,515,402,2,0,113,57,54,111,2
2023-04-19,UG,Georgia,523,409,2,0,114,53,59,112,2
2023-04-20,UG,Georgia,584,420,2,0,164,82,80,162,2
2023-04-21,UG,Georgia,560,444,2,0,116,57,57,114,2
2023-04-22,UG,Georgia,548,438,3,0,110,55,52,107,3
2023-04-23,UG,Georgia,572,417,2,0,155,75,78,153,2
2023-04-24,UG,Georgia,548,415,2,0,133,64,67,131,2
2023-04-25,UG,Georgia,574,448,3,0,126,63,60,123,3
2023-04-26,UG,Georgia,559,453,2,0,106,49,55,104,2
2023-04-27,UG,Georgia,587,452,2,0,135,68,65,133,2
2023-04-28,UG,Georgia,619,486,2,0,133,66,65,131,2
2023-04-29,UG,Georgia,622,505,3,0,117,57,57,114,3
2023-04-30,UG,Georgia,594,469,4,0,125,60,61,121,4
2023-05-01,UG,Georgia,549,442,1,1,107,53,53,106,0
2023-05-02,UG,Georgia,542,421,0,0,121,60,61,121,0
2023-05-03,UG,Georgia,537,444,2,0,93,46,45,91,2
2023-05-04,UG,Georgia,601,470,3,1,131,63,65,128,2
2023-05-05,UG,Georgia,610,478,2,0,132,63,67,130,2
2023-05-06,UG,Georgia,621,504,0,0,117,62,55,117,0
2023-05-07,UG,Georgia,604,483,2,0,121,59,60,119,2
2023-05-08,UG,Georgia,579,467,2,0,112,53,57,110,2
2023-05-09,UG,Georgia,581,464,2,0,117,60,55,115,2
2023-05-10,UG,Georgia,605,500,2,0,105,51,52,103,2
2023-05-11,UG,Georgia,607,473,2,0,134,66,66,132,2
2023-05-12,UG,Georgia,617,499,2,0,118,58,58,116,2
2023-05-13,UG,Georgia,631,509,0,0,122,61,61,122,0
2023-05-14,UG,Georgia,631,514,2,0,117,56,59,115,2
2023-05-15,UG,Georgia,608,493,2,0,115,57,56,113,2
2023-05-16,UG,Georgia,582,463,2,0,119,61,56,117,2
2023-05-17,UG,Georgia,582,486,2,0,96,46,48,94,2
2023-05-18,UG,Georgia,612,483,3,0,129,64,62,126,3
2023-05-19,UG,Georgia,636,513,4,0,123,57,62,119,4
2023-05-20,UG,Georgia,614,503,0,0,111,57,54,111,0
2023-05-21,UG,Georgia,658,530,2,0,128,65,61,126,2
2023-05-22,UG,Georgia,592,480,2,0,112,53,57,110,2
2023-05-23,UG,Georgia,613,491,2,0,122,61,59,120,2
2023-05-24,UG,Georgia,605,488,2,0,117,56,59,115,2
2023-05-25,UG,Georgia,639,507,2,0,132,68,62,130,2
2023-05-26,UG,Georgia,672,551,2,0,121,58,61,119,2
2023-05-27,UG,Georgia,647,535,0,0,112,57,55,112,0
2023-05-28,UG,Georgia,647,520,2,0,127,61,64,125,2
2023-05-29,UG,Georgia,638,522,4,1,116,57,55,112,3
2023-05-30,UG,Georgia,622,506,2,0,116,56,58,114,2
2023-05-31,UG,Georgia,629,509,2,0,120,58,60,118,2
2023-06-01,UG,Georgia,720,562,4,0,158,78,76,154,4
2023-06-02,UG,Georgia,706,563,4,0,143,67,72,139,4
2023-06-03,UG,Georgia,699,564,0,0,135,70,65,135,0
2023-06-04,UG,Georgia,696,546,2,0,150,72,76,148,2
2023-06-05,UG,Georgia,693,552,3,0,141,68,70,138,3
2023-06-06,UG,Georgia,685,541,4,0,144,72,68,140,4
2023-06-07,UG,Georgia,673,543,2,0,130,63,65,128,2
2023-06-08,UG,Georgia,717,555,2,0,162,82,78,160,2
2023-06-09,UG,Georgia,733,598,2,0,135,64,69,133,2
2023-06-10,UG,Georgia,719,574,2,0,145,70,73,143,2
2023-06-11,UG,Georgia,729,566,2,0,163,82,79,161,2
2023-06-12,UG,Georgia,680,550,2,0,130,63,65,128,2
2023-06-13,UG,Georgia,709,562,3,0,147,74,70,144,3
2023-06-14,UG,Georgia,712,562,9,5,150,67,74,141,4
2023-06-15,UG,Georgia,779,605,2,0,174,87,85,172,2
2023-06-16,UG,Georgia,752,611,2,0,141,70,69,139,2
2023-06-17,UG,Georgia,740,604,2,1,136,68,66,134,1
2023-06-18,UG,Georgia,731,576,2,0,155,75,78,153,2
2023-06-19,UG,Georgia,727,586,3,0,141,68,70,138,3
2023-06-20,UG,Georgia,741,581,2,0,160,83,75,158,2
2023-06-21,UG,Georgia,721,590,2,0,131,62,67,129,2
2023-06-22,UG,Georgia,747,569,3,0,178,90,85,175,3
2023-06-23,UG,Georgia,780,624,3,1,156,78,75,153,2
2023-06-24,UG,Georgia,762,608,0,0,154,78,76,154,0
2023-06-25,UG,Georgia,780,603,2,0,177,84,91,175,2
2023-06-26,UG,Georgia,740,570,4,0,170,80,86,166,4
2023-06-27,UG,Georgia,757,575,2,0,182,94,86,180,2
2023-06-28,UG,Georgia,758,587,3,1,171,83,85,168,2
2023-06-29,UG,Georgia,776,579,2,0,197,98,97,195,2
2023-06-30,UG,Georgia,748,584,2,0,164,80,82,162,2
2023-07-01,UG,Georgia,767,588,0,0,179,91,88,179,0
2023-07-02,UG,Georgia,805,597,3,0,208,102,103,205,3
2023-07-03,UG,Georgia,744,575,4,0,169,82,83,165,4
2023-07-04,UG,Georgia,740,578,2,0,162,81,79,160,2
2023-07-05,UG,Georgia,744,590,2,0,154,74,78,152,2
2023-07-06,UG,Georgia,790,586,2,0,204,102,100,202,2
2023-07-07,UG,Georgia,761,594,5,1,167,79,83,162,4
2023-07-08,UG,Georgia,748,589,1,0,159,81,77,158,1
2023-07-09,UG,Georgia,729,556,3,0,173,87,83,170,3
2023-07-10,UG,Georgia,733,586,4,0,147,69,74,143,4
2023-07-11,UG,Georgia,753,578,4,0,175,89,82,171,4
2023-07-12,UG,Georgia,734,572,3,0,162,76,83,159,3
2023-07-13,UG,Georgia,775,577,5,0,198,100,93,193,5
2023-07-14,UG,Georgia,795,631,3,0,164,79,82,161,3
2023-07-15,UG,Georgia,743,578,1,0,165,82,82,164,1
2023-07-16,UG,Georgia,754,575,1,0,179,90,88,178,1
2023-07-17,UG,Georgia,755,598,2,0,157,75,80,155,2
2023-07-18,UG,Georgia,773,600,11,2,173,82,80,162,9
2023-07-19,UG,Georgia,745,578,1,0,167,81,85,166,1
2023-07-20,UG,Georgia,772,575,2,0,197,97,98,195,2
2023-07-21,UG,Georgia,790,618,3,0,172,85,84,169,3
2023-07-22,UG,Georgia,751,598,1,0,153,78,74,152,1
2023-07-23,UG,Georgia,781,593,3,1,188,93,92,185,2
2023-07-24,UG,Georgia,736,583,2,0,153,73,78,151,2
2023-07-25,UG,Georgia,788,618,5,0,170,84,81,165,5
2023-07-26,UG,Georgia,773,602,2,0,171,83,86,169,2
2023-07-27,UG,Georgia,801,609,2,0,192,97,93,190,2
2023-07-28,UG,Georgia,806,640,2,0,166,81,83,164,2
2023-07-29,UG,Georgia,751,592,0,0,159,79,80,159,0
2023-07-30,UG,Georgia,772,581,3,0,191,95,93,188,3
2023-07-31,UG,Georgia,733,579,5,1,154,73,76,149,4
2023-08-01,UG,Georgia,759,594,2,0,165,83,80,163,2
2023-08-02,UG,Georgia,766,593,3,1,173,82,88,170,2
2023-08-03,UG,Georgia,775,582,4,0,193,95,94,189,4
2023-08-04,UG,Georgia,747,565,7,0,182,89,86,175,7
2023-08-05,UG,Georgia,748,582,5,0,166,81,80,161,5
2023-08-06,UG,Georgia,757,571,6,0,186,90,90,180,6
2023-08-07,UG,Georgia,754,591,6,0,163,77,80,157,6
2023-08-08,UG,Georgia,741,576,2,0,165,82,81,163,2
2023-08-09,UG,Georgia,741,571,5,0,170,82,83,165,5
2023-08-10,UG,Georgia,794,576,4,0,218,104,110,214,4
2023-08-11,UG,Georgia,783,601,7,0,182,88,87,175,7
2023-08-12,UG,Georgia,739,566,4,0,173,85,84,169,4
2023-08-13,UG,Georgia,775,578,7,0,197,97,93,190,7
2023-08-14,UG,Georgia,730,569,6,0,161,75,80,155,6
2023-08-15,UG,Georgia,760,588,2,0,172,87,83,170,2
2023-08-16,UG,Georgia,749,585,3,1,164,79,82,161,2
2023-08-17,UG,Georgia,827,622,8,0,205,100,97,197,8
2023-08-18,UG,Georgia,800,619,6,0,181,84,91,175,6
2023-08-19,UG,Georgia,780,600,4,0,180,90,86,176,4
2023-08-20,UG,Georgia,778,577,6,0,201,100,95,195,6
2023-08-21,UG,Georgia,727,568,10,0,159,70,79,149,10
2023-08-22,UG,Georgia,764,584,3,0,180,90,87,177,3
2023-08-23,UG,Georgia,749,570,7,1,179,82,90,172,6
2023-08-24,UG,Georgia,776,576,4,0,200,104,92,196,4
2023-08-25,UG,Georgia,756,594,4,0,162,78,80,158,4
2023-08-26,UG,Georgia,758,592,5,0,166,81,80,161,5
2023-08-27,UG,Georgia,808,604,4,0,204,103,97,200,4
2023-08-28,UG,Georgia,725,572,4,0,153,72,77,149,4
2023-08-29,UG,Georgia,746,583,2,0,163,82,79,161,2
2023-08-30,UG,Georgia,750,588,4,0,162,77,81,158,4
2023-08-31,UG,Georgia,787,594,4,0,193,95,94,189,4
2023-09-01,UG,Georgia,752,591,4,0,161,78,79,157,4
2023-09-02,UG,Georgia,740,574,4,0,166,82,80,162,4
2023-09-03,UG,Georgia,750,559,4,0,191,92,95,187,4
2023-09-04,UG,Georgia,756,596,7,1,160,77,76,153,6
2023-09-05,UG,Georgia,736,561,2,0,175,88,85,173,2
2023-09-06,UG,Georgia,746,573,4,0,173,82,87,169,4
2023-09-07,UG,Georgia,765,569,4,0,196,98,94,192,4
2023-09-08,UG,Georgia,755,593,6,0,162,77,79,156,6
2023-09-09,UG,Georgia,761,600,4,0,161,79,78,157,4
2023-09-10,UG,Georgia,761,567,6,0,194,96,92,188,6
2023-09-11,UG,Georgia,706,560,6,0,146,69,71,140,6
2023-09-12,UG,Georgia,716,566,2,0,150,74,74,148,2
2023-09-13,UG,Georgia,715,547,4,0,168,81,83,164,4
2023-09-14,UG,Georgia,758,570,4,0,188,93,91,184,4
2023-09-15,UG,Georgia,767,610,7,1,157,73,77,150,6
2023-09-16,UG,Georgia,765,595,4,0,170,85,81,166,4
2023-09-17,UG,Georgia,758,559,7,0,199,98,94,192,7
2023-09-18,UG,Georgia,711,570,6,0,141,64,71,135,6
2023-09-19,UG,Georgia,802,645,2,0,157,79,76,155,2
2023-09-20,UG,Georgia,746,586,4,0,160,75,81,156,4
2023-09-21,UG,Georgia,791,617,4,0,174,88,82,170,4
2023-09-22,UG,Georgia,826,672,6,0,154,72,76,148,6
2023-09-23,UG,Georgia,771,617,4,0,154,76,74,150,4
2023-09-24,UG,Georgia,779,608,6,0,171,79,86,165,6
2023-09-25,UG,Georgia,720,585,8,2,135,66,61,127,6
2023-09-26,UG,Georgia,704,561,6,2,143,71,66,137,4
2023-09-27,UG,Georgia,786,626,6,1,160,75,79,154,5
2023-09-28,UG,Georgia,773,603,5,1,170,85,80,165,4
2023-09-29,UG,Georgia,811,646,6,0,165,78,81,159,6
2023-09-30,UG,Georgia,810,663,4,0,147,70,73,143,4
2023-10-01,UG,Georgia,816,626,8,1,190,91,91,182,7
2023-10-02,UG,Georgia,746,597,6,0,149,74,69,143,6
2023-01-01,ED,Germany,5604,2754,201,2,2850,1338,1311,2649,199
2023-01-02,ED,Germany,6605,3011,401,9,3594,1593,1600,3193,392
2023-01-03,ED,Germany,6251,2779,451,24,3472,1505,1516,3021,427
2023-01-04,ED,Germany,6213,2709,416,29,3504,1552,1536,3088,387
2023-01-05,ED,Germany,6351,2733,445,19,3618,1585,1588,3173,426
2023-01-06,ED,Germany,6735,2928,448,18,3807,1672,1687,3359,430
2023-01-07,ED,Germany,6471,3047,429,9,3424,1493,1502,2995,420
2023-01-08,ED,Germany,6731,3089,391,7,3642,1623,1628,3251,384
2023-01-09,ED,Germany,6324,2766,459,15,3558,1536,1563,3099,444
2023-01-10,ED,Germany,5727,2381,552,25,3346,1392,1402,2794,527
2023-01-11,ED,Germany,5864,2443,559,20,3421,1446,1416,2862,539
2023-01-12,ED,Germany,6026,2584,478,15,3442,1484,1480,2964,463
2023-01-13,ED,Germany,6581,2863,514,14,3718,1616,1588,3204,500
2023-01-14,ED,Germany,5780,2822,334,16,2958,1313,1311,2624,318
2023-01-15,ED,Germany,6093,2873,352,11,3220,1425,1443,2868,341
2023-01-16,ED,Germany,6186,2735,478,11,3451,1449,1524,2973,467
2023-01-17,ED,Germany,5611,2322,592,30,3289,1329,1368,2697,562
2023-01-18,ED,Germany,5764,2381,598,26,3383,1406,1379,2785,572
2023-01-19,ED,Germany,6153,2695,542,25,3458,1464,1452,2916,517
2023-01-20,ED,Germany,6750,2902,548,22,3848,1657,1643,3300,526
2023-01-21,ED,Germany,5622,2742,309,7,2880,1303,1268,2571,302
2023-01-22,ED,Germany,5949,2863,317,8,3086,1383,1386,2769,309
2023-01-23,ED,Germany,6129,2712,497,14,3417,1443,1477,2920,483
2023-01-24,ED,Germany,5593,2253,604,21,3340,1374,1362,2736,583
2023-01-25,ED,Germany,5465,2381,477,20,3084,1317,1290,2607,457
2023-01-26,ED,Germany,6031,2560,527,11,3471,1474,1470,2944,516
2023-01-27,ED,Germany,6446,2773,526,21,3673,1579,1568,3147,505
2023-01-28,ED,Germany,5763,2764,404,12,2999,1313,1282,2595,392
2023-01-29,ED,Germany,6146,2843,427,15,3303,1439,1437,2876,412
2023-01-30,ED,Germany,5999,2561,499,11,3438,1458,1481,2939,488
2023-01-31,ED,Germany,5586,2299,532,17,3287,1365,1390,2755,515
2023-02-01,ED,Germany,5812,2417,540,19,3395,1432,1423,2855,521
2023-02-02,ED,Germany,6068,2561,523,20,3507,1488,1496,2984,503
2023-02-03,ED,Germany,6606,2812,505,16,3794,1662,1627,3289,489
2023-02-04,ED,Germany,5958,2832,403,8,3126,1368,1355,2723,395
2023-02-05,ED,Germany,6230,2868,377,6,3362,1491,1494,2985,371
2023-02-06,ED,Germany,6299,2674,561,26,3625,1515,1549,3064,535
2023-02-07,ED,Germany,6057,2465,720,36,3592,1431,1441,2872,684
2023-02-08,ED,Germany,6301,2534,768,35,3767,1498,1501,2999,733
2023-02-09,ED,Germany,6565,2649,725,33,3916,1625,1566,3191,692
2023-02-10,ED,Germany,7177,3039,662,36,4138,1740,1736,3476,626
2023-02-11,ED,Germany,6367,3157,366,10,3210,1424,1420,2844,356
2023-02-12,ED,Germany,6489,2976,442,10,3513,1532,1539,3071,432
2023-02-13,ED,Germany,6565,2783,594,30,3782,1577,1611,3188,564
2023-02-14,ED,Germany,6007,2390,704,31,3617,1462,1451,2913,673
2023-02-15,ED,Germany,6187,2651,592,22,3536,1467,1477,2944,570
2023-02-16,ED,Germany,7041,2912,780,34,4129,1683,1666,3349,746
2023-02-17,ED,Germany,5235,3061,228,17,2174,951,995,1946,211
2023-02-18,ED,Germany,6783,3207,397,9,3576,1620,1559,3179,388
2023-02-19,ED,Germany,6887,3226,422,6,3661,1617,1622,3239,416
2023-02-20,ED,Germany,6711,2853,574,21,3858,1630,1654,3284,553
2023-02-21,ED,Germany,6194,2478,633,37,3716,1544,1539,3083,596
2023-02-22,ED,Germany,6575,2692,710,42,3883,1591,1582,3173,668
2023-02-23,ED,Germany,6722,2778,657,29,3944,1655,1632,3287,628
2023-02-24,ED,Germany,7275,3114,579,19,4161,1782,1800,3582,560
2023-02-25,ED,Germany,6557,3140,419,14,3417,1512,1486,2998,405
2023-02-26,ED,Germany,6919,3193,462,11,3726,1618,1646,3264,451
2023-02-27,ED,Germany,6619,2971,588,25,3648,1514,1546,3060,563
2023-02-28,ED,Germany,6403,2598,727,23,3805,1543,1535,3078,704
2023-03-01,ED,Germany,6767,2689,740,25,4078,1680,1658,3338,715
2023-03-02,ED,Germany,6924,2823,709,17,4101,1692,1700,3392,692
2023-03-03,ED,Germany,7436,3115,646,26,4321,1837,1838,3675,620
2023-03-04,ED,Germany,6544,3114,389,9,3430,1533,1508,3041,380
2023-03-05,ED,Germany,6797,3107,409,3,3690,1642,1639,3281,406
2023-03-06,ED,Germany,6750,2868,518,15,3882,1649,1715,3364,503
2023-03-07,ED,Germany,6176,2636,531,11,3540,1506,1503,3009,520
2023-03-08,ED,Germany,6529,2803,563,13,3726,1579,1584,3163,550
2023-03-09,ED,Germany,6934,2964,606,21,3970,1706,1658,3364,585
2023-03-10,ED,Germany,7263,3236,521,20,4027,1751,1755,3506,501
2023-03-11,ED,Germany,6797,3358,448,15,3439,1515,1476,2991,433
2023-03-12,ED,Germany,7037,3410,379,2,3627,1627,1621,3248,377
2023-03-13,ED,Germany,6479,2842,471,21,3637,1545,1621,3166,450
2023-03-14,ED,Germany,6433,2594,606,25,3839,1635,1598,3233,581
2023-03-15,ED,Germany,6972,2890,710,35,4082,1709,1663,3372,675
2023-03-16,ED,Germany,7022,2756,767,24,4266,1755,1744,3499,743
2023-03-17,ED,Germany,7134,3067,660,30,4067,1699,1708,3407,630
2023-03-18,ED,Germany,6571,2979,505,11,3592,1549,1538,3087,494
2023-03-19,ED,Germany,6946,3176,468,11,3770,1629,1673,3302,457
2023-03-20,ED,Germany,7282,3118,675,31,4164,1724,1765,3489,644
2023-03-21,ED,Germany,6677,2726,761,41,3951,1596,1594,3190,720
2023-03-22,ED,Germany,7122,2962,791,34,4160,1685,1684,3369,757
2023-03-23,ED,Germany,7309,3055,753,28,4254,1760,1741,3501,725
2023-03-24,ED,Germany,7655,3349,632,27,4306,1832,1842,3674,605
2023-03-25,ED,Germany,6509,3175,306,7,3334,1523,1505,3028,299
2023-03-26,ED,Germany,6846,3561,301,7,3285,1505,1479,2984,294
2023-03-27,ED,Germany,5237,3491,256,26,1746,717,773,1490,230
2023-03-28,ED,Germany,7804,3240,787,44,4564,1889,1888,3777,743
2023-03-29,ED,Germany,8045,3431,790,47,4614,1903,1921,3824,743
2023-03-30,ED,Germany,8102,3512,687,34,4590,1942,1961,3903,653
2023-03-31,ED,Germany,8370,3627,629,24,4743,2068,2046,4114,605
2023-04-01,ED,Germany,7829,3707,403,5,4122,1879,1840,3719,398
2023-04-02,ED,Germany,8056,3746,462,8,4310,1941,1907,3848,454
2023-04-03,ED,Germany,8376,3722,673,32,4654,1985,1996,3981,641
2023-04-04,ED,Germany,8099,3510,673,28,4589,1951,1965,3916,645
2023-04-05,ED,Germany,8477,3630,701,31,4847,2069,2077,4146,670
2023-04-06,ED,Germany,8461,3603,679,35,4858,2115,2064,4179,644
2023-04-07,ED,Germany,8018,3646,429,11,4372,1990,1953,3943,418
2023-04-08,ED,Germany,7438,3570,370,11,3868,1772,1726,3498,359
2023-04-09,ED,Germany,7597,3536,397,7,4061,1814,1850,3664,390
2023-04-10,ED,Germany,7842,3532,484,12,4310,1881,1945,3826,472
2023-04-11,ED,Germany,7878,3361,601,17,4517,1944,1972,3916,584
2023-04-12,ED,Germany,7878,3350,578,31,4528,1990,1960,3950,547
2023-04-13,ED,Germany,8318,3581,636,36,4737,2042,2059,4101,600
2023-04-14,ED,Germany,8584,3570,672,33,5014,2166,2176,4342,639
2023-04-15,ED,Germany,7770,3532,480,11,4238,1884,1874,3758,469
2023-04-16,ED,Germany,8078,3622,467,8,4456,1965,2024,3989,459
2023-04-17,ED,Germany,8238,3462,663,15,4776,2047,2066,4113,648
2023-04-18,ED,Germany,8080,3294,751,30,4786,1996,2039,4035,721
2023-04-19,ED,Germany,8484,3455,832,26,5029,2099,2098,4197,806
2023-04-20,ED,Germany,8140,3448,711,26,4692,1996,1985,3981,685
2023-04-21,ED,Germany,8357,3509,757,31,4848,2038,2053,4091,726
2023-04-22,ED,Germany,7755,3345,590,10,4410,1953,1867,3820,580
2023-04-23,ED,Germany,8215,3615,548,9,4600,2035,2017,4052,539
2023-04-24,ED,Germany,8012,3432,655,22,4580,1943,1982,3925,633
2023-04-25,ED,Germany,8003,3235,754,26,4768,2006,2008,4014,728
2023-04-26,ED,Germany,8247,3402,800,21,4845,2034,2011,4045,779
2023-04-27,ED,Germany,8549,3423,809,32,5126,2174,2143,4317,777
2023-04-28,ED,Germany,8687,3588,743,35,5099,2185,2171,4356,708
2023-04-29,ED,Germany,7726,3477,505,14,4249,1883,1861,3744,491
2023-04-30,ED,Germany,7915,3524,497,8,4391,1930,1964,3894,489
2023-05-01,ED,Germany,8272,3899,530,13,4373,1880,1963,3843,517
2023-05-02,ED,Germany,8182,3527,685,28,4655,1996,1974,3970,657
2023-05-03,ED,Germany,8447,3495,785,23,4952,2101,2066,4167,762
2023-05-04,ED,Germany,8633,3564,762,28,5069,2150,2157,4307,734
2023-05-05,ED,Germany,8618,3659,659,19,4959,2163,2137,4300,640
2023-05-06,ED,Germany,7904,3621,492,7,4283,1902,1889,3791,485
2023-05-07,ED,Germany,8234,3732,492,18,4502,1993,2017,4010,474
2023-05-08,ED,Germany,8568,3700,708,16,4868,2058,2102,4160,692
2023-05-09,ED,Germany,8422,3533,763,26,4889,2071,2055,4126,737
2023-05-10,ED,Germany,8743,3680,780,33,5063,2148,2135,4283,747
2023-05-11,ED,Germany,8812,3717,799,31,5095,2158,2138,4296,768
2023-05-12,ED,Germany,9206,3868,775,27,5338,2290,2273,4563,748
2023-05-13,ED,Germany,8246,3747,527,6,4499,1997,1975,3972,521
2023-05-14,ED,Germany,8607,3902,526,8,4705,2070,2109,4179,518
2023-05-15,ED,Germany,8877,3785,694,20,5092,2204,2194,4398,674
2023-05-16,ED,Germany,8524,3569,713,34,4955,2118,2124,4242,679
2023-05-17,ED,Germany,9019,3839,733,20,5180,2237,2210,4447,713
2023-05-18,ED,Germany,8640,3823,529,12,4817,2176,2112,4288,517
2023-05-19,ED,Germany,8314,3569,550,19,4745,2099,2096,4195,531
2023-05-20,ED,Germany,8051,3711,440,9,4340,1934,1966,3900,431
2023-05-21,ED,Germany,8841,3951,539,9,4890,2134,2217,4351,530
2023-05-22,ED,Germany,8846,3809,686,27,5037,2177,2174,4351,659
2023-05-23,ED,Germany,8605,3587,749,28,5018,2147,2122,4269,721
2023-05-24,ED,Germany,8994,3811,725,36,5183,2225,2233,4458,689
2023-05-25,ED,Germany,9201,3915,754,30,5286,2260,2272,4532,724
2023-05-26,ED,Germany,9480,3986,718,23,5494,2409,2367,4776,695
2023-05-27,ED,Germany,8498,3853,477,20,4645,2124,2044,4168,457
2023-05-28,ED,Germany,8555,3906,428,8,4649,2095,2126,4221,420
2023-05-29,ED,Germany,8870,4012,489,5,4858,2148,2221,4369,484
2023-05-30,ED,Germany,8907,3769,657,24,5138,2239,2242,4481,633
2023-05-31,ED,Germany,9098,3845,732,30,5253,2269,2252,4521,702
2023-06-01,ED,Germany,9281,3907,743,22,5374,2331,2300,4631,721
2023-06-02,ED,Germany,9391,3964,680,21,5427,2372,2375,4747,659
2023-06-03,ED,Germany,8556,3804,472,14,4752,2143,2137,4280,458
2023-06-04,ED,Germany,9074,4104,570,15,4970,2188,2212,4400,555
2023-06-05,ED,Germany,9100,3880,660,18,5220,2255,2305,4560,642
2023-06-06,ED,Germany,9347,4097,727,19,5250,2254,2269,4523,708
2023-06-07,ED,Germany,9515,3996,764,32,5519,2381,2374,4755,732
2023-06-08,ED,Germany,9131,3983,571,17,5148,2318,2259,4577,554
2023-06-09,ED,Germany,9366,4008,633,34,5358,2375,2350,4725,599
2023-06-10,ED,Germany,8641,3911,452,13,4730,2147,2131,4278,439
2023-06-11,ED,Germany,9355,4237,555,17,5118,2249,2314,4563,538
2023-06-12,ED,Germany,8971,3693,656,16,5278,2284,2338,4622,640
2023-06-13,ED,Germany,8904,3596,727,34,5308,2299,2282,4581,693
2023-06-14,ED,Germany,9122,3708,737,40,5414,2344,2333,4677,697
2023-06-15,ED,Germany,9295,3769,751,35,5526,2401,2374,4775,716
2023-06-16,ED,Germany,9274,3764,666,26,5510,2428,2416,4844,640
2023-06-17,ED,Germany,8679,3966,461,6,4713,2134,2118,4252,455
2023-06-18,ED,Germany,9055,4047,533,10,5008,2216,2259,4475,523
2023-06-19,ED,Germany,9094,3764,688,23,5330,2299,2343,4642,665
2023-06-20,ED,Germany,8789,3642,713,36,5147,2218,2216,4434,677
2023-06-21,ED,Germany,9055,3634,717,34,5421,2372,2332,4704,683
2023-06-22,ED,Germany,8831,3806,542,23,5025,2247,2236,4483,519
2023-06-23,ED,Germany,9615,4125,680,22,5490,2418,2392,4810,658
2023-06-24,ED,Germany,8701,3948,486,16,4753,2157,2110,4267,470
2023-06-25,ED,Germany,9185,4129,514,8,5056,2248,2294,4542,506
2023-06-26,ED,Germany,9471,4075,716,28,5396,2334,2346,4680,688
2023-06-27,ED,Germany,9253,3923,738,49,5330,2287,2305,4592,689
2023-06-28,ED,Germany,9399,4016,791,53,5383,2317,2275,4592,738
2023-06-29,ED,Germany,9451,4016,724,41,5435,2352,2359,4711,683
2023-06-30,ED,Germany,9577,4133,667,32,5444,2401,2376,4777,635
2023-07-01,ED,Germany,8851,4093,448,6,4758,2170,2140,4310,442
2023-07-02,ED,Germany,9266,4295,491,5,4971,2230,2250,4480,486
2023-07-03,ED,Germany,9366,4168,655,13,5198,2246,2297,4543,642
2023-07-04,ED,Germany,9102,3961,666,16,5141,2230,2245,4475,650
2023-07-05,ED,Germany,9139,3912,653,28,5227,2292,2282,4574,625
2023-07-06,ED,Germany,9540,4072,765,40,5468,2361,2342,4703,725
2023-07-07,ED,Germany,9851,4292,714,35,5559,2431,2414,4845,679
2023-07-08,ED,Germany,8971,4172,469,4,4799,2177,2153,4330,465
2023-07-09,ED,Germany,9271,4364,475,5,4907,2201,2231,4432,470
2023-07-10,ED,Germany,9391,4079,672,32,5312,2292,2348,4640,640
2023-07-11,ED,Germany,9200,3996,677,38,5204,2271,2256,4527,639
2023-07-12,ED,Germany,9292,4069,726,35,5223,2258,2239,4497,691
2023-07-13,ED,Germany,9567,4154,721,29,5413,2352,2340,4692,692
2023-07-14,ED,Germany,9762,4251,697,33,5511,2424,2390,4814,664
2023-07-15,ED,Germany,8480,3937,379,7,4543,2081,2083,4164,372
2023-07-16,ED,Germany,9194,4301,461,2,4893,2209,2223,4432,459
2023-07-17,ED,Germany,9403,4129,649,29,5274,2298,2327,4625,620
2023-07-18,ED,Germany,9212,3966,706,35,5246,2267,2273,4540,671
2023-07-19,ED,Germany,9328,4024,692,37,5304,2323,2289,4612,655
2023-07-20,ED,Germany,9586,4117,720,27,5469,2368,2381,4749,693
2023-07-21,ED,Germany,9607,4115,661,26,5492,2414,2417,4831,635
2023-07-22,ED,Germany,8937,4144,463,13,4793,2177,2153,4330,450
2023-07-23,ED,Germany,9290,4303,468,3,4987,2271,2248,4519,465
2023-07-24,ED,Germany,9093,4075,550,30,5018,2207,2261,4468,520
2023-07-25,ED,Germany,9062,3954,637,38,5108,2234,2237,4471,599
2023-07-26,ED,Germany,9380,4179,645,32,5201,2283,2273,4556,613
2023-07-27,ED,Germany,9491,4122,658,34,5369,2349,2362,4711,624
2023-07-28,ED,Germany,9675,4278,657,30,5397,2389,2351,4740,627
2023-07-29,ED,Germany,8831,4121,421,11,4710,2163,2126,4289,410
2023-07-30,ED,Germany,9258,4266,485,9,4992,2240,2267,4507,476
2023-07-31,ED,Germany,9245,4078,600,25,5167,2261,2306,4567,575
2023-08-01,ED,Germany,9070,4054,578,31,5016,2233,2205,4438,547
2023-08-02,ED,Germany,9254,4086,607,33,5168,2276,2285,4561,574
2023-08-03,ED,Germany,9284,4057,570,31,5227,2340,2317,4657,539
2023-08-04,ED,Germany,9536,4174,664,30,5362,2354,2344,4698,634
2023-08-05,ED,Germany,8911,4102,450,12,4809,2189,2170,4359,438
2023-08-06,ED,Germany,9195,4277,434,6,4918,2228,2256,4484,428
2023-08-07,ED,Germany,9255,4101,586,24,5154,2268,2300,4568,562
2023-08-08,ED,Germany,9038,3942,636,49,5096,2239,2221,4460,587
2023-08-09,ED,Germany,9304,4057,729,47,5247,2257,2261,4518,682
2023-08-10,ED,Germany,9472,4089,718,38,5383,2340,2325,4665,680
2023-08-11,ED,Germany,9523,4129,665,36,5394,2367,2362,4729,629
2023-08-12,ED,Germany,8724,4008,422,13,4716,2156,2138,4294,409
2023-08-13,ED,Germany,9155,4171,488,2,4984,2242,2254,4496,486
2023-08-14,ED,Germany,9076,3933,608,16,5143,2242,2293,4535,592
2023-08-15,ED,Germany,8716,3831,542,29,4885,2172,2171,4343,513
2023-08-16,ED,Germany,8992,3949,614,20,5043,2198,2231,4429,594
2023-08-17,ED,Germany,8969,3917,570,25,5052,2278,2204,4482,545
2023-08-18,ED,Germany,9402,4046,623,26,5356,2373,2360,4733,597
2023-08-19,ED,Germany,8804,4045,431,11,4759,2177,2151,4328,420
2023-08-20,ED,Germany,9144,4146,471,9,4998,2247,2280,4527,462
2023-08-21,ED,Germany,9175,3924,633,25,5251,2293,2325,4618,608
2023-08-22,ED,Germany,9086,3834,664,28,5252,2295,2293,4588,636
2023-08-23,ED,Germany,9279,3944,752,21,5335,2292,2291,4583,731
2023-08-24,ED,Germany,9138,3862,663,29,5276,2306,2307,4613,634
2023-08-25,ED,Germany,9172,3987,532,22,5185,2328,2325,4653,510
2023-08-26,ED,Germany,8662,3957,422,10,4705,2167,2116,4283,412
2023-08-27,ED,Germany,9062,4213,446,11,4849,2193,2210,4403,435
2023-08-28,ED,Germany,8831,3694,610,14,5137,2235,2292,4527,596
2023-08-29,ED,Germany,9253,3944,661,15,5309,2339,2309,4648,646
2023-08-30,ED,Germany,9472,4073,720,31,5399,2350,2329,4679,689
2023-08-31,ED,Germany,9585,4068,684,15,5517,2411,2422,4833,669
2023-09-01,ED,Germany,9603,4039,641,14,5564,2458,2465,4923,627
2023-09-02,ED,Germany,8846,4038,433,6,4808,2226,2149,4375,427
2023-09-03,ED,Germany,9266,4189,461,5,5077,2279,2337,4616,456
2023-09-04,ED,Germany,9431,4002,648,17,5429,2352,2429,4781,631
2023-09-05,ED,Germany,9219,3848,700,17,5371,2348,2323,4671,683
2023-09-06,ED,Germany,9371,3903,727,27,5468,2383,2358,4741,700
2023-09-07,ED,Germany,9623,4030,692,26,5593,2458,2443,4901,666
2023-09-08,ED,Germany,9602,4019,652,22,5583,2476,2455,4931,630
2023-09-09,ED,Germany,8784,3942,465,17,4842,2196,2181,4377,448
2023-09-10,ED,Germany,9379,4190,523,5,5189,2321,2345,4666,518
2023-09-11,ED,Germany,9444,3963,703,25,5481,2375,2403,4778,678
2023-09-12,ED,Germany,9271,3927,698,21,5344,2308,2338,4646,677
2023-09-13,ED,Germany,9428,4024,713,20,5404,2363,2328,4691,693
2023-09-14,ED,Germany,9751,4111,772,21,5640,2433,2435,4868,751
2023-09-15,ED,Germany,9847,4135,748,22,5712,2490,2474,4964,726
2023-09-16,ED,Germany,8784,4033,446,15,4751,2172,2133,4305,431
2023-09-17,ED,Germany,9365,4185,525,7,5180,2301,2354,4655,518
2023-09-18,ED,Germany,9444,4097,653,14,5347,2332,2362,4694,639
2023-09-19,ED,Germany,9393,3879,712,22,5514,2405,2397,4802,690
2023-09-20,ED,Germany,9644,4079,775,28,5565,2416,2374,4790,747
2023-09-21,ED,Germany,9670,4081,778,16,5589,2393,2418,4811,762
2023-09-22,ED,Germany,9815,4206,715,20,5609,2455,2439,4894,695
2023-09-23,ED,Germany,8709,3954,435,10,4755,2175,2145,4320,425
2023-09-24,ED,Germany,9152,4133,513,6,5019,2235,2271,4506,507
2023-09-25,ED,Germany,9317,3963,689,21,5354,2319,2346,4665,668
2023-09-26,ED,Germany,9016,3559,748,35,5457,2362,2347,4709,713
2023-09-27,ED,Germany,9529,3980,823,38,5549,2353,2373,4726,785
2023-09-28,ED,Germany,9747,4076,834,34,5671,2414,2423,4837,800
2023-09-29,ED,Germany,9791,4065,752,17,5726,2515,2459,4974,735
2023-09-30,ED,Germany,8762,3939,429,4,4823,2228,2166,4394,425
2023-10-01,ED,Germany,9213,4121,442,10,5092,2341,2309,4650,432
2023-10-02,ED,Germany,9092,3897,550,17,5195,2309,2336,4645,533
2023-01-01,LG,Greece,1601,1150,143,0,451,160,148,308,143
2023-01-02,LG,Greece,1812,1171,268,12,641,185,188,373,256
2023-01-03,LG,Greece,1711,1108,251,10,603,177,175,352,241
2023-01-04,LG,Greece,1716,1111,256,13,605,172,177,349,243
2023-01-05,LG,Greece,1753,1126,272,19,627,177,178,355,253
2023-01-06,LG,Greece,1736,1142,224,4,594,183,187,370,220
2023-01-07,LG,Greece,1810,1194,254,4,616,179,183,362,250
2023-01-08,LG,Greece,1889,1243,259,4,646,195,192,387,255
2023-01-09,LG,Greece,1629,1005,282,19,624,174,168,342,263
2023-01-10,LG,Greece,1435,940,210,7,495,141,144,285,203
2023-01-11,LG,Greece,1494,946,249,12,548,151,148,299,237
2023-01-12,LG,Greece,1540,968,253,15,572,158,161,319,238
2023-01-13,LG,Greece,1549,973,242,11,576,168,166,334,231
2023-01-14,LG,Greece,1590,1079,232,6,511,141,138,279,226
2023-01-15,LG,Greece,1703,1136,237,9,567,161,169,330,228
2023-01-16,LG,Greece,1548,940,265,21,608,173,170,343,244
2023-01-17,LG,Greece,1351,848,239,32,503,133,131,264,207
2023-01-18,LG,Greece,1379,866,239,27,513,136,138,274,212
2023-01-19,LG,Greece,1514,955,234,22,559,166,159,325,212
2023-01-20,LG,Greece,1522,941,235,5,581,168,178,346,230
2023-01-21,LG,Greece,1593,1088,218,6,505,145,142,287,212
2023-01-22,LG,Greece,1656,1098,228,10,558,171,159,330,218
2023-01-23,LG,Greece,1423,848,255,19,575,156,164,320,236
2023-01-24,LG,Greece,1372,870,245,33,502,129,128,257,212
2023-01-25,LG,Greece,1437,894,264,27,543,139,140,279,237
2023-01-26,LG,Greece,1491,946,232,12,545,156,157,313,220
2023-01-27,LG,Greece,1512,912,262,9,600,166,172,338,253
2023-01-28,LG,Greece,1530,1034,225,5,496,135,136,271,220
2023-01-29,LG,Greece,1641,1070,245,5,571,166,160,326,240
2023-01-30,LG,Greece,1496,900,267,11,596,166,163,329,256
2023-01-31,LG,Greece,1414,898,247,20,516,134,135,269,227
2023-02-01,LG,Greece,1543,962,272,13,581,154,155,309,259
2023-02-02,LG,Greece,1614,1017,259,15,597,169,169,338,244
2023-02-03,LG,Greece,1629,1027,266,11,602,169,167,336,255
2023-02-04,LG,Greece,1676,1165,232,3,511,139,140,279,229
2023-02-05,LG,Greece,1667,1132,208,11,535,162,165,327,197
2023-02-06,LG,Greece,1573,984,243,5,589,175,171,346,238
2023-02-07,LG,Greece,1502,995,232,13,507,138,137,275,219
2023-02-08,LG,Greece,1493,988,217,7,505,144,144,288,210
2023-02-09,LG,Greece,1532,983,228,10,549,161,160,321,218
2023-02-10,LG,Greece,1648,1029,260,12,619,177,182,359,248
2023-02-11,LG,Greece,1691,1178,227,10,513,141,145,286,217
2023-02-12,LG,Greece,1782,1192,238,11,590,174,178,352,227
2023-02-13,LG,Greece,1586,971,263,15,615,178,174,352,248
2023-02-14,LG,Greece,1479,949,247,34,530,146,137,283,213
2023-02-15,LG,Greece,1620,1062,258,26,558,147,153,300,232
2023-02-16,LG,Greece,1664,1066,274,15,598,164,160,324,259
2023-02-17,LG,Greece,1603,999,262,9,604,166,176,342,253
2023-02-18,LG,Greece,1800,1239,232,7,561,167,162,329,225
2023-02-19,LG,Greece,1841,1243,239,4,598,179,180,359,235
2023-02-20,LG,Greece,1594,969,274,21,625,174,177,351,253
2023-02-21,LG,Greece,1472,931,261,38,541,137,143,280,223
2023-02-22,LG,Greece,1646,1066,258,20,580,160,162,322,238
2023-02-23,LG,Greece,1698,1059,284,25,639,174,181,355,259
2023-02-24,LG,Greece,1704,1057,280,12,647,188,179,367,268
2023-02-25,LG,Greece,1749,1213,224,5,536,157,155,312,219
2023-02-26,LG,Greece,1769,1256,175,5,513,173,165,338,170
2023-02-27,LG,Greece,1588,1007,238,5,581,167,176,343,233
2023-02-28,LG,Greece,1591,989,287,26,602,155,160,315,261
2023-03-01,LG,Greece,1732,1115,277,22,617,171,169,340,255
2023-03-02,LG,Greece,1727,1097,277,15,630,180,173,353,262
2023-03-03,LG,Greece,1743,1066,292,9,677,190,195,385,283
2023-03-04,LG,Greece,1770,1214,235,5,556,161,160,321,230
2023-03-05,LG,Greece,1861,1257,243,5,604,183,178,361,238
2023-03-06,LG,Greece,1666,1008,298,13,658,179,181,360,285
2023-03-07,LG,Greece,1535,943,275,18,592,159,158,317,257
2023-03-08,LG,Greece,1659,1109,239,20,550,157,154,311,219
2023-03-09,LG,Greece,1779,1132,293,18,647,178,176,354,275
2023-03-10,LG,Greece,1716,1058,283,13,658,183,192,375,270
2023-03-11,LG,Greece,1801,1238,237,7,563,162,164,326,230
2023-03-12,LG,Greece,1882,1272,259,6,610,178,173,351,253
2023-03-13,LG,Greece,1657,1024,275,13,633,175,183,358,262
2023-03-14,LG,Greece,1680,1068,291,26,612,159,162,321,265
2023-03-15,LG,Greece,1757,1175,256,13,582,170,156,326,243
2023-03-16,LG,Greece,1232,1154,33,12,78,16,29,45,21
2023-03-17,LG,Greece,1862,1121,294,12,741,226,221,447,282
2023-03-18,LG,Greece,1918,1333,246,11,585,169,170,339,235
2023-03-19,LG,Greece,2060,1412,271,10,648,193,184,377,261
2023-03-20,LG,Greece,1886,1215,291,20,671,192,188,380,271
2023-03-21,LG,Greece,1712,1139,270,19,573,152,151,303,251
2023-03-22,LG,Greece,1742,1147,259,21,595,165,171,336,238
2023-03-23,LG,Greece,1697,1036,294,26,661,187,180,367,268
2023-03-24,LG,Greece,1779,1125,274,7,654,184,196,380,267
2023-03-25,LG,Greece,1927,1372,215,7,555,169,171,340,208
2023-03-26,LG,Greece,2137,1389,264,7,748,245,239,484,257
2023-03-27,LG,Greece,1789,1032,309,16,757,220,228,448,293
2023-03-28,LG,Greece,1841,1101,269,12,740,238,233,471,257
2023-03-29,LG,Greece,2042,1272,292,24,770,236,242,478,268
2023-03-30,LG,Greece,2080,1283,295,23,797,255,247,502,272
2023-03-31,LG,Greece,2252,1387,312,14,865,273,280,553,298
2023-04-01,LG,Greece,2571,1646,233,5,925,345,347,692,228
2023-04-02,LG,Greece,2411,1493,283,1,918,320,315,635,282
2023-04-03,LG,Greece,2207,1362,272,15,845,289,284,573,257
2023-04-04,LG,Greece,2214,1314,299,26,900,292,309,601,273
2023-04-05,LG,Greece,2196,1298,309,23,898,298,291,589,286
2023-04-06,LG,Greece,2167,1267,285,18,900,304,311,615,267
2023-04-07,LG,Greece,2356,1331,346,12,1025,333,346,679,334
2023-04-08,LG,Greece,2561,1491,273,5,1070,397,400,797,268
2023-04-09,LG,Greece,2413,1458,283,4,955,344,328,672,279
2023-04-10,LG,Greece,2317,1344,345,20,973,310,318,628,325
2023-04-11,LG,Greece,2213,1311,321,27,902,291,290,581,294
2023-04-12,LG,Greece,2286,1312,345,13,974,318,311,629,332
2023-04-13,LG,Greece,2298,1258,357,10,1040,341,342,683,347
2023-04-14,LG,Greece,2377,1390,306,8,987,339,342,681,298
2023-04-15,LG,Greece,2680,1589,271,6,1091,410,410,820,265
2023-04-16,LG,Greece,2416,1524,204,3,892,352,336,688,201
2023-04-17,LG,Greece,2262,1290,345,3,972,310,317,627,342
2023-04-18,LG,Greece,2140,1132,357,12,1008,321,330,651,345
2023-04-19,LG,Greece,2186,1186,329,18,1000,333,338,671,311
2023-04-20,LG,Greece,2329,1291,325,14,1038,351,362,713,311
2023-04-21,LG,Greece,2343,1304,323,10,1039,359,357,716,313
2023-04-22,LG,Greece,2639,1453,282,4,1186,448,456,904,278
2023-04-23,LG,Greece,2590,1382,313,7,1208,455,440,895,306
2023-04-24,LG,Greece,2363,1335,341,14,1028,341,346,687,327
2023-04-25,LG,Greece,2286,1294,325,17,992,334,333,667,308
2023-04-26,LG,Greece,2402,1389,323,12,1013,340,350,690,311
2023-04-27,LG,Greece,2484,1390,338,17,1094,379,377,756,321
2023-04-28,LG,Greece,2690,1464,378,15,1226,422,426,848,363
2023-04-29,LG,Greece,2878,1570,289,9,1308,510,509,1019,280
2023-04-30,LG,Greece,2737,1500,284,6,1237,475,478,953,278
2023-05-01,LG,Greece,2471,1241,348,5,1230,443,439,882,343
2023-05-02,LG,Greece,2529,1313,356,21,1216,429,431,860,335
2023-05-03,LG,Greece,2636,1394,349,17,1242,449,444,893,332
2023-05-04,LG,Greece,2572,1318,351,13,1254,447,456,903,338
2023-05-05,LG,Greece,2661,1297,355,12,1364,512,497,1009,343
2023-05-06,LG,Greece,3058,1567,289,7,1491,601,601,1202,282
2023-05-07,LG,Greece,3009,1528,316,3,1481,589,576,1165,313
2023-05-08,LG,Greece,2762,1424,384,19,1338,478,476,954,365
2023-05-09,LG,Greece,2563,1312,357,24,1251,441,453,894,333
2023-05-10,LG,Greece,2680,1373,372,26,1307,470,465,935,346
2023-05-11,LG,Greece,2603,1300,352,4,1303,475,476,951,348
2023-05-12,LG,Greece,2849,1376,370,13,1473,553,550,1103,357
2023-05-13,LG,Greece,3097,1425,308,3,1672,678,686,1364,305
2023-05-14,LG,Greece,3076,1480,318,5,1596,639,639,1278,313
2023-05-15,LG,Greece,2786,1359,385,19,1427,522,520,1042,366
2023-05-16,LG,Greece,2656,1261,364,17,1395,516,515,1031,347
2023-05-17,LG,Greece,2703,1273,371,27,1430,520,539,1059,344
2023-05-18,LG,Greece,2839,1337,391,22,1502,554,557,1111,369
2023-05-19,LG,Greece,2894,1328,392,7,1566,584,590,1174,385
2023-05-20,LG,Greece,3409,1604,339,3,1805,731,735,1466,336
2023-05-21,LG,Greece,3276,1520,353,4,1756,711,692,1403,349
2023-05-22,LG,Greece,2820,1275,411,19,1545,567,567,1134,392
2023-05-23,LG,Greece,2766,1294,404,34,1472,531,537,1068,370
2023-05-24,LG,Greece,2887,1289,401,23,1598,598,599,1197,378
2023-05-25,LG,Greece,3001,1392,405,22,1609,604,600,1204,383
2023-05-26,LG,Greece,3139,1402,403,11,1737,658,676,1334,392
2023-05-27,LG,Greece,3490,1539,362,12,1951,788,801,1589,350
2023-05-28,LG,Greece,3507,1629,359,6,1878,765,754,1519,353
2023-05-29,LG,Greece,3226,1503,419,20,1723,662,642,1304,399
2023-05-30,LG,Greece,3087,1426,388,18,1661,634,639,1273,370
2023-05-31,LG,Greece,3202,1481,421,23,1721,652,648,1300,398
2023-06-01,LG,Greece,3315,1454,437,13,1861,715,709,1424,424
2023-06-02,LG,Greece,3470,1469,457,14,2001,767,777,1544,443
2023-06-03,LG,Greece,3823,1661,403,14,2162,879,880,1759,389
2023-06-04,LG,Greece,3739,1678,360,3,2061,847,854,1701,357
2023-06-05,LG,Greece,3416,1521,448,11,1895,726,721,1447,437
2023-06-06,LG,Greece,3358,1471,457,26,1887,715,715,1430,431
2023-06-07,LG,Greece,3507,1608,438,16,1899,722,739,1461,422
2023-06-08,LG,Greece,3541,1572,463,23,1969,757,749,1506,440
2023-06-09,LG,Greece,3674,1607,450,15,2067,797,820,1617,435
2023-06-10,LG,Greece,3945,1705,412,10,2240,915,913,1828,402
2023-06-11,LG,Greece,3871,1693,418,6,2178,888,872,1760,412
2023-06-12,LG,Greece,3555,1567,443,19,1988,777,768,1545,424
2023-06-13,LG,Greece,3538,1543,460,31,1995,769,766,1535,429
2023-06-14,LG,Greece,3604,1590,442,19,2014,788,784,1572,423
2023-06-15,LG,Greece,3670,1604,487,18,2066,782,797,1579,469
2023-06-16,LG,Greece,3725,1527,484,15,2198,849,865,1714,469
2023-06-17,LG,Greece,3848,1542,413,3,2306,951,942,1893,410
2023-06-18,LG,Greece,3916,1660,419,7,2256,926,911,1837,412
2023-06-19,LG,Greece,3685,1601,477,24,2084,804,803,1607,453
2023-06-20,LG,Greece,3601,1542,478,36,2059,793,788,1581,442
2023-06-21,LG,Greece,3727,1609,499,36,2118,801,818,1619,463
2023-06-22,LG,Greece,3616,1531,470,23,2085,803,812,1615,447
2023-06-23,LG,Greece,3791,1526,495,15,2265,881,889,1770,480
2023-06-24,LG,Greece,3923,1535,431,8,2388,979,978,1957,423
2023-06-25,LG,Greece,4049,1735,436,8,2314,942,936,1878,428
2023-06-26,LG,Greece,3899,1640,497,17,2259,886,876,1762,480
2023-06-27,LG,Greece,3839,1590,491,39,2249,879,879,1758,452
2023-06-28,LG,Greece,3854,1601,459,20,2253,898,896,1794,439
2023-06-29,LG,Greece,3813,1599,477,15,2214,865,872,1737,462
2023-06-30,LG,Greece,3859,1448,498,20,2411,947,966,1913,478
2023-07-01,LG,Greece,4243,1633,461,12,2610,1075,1074,2149,449
2023-07-02,LG,Greece,4338,1826,452,6,2512,1032,1028,2060,446
2023-07-03,LG,Greece,4073,1706,522,18,2367,928,917,1845,504
2023-07-04,LG,Greece,3899,1562,478,25,2337,931,928,1859,453
2023-07-05,LG,Greece,4010,1668,480,18,2342,931,931,1862,462
2023-07-06,LG,Greece,3939,1598,488,19,2341,926,927,1853,469
2023-07-07,LG,Greece,4161,1698,508,12,2463,971,984,1955,496
2023-07-08,LG,Greece,4374,1763,437,9,2611,1086,1088,2174,428
2023-07-09,LG,Greece,4367,1804,464,8,2563,1048,1051,2099,456
2023-07-10,LG,Greece,4112,1710,499,21,2402,953,950,1903,478
2023-07-11,LG,Greece,3930,1573,477,32,2357,949,931,1880,445
2023-07-12,LG,Greece,4029,1648,461,13,2381,956,964,1920,448
2023-07-13,LG,Greece,4135,1780,476,14,2355,937,942,1879,462
2023-07-14,LG,Greece,4186,1754,486,5,2432,965,981,1946,481
2023-07-15,LG,Greece,4429,1828,452,5,2601,1075,1074,2149,447
2023-07-16,LG,Greece,4465,1875,457,4,2590,1071,1062,2133,453
2023-07-17,LG,Greece,4103,1703,485,12,2400,962,953,1915,473
2023-07-18,LG,Greece,4021,1642,476,22,2379,955,948,1903,454
2023-07-19,LG,Greece,4115,1726,482,18,2389,949,958,1907,464
2023-07-20,LG,Greece,4213,1814,484,19,2399,954,961,1915,465
2023-07-21,LG,Greece,4180,1710,501,10,2470,984,985,1969,491
2023-07-22,LG,Greece,4487,1830,441,6,2657,1108,1108,2216,435
2023-07-23,LG,Greece,4441,1821,458,6,2620,1078,1084,2162,452
2023-07-24,LG,Greece,4124,1667,518,25,2457,977,962,1939,493
2023-07-25,LG,Greece,4113,1681,480,16,2432,980,972,1952,464
2023-07-26,LG,Greece,4222,1783,488,17,2439,976,975,1951,471
2023-07-27,LG,Greece,4188,1773,481,17,2415,964,970,1934,464
2023-07-28,LG,Greece,4172,1696,481,15,2476,997,998,1995,466
2023-07-29,LG,Greece,4463,1772,431,7,2691,1125,1135,2260,424
2023-07-30,LG,Greece,4460,1885,441,8,2575,1074,1060,2134,433
2023-07-31,LG,Greece,4150,1763,499,24,2387,944,944,1888,475
2023-08-01,LG,Greece,4171,1728,467,33,2443,989,987,1976,434
2023-08-02,LG,Greece,4253,1774,476,26,2479,999,1004,2003,450
2023-08-03,LG,Greece,4101,1728,469,17,2373,945,959,1904,452
2023-08-04,LG,Greece,4196,1717,506,20,2479,988,985,1973,486
2023-08-05,LG,Greece,4548,1855,469,16,2693,1106,1118,2224,453
2023-08-06,LG,Greece,4471,1895,450,6,2576,1074,1052,2126,444
2023-08-07,LG,Greece,4205,1765,498,26,2440,973,969,1942,472
2023-08-08,LG,Greece,4156,1766,465,21,2390,968,957,1925,444
2023-08-09,LG,Greece,4260,1817,492,39,2443,972,979,1951,453
2023-08-10,LG,Greece,4166,1791,476,21,2375,949,950,1899,455
2023-08-11,LG,Greece,4197,1737,474,13,2460,992,994,1986,461
2023-08-12,LG,Greece,4525,1849,449,7,2676,1110,1117,2227,442
2023-08-13,LG,Greece,4431,1868,445,7,2563,1061,1057,2118,438
2023-08-14,LG,Greece,4053,1733,464,9,2320,934,922,1856,455
2023-08-15,LG,Greece,4079,1743,443,3,2336,945,948,1893,440
2023-08-16,LG,Greece,4204,1789,466,22,2415,975,974,1949,444
2023-08-17,LG,Greece,4134,1780,462,14,2354,953,939,1892,448
2023-08-18,LG,Greece,4180,1724,471,9,2456,984,1001,1985,462
2023-08-19,LG,Greece,4532,1871,436,7,2661,1107,1118,2225,429
2023-08-20,LG,Greece,4529,1936,450,7,2593,1077,1066,2143,443
2023-08-21,LG,Greece,4156,1760,488,13,2396,956,952,1908,475
2023-08-22,LG,Greece,4011,1628,459,12,2383,966,958,1924,447
2023-08-23,LG,Greece,4032,1649,471,31,2383,951,961,1912,440
2023-08-24,LG,Greece,4090,1763,464,21,2327,928,935,1863,443
2023-08-25,LG,Greece,4177,1728,491,17,2449,976,982,1958,474
2023-08-26,LG,Greece,4452,1849,428,8,2603,1084,1091,2175,420
2023-08-27,LG,Greece,4381,1877,448,5,2504,1032,1024,2056,443
2023-08-28,LG,Greece,3886,1663,488,22,2223,859,876,1735,466
2023-08-29,LG,Greece,4115,1738,475,25,2377,965,937,1902,450
2023-08-30,LG,Greece,4258,1896,476,23,2362,941,945,1886,453
2023-08-31,LG,Greece,4123,1791,471,19,2332,921,940,1861,452
2023-09-01,LG,Greece,4084,1722,502,14,2362,924,936,1860,488
2023-09-02,LG,Greece,4344,1794,428,11,2550,1062,1060,2122,417
2023-09-03,LG,Greece,4296,1864,433,9,2432,1007,992,1999,424
2023-09-04,LG,Greece,3816,1646,488,15,2170,845,837,1682,473
2023-09-05,LG,Greece,3745,1681,426,9,2064,823,815,1638,417
2023-09-06,LG,Greece,3655,1582,414,10,2073,818,841,1659,404
2023-09-07,LG,Greece,3833,1625,486,18,2208,867,855,1722,468
2023-09-08,LG,Greece,3823,1583,495,10,2240,871,874,1745,485
2023-09-09,LG,Greece,4177,1768,425,10,2409,993,991,1984,415
2023-09-10,LG,Greece,4075,1785,429,5,2290,939,922,1861,424
2023-09-11,LG,Greece,3704,1657,438,14,2047,798,811,1609,424
2023-09-12,LG,Greece,3693,1577,476,36,2116,827,813,1640,440
2023-09-13,LG,Greece,3704,1632,463,45,2072,801,808,1609,418
2023-09-14,LG,Greece,3690,1610,466,28,2080,809,805,1614,438
2023-09-15,LG,Greece,3702,1538,477,10,2164,842,845,1687,467
2023-09-16,LG,Greece,4027,1699,406,6,2328,960,962,1922,400
2023-09-17,LG,Greece,3919,1685,431,7,2234,909,894,1803,424
2023-09-18,LG,Greece,3568,1544,430,8,2024,798,796,1594,422
2023-09-19,LG,Greece,3454,1439,434,31,2015,789,792,1581,403
2023-09-20,LG,Greece,3524,1480,441,23,2044,800,803,1603,418
2023-09-21,LG,Greece,3489,1497,453,28,1992,762,777,1539,425
2023-09-22,LG,Greece,3677,1522,472,13,2155,843,840,1683,459
2023-09-23,LG,Greece,3974,1678,405,11,2296,945,946,1891,394
2023-09-24,LG,Greece,3813,1612,410,4,2201,897,894,1791,406
2023-09-25,LG,Greece,3233,1337,432,24,1896,740,724,1464,408
2023-09-26,LG,Greece,3357,1423,399,10,1934,766,769,1535,389
2023-09-27,LG,Greece,3422,1541,398,10,1881,736,747,1483,388
2023-09-28,LG,Greece,3541,1574,450,30,1967,762,755,1517,420
2023-09-29,LG,Greece,3575,1541,441,26,2034,796,797,1593,415
2023-09-30,LG,Greece,3996,1751,400,21,2245,921,924,1845,379
2023-10-01,LG,Greece,3833,1788,411,39,2045,827,807,1634,372
2023-10-02,LG,Greece,3325,1563,456,54,1762,654,652,1306,402
2023-01-01,LH,Hungary,1984,1722,0,0,262,126,136,262,0
2023-01-02,LH,Hungary,2070,1782,1,0,288,150,137,287,1
2023-01-03,LH,Hungary,2080,1812,3,0,268,129,136,265,3
2023-01-04,LH,Hungary,2108,1848,3,2,260,128,129,257,1
2023-01-05,LH,Hungary,2105,1861,1,1,244,120,123,243,0
2023-01-06,LH,Hungary,2196,1894,3,2,302,152,147,299,1
2023-01-07,LH,Hungary,2246,2017,1,0,229,113,115,228,1
2023-01-08,LH,Hungary,2318,2030,1,0,288,139,148,287,1
2023-01-09,LH,Hungary,2046,1777,2,0,269,141,126,267,2
2023-01-10,LH,Hungary,1987,1762,1,1,225,109,115,224,0
2023-01-11,LH,Hungary,2000,1752,14,5,248,117,117,234,9
2023-01-12,LH,Hungary,2036,1800,2,1,236,116,118,234,1
2023-01-13,LH,Hungary,2150,1857,5,0,293,146,142,288,5
2023-01-14,LH,Hungary,2086,1872,3,1,214,105,106,211,2
2023-01-15,LH,Hungary,2152,1896,0,0,256,126,130,256,0
2023-01-16,LH,Hungary,1980,1702,2,0,278,143,133,276,2
2023-01-17,LH,Hungary,1907,1679,4,2,228,110,114,224,2
2023-01-18,LH,Hungary,1909,1667,2,0,242,119,121,240,2
2023-01-19,LH,Hungary,1926,1711,2,1,215,109,104,213,1
2023-01-20,LH,Hungary,2134,1839,1,1,295,146,148,294,0
2023-01-21,LH,Hungary,2066,1866,0,0,200,98,102,200,0
2023-01-22,LH,Hungary,2129,1874,0,0,255,125,130,255,0
2023-01-23,LH,Hungary,1974,1703,4,0,271,139,128,267,4
2023-01-24,LH,Hungary,1764,1557,2,2,207,102,103,205,0
2023-01-25,LH,Hungary,1778,1539,4,0,239,117,118,235,4
2023-01-26,LH,Hungary,1986,1755,1,0,231,117,113,230,1
2023-01-27,LH,Hungary,2099,1789,3,0,310,150,157,307,3
2023-01-28,LH,Hungary,2007,1800,0,0,207,109,98,207,0
2023-01-29,LH,Hungary,2105,1839,5,1,266,126,135,261,4
2023-01-30,LH,Hungary,1875,1603,3,2,272,135,134,269,1
2023-01-31,LH,Hungary,1760,1539,2,2,221,108,111,219,0
2023-02-01,LH,Hungary,1808,1566,3,1,242,119,120,239,2
2023-02-02,LH,Hungary,1840,1621,2,1,219,113,104,217,1
2023-02-03,LH,Hungary,2036,1730,3,1,306,154,149,303,2
2023-02-04,LH,Hungary,1978,1771,0,0,207,105,102,207,0
2023-02-05,LH,Hungary,2042,1787,1,0,255,122,132,254,1
2023-02-06,LH,Hungary,1826,1567,0,0,259,134,125,259,0
2023-02-07,LH,Hungary,1721,1492,3,1,229,109,117,226,2
2023-02-08,LH,Hungary,1778,1527,5,3,251,121,125,246,2
2023-02-09,LH,Hungary,1911,1657,3,1,254,126,125,251,2
2023-02-10,LH,Hungary,2123,1819,2,1,304,152,150,302,1
2023-02-11,LH,Hungary,2075,1864,5,2,211,104,102,206,3
2023-02-12,LH,Hungary,2180,1893,0,0,287,142,145,287,0
2023-02-13,LH,Hungary,1966,1670,6,1,296,147,143,290,5
2023-02-14,LH,Hungary,1835,1622,2,1,213,108,103,211,1
2023-02-15,LH,Hungary,1925,1672,3,1,253,122,128,250,2
2023-02-16,LH,Hungary,2003,1760,5,1,243,119,119,238,4
2023-02-17,LH,Hungary,1933,1650,2,0,283,145,136,281,2
2023-02-18,LH,Hungary,2127,1895,0,0,232,115,117,232,0
2023-02-19,LH,Hungary,2165,1906,2,0,259,126,131,257,2
2023-02-20,LH,Hungary,1973,1676,4,1,297,147,146,293,3
2023-02-21,LH,Hungary,1849,1614,5,1,235,113,117,230,4
2023-02-22,LH,Hungary,1946,1691,4,2,255,129,122,251,2
2023-02-23,LH,Hungary,1964,1697,5,2,267,130,132,262,3
2023-02-24,LH,Hungary,2130,1828,7,0,302,150,145,295,7
2023-02-25,LH,Hungary,2094,1865,1,0,229,113,115,228,1
2023-02-26,LH,Hungary,2207,1946,0,0,261,129,132,261,0
2023-02-27,LH,Hungary,2025,1709,2,0,316,158,156,314,2
2023-02-28,LH,Hungary,1862,1628,0,0,234,116,118,234,0
2023-03-01,LH,Hungary,1946,1694,5,3,252,120,127,247,2
2023-03-02,LH,Hungary,2026,1764,5,3,262,133,124,257,2
2023-03-03,LH,Hungary,2199,1879,3,2,320,160,157,317,1
2023-03-04,LH,Hungary,2097,1877,1,0,220,110,109,219,1
2023-03-05,LH,Hungary,2201,1918,0,0,283,136,147,283,0
2023-03-06,LH,Hungary,2014,1718,1,1,296,149,146,295,0
2023-03-07,LH,Hungary,1851,1634,2,1,217,107,108,215,1
2023-03-08,LH,Hungary,1941,1684,1,1,257,128,128,256,0
2023-03-09,LH,Hungary,2043,1779,0,0,264,129,135,264,0
2023-03-10,LH,Hungary,2165,1856,2,1,309,154,153,307,1
2023-03-11,LH,Hungary,2196,1975,0,0,221,112,109,221,0
2023-03-12,LH,Hungary,2267,1975,1,0,292,139,152,291,1
2023-03-13,LH,Hungary,1984,1695,2,1,289,147,140,287,1
2023-03-14,LH,Hungary,1955,1697,1,1,258,132,125,257,0
2023-03-15,LH,Hungary,1991,1712,8,1,279,133,138,271,7
2023-03-16,LH,Hungary,2035,1755,0,0,280,138,142,280,0
2023-03-17,LH,Hungary,2089,1781,2,0,308,161,145,306,2
2023-03-18,LH,Hungary,2081,1856,2,2,225,109,114,223,0
2023-03-19,LH,Hungary,2181,1889,3,2,292,143,146,289,1
2023-03-20,LH,Hungary,2020,1701,8,1,319,156,155,311,7
2023-03-21,LH,Hungary,1902,1659,6,2,243,117,120,237,4
2023-03-22,LH,Hungary,2005,1711,8,6,294,140,146,286,2
2023-03-23,LH,Hungary,2064,1789,5,4,275,137,133,270,1
2023-03-24,LH,Hungary,2170,1849,1,1,321,164,156,320,0
2023-03-25,LH,Hungary,2115,1877,4,0,238,119,115,234,4
2023-03-26,LH,Hungary,2360,2066,1,1,294,143,150,293,0
2023-03-27,LH,Hungary,1865,1586,2,0,279,137,140,277,2
2023-03-28,LH,Hungary,2364,2032,6,5,332,166,160,326,1
2023-03-29,LH,Hungary,2305,1979,5,3,326,163,158,321,2
2023-03-30,LH,Hungary,2338,2000,10,2,338,165,163,328,8
2023-03-31,LH,Hungary,2388,2056,4,0,332,165,163,328,4
2023-04-01,LH,Hungary,2535,2247,1,0,288,145,142,287,1
2023-04-02,LH,Hungary,2531,2233,1,1,298,144,153,297,0
2023-04-03,LH,Hungary,2439,2123,3,1,316,159,154,313,2
2023-04-04,LH,Hungary,2421,2114,3,1,307,153,151,304,2
2023-04-05,LH,Hungary,2498,2180,3,3,318,159,156,315,0
2023-04-06,LH,Hungary,2576,2233,3,1,343,171,169,340,2
2023-04-07,LH,Hungary,2540,2216,0,0,324,161,163,324,0
2023-04-08,LH,Hungary,2567,2310,0,0,257,129,128,257,0
2023-04-09,LH,Hungary,2561,2285,0,0,276,136,140,276,0
2023-04-10,LH,Hungary,2420,2119,1,0,301,148,152,300,1
2023-04-11,LH,Hungary,2395,2079,7,5,316,153,156,309,2
2023-04-12,LH,Hungary,2374,2062,6,1,312,153,153,306,5
2023-04-13,LH,Hungary,2569,2237,7,7,332,166,159,325,0
2023-04-14,LH,Hungary,2536,2220,3,1,316,152,161,313,2
2023-04-15,LH,Hungary,2668,2388,1,0,280,140,139,279,1
2023-04-16,LH,Hungary,2653,2341,0,0,312,153,159,312,0
2023-04-17,LH,Hungary,2462,2139,2,0,323,163,158,321,2
2023-04-18,LH,Hungary,2495,2169,9,3,326,159,158,317,6
2023-04-19,LH,Hungary,2542,2223,4,1,319,160,155,315,3
2023-04-20,LH,Hungary,2615,2272,7,4,343,165,171,336,3
2023-04-21,LH,Hungary,2556,2201,5,5,355,178,172,350,0
2023-04-22,LH,Hungary,2698,2416,2,2,282,140,140,280,0
2023-04-23,LH,Hungary,2772,2460,2,0,312,149,161,310,2
2023-04-24,LH,Hungary,2536,2199,2,1,337,173,162,335,1
2023-04-25,LH,Hungary,2541,2216,5,0,325,160,160,320,5
2023-04-26,LH,Hungary,2580,2271,1,1,309,154,154,308,0
2023-04-27,LH,Hungary,2775,2417,10,4,358,173,175,348,6
2023-04-28,LH,Hungary,2824,2484,9,5,340,167,164,331,4
2023-04-29,LH,Hungary,2859,2574,3,0,285,143,139,282,3
2023-04-30,LH,Hungary,2847,2555,1,1,292,145,146,291,0
2023-05-01,LH,Hungary,2680,2374,0,0,306,150,156,306,0
2023-05-02,LH,Hungary,2655,2322,10,2,333,163,160,323,8
2023-05-03,LH,Hungary,2683,2351,7,1,332,160,165,325,6
2023-05-04,LH,Hungary,2865,2514,7,5,351,171,173,344,2
2023-05-05,LH,Hungary,2832,2478,14,6,354,173,167,340,8
2023-05-06,LH,Hungary,2941,2662,2,0,279,138,139,277,2
2023-05-07,LH,Hungary,2999,2687,1,0,312,156,155,311,1
2023-05-08,LH,Hungary,2737,2402,10,2,335,165,160,325,8
2023-05-09,LH,Hungary,2637,2319,5,4,318,152,161,313,1
2023-05-10,LH,Hungary,2765,2426,17,10,339,160,162,322,7
2023-05-11,LH,Hungary,2856,2516,7,3,340,165,168,333,4
2023-05-12,LH,Hungary,2972,2621,1,1,351,178,172,350,0
2023-05-13,LH,Hungary,3079,2790,4,1,289,142,143,285,3
2023-05-14,LH,Hungary,3050,2735,1,0,315,155,159,314,1
2023-05-15,LH,Hungary,2740,2413,5,0,327,163,159,322,5
2023-05-16,LH,Hungary,2726,2415,3,1,311,155,153,308,2
2023-05-17,LH,Hungary,2750,2436,1,0,314,157,156,313,1
2023-05-18,LH,Hungary,2902,2582,3,1,320,159,158,317,2
2023-05-19,LH,Hungary,2905,2549,7,2,356,176,173,349,5
2023-05-20,LH,Hungary,3141,2862,4,4,279,136,139,275,0
2023-05-21,LH,Hungary,3176,2853,2,0,323,156,165,321,2
2023-05-22,LH,Hungary,2874,2547,3,1,327,164,160,324,2
2023-05-23,LH,Hungary,2776,2457,6,2,319,159,154,313,4
2023-05-24,LH,Hungary,2946,2617,5,1,329,161,163,324,4
2023-05-25,LH,Hungary,3049,2703,7,4,346,168,171,339,3
2023-05-26,LH,Hungary,3191,2833,4,0,358,183,171,354,4
2023-05-27,LH,Hungary,3324,3036,3,0,288,141,144,285,3
2023-05-28,LH,Hungary,3210,2892,3,1,318,155,160,315,2
2023-05-29,LH,Hungary,2993,2660,1,0,333,163,169,332,1
2023-05-30,LH,Hungary,2972,2604,10,1,368,174,184,358,9
2023-05-31,LH,Hungary,3133,2709,9,4,424,182,233,415,5
2023-06-01,LH,Hungary,3366,2916,8,4,450,249,193,442,4
2023-06-02,LH,Hungary,3389,3042,4,1,347,172,171,343,3
2023-06-03,LH,Hungary,3478,3185,4,1,293,150,139,289,3
2023-06-04,LH,Hungary,3532,3197,4,2,335,161,170,331,2
2023-06-05,LH,Hungary,3173,2839,3,1,334,168,163,331,2
2023-06-06,LH,Hungary,3142,2805,3,1,337,168,166,334,2
2023-06-07,LH,Hungary,3257,2909,7,4,348,169,172,341,3
2023-06-08,LH,Hungary,3263,2909,2,1,354,180,172,352,1
2023-06-09,LH,Hungary,3350,2996,5,0,354,176,173,349,5
2023-06-10,LH,Hungary,3515,3217,0,0,298,147,151,298,0
2023-06-11,LH,Hungary,3490,3137,1,0,353,176,176,352,1
2023-06-12,LH,Hungary,3167,2811,6,2,356,173,177,350,4
2023-06-13,LH,Hungary,3202,2856,6,6,346,170,170,340,0
2023-06-14,LH,Hungary,3269,2919,5,0,350,175,170,345,5
2023-06-15,LH,Hungary,3357,2969,7,5,388,190,191,381,2
2023-06-16,LH,Hungary,3450,3055,10,2,395,197,188,385,8
2023-06-17,LH,Hungary,3542,3236,1,0,306,155,150,305,1
2023-06-18,LH,Hungary,3521,3162,0,0,359,174,185,359,0
2023-06-19,LH,Hungary,3280,2921,9,3,359,176,174,350,6
2023-06-20,LH,Hungary,3269,2934,6,4,335,169,160,329,2
2023-06-21,LH,Hungary,3446,3065,6,2,381,182,193,375,4
2023-06-22,LH,Hungary,3414,3049,8,1,365,186,171,357,7
2023-06-23,LH,Hungary,3780,3411,5,1,369,179,185,364,4
2023-06-24,LH,Hungary,3743,3415,1,0,328,166,161,327,1
2023-06-25,LH,Hungary,3686,3315,2,1,371,182,187,369,1
2023-06-26,LH,Hungary,3443,3093,1,1,350,172,177,349,0
2023-06-27,LH,Hungary,3462,3088,3,2,374,188,183,371,1
2023-06-28,LH,Hungary,3571,3180,6,4,391,189,196,385,2
2023-06-29,LH,Hungary,3542,3160,8,7,382,189,185,374,1
2023-06-30,LH,Hungary,3750,3340,8,2,410,201,201,402,6
2023-07-01,LH,Hungary,3895,3564,2,1,331,162,167,329,1
2023-07-02,LH,Hungary,3765,3379,3,2,386,188,195,383,1
2023-07-03,LH,Hungary,3612,3228,3,0,384,190,191,381,3
2023-07-04,LH,Hungary,3684,3309,2,2,375,191,182,373,0
2023-07-05,LH,Hungary,3732,3341,11,8,391,192,188,380,3
2023-07-06,LH,Hungary,3676,3307,4,1,369,183,182,365,3
2023-07-07,LH,Hungary,3876,3478,2,2,398,198,198,396,0
2023-07-08,LH,Hungary,3821,3505,0,0,316,161,155,316,0
2023-07-09,LH,Hungary,3736,3373,0,0,363,176,187,363,0
2023-07-10,LH,Hungary,3645,3255,7,1,390,193,190,383,6
2023-07-11,LH,Hungary,3591,3221,4,3,370,184,182,366,1
2023-07-12,LH,Hungary,3724,3335,4,1,389,196,189,385,3
2023-07-13,LH,Hungary,3663,3318,5,4,345,170,170,340,1
2023-07-14,LH,Hungary,3810,3421,2,2,389,196,191,387,0
2023-07-15,LH,Hungary,3728,3423,0,0,305,152,153,305,0
2023-07-16,LH,Hungary,3730,3367,1,0,363,174,188,362,1
2023-07-17,LH,Hungary,3611,3238,4,3,373,186,183,369,1
2023-07-18,LH,Hungary,3836,3475,8,5,361,182,171,353,3
2023-07-19,LH,Hungary,3901,3523,4,2,378,186,188,374,2
2023-07-20,LH,Hungary,3776,3366,6,5,410,199,205,404,1
2023-07-21,LH,Hungary,3854,3449,3,2,405,198,204,402,1
2023-07-22,LH,Hungary,3909,3569,0,0,340,165,175,340,0
2023-07-23,LH,Hungary,3884,3466,0,0,418,212,206,418,0
2023-07-24,LH,Hungary,3756,3345,5,1,411,207,199,406,4
2023-07-25,LH,Hungary,3671,3299,2,0,372,184,186,370,2
2023-07-26,LH,Hungary,3757,3395,3,0,362,182,177,359,3
2023-07-27,LH,Hungary,3722,3356,7,3,366,181,178,359,4
2023-07-28,LH,Hungary,3926,3547,3,0,379,188,188,376,3
2023-07-29,LH,Hungary,3826,3513,2,0,313,159,152,311,2
2023-07-30,LH,Hungary,3781,3435,0,0,346,165,181,346,0
2023-07-31,LH,Hungary,3630,3269,2,1,361,180,179,359,1
2023-08-01,LH,Hungary,3720,3357,8,7,363,181,174,355,1
2023-08-02,LH,Hungary,3704,3358,6,5,346,172,168,340,1
2023-08-03,LH,Hungary,3719,3379,4,4,340,165,171,336,0
2023-08-04,LH,Hungary,3983,3626,1,0,357,180,176,356,1
2023-08-05,LH,Hungary,3677,3366,2,0,311,154,155,309,2
2023-08-06,LH,Hungary,3920,3565,0,0,355,173,182,355,0
2023-08-07,LH,Hungary,3741,3404,2,0,337,169,166,335,2
2023-08-08,LH,Hungary,3750,3398,5,2,352,180,167,347,3
2023-08-09,LH,Hungary,3772,3409,8,3,363,173,182,355,5
2023-08-10,LH,Hungary,3709,3355,7,3,354,175,172,347,4
2023-08-11,LH,Hungary,3819,3444,7,5,375,183,185,368,2
2023-08-12,LH,Hungary,3788,3479,0,0,309,157,152,309,0
2023-08-13,LH,Hungary,3839,3479,0,0,360,176,184,360,0
2023-08-14,LH,Hungary,3631,3284,1,1,347,174,172,346,0
2023-08-15,LH,Hungary,3638,3298,4,4,340,169,167,336,0
2023-08-16,LH,Hungary,3719,3379,2,2,340,171,167,338,0
2023-08-17,LH,Hungary,3639,3291,2,1,348,171,175,346,1
2023-08-18,LH,Hungary,3833,3478,1,1,355,180,174,354,0
2023-08-19,LH,Hungary,3821,3510,0,0,311,149,162,311,0
2023-08-20,LH,Hungary,3814,3444,4,4,370,178,188,366,0
2023-08-21,LH,Hungary,3594,3227,1,0,367,190,176,366,1
2023-08-22,LH,Hungary,3564,3232,2,1,332,169,161,330,1
2023-08-23,LH,Hungary,3684,3315,6,1,369,180,183,363,5
2023-08-24,LH,Hungary,3621,3259,10,3,362,175,177,352,7
2023-08-25,LH,Hungary,3836,3466,4,1,370,183,183,366,3
2023-08-26,LH,Hungary,3811,3510,1,0,301,148,152,300,1
2023-08-27,LH,Hungary,3776,3422,1,0,354,173,180,353,1
2023-08-28,LH,Hungary,3555,3213,2,0,342,171,169,340,2
2023-08-29,LH,Hungary,3504,3164,4,0,340,171,165,336,4
2023-08-30,LH,Hungary,3683,3326,4,1,357,176,177,353,3
2023-08-31,LH,Hungary,3748,3369,3,2,379,189,187,376,1
2023-09-01,LH,Hungary,3769,3396,4,2,373,186,183,369,2
2023-09-02,LH,Hungary,3802,3494,2,0,308,154,152,306,2
2023-09-03,LH,Hungary,3762,3403,3,2,359,172,184,356,1
2023-09-04,LH,Hungary,3465,3120,0,0,345,173,172,345,0
2023-09-05,LH,Hungary,3478,3134,2,1,344,171,171,342,1
2023-09-06,LH,Hungary,3628,3250,3,1,378,184,191,375,2
2023-09-07,LH,Hungary,3594,3225,2,1,369,183,184,367,1
2023-09-08,LH,Hungary,3665,3276,2,0,389,195,192,387,2
2023-09-09,LH,Hungary,3706,3394,0,0,312,159,153,312,0
2023-09-10,LH,Hungary,3665,3307,2,0,358,174,182,356,2
2023-09-11,LH,Hungary,3395,3035,6,3,360,181,173,354,3
2023-09-12,LH,Hungary,3388,3023,2,0,365,185,178,363,2
2023-09-13,LH,Hungary,3582,3220,3,2,362,176,183,359,1
2023-09-14,LH,Hungary,3496,3116,1,0,380,191,188,379,1
2023-09-15,LH,Hungary,3649,3261,3,3,388,195,190,385,0
2023-09-16,LH,Hungary,3697,3384,4,0,313,155,154,309,4
2023-09-17,LH,Hungary,3656,3315,4,0,341,161,176,337,4
2023-09-18,LH,Hungary,3432,3056,6,4,376,186,184,370,2
2023-09-19,LH,Hungary,3327,2971,3,1,356,176,177,353,2
2023-09-20,LH,Hungary,3438,3075,4,2,363,181,178,359,2
2023-09-21,LH,Hungary,3508,3139,6,2,369,181,182,363,4
2023-09-22,LH,Hungary,3603,3242,0,0,361,179,182,361,0
2023-09-23,LH,Hungary,3646,3340,4,1,306,152,150,302,3
2023-09-24,LH,Hungary,3533,3173,0,0,360,177,183,360,0
2023-09-25,LH,Hungary,3322,2963,0,0,359,182,177,359,0
2023-09-26,LH,Hungary,3089,2733,0,0,356,180,176,356,0
2023-09-27,LH,Hungary,3450,3106,3,1,344,171,170,341,2
2023-09-28,LH,Hungary,3469,3102,5,1,367,178,184,362,4
2023-09-29,LH,Hungary,3511,3130,6,0,381,187,188,375,6
2023-09-30,LH,Hungary,3572,3280,3,1,292,150,139,289,2
2023-10-01,LH,Hungary,3487,3144,1,1,343,166,176,342,0
2023-10-02,LH,Hungary,3184,2833,0,0,351,179,172,351,0
2023-01-01,EI,Ireland,1235,539,7,0,696,346,343,689,7
2023-01-02,EI,Ireland,1372,672,10,0,700,342,348,690,10
2023-01-03,EI,Ireland,1307,599,11,0,708,348,349,697,11
2023-01-04,EI,Ireland,1302,571,17,3,731,355,359,714,14
2023-01-05,EI,Ireland,1375,655,13,3,720,352,355,707,10
2023-01-06,EI,Ireland,1495,698,18,3,797,387,392,779,15
2023-01-07,EI,Ireland,1159,496,10,0,663,331,322,653,10
2023-01-08,EI,Ireland,1264,515,11,1,749,368,370,738,10
2023-01-09,EI,Ireland,1192,538,15,3,654,317,322,639,12
2023-01-10,EI,Ireland,1175,607,15,3,568,279,274,553,12
2023-01-11,EI,Ireland,964,388,12,0,576,283,281,564,12
2023-01-12,EI,Ireland,1093,494,9,2,599,292,298,590,7
2023-01-13,EI,Ireland,1260,525,16,3,735,355,364,719,13
2023-01-14,EI,Ireland,1186,569,11,4,617,305,301,606,7
2023-01-15,EI,Ireland,1184,486,15,6,698,339,344,683,9
2023-01-16,EI,Ireland,1191,515,23,11,676,326,327,653,12
2023-01-17,EI,Ireland,1144,572,13,2,572,284,275,559,11
2023-01-18,EI,Ireland,1124,549,13,2,575,281,281,562,11
2023-01-19,EI,Ireland,1216,612,14,3,604,292,298,590,11
2023-01-20,EI,Ireland,1405,669,11,1,736,364,361,725,10
2023-01-21,EI,Ireland,1293,678,12,1,615,304,299,603,11
2023-01-22,EI,Ireland,1239,564,8,0,675,333,334,667,8
2023-01-23,EI,Ireland,1263,626,18,2,637,308,311,619,16
2023-01-24,EI,Ireland,1172,582,16,2,590,292,282,574,14
2023-01-25,EI,Ireland,1131,555,22,4,576,272,282,554,18
2023-01-26,EI,Ireland,1174,540,17,2,634,308,309,617,15
2023-01-27,EI,Ireland,1358,642,17,7,716,351,348,699,10
2023-01-28,EI,Ireland,1166,570,10,1,596,293,293,586,9
2023-01-29,EI,Ireland,1128,441,11,1,687,334,342,676,10
2023-01-30,EI,Ireland,1295,637,13,2,658,326,319,645,11
2023-01-31,EI,Ireland,1141,555,11,1,586,289,286,575,10
2023-02-01,EI,Ireland,1131,556,12,1,575,278,285,563,11
2023-02-02,EI,Ireland,1193,577,13,3,616,304,299,603,10
2023-02-03,EI,Ireland,1388,632,21,3,756,363,372,735,18
2023-02-04,EI,Ireland,1202,556,11,2,646,319,316,635,9
2023-02-05,EI,Ireland,1366,666,10,3,700,345,345,690,7
2023-02-06,EI,Ireland,1361,719,12,2,642,311,319,630,10
2023-02-07,EI,Ireland,1199,629,15,4,570,275,280,555,11
2023-02-08,EI,Ireland,1097,487,13,2,610,301,296,597,11
2023-02-09,EI,Ireland,1141,523,12,3,618,307,299,606,9
2023-02-10,EI,Ireland,1445,574,31,6,871,411,429,840,25
2023-02-11,EI,Ireland,1321,666,11,1,655,325,319,644,10
2023-02-12,EI,Ireland,1523,716,17,2,807,400,390,790,15
2023-02-13,EI,Ireland,1353,669,13,1,684,338,333,671,12
2023-02-14,EI,Ireland,1228,639,13,3,589,286,290,576,10
2023-02-15,EI,Ireland,1175,553,16,3,622,304,302,606,13
2023-02-16,EI,Ireland,1336,703,17,6,633,308,308,616,11
2023-02-17,EI,Ireland,1347,600,14,2,747,365,368,733,12
2023-02-18,EI,Ireland,1248,589,9,1,659,329,321,650,8
2023-02-19,EI,Ireland,1293,558,10,1,735,358,367,725,9
2023-02-20,EI,Ireland,1380,679,16,2,701,345,340,685,14
2023-02-21,EI,Ireland,1284,689,17,5,595,289,289,578,12
2023-02-22,EI,Ireland,1250,633,17,5,617,298,302,600,12
2023-02-23,EI,Ireland,1284,629,20,3,655,317,318,635,17
2023-02-24,EI,Ireland,1380,583,12,1,797,389,396,785,11
2023-02-25,EI,Ireland,1353,697,12,2,656,326,318,644,10
2023-02-26,EI,Ireland,1516,762,9,1,754,372,373,745,8
2023-02-27,EI,Ireland,1404,712,14,3,692,341,337,678,11
2023-02-28,EI,Ireland,1342,737,14,1,605,296,295,591,13
2023-03-01,EI,Ireland,1417,786,13,1,631,309,309,618,12
2023-03-02,EI,Ireland,1414,746,17,3,668,322,329,651,14
2023-03-03,EI,Ireland,1505,713,14,3,792,390,388,778,11
2023-03-04,EI,Ireland,1359,700,14,2,659,328,317,645,12
2023-03-05,EI,Ireland,1417,695,12,3,722,354,356,710,9
2023-03-06,EI,Ireland,1220,527,13,2,693,340,340,680,11
2023-03-07,EI,Ireland,1309,713,15,5,596,290,291,581,10
2023-03-08,EI,Ireland,1259,628,12,2,631,310,309,619,10
2023-03-09,EI,Ireland,1323,684,11,1,639,315,313,628,10
2023-03-10,EI,Ireland,1340,565,11,2,775,381,383,764,9
2023-03-11,EI,Ireland,1403,718,11,3,685,339,335,674,8
2023-03-12,EI,Ireland,1527,766,10,1,761,372,379,751,9
2023-03-13,EI,Ireland,1409,706,14,3,703,347,342,689,11
2023-03-14,EI,Ireland,1344,702,16,4,642,315,311,626,12
2023-03-15,EI,Ireland,1405,715,12,2,690,337,341,678,10
2023-03-16,EI,Ireland,1420,687,23,6,733,349,361,710,17
2023-03-17,EI,Ireland,1588,756,15,6,832,406,411,817,9
2023-03-18,EI,Ireland,1355,659,25,10,696,333,338,671,15
2023-03-19,EI,Ireland,1578,735,15,5,843,421,407,828,10
2023-03-20,EI,Ireland,1486,760,12,0,726,360,354,714,12
2023-03-21,EI,Ireland,1252,619,20,7,633,313,300,613,13
2023-03-22,EI,Ireland,1157,502,17,7,655,318,320,638,10
2023-03-23,EI,Ireland,1323,643,16,6,680,332,332,664,10
2023-03-24,EI,Ireland,1377,582,15,1,795,390,390,780,14
2023-03-25,EI,Ireland,1385,727,16,7,658,325,317,642,9
2023-03-26,EI,Ireland,1612,782,19,6,830,401,410,811,13
2023-03-27,EI,Ireland,1505,700,17,5,805,400,388,788,12
2023-03-28,EI,Ireland,1462,653,17,4,809,395,397,792,13
2023-03-29,EI,Ireland,1434,624,19,6,810,395,396,791,13
2023-03-30,EI,Ireland,1532,692,21,7,840,406,413,819,14
2023-03-31,EI,Ireland,1519,647,24,9,872,419,429,848,15
2023-04-01,EI,Ireland,1448,709,14,2,739,367,358,725,12
2023-04-02,EI,Ireland,1672,814,18,7,858,417,423,840,11
2023-04-03,EI,Ireland,1601,769,19,5,832,416,397,813,14
2023-04-04,EI,Ireland,1522,703,23,9,819,397,399,796,14
2023-04-05,EI,Ireland,1506,672,21,3,834,406,407,813,18
2023-04-06,EI,Ireland,1566,717,17,3,849,415,417,832,14
2023-04-07,EI,Ireland,1586,718,16,4,868,428,424,852,12
2023-04-08,EI,Ireland,1405,687,12,0,718,352,354,706,12
2023-04-09,EI,Ireland,1506,686,15,1,820,405,400,805,14
2023-04-10,EI,Ireland,1355,552,8,1,803,399,396,795,7
2023-04-11,EI,Ireland,1380,564,15,0,816,397,404,801,15
2023-04-12,EI,Ireland,1361,539,16,2,822,400,406,806,14
2023-04-13,EI,Ireland,1394,555,23,7,839,403,413,816,16
2023-04-14,EI,Ireland,1626,733,28,2,893,434,431,865,26
2023-04-15,EI,Ireland,1540,777,11,1,763,378,374,752,10
2023-04-16,EI,Ireland,1723,863,14,2,860,424,422,846,12
2023-04-17,EI,Ireland,1622,779,14,2,843,411,418,829,12
2023-04-18,EI,Ireland,1600,756,18,4,844,412,414,826,14
2023-04-19,EI,Ireland,1584,746,16,3,838,416,406,822,13
2023-04-20,EI,Ireland,1614,764,19,6,850,418,413,831,13
2023-04-21,EI,Ireland,1688,796,22,4,892,432,438,870,18
2023-04-22,EI,Ireland,1586,842,9,0,744,368,367,735,9
2023-04-23,EI,Ireland,1637,781,14,0,856,418,424,842,14
2023-04-24,EI,Ireland,1635,787,16,3,848,413,419,832,13
2023-04-25,EI,Ireland,1627,772,19,3,855,422,414,836,16
2023-04-26,EI,Ireland,1549,705,19,5,844,408,417,825,14
2023-04-27,EI,Ireland,1703,842,16,2,861,429,416,845,14
2023-04-28,EI,Ireland,1710,831,17,4,879,427,435,862,13
2023-04-29,EI,Ireland,1578,841,10,0,737,367,360,727,10
2023-04-30,EI,Ireland,1587,748,13,1,839,413,413,826,12
2023-05-01,EI,Ireland,1684,850,11,3,834,412,411,823,8
2023-05-02,EI,Ireland,1647,755,19,2,892,435,438,873,17
2023-05-03,EI,Ireland,1779,913,17,4,866,423,426,849,13
2023-05-04,EI,Ireland,1757,871,15,0,886,435,436,871,15
2023-05-05,EI,Ireland,1662,737,18,2,925,454,453,907,16
2023-05-06,EI,Ireland,1460,687,10,2,773,379,384,763,8
2023-05-07,EI,Ireland,1754,842,15,2,912,451,446,897,13
2023-05-08,EI,Ireland,1556,691,22,2,865,424,419,843,20
2023-05-09,EI,Ireland,1658,786,18,5,872,426,428,854,13
2023-05-10,EI,Ireland,1735,871,14,2,864,421,429,850,12
2023-05-11,EI,Ireland,1737,834,20,2,903,441,442,883,18
2023-05-12,EI,Ireland,1908,968,18,2,940,457,465,922,16
2023-05-13,EI,Ireland,1568,796,15,3,772,384,373,757,12
2023-05-14,EI,Ireland,1746,828,12,3,918,450,456,906,9
2023-05-15,EI,Ireland,1810,921,17,2,889,428,444,872,15
2023-05-16,EI,Ireland,1844,923,20,2,921,458,443,901,18
2023-05-17,EI,Ireland,1851,948,23,4,903,437,443,880,19
2023-05-18,EI,Ireland,1660,755,19,3,905,441,445,886,16
2023-05-19,EI,Ireland,1738,801,14,2,937,460,463,923,12
2023-05-20,EI,Ireland,1588,784,8,0,804,395,401,796,8
2023-05-21,EI,Ireland,1769,835,12,1,934,461,461,922,11
2023-05-22,EI,Ireland,1733,824,25,6,909,449,435,884,19
2023-05-23,EI,Ireland,1664,782,15,2,882,434,433,867,13
2023-05-24,EI,Ireland,1742,828,17,1,914,449,448,897,16
2023-05-25,EI,Ireland,1707,820,20,1,887,432,435,867,19
2023-05-26,EI,Ireland,1822,872,18,1,950,463,469,932,17
2023-05-27,EI,Ireland,1544,748,9,0,796,392,395,787,9
2023-05-28,EI,Ireland,1801,888,16,3,913,448,449,897,13
2023-05-29,EI,Ireland,1780,910,23,5,870,427,420,847,18
2023-05-30,EI,Ireland,1635,729,17,1,906,442,447,889,16
2023-05-31,EI,Ireland,1716,794,20,2,922,453,449,902,18
2023-06-01,EI,Ireland,1728,792,22,6,936,450,464,914,16
2023-06-02,EI,Ireland,1792,821,19,5,971,479,473,952,14
2023-06-03,EI,Ireland,1732,893,12,2,839,413,414,827,10
2023-06-04,EI,Ireland,1931,1008,9,1,923,458,456,914,8
2023-06-05,EI,Ireland,1815,918,13,2,897,448,436,884,11
2023-06-06,EI,Ireland,1849,976,20,2,873,420,433,853,18
2023-06-07,EI,Ireland,1825,913,20,5,912,448,444,892,15
2023-06-08,EI,Ireland,1846,933,18,1,913,446,449,895,17
2023-06-09,EI,Ireland,2001,1037,21,2,964,471,472,943,19
2023-06-10,EI,Ireland,1696,876,8,0,820,409,403,812,8
2023-06-11,EI,Ireland,1799,886,15,3,913,445,453,898,12
2023-06-12,EI,Ireland,1874,956,20,2,918,454,444,898,18
2023-06-13,EI,Ireland,1809,884,18,2,925,454,453,907,16
2023-06-14,EI,Ireland,1844,937,16,1,907,443,448,891,15
2023-06-15,EI,Ireland,1846,924,22,6,922,454,446,900,16
2023-06-16,EI,Ireland,1756,791,18,3,965,469,478,947,15
2023-06-17,EI,Ireland,1687,854,18,7,833,409,406,815,11
2023-06-18,EI,Ireland,1844,910,14,5,934,459,461,920,9
2023-06-19,EI,Ireland,1648,746,21,7,902,443,438,881,14
2023-06-20,EI,Ireland,1686,750,20,1,936,454,462,916,19
2023-06-21,EI,Ireland,1896,964,19,0,932,451,462,913,19
2023-06-22,EI,Ireland,2019,1073,22,2,946,465,459,924,20
2023-06-23,EI,Ireland,1909,950,18,2,959,473,468,941,16
2023-06-24,EI,Ireland,1669,833,12,1,836,411,413,824,11
2023-06-25,EI,Ireland,1552,589,14,2,963,483,466,949,12
2023-06-26,EI,Ireland,1678,772,16,2,906,440,450,890,14
2023-06-27,EI,Ireland,1853,914,27,8,939,459,453,912,19
2023-06-28,EI,Ireland,1875,960,20,7,915,446,449,895,13
2023-06-29,EI,Ireland,1818,884,24,3,934,454,456,910,21
2023-06-30,EI,Ireland,1879,894,20,4,985,480,485,965,16
2023-07-01,EI,Ireland,1635,787,11,1,848,419,418,837,10
2023-07-02,EI,Ireland,1750,825,12,1,925,457,456,913,11
2023-07-03,EI,Ireland,1767,844,19,2,923,457,447,904,17
2023-07-04,EI,Ireland,1696,767,17,2,929,455,457,912,15
2023-07-05,EI,Ireland,1767,854,20,5,913,445,448,893,15
2023-07-06,EI,Ireland,1763,847,15,0,916,446,455,901,15
2023-07-07,EI,Ireland,1937,952,15,2,985,485,485,970,13
2023-07-08,EI,Ireland,1718,857,9,0,861,426,426,852,9
2023-07-09,EI,Ireland,1696,761,14,3,935,461,460,921,11
2023-07-10,EI,Ireland,1772,862,18,5,910,447,445,892,13
2023-07-11,EI,Ireland,1841,911,16,3,930,453,461,914,13
2023-07-12,EI,Ireland,1927,1002,16,3,925,457,452,909,13
2023-07-13,EI,Ireland,1886,961,17,2,925,456,452,908,15
2023-07-14,EI,Ireland,1929,999,16,1,930,457,457,914,15
2023-07-15,EI,Ireland,1640,802,9,0,838,411,418,829,9
2023-07-16,EI,Ireland,1878,922,13,1,956,470,473,943,12
2023-07-17,EI,Ireland,1928,972,18,1,956,470,468,938,17
2023-07-18,EI,Ireland,1938,999,16,2,939,466,457,923,14
2023-07-19,EI,Ireland,1904,964,16,1,940,459,465,924,15
2023-07-20,EI,Ireland,1819,891,17,2,928,459,452,911,15
2023-07-21,EI,Ireland,1785,825,20,2,960,471,469,940,18
2023-07-22,EI,Ireland,1747,917,10,0,830,405,415,820,10
2023-07-23,EI,Ireland,1915,981,11,1,934,465,458,923,10
2023-07-24,EI,Ireland,1733,839,16,2,894,439,439,878,14
2023-07-25,EI,Ireland,1783,863,16,3,920,450,454,904,13
2023-07-26,EI,Ireland,1866,935,12,0,931,461,458,919,12
2023-07-27,EI,Ireland,1739,806,16,2,933,457,460,917,14
2023-07-28,EI,Ireland,1678,712,18,2,966,476,472,948,16
2023-07-29,EI,Ireland,1579,736,16,1,843,413,414,827,15
2023-07-30,EI,Ireland,1768,810,15,4,958,473,470,943,11
2023-07-31,EI,Ireland,1560,639,21,7,921,454,446,900,14
2023-08-01,EI,Ireland,1626,695,16,5,931,454,461,915,11
2023-08-02,EI,Ireland,1658,726,22,8,932,456,454,910,14
2023-08-03,EI,Ireland,1559,636,23,4,923,448,452,900,19
2023-08-04,EI,Ireland,1592,621,16,2,971,478,477,955,14
2023-08-05,EI,Ireland,1500,647,16,1,853,417,420,837,15
2023-08-06,EI,Ireland,1733,799,18,1,934,460,456,916,17
2023-08-07,EI,Ireland,1760,836,14,3,924,454,456,910,11
2023-08-08,EI,Ireland,1739,808,17,4,931,454,460,914,13
2023-08-09,EI,Ireland,1847,941,20,3,906,443,443,886,17
2023-08-10,EI,Ireland,1828,911,21,0,917,452,444,896,21
2023-08-11,EI,Ireland,1800,840,21,8,960,465,474,939,13
2023-08-12,EI,Ireland,1409,564,15,2,845,416,414,830,13
2023-08-13,EI,Ireland,1710,760,15,1,950,466,469,935,14
2023-08-14,EI,Ireland,1792,889,20,2,903,445,438,883,18
2023-08-15,EI,Ireland,1768,841,17,3,927,455,455,910,14
2023-08-16,EI,Ireland,1852,949,17,3,903,447,439,886,14
2023-08-17,EI,Ireland,1817,888,20,7,929,451,458,909,13
2023-08-18,EI,Ireland,1804,839,20,2,965,476,469,945,18
2023-08-19,EI,Ireland,1619,761,14,1,858,421,423,844,13
2023-08-20,EI,Ireland,1639,681,15,3,958,464,479,943,12
2023-08-21,EI,Ireland,1845,937,18,3,908,454,436,890,15
2023-08-22,EI,Ireland,1806,874,18,3,932,454,460,914,15
2023-08-23,EI,Ireland,1841,886,26,4,955,459,470,929,22
2023-08-24,EI,Ireland,1883,938,20,3,945,457,468,925,17
2023-08-25,EI,Ireland,1960,1026,15,1,934,455,464,919,14
2023-08-26,EI,Ireland,1644,812,11,1,832,411,410,821,10
2023-08-27,EI,Ireland,1658,708,16,2,950,481,453,934,14
2023-08-28,EI,Ireland,1540,760,18,3,780,383,379,762,15
2023-08-29,EI,Ireland,1687,757,16,1,930,455,459,914,15
2023-08-30,EI,Ireland,1853,936,14,1,917,456,447,903,13
2023-08-31,EI,Ireland,1785,829,19,2,956,466,471,937,17
2023-09-01,EI,Ireland,1806,863,14,2,943,464,465,929,12
2023-09-02,EI,Ireland,1692,859,12,0,833,407,414,821,12
2023-09-03,EI,Ireland,1671,733,12,0,938,463,463,926,12
2023-09-04,EI,Ireland,1940,1006,14,2,934,467,453,920,12
2023-09-05,EI,Ireland,1901,969,18,3,932,455,459,914,15
2023-09-06,EI,Ireland,1873,961,17,1,912,443,452,895,16
2023-09-07,EI,Ireland,1921,968,15,3,953,464,474,938,12
2023-09-08,EI,Ireland,1935,963,19,3,972,480,473,953,16
2023-09-09,EI,Ireland,1709,870,11,1,839,412,416,828,10
2023-09-10,EI,Ireland,1817,866,11,2,951,473,467,940,9
2023-09-11,EI,Ireland,1803,889,18,3,914,452,444,896,15
2023-09-12,EI,Ireland,1778,824,16,0,954,464,474,938,16
2023-09-13,EI,Ireland,1702,774,13,1,928,456,459,915,12
2023-09-14,EI,Ireland,1842,889,17,4,953,472,464,936,13
2023-09-15,EI,Ireland,1828,868,14,2,960,470,476,946,12
2023-09-16,EI,Ireland,1559,721,13,1,838,410,415,825,12
2023-09-17,EI,Ireland,1676,716,15,0,960,473,472,945,15
2023-09-18,EI,Ireland,1638,721,16,2,917,453,448,901,14
2023-09-19,EI,Ireland,1786,877,16,1,909,446,447,893,15
2023-09-20,EI,Ireland,1710,797,20,5,913,446,447,893,15
2023-09-21,EI,Ireland,1836,891,17,3,945,463,465,928,14
2023-09-22,EI,Ireland,2011,994,15,2,1017,503,499,1002,13
2023-09-23,EI,Ireland,1619,790,13,4,829,412,404,816,9
2023-09-24,EI,Ireland,1801,801,11,1,1000,481,508,989,10
2023-09-25,EI,Ireland,1802,874,14,2,928,467,447,914,12
2023-09-26,EI,Ireland,1576,641,17,5,935,459,459,918,12
2023-09-27,EI,Ireland,1632,775,16,3,857,423,418,841,13
2023-09-28,EI,Ireland,1766,806,19,6,960,467,474,941,13
2023-09-29,EI,Ireland,1870,911,21,5,959,474,464,938,16
2023-09-30,EI,Ireland,1707,883,6,0,824,410,408,818,6
2023-10-01,EI,Ireland,1809,900,10,1,909,448,451,899,9
2023-10-02,EI,Ireland,1792,887,21,9,905,440,444,884,12
2023-01-01,LL,Israel,570,93,42,1,477,212,223,435,41
2023-01-02,LL,Israel,580,77,47,1,503,228,228,456,46
2023-01-03,LL,Israel,540,98,49,5,442,198,195,393,44
2023-01-04,LL,Israel,550,96,48,7,454,205,201,406,41
2023-01-05,LL,Israel,592,96,37,1,496,230,229,459,36
2023-01-06,LL,Israel,496,143,15,0,353,175,163,338,15
2023-01-07,LL,Israel,448,128,20,0,320,142,158,300,20
2023-01-08,LL,Israel,621,103,45,5,518,241,232,473,40
2023-01-09,LL,Israel,499,74,47,8,425,196,182,378,39
2023-01-10,LL,Israel,485,93,36,4,392,176,180,356,32
2023-01-11,LL,Israel,515,88,55,4,427,184,188,372,51
2023-01-12,LL,Israel,573,92,38,1,481,225,218,443,37
2023-01-13,LL,Israel,475,152,14,0,323,155,154,309,14
2023-01-14,LL,Israel,470,147,19,0,323,146,158,304,19
2023-01-15,LL,Israel,605,90,45,0,515,234,236,470,45
2023-01-16,LL,Israel,514,83,55,6,431,192,184,376,49
2023-01-17,LL,Israel,497,95,49,4,402,176,177,353,45
2023-01-18,LL,Israel,481,78,42,5,403,179,182,361,37
2023-01-19,LL,Israel,577,81,44,1,496,233,219,452,43
2023-01-20,LL,Israel,484,151,12,1,333,163,158,321,11
2023-01-21,LL,Israel,463,148,21,0,315,141,153,294,21
2023-01-22,LL,Israel,598,92,42,3,506,230,234,464,39
2023-01-23,LL,Israel,505,65,60,8,440,190,190,380,52
2023-01-24,LL,Israel,488,88,51,6,400,177,172,349,45
2023-01-25,LL,Israel,471,72,45,8,399,175,179,354,37
2023-01-26,LL,Israel,565,87,39,5,478,220,219,439,34
2023-01-27,LL,Israel,429,133,18,2,296,145,133,278,16
2023-01-28,LL,Israel,476,152,22,0,324,143,159,302,22
2023-01-29,LL,Israel,611,98,51,1,513,233,229,462,50
2023-01-30,LL,Israel,531,83,55,6,448,196,197,393,49
2023-01-31,LL,Israel,483,111,23,0,372,180,169,349,23
2023-02-01,LL,Israel,513,83,45,0,430,192,193,385,45
2023-02-02,LL,Israel,609,114,48,2,495,227,220,447,46
2023-02-03,LL,Israel,498,158,14,0,340,164,162,326,14
2023-02-04,LL,Israel,482,169,19,0,313,143,151,294,19
2023-02-05,LL,Israel,620,106,61,2,514,228,225,453,59
2023-02-06,LL,Israel,493,78,34,4,415,190,191,381,30
2023-02-07,LL,Israel,503,111,41,0,392,178,173,351,41
2023-02-08,LL,Israel,526,86,46,4,440,197,197,394,42
2023-02-09,LL,Israel,623,131,43,0,492,222,227,449,43
2023-02-10,LL,Israel,500,173,21,5,327,156,150,306,16
2023-02-11,LL,Israel,454,150,19,0,304,137,148,285,19
2023-02-12,LL,Israel,611,106,48,6,505,230,227,457,42
2023-02-13,LL,Israel,546,77,61,8,469,208,200,408,53
2023-02-14,LL,Israel,508,102,37,2,406,188,181,369,35
2023-02-15,LL,Israel,541,79,51,4,462,200,211,411,47
2023-02-16,LL,Israel,618,127,36,2,491,230,225,455,34
2023-02-17,LL,Israel,441,148,13,2,293,143,137,280,11
2023-02-18,LL,Israel,475,133,25,0,342,151,166,317,25
2023-02-19,LL,Israel,614,94,40,4,520,239,241,480,36
2023-02-20,LL,Israel,531,85,41,3,446,202,203,405,38
2023-02-21,LL,Israel,507,98,28,3,409,194,187,381,25
2023-02-22,LL,Israel,540,100,52,5,440,194,194,388,47
2023-02-23,LL,Israel,607,102,44,2,505,231,230,461,42
2023-02-24,LL,Israel,498,163,15,1,335,163,157,320,14
2023-02-25,LL,Israel,490,154,25,1,336,148,163,311,24
2023-02-26,LL,Israel,625,120,39,0,505,236,230,466,39
2023-02-27,LL,Israel,532,79,42,6,453,211,200,411,36
2023-02-28,LL,Israel,502,103,34,2,399,180,185,365,32
2023-03-01,LL,Israel,577,97,54,11,480,213,213,426,43
2023-03-02,LL,Israel,619,126,43,4,493,227,223,450,39
2023-03-03,LL,Israel,510,150,13,0,360,177,170,347,13
2023-03-04,LL,Israel,479,132,23,1,347,155,169,324,22
2023-03-05,LL,Israel,619,111,28,3,508,239,241,480,25
2023-03-06,LL,Israel,558,84,42,6,474,221,211,432,36
2023-03-07,LL,Israel,479,95,23,2,384,181,180,361,21
2023-03-08,LL,Israel,575,103,46,4,472,211,215,426,42
2023-03-09,LL,Israel,631,130,48,3,501,228,225,453,45
2023-03-10,LL,Israel,508,148,17,1,360,173,170,343,16
2023-03-11,LL,Israel,526,163,26,1,363,154,183,337,25
2023-03-12,LL,Israel,661,125,44,3,536,248,244,492,41
2023-03-13,LL,Israel,558,81,44,9,477,221,212,433,35
2023-03-14,LL,Israel,543,101,30,6,442,205,207,412,24
2023-03-15,LL,Israel,606,106,55,1,500,224,221,445,54
2023-03-16,LL,Israel,656,140,51,6,516,238,227,465,45
2023-03-17,LL,Israel,538,197,17,0,341,164,160,324,17
2023-03-18,LL,Israel,530,186,20,0,344,152,172,324,20
2023-03-19,LL,Israel,683,131,60,0,552,250,242,492,60
2023-03-20,LL,Israel,620,102,63,6,518,228,227,455,57
2023-03-21,LL,Israel,562,121,27,1,441,205,209,414,26
2023-03-22,LL,Israel,589,100,47,7,489,228,214,442,40
2023-03-23,LL,Israel,625,99,51,6,526,241,234,475,45
2023-03-24,LL,Israel,520,148,17,2,372,182,173,355,15
2023-03-25,LL,Israel,520,167,23,0,353,153,177,330,23
2023-03-26,LL,Israel,629,103,45,4,526,237,244,481,41
2023-03-27,LL,Israel,502,85,32,4,417,197,188,385,28
2023-03-28,LL,Israel,566,70,38,5,496,229,229,458,33
2023-03-29,LL,Israel,636,110,47,1,526,242,237,479,46
2023-03-30,LL,Israel,682,127,39,1,555,255,261,516,38
2023-03-31,LL,Israel,603,186,10,0,417,207,200,407,10
2023-04-01,LL,Israel,521,156,21,1,365,165,179,344,20
2023-04-02,LL,Israel,677,93,55,4,584,256,273,529,51
2023-04-03,LL,Israel,683,87,42,5,596,273,281,554,37
2023-04-04,LL,Israel,753,114,53,1,639,294,292,586,52
2023-04-05,LL,Israel,667,166,36,2,501,233,232,465,34
2023-04-06,LL,Israel,625,141,15,1,484,239,230,469,14
2023-04-07,LL,Israel,643,158,16,1,485,243,226,469,15
2023-04-08,LL,Israel,503,107,19,0,396,184,193,377,19
2023-04-09,LL,Israel,704,124,35,0,580,274,271,545,35
2023-04-10,LL,Israel,712,155,25,2,557,266,266,532,23
2023-04-11,LL,Israel,663,168,16,2,495,246,233,479,14
2023-04-12,LL,Israel,623,157,22,1,466,216,228,444,21
2023-04-13,LL,Israel,763,123,36,1,640,302,302,604,35
2023-04-14,LL,Israel,681,160,19,2,521,247,255,502,17
2023-04-15,LL,Israel,615,129,34,1,486,227,225,452,33
2023-04-16,LL,Israel,718,98,40,2,620,294,286,580,38
2023-04-17,LL,Israel,632,94,33,3,538,259,246,505,30
2023-04-18,LL,Israel,557,76,35,3,481,220,226,446,32
2023-04-19,LL,Israel,647,110,43,0,537,248,246,494,43
2023-04-20,LL,Israel,767,159,49,1,608,277,282,559,48
2023-04-21,LL,Israel,600,202,16,1,398,200,182,382,15
2023-04-22,LL,Israel,524,158,22,3,366,164,180,344,19
2023-04-23,LL,Israel,707,100,61,1,607,265,281,546,60
2023-04-24,LL,Israel,692,170,35,0,522,249,238,487,35
2023-04-25,LL,Israel,642,188,22,0,454,215,217,432,22
2023-04-26,LL,Israel,646,198,17,1,448,218,213,431,16
2023-04-27,LL,Israel,755,185,38,1,570,265,267,532,37
2023-04-28,LL,Israel,642,213,13,0,429,211,205,416,13
2023-04-29,LL,Israel,564,196,24,0,368,167,177,344,24
2023-04-30,LL,Israel,691,116,44,0,575,266,265,531,44
2023-05-01,LL,Israel,632,107,35,2,525,248,242,490,33
2023-05-02,LL,Israel,552,95,34,1,457,213,210,423,33
2023-05-03,LL,Israel,611,90,52,0,521,237,232,469,52
2023-05-04,LL,Israel,663,112,46,0,551,252,253,505,46
2023-05-05,LL,Israel,571,161,20,0,410,198,192,390,20
2023-05-06,LL,Israel,512,138,29,0,374,167,178,345,29
2023-05-07,LL,Israel,674,99,38,0,575,268,269,537,38
2023-05-08,LL,Israel,644,104,53,5,540,246,241,487,48
2023-05-09,LL,Israel,535,85,23,0,450,218,209,427,23
2023-05-10,LL,Israel,586,91,32,0,495,232,231,463,32
2023-05-11,LL,Israel,661,98,46,3,563,256,261,517,43
2023-05-12,LL,Israel,529,127,10,0,402,197,195,392,10
2023-05-13,LL,Israel,447,98,18,0,349,161,170,331,18
2023-05-14,LL,Israel,644,66,45,4,578,268,265,533,41
2023-05-15,LL,Israel,605,81,28,3,524,250,246,496,25
2023-05-16,LL,Israel,541,90,23,1,451,213,215,428,22
2023-05-17,LL,Israel,622,95,39,1,527,242,246,488,38
2023-05-18,LL,Israel,704,128,50,0,576,267,259,526,50
2023-05-19,LL,Israel,556,204,11,1,352,174,167,341,10
2023-05-20,LL,Israel,533,168,26,1,365,164,175,339,25
2023-05-21,LL,Israel,705,108,45,4,597,271,281,552,41
2023-05-22,LL,Israel,633,97,46,4,536,247,243,490,42
2023-05-23,LL,Israel,582,85,43,7,497,224,230,454,36
2023-05-24,LL,Israel,723,105,43,0,618,289,286,575,43
2023-05-25,LL,Israel,688,164,28,0,524,261,235,496,28
2023-05-26,LL,Israel,493,153,7,0,340,171,162,333,7
2023-05-27,LL,Israel,521,104,29,1,417,184,204,388,28
2023-05-28,LL,Israel,721,85,47,1,636,292,297,589,46
2023-05-29,LL,Israel,648,89,31,2,559,264,264,528,29
2023-05-30,LL,Israel,588,85,47,5,503,230,226,456,42
2023-05-31,LL,Israel,624,97,43,5,527,240,244,484,38
2023-06-01,LL,Israel,679,112,36,2,567,270,261,531,34
2023-06-02,LL,Israel,611,156,8,0,455,228,219,447,8
2023-06-03,LL,Israel,516,144,20,0,372,169,183,352,20
2023-06-04,LL,Israel,703,85,50,1,618,281,287,568,49
2023-06-05,LL,Israel,655,104,29,2,551,265,257,522,27
2023-06-06,LL,Israel,589,98,28,2,491,231,232,463,26
2023-06-07,LL,Israel,630,99,27,4,531,254,250,504,23
2023-06-08,LL,Israel,727,129,41,3,598,282,275,557,38
2023-06-09,LL,Israel,647,201,11,0,446,223,212,435,11
2023-06-10,LL,Israel,547,156,27,0,391,174,190,364,27
2023-06-11,LL,Israel,695,99,35,2,596,275,286,561,33
2023-06-12,LL,Israel,681,114,44,3,567,265,258,523,41
2023-06-13,LL,Israel,631,107,33,3,524,245,246,491,30
2023-06-14,LL,Israel,680,117,41,2,563,261,261,522,39
2023-06-15,LL,Israel,759,118,57,1,641,290,294,584,56
2023-06-16,LL,Israel,664,167,19,0,497,251,227,478,19
2023-06-17,LL,Israel,522,125,20,2,397,179,198,377,18
2023-06-18,LL,Israel,692,82,42,0,610,280,288,568,42
2023-06-19,LL,Israel,683,116,37,3,567,269,261,530,34
2023-06-20,LL,Israel,624,104,32,3,520,248,240,488,29
2023-06-21,LL,Israel,672,106,46,4,566,259,261,520,42
2023-06-22,LL,Israel,725,122,45,0,603,282,276,558,45
2023-06-23,LL,Israel,593,169,18,1,424,211,195,406,17
2023-06-24,LL,Israel,532,130,23,1,402,180,199,379,22
2023-06-25,LL,Israel,756,115,59,6,641,288,294,582,53
2023-06-26,LL,Israel,740,127,42,5,613,287,284,571,37
2023-06-27,LL,Israel,713,124,42,1,589,274,273,547,41
2023-06-28,LL,Israel,707,120,32,1,587,272,283,555,31
2023-06-29,LL,Israel,768,148,38,3,620,293,289,582,35
2023-06-30,LL,Israel,684,179,18,1,505,249,238,487,17
2023-07-01,LL,Israel,579,138,17,0,441,209,215,424,17
2023-07-02,LL,Israel,775,120,52,1,655,301,302,603,51
2023-07-03,LL,Israel,764,129,35,2,635,301,299,600,33
2023-07-04,LL,Israel,735,119,26,0,616,302,288,590,26
2023-07-05,LL,Israel,737,123,33,5,614,285,296,581,28
2023-07-06,LL,Israel,820,148,39,3,672,318,315,633,36
2023-07-07,LL,Israel,705,186,19,0,519,258,242,500,19
2023-07-08,LL,Israel,564,123,19,0,441,204,218,422,19
2023-07-09,LL,Israel,760,122,45,2,638,295,298,593,43
2023-07-10,LL,Israel,743,125,42,6,618,288,288,576,36
2023-07-11,LL,Israel,702,114,36,3,588,281,271,552,33
2023-07-12,LL,Israel,735,124,42,4,611,280,289,569,38
2023-07-13,LL,Israel,762,116,33,0,646,303,310,613,33
2023-07-14,LL,Israel,675,166,14,0,509,254,241,495,14
2023-07-15,LL,Israel,561,128,20,0,433,199,214,413,20
2023-07-16,LL,Israel,773,124,47,2,649,300,302,602,45
2023-07-17,LL,Israel,740,123,42,4,617,290,285,575,38
2023-07-18,LL,Israel,702,109,33,2,593,288,272,560,31
2023-07-19,LL,Israel,712,120,35,2,592,276,281,557,33
2023-07-20,LL,Israel,785,138,44,1,647,306,297,603,43
2023-07-21,LL,Israel,651,162,15,1,489,239,235,474,14
2023-07-22,LL,Israel,567,136,15,0,431,204,212,416,15
2023-07-23,LL,Israel,725,92,50,1,633,291,292,583,49
2023-07-24,LL,Israel,701,95,36,6,606,281,289,570,30
2023-07-25,LL,Israel,699,115,29,4,584,282,273,555,25
2023-07-26,LL,Israel,736,135,35,6,601,284,282,566,29
2023-07-27,LL,Israel,751,130,40,1,621,289,292,581,39
2023-07-28,LL,Israel,609,162,16,2,447,219,212,431,14
2023-07-29,LL,Israel,563,116,16,0,447,209,222,431,16
2023-07-30,LL,Israel,775,112,40,0,663,311,312,623,40
2023-07-31,LL,Israel,754,121,33,4,633,300,300,600,29
2023-08-01,LL,Israel,770,126,43,6,644,299,302,601,37
2023-08-02,LL,Israel,744,128,35,2,616,297,284,581,33
2023-08-03,LL,Israel,775,133,45,6,642,297,300,597,39
2023-08-04,LL,Israel,679,160,11,1,519,259,249,508,10
2023-08-05,LL,Israel,586,132,16,0,454,211,227,438,16
2023-08-06,LL,Israel,754,110,42,1,644,304,298,602,41
2023-08-07,LL,Israel,761,118,42,2,643,302,299,601,40
2023-08-08,LL,Israel,721,113,22,0,608,295,291,586,22
2023-08-09,LL,Israel,749,121,35,0,628,294,299,593,35
2023-08-10,LL,Israel,795,129,43,1,666,317,306,623,42
2023-08-11,LL,Israel,684,176,18,0,508,248,242,490,18
2023-08-12,LL,Israel,593,128,20,0,465,214,231,445,20
2023-08-13,LL,Israel,795,130,54,3,665,307,304,611,51
2023-08-14,LL,Israel,754,115,49,5,639,296,294,590,44
2023-08-15,LL,Israel,762,120,41,7,642,302,299,601,34
2023-08-16,LL,Israel,775,129,58,5,646,296,292,588,53
2023-08-17,LL,Israel,782,118,45,2,664,311,308,619,43
2023-08-18,LL,Israel,681,162,12,0,519,256,251,507,12
2023-08-19,LL,Israel,616,134,21,1,482,224,237,461,20
2023-08-20,LL,Israel,824,126,70,2,698,314,314,628,68
2023-08-21,LL,Israel,750,113,29,3,637,304,304,608,26
2023-08-22,LL,Israel,748,114,43,5,634,297,294,591,38
2023-08-23,LL,Israel,785,130,41,3,655,306,308,614,38
2023-08-24,LL,Israel,794,125,45,3,669,314,310,624,42
2023-08-25,LL,Israel,688,169,12,1,519,262,245,507,11
2023-08-26,LL,Israel,618,130,22,2,488,222,244,466,20
2023-08-27,LL,Israel,778,119,34,0,659,312,313,625,34
2023-08-28,LL,Israel,760,133,28,2,627,299,300,599,26
2023-08-29,LL,Israel,765,132,23,2,633,312,298,610,21
2023-08-30,LL,Israel,771,137,17,0,634,303,314,617,17
2023-08-31,LL,Israel,769,126,32,0,643,307,304,611,32
2023-09-01,LL,Israel,644,147,14,0,497,243,240,483,14
2023-09-02,LL,Israel,582,101,31,2,481,218,232,450,29
2023-09-03,LL,Israel,739,97,42,1,642,305,295,600,41
2023-09-04,LL,Israel,704,92,44,2,612,287,281,568,42
2023-09-05,LL,Israel,667,106,32,3,561,267,262,529,29
2023-09-06,LL,Israel,685,105,35,1,580,270,275,545,34
2023-09-07,LL,Israel,755,116,40,4,639,303,296,599,36
2023-09-08,LL,Israel,581,156,14,2,425,206,205,411,12
2023-09-09,LL,Israel,581,122,26,0,459,209,224,433,26
2023-09-10,LL,Israel,754,114,56,7,640,292,292,584,49
2023-09-11,LL,Israel,733,101,42,8,632,297,293,590,34
2023-09-12,LL,Israel,731,102,57,12,629,293,279,572,45
2023-09-13,LL,Israel,785,112,51,2,673,308,314,622,49
2023-09-14,LL,Israel,795,122,37,0,673,317,319,636,37
2023-09-15,LL,Israel,618,147,19,1,471,226,226,452,18
2023-09-16,LL,Israel,499,109,7,2,390,190,193,383,5
2023-09-17,LL,Israel,616,122,36,0,494,231,227,458,36
2023-09-18,LL,Israel,763,78,58,4,685,315,312,627,54
2023-09-19,LL,Israel,754,115,40,5,639,304,295,599,35
2023-09-20,LL,Israel,758,117,60,7,641,287,294,581,53
2023-09-21,LL,Israel,746,104,44,3,642,297,301,598,41
2023-09-22,LL,Israel,678,148,21,1,530,262,247,509,20
2023-09-23,LL,Israel,582,116,28,0,466,210,228,438,28
2023-09-24,LL,Israel,327,71,8,0,256,152,96,248,8
2023-09-25,LL,Israel,111,5,0,0,106,26,80,106,0
2023-09-26,LL,Israel,734,43,49,5,691,321,321,642,44
2023-09-27,LL,Israel,798,128,46,4,670,307,317,624,42
2023-09-28,LL,Israel,799,116,57,1,683,309,317,626,56
2023-09-29,LL,Israel,691,143,23,2,548,274,251,525,21
2023-09-30,LL,Israel,587,111,20,0,476,221,235,456,20
2023-10-01,LL,Israel,781,137,36,1,644,307,301,608,35
2023-10-02,LL,Israel,703,104,20,1,599,289,290,579,19
2023-01-01,LI,Italy,3769,1249,620,1,2520,943,957,1900,619
2023-01-02,LI,Italy,4410,1390,756,8,3020,1134,1130,2264,748
2023-01-03,LI,Italy,3879,1239,706,12,2640,968,966,1934,694
2023-01-04,LI,Italy,3797,1140,736,28,2657,949,972,1921,708
2023-01-05,LI,Italy,3919,1231,712,13,2688,993,983,1976,699
2023-01-06,LI,Italy,4188,1367,705,7,2821,1061,1055,2116,698
2023-01-07,LI,Italy,3881,1342,616,2,2539,957,966,1923,614
2023-01-08,LI,Italy,4308,1435,710,4,2873,1082,1081,2163,706
2023-01-09,LI,Italy,4007,1194,761,23,2813,1026,1026,2052,738
2023-01-10,LI,Italy,3297,1016,615,26,2281,837,829,1666,589
2023-01-11,LI,Italy,3345,999,672,38,2346,823,851,1674,634
2023-01-12,LI,Italy,3480,1051,678,18,2429,873,878,1751,660
2023-01-13,LI,Italy,3913,1127,742,10,2786,1012,1032,2044,732
2023-01-14,LI,Italy,3478,1144,572,11,2334,885,877,1762,561
2023-01-15,LI,Italy,3899,1268,634,4,2631,1002,995,1997,630
2023-01-16,LI,Italy,3756,1146,685,9,2610,964,961,1925,676
2023-01-17,LI,Italy,3120,936,602,27,2184,794,788,1582,575
2023-01-18,LI,Italy,3206,937,627,30,2269,816,826,1642,597
2023-01-19,LI,Italy,3421,1028,669,26,2393,857,867,1724,643
2023-01-20,LI,Italy,4046,1259,744,19,2787,1014,1029,2043,725
2023-01-21,LI,Italy,3541,1228,565,7,2313,882,866,1748,558
2023-01-22,LI,Italy,3909,1340,631,9,2569,971,967,1938,622
2023-01-23,LI,Italy,3753,1149,711,25,2604,953,940,1893,686
2023-01-24,LI,Italy,3195,982,625,33,2213,786,802,1588,592
2023-01-25,LI,Italy,3214,953,651,27,2261,802,808,1610,624
2023-01-26,LI,Italy,3464,1066,668,24,2398,857,873,1730,644
2023-01-27,LI,Italy,3807,1217,677,10,2590,957,956,1913,667
2023-01-28,LI,Italy,3519,1185,568,7,2334,888,878,1766,561
2023-01-29,LI,Italy,3882,1279,625,4,2603,986,992,1978,621
2023-01-30,LI,Italy,3734,1121,709,20,2613,956,948,1904,689
2023-01-31,LI,Italy,3175,946,622,23,2229,811,796,1607,599
2023-02-01,LI,Italy,3245,951,634,22,2294,831,829,1660,612
2023-02-02,LI,Italy,3531,1095,659,31,2436,887,890,1777,628
2023-02-03,LI,Italy,4038,1229,727,10,2809,1034,1048,2082,717
2023-02-04,LI,Italy,3496,1140,564,5,2356,901,891,1792,559
2023-02-05,LI,Italy,4025,1334,655,7,2691,1014,1022,2036,648
2023-02-06,LI,Italy,3936,1146,736,17,2790,1034,1020,2054,719
2023-02-07,LI,Italy,3366,1068,615,15,2298,842,841,1683,600
2023-02-08,LI,Italy,3468,1078,640,22,2390,871,879,1750,618
2023-02-09,LI,Italy,3626,1113,658,22,2513,924,931,1855,636
2023-02-10,LI,Italy,4235,1283,735,17,2952,1099,1118,2217,718
2023-02-11,LI,Italy,3823,1268,590,15,2555,986,979,1965,575
2023-02-12,LI,Italy,4224,1398,662,7,2826,1069,1095,2164,655
2023-02-13,LI,Italy,4065,1240,714,13,2825,1062,1049,2111,701
2023-02-14,LI,Italy,3531,1088,633,24,2443,907,903,1810,609
2023-02-15,LI,Italy,3647,1143,636,20,2504,937,931,1868,616
2023-02-16,LI,Italy,3792,1192,662,22,2600,968,970,1938,640
2023-02-17,LI,Italy,4151,1295,723,15,2856,1063,1070,2133,708
2023-02-18,LI,Italy,4036,1385,587,10,2651,1040,1024,2064,577
2023-02-19,LI,Italy,4263,1421,642,4,2842,1094,1106,2200,638
2023-02-20,LI,Italy,4161,1280,683,7,2881,1097,1101,2198,676
2023-02-21,LI,Italy,3477,1028,607,18,2449,914,928,1842,589
2023-02-22,LI,Italy,3633,1071,638,23,2562,948,976,1924,615
2023-02-23,LI,Italy,3885,1143,699,24,2742,1017,1026,2043,675
2023-02-24,LI,Italy,4345,1315,740,23,3030,1142,1148,2290,717
2023-02-25,LI,Italy,3941,1334,588,11,2607,1015,1004,2019,577
2023-02-26,LI,Italy,4247,1378,637,7,2869,1119,1113,2232,630
2023-02-27,LI,Italy,4126,1268,707,24,2858,1084,1067,2151,683
2023-02-28,LI,Italy,3555,1148,597,27,2407,902,908,1810,570
2023-03-01,LI,Italy,3729,1196,644,35,2533,943,946,1889,609
2023-03-02,LI,Italy,3864,1220,649,24,2644,996,999,1995,625
2023-03-03,LI,Italy,4448,1421,733,27,3027,1139,1155,2294,706
2023-03-04,LI,Italy,4000,1391,569,9,2609,1030,1010,2040,560
2023-03-05,LI,Italy,4297,1475,625,12,2822,1089,1108,2197,613
2023-03-06,LI,Italy,4211,1328,697,10,2883,1098,1088,2186,687
2023-03-07,LI,Italy,3454,1062,610,20,2392,890,892,1782,590
2023-03-08,LI,Italy,3630,1127,649,21,2503,926,928,1854,628
2023-03-09,LI,Italy,3904,1250,679,25,2654,978,997,1975,654
2023-03-10,LI,Italy,4219,1289,736,15,2930,1104,1090,2194,721
2023-03-11,LI,Italy,3952,1365,577,4,2587,1009,1001,2010,573
2023-03-12,LI,Italy,4330,1474,626,7,2856,1117,1113,2230,619
2023-03-13,LI,Italy,4235,1379,693,16,2856,1091,1072,2163,677
2023-03-14,LI,Italy,3753,1242,618,22,2511,931,962,1893,596
2023-03-15,LI,Italy,3865,1300,612,21,2565,971,982,1953,591
2023-03-16,LI,Italy,4012,1280,657,23,2732,1040,1035,2075,634
2023-03-17,LI,Italy,4420,1470,720,13,2950,1105,1125,2230,707
2023-03-18,LI,Italy,4024,1408,587,11,2616,1016,1013,2029,576
2023-03-19,LI,Italy,4410,1506,621,4,2904,1142,1141,2283,617
2023-03-20,LI,Italy,4367,1386,688,22,2981,1147,1146,2293,666
2023-03-21,LI,Italy,3737,1193,622,23,2544,957,965,1922,599
2023-03-22,LI,Italy,3832,1222,628,18,2610,987,995,1982,610
2023-03-23,LI,Italy,3973,1248,655,17,2725,1040,1030,2070,638
2023-03-24,LI,Italy,4459,1399,743,12,3060,1148,1169,2317,731
2023-03-25,LI,Italy,4010,1464,567,7,2546,986,993,1979,560
2023-03-26,LI,Italy,4775,1600,726,7,3175,1222,1227,2449,719
2023-03-27,LI,Italy,4457,1323,789,8,3134,1178,1167,2345,781
2023-03-28,LI,Italy,4560,1415,783,14,3145,1183,1179,2362,769
2023-03-29,LI,Italy,4708,1477,759,18,3231,1232,1240,2472,741
2023-03-30,LI,Italy,4912,1566,807,20,3346,1271,1268,2539,787
2023-03-31,LI,Italy,5191,1775,808,14,3416,1293,1315,2608,794
2023-04-01,LI,Italy,5187,1937,713,7,3250,1267,1270,2537,706
2023-04-02,LI,Italy,4733,1850,616,5,2883,1133,1134,2267,611
2023-04-03,LI,Italy,5146,1582,822,12,3564,1380,1362,2742,810
2023-04-04,LI,Italy,4971,1598,831,22,3373,1255,1287,2542,809
2023-04-05,LI,Italy,5077,1628,782,17,3449,1347,1320,2667,765
2023-04-06,LI,Italy,5377,1758,863,26,3619,1375,1381,2756,837
2023-04-07,LI,Italy,5452,1812,860,11,3640,1372,1408,2780,849
2023-04-08,LI,Italy,5104,1912,711,16,3192,1257,1224,2481,695
2023-04-09,LI,Italy,5060,1786,716,3,3274,1280,1278,2558,713
2023-04-10,LI,Italy,5271,1752,802,4,3519,1357,1360,2717,798
2023-04-11,LI,Italy,5122,1627,819,7,3495,1335,1341,2676,812
2023-04-12,LI,Italy,5100,1645,805,19,3455,1322,1328,2650,786
2023-04-13,LI,Italy,5265,1714,844,11,3551,1361,1346,2707,833
2023-04-14,LI,Italy,5539,1835,840,13,3704,1424,1440,2864,827
2023-04-15,LI,Italy,5354,2043,699,7,3311,1309,1303,2612,692
2023-04-16,LI,Italy,5437,1973,754,9,3464,1360,1350,2710,745
2023-04-17,LI,Italy,5427,1769,843,11,3658,1397,1418,2815,832
2023-04-18,LI,Italy,5198,1631,843,12,3567,1343,1381,2724,831
2023-04-19,LI,Italy,5187,1642,810,17,3545,1365,1370,2735,793
2023-04-20,LI,Italy,5400,1798,843,12,3602,1378,1381,2759,831
2023-04-21,LI,Italy,5607,1918,857,9,3689,1419,1413,2832,848
2023-04-22,LI,Italy,5420,2058,727,9,3362,1327,1308,2635,718
2023-04-23,LI,Italy,5632,2070,760,9,3562,1415,1387,2802,751
2023-04-24,LI,Italy,5441,1919,793,6,3522,1375,1354,2729,787
2023-04-25,LI,Italy,5052,1677,787,7,3375,1284,1304,2588,780
2023-04-26,LI,Italy,5262,1740,806,16,3522,1348,1368,2716,790
2023-04-27,LI,Italy,5497,1825,860,18,3672,1403,1409,2812,842
2023-04-28,LI,Italy,5931,2029,899,18,3902,1477,1526,3003,881
2023-04-29,LI,Italy,5553,2189,727,13,3364,1322,1315,2637,714
2023-04-30,LI,Italy,5498,2084,748,9,3414,1341,1325,2666,739
2023-05-01,LI,Italy,5423,1920,811,7,3503,1372,1320,2692,804
2023-05-02,LI,Italy,5305,1781,839,16,3524,1333,1352,2685,823
2023-05-03,LI,Italy,5332,1824,778,19,3508,1352,1378,2730,759
2023-05-04,LI,Italy,5613,1882,868,20,3731,1437,1426,2863,848
2023-05-05,LI,Italy,5890,2015,908,14,3875,1472,1495,2967,894
2023-05-06,LI,Italy,5685,2249,757,11,3436,1344,1335,2679,746
2023-05-07,LI,Italy,5848,2229,781,8,3619,1415,1423,2838,773
2023-05-08,LI,Italy,5787,1977,844,7,3810,1490,1476,2966,837
2023-05-09,LI,Italy,5393,1783,855,19,3610,1366,1389,2755,836
2023-05-10,LI,Italy,5542,1835,857,15,3707,1414,1436,2850,842
2023-05-11,LI,Italy,5728,1867,885,24,3861,1484,1492,2976,861
2023-05-12,LI,Italy,5930,2042,902,18,3888,1485,1501,2986,884
2023-05-13,LI,Italy,5911,2336,791,9,3575,1414,1370,2784,782
2023-05-14,LI,Italy,5928,2193,807,9,3735,1465,1463,2928,798
2023-05-15,LI,Italy,5813,1951,907,12,3862,1477,1478,2955,895
2023-05-16,LI,Italy,5537,1850,855,20,3687,1409,1423,2832,835
2023-05-17,LI,Italy,5857,2031,861,23,3826,1484,1481,2965,838
2023-05-18,LI,Italy,5900,2062,888,13,3838,1452,1498,2950,875
2023-05-19,LI,Italy,5404,2070,801,16,3334,1252,1281,2533,785
2023-05-20,LI,Italy,5977,2410,761,7,3567,1414,1392,2806,754
2023-05-21,LI,Italy,6200,2403,781,12,3797,1532,1484,3016,769
2023-05-22,LI,Italy,6036,2107,882,16,3929,1535,1512,3047,866
2023-05-23,LI,Italy,5640,1949,865,21,3691,1409,1417,2826,844
2023-05-24,LI,Italy,5743,2026,845,22,3717,1423,1449,2872,823
2023-05-25,LI,Italy,5942,2101,883,18,3841,1465,1493,2958,865
2023-05-26,LI,Italy,6493,2326,950,20,4167,1582,1635,3217,930
2023-05-27,LI,Italy,6294,2506,859,12,3788,1442,1487,2929,847
2023-05-28,LI,Italy,6371,2525,855,5,3846,1502,1489,2991,850
2023-05-29,LI,Italy,6450,2346,943,16,4104,1625,1536,3161,927
2023-05-30,LI,Italy,6104,2222,921,26,3882,1474,1487,2961,895
2023-05-31,LI,Italy,5984,2096,892,24,3888,1512,1484,2996,868
2023-06-01,LI,Italy,6323,2199,975,31,4124,1573,1576,3149,944
2023-06-02,LI,Italy,6298,2314,913,8,3984,1520,1551,3071,905
2023-06-03,LI,Italy,6419,2586,891,10,3833,1466,1476,2942,881
2023-06-04,LI,Italy,6171,2607,783,9,3564,1401,1380,2781,774
2023-06-05,LI,Italy,6449,2260,956,14,4189,1616,1617,3233,942
2023-06-06,LI,Italy,5872,2133,888,15,3739,1433,1418,2851,873
2023-06-07,LI,Italy,6253,2281,900,27,3972,1526,1546,3072,873
2023-06-08,LI,Italy,6553,2407,974,17,4146,1577,1595,3172,957
2023-06-09,LI,Italy,6733,2422,1013,20,4311,1630,1668,3298,993
2023-06-10,LI,Italy,6688,2601,944,11,4087,1585,1558,3143,933
2023-06-11,LI,Italy,7027,2684,961,7,4343,1704,1678,3382,954
2023-06-12,LI,Italy,6671,2461,961,16,4210,1624,1625,3249,945
2023-06-13,LI,Italy,6231,2237,916,12,3994,1539,1539,3078,904
2023-06-14,LI,Italy,6327,2288,952,19,4039,1543,1544,3087,933
2023-06-15,LI,Italy,6668,2421,973,16,4247,1635,1639,3274,957
2023-06-16,LI,Italy,6896,2532,989,5,4364,1668,1707,3375,984
2023-06-17,LI,Italy,6710,2611,958,6,4099,1563,1578,3141,952
2023-06-18,LI,Italy,6964,2644,1001,9,4320,1680,1639,3319,992
2023-06-19,LI,Italy,6913,2544,975,13,4369,1709,1685,3394,962
2023-06-20,LI,Italy,6072,2379,880,26,3693,1414,1399,2813,854
2023-06-21,LI,Italy,6854,2684,955,27,4170,1610,1605,3215,928
2023-06-22,LI,Italy,6890,2602,1035,22,4288,1617,1636,3253,1013
2023-06-23,LI,Italy,7135,2705,1019,14,4430,1690,1721,3411,1005
2023-06-24,LI,Italy,6904,2699,993,8,4205,1593,1619,3212,985
2023-06-25,LI,Italy,7170,2756,994,5,4414,1711,1709,3420,989
2023-06-26,LI,Italy,6951,2540,1013,26,4411,1702,1696,3398,987
2023-06-27,LI,Italy,6530,2409,1015,41,4121,1557,1549,3106,974
2023-06-28,LI,Italy,6665,2443,993,26,4222,1622,1607,3229,967
2023-06-29,LI,Italy,6742,2427,1006,25,4315,1640,1669,3309,981
2023-06-30,LI,Italy,6971,2539,1012,15,4432,1700,1720,3420,997
2023-07-01,LI,Italy,7426,3038,995,12,4388,1689,1704,3393,983
2023-07-02,LI,Italy,7458,2933,997,9,4525,1777,1751,3528,988
2023-07-03,LI,Italy,7078,2579,984,13,4499,1767,1748,3515,971
2023-07-04,LI,Italy,6728,2533,1003,15,4195,1595,1597,3192,988
2023-07-05,LI,Italy,6969,2658,982,18,4311,1677,1652,3329,964
2023-07-06,LI,Italy,7120,2644,1024,32,4476,1704,1748,3452,992
2023-07-07,LI,Italy,7208,2646,1033,12,4562,1754,1775,3529,1021
2023-07-08,LI,Italy,7356,3025,991,8,4331,1667,1673,3340,983
2023-07-09,LI,Italy,7434,2923,1007,9,4511,1761,1743,3504,998
2023-07-10,LI,Italy,7247,2720,1003,28,4527,1777,1747,3524,975
2023-07-11,LI,Italy,6833,2627,987,24,4206,1598,1621,3219,963
2023-07-12,LI,Italy,7000,2661,1016,19,4339,1661,1662,3323,997
2023-07-13,LI,Italy,7359,2868,1048,20,4491,1738,1705,3443,1028
2023-07-14,LI,Italy,7276,2740,1007,14,4536,1756,1773,3529,993
2023-07-15,LI,Italy,6699,3197,782,12,3502,1359,1361,2720,770
2023-07-16,LI,Italy,7588,2992,1069,9,4596,1761,1766,3527,1060
2023-07-17,LI,Italy,7291,2898,940,22,4393,1730,1723,3453,918
2023-07-18,LI,Italy,6949,2729,974,26,4220,1614,1632,3246,948
2023-07-19,LI,Italy,6983,2730,974,21,4253,1652,1627,3279,953
2023-07-20,LI,Italy,7172,2731,1002,19,4441,1698,1741,3439,983
2023-07-21,LI,Italy,7180,2758,1015,11,4422,1688,1719,3407,1004
2023-07-22,LI,Italy,7526,3104,999,8,4422,1711,1712,3423,991
2023-07-23,LI,Italy,7429,2946,1003,6,4483,1743,1737,3480,997
2023-07-24,LI,Italy,7109,2665,989,24,4444,1729,1726,3455,965
2023-07-25,LI,Italy,7051,2836,968,9,4215,1620,1627,3247,959
2023-07-26,LI,Italy,7084,2706,979,19,4378,1705,1694,3399,960
2023-07-27,LI,Italy,7097,2682,1024,16,4415,1714,1677,3391,1008
2023-07-28,LI,Italy,7252,2703,1046,10,4549,1740,1763,3503,1036
2023-07-29,LI,Italy,7613,3225,986,17,4388,1695,1707,3402,969
2023-07-30,LI,Italy,7667,3153,1005,11,4514,1757,1752,3509,994
2023-07-31,LI,Italy,7309,2799,1010,18,4510,1756,1744,3500,992
2023-08-01,LI,Italy,7050,2730,986,11,4320,1660,1674,3334,975
2023-08-02,LI,Italy,7116,2743,961,17,4373,1727,1685,3412,944
2023-08-03,LI,Italy,7022,2662,978,18,4360,1695,1687,3382,960
2023-08-04,LI,Italy,7172,2749,986,10,4423,1704,1733,3437,976
2023-08-05,LI,Italy,7785,3305,1014,11,4480,1733,1733,3466,1003
2023-08-06,LI,Italy,7544,3019,1018,9,4525,1762,1745,3507,1009
2023-08-07,LI,Italy,7206,2746,956,17,4460,1758,1746,3504,939
2023-08-08,LI,Italy,6678,2559,925,20,4119,1603,1591,3194,905
2023-08-09,LI,Italy,6739,2581,907,17,4158,1634,1617,3251,890
2023-08-10,LI,Italy,6902,2668,941,19,4234,1642,1651,3293,922
2023-08-11,LI,Italy,7051,2641,966,13,4410,1710,1734,3444,953
2023-08-12,LI,Italy,7402,3032,969,9,4370,1708,1693,3401,960
2023-08-13,LI,Italy,7247,2874,978,8,4373,1688,1707,3395,970
2023-08-14,LI,Italy,6732,2622,823,10,4110,1652,1635,3287,813
2023-08-15,LI,Italy,6788,2808,873,9,3980,1566,1541,3107,864
2023-08-16,LI,Italy,6777,2729,899,16,4048,1570,1579,3149,883
2023-08-17,LI,Italy,6979,2749,955,23,4230,1630,1645,3275,932
2023-08-18,LI,Italy,7124,2734,964,12,4390,1695,1731,3426,952
2023-08-19,LI,Italy,7336,3000,982,9,4336,1673,1681,3354,973
2023-08-20,LI,Italy,7359,2918,1004,10,4441,1732,1705,3437,994
2023-08-21,LI,Italy,7016,2666,960,21,4350,1719,1671,3390,939
2023-08-22,LI,Italy,6698,2605,935,21,4093,1571,1587,3158,914
2023-08-23,LI,Italy,6891,2782,903,16,4109,1612,1594,3206,887
2023-08-24,LI,Italy,6891,2731,923,24,4160,1610,1627,3237,899
2023-08-25,LI,Italy,7263,2866,955,7,4397,1714,1728,3442,948
2023-08-26,LI,Italy,7369,3141,987,12,4228,1602,1639,3241,975
2023-08-27,LI,Italy,7073,2687,977,11,4386,1722,1687,3409,966
2023-08-28,LI,Italy,6661,2510,944,9,4151,1602,1605,3207,935
2023-08-29,LI,Italy,6948,2730,964,13,4218,1637,1617,3254,951
2023-08-30,LI,Italy,6959,2724,944,20,4235,1653,1638,3291,924
2023-08-31,LI,Italy,7008,2589,987,21,4419,1696,1736,3432,966
2023-09-01,LI,Italy,7057,2615,976,18,4442,1715,1751,3466,958
2023-09-02,LI,Italy,7133,2860,973,16,4273,1635,1665,3300,957
2023-09-03,LI,Italy,7395,2837,1013,12,4558,1795,1750,3545,1001
2023-09-04,LI,Italy,6970,2522,951,11,4448,1773,1724,3497,940
2023-09-05,LI,Italy,6451,2362,954,22,4089,1568,1567,3135,932
2023-09-06,LI,Italy,6505,2442,893,18,4063,1584,1586,3170,875
2023-09-07,LI,Italy,6697,2466,931,15,4231,1646,1654,3300,916
2023-09-08,LI,Italy,6409,2454,872,17,3955,1527,1556,3083,855
2023-09-09,LI,Italy,6845,2711,928,12,4134,1604,1602,3206,916
2023-09-10,LI,Italy,7050,2738,935,11,4312,1698,1679,3377,924
2023-09-11,LI,Italy,6736,2457,928,20,4279,1686,1665,3351,908
2023-09-12,LI,Italy,6407,2343,927,14,4064,1563,1574,3137,913
2023-09-13,LI,Italy,6460,2384,893,20,4076,1593,1590,3183,873
2023-09-14,LI,Italy,6589,2401,925,18,4188,1626,1637,3263,907
2023-09-15,LI,Italy,6818,2482,967,12,4336,1671,1698,3369,955
2023-09-16,LI,Italy,6602,2676,900,9,3926,1513,1513,3026,891
2023-09-17,LI,Italy,6941,2707,908,8,4234,1674,1652,3326,900
2023-09-18,LI,Italy,6589,2342,934,11,4247,1653,1660,3313,923
2023-09-19,LI,Italy,6307,2312,919,19,3995,1549,1527,3076,900
2023-09-20,LI,Italy,6500,2373,905,20,4127,1601,1621,3222,885
2023-09-21,LI,Italy,6567,2346,953,24,4221,1627,1641,3268,929
2023-09-22,LI,Italy,6589,2308,940,7,4281,1658,1683,3341,933
2023-09-23,LI,Italy,6708,2708,917,8,4000,1550,1533,3083,909
2023-09-24,LI,Italy,6867,2594,928,6,4273,1679,1666,3345,922
2023-09-25,LI,Italy,6524,2290,948,17,4234,1665,1621,3286,931
2023-09-26,LI,Italy,6186,2132,951,24,4054,1531,1572,3103,927
2023-09-27,LI,Italy,6513,2368,910,20,4145,1618,1617,3235,890
2023-09-28,LI,Italy,6574,2310,956,23,4264,1648,1660,3308,933
2023-09-29,LI,Italy,6315,2423,876,21,3892,1476,1540,3016,855
2023-09-30,LI,Italy,6686,2699,885,12,3987,1547,1555,3102,873
2023-10-01,LI,Italy,6827,2522,897,7,4305,1711,1697,3408,890
2023-10-02,LI,Italy,6486,2283,950,18,4203,1652,1601,3253,932
2023-01-01,EV,Latvia,431,278,0,0,153,75,78,153,0
2023-01-02,EV,Latvia,481,308,0,0,173,88,85,173,0
2023-01-03,EV,Latvia,415,275,2,2,140,69,69,138,0
2023-01-04,EV,Latvia,430,296,1,1,134,67,66,133,0
2023-01-05,EV,Latvia,421,275,1,1,146,71,74,145,0
2023-01-06,EV,Latvia,456,296,1,1,160,80,79,159,0
2023-01-07,EV,Latvia,470,334,0,0,136,66,70,136,0
2023-01-08,EV,Latvia,466,312,1,1,154,77,76,153,0
2023-01-09,EV,Latvia,435,271,1,1,164,81,82,163,0
2023-01-10,EV,Latvia,378,256,1,1,122,60,61,121,0
2023-01-11,EV,Latvia,393,274,2,2,119,59,58,117,0
2023-01-12,EV,Latvia,396,268,0,0,128,63,65,128,0
2023-01-13,EV,Latvia,437,279,2,2,158,79,77,156,0
2023-01-14,EV,Latvia,401,281,0,0,120,60,60,120,0
2023-01-15,EV,Latvia,434,285,0,0,149,75,74,149,0
2023-01-16,EV,Latvia,399,239,2,2,160,80,78,158,0
2023-01-17,EV,Latvia,337,220,0,0,117,55,62,117,0
2023-01-18,EV,Latvia,364,251,0,0,113,59,54,113,0
2023-01-19,EV,Latvia,370,243,0,0,127,64,63,127,0
2023-01-20,EV,Latvia,427,273,0,0,154,79,75,154,0
2023-01-21,EV,Latvia,374,247,1,1,127,59,67,126,0
2023-01-22,EV,Latvia,409,260,0,0,149,75,74,149,0
2023-01-23,EV,Latvia,401,242,0,0,159,81,78,159,0
2023-01-24,EV,Latvia,340,223,2,2,117,56,59,115,0
2023-01-25,EV,Latvia,360,253,0,0,107,53,54,107,0
2023-01-26,EV,Latvia,364,226,1,1,138,69,68,137,0
2023-01-27,EV,Latvia,428,267,0,0,161,83,78,161,0
2023-01-28,EV,Latvia,375,249,3,3,126,59,64,123,0
2023-01-29,EV,Latvia,423,276,0,0,147,74,73,147,0
2023-01-30,EV,Latvia,419,253,0,0,166,83,83,166,0
2023-01-31,EV,Latvia,355,234,1,1,121,57,63,120,0
2023-02-01,EV,Latvia,348,241,0,0,107,54,53,107,0
2023-02-02,EV,Latvia,363,227,1,1,136,68,67,135,0
2023-02-03,EV,Latvia,412,263,0,0,149,76,73,149,0
2023-02-04,EV,Latvia,358,239,0,0,119,58,61,119,0
2023-02-05,EV,Latvia,413,267,2,0,146,72,72,144,2
2023-02-06,EV,Latvia,395,234,2,2,161,79,80,159,0
2023-02-07,EV,Latvia,342,228,0,0,114,58,56,114,0
2023-02-08,EV,Latvia,393,280,1,1,113,57,55,112,0
2023-02-09,EV,Latvia,403,265,3,3,138,67,68,135,0
2023-02-10,EV,Latvia,428,274,0,0,154,77,77,154,0
2023-02-11,EV,Latvia,390,264,0,0,126,62,64,126,0
2023-02-12,EV,Latvia,434,287,0,0,147,75,72,147,0
2023-02-13,EV,Latvia,418,255,0,0,163,81,82,163,0
2023-02-14,EV,Latvia,341,234,2,2,107,50,55,105,0
2023-02-15,EV,Latvia,376,265,0,0,111,57,54,111,0
2023-02-16,EV,Latvia,386,254,0,0,132,65,67,132,0
2023-02-17,EV,Latvia,400,259,1,1,141,72,68,140,0
2023-02-18,EV,Latvia,387,264,0,0,123,58,65,123,0
2023-02-19,EV,Latvia,437,288,1,1,149,76,72,148,0
2023-02-20,EV,Latvia,435,269,0,0,166,84,82,166,0
2023-02-21,EV,Latvia,356,235,0,0,121,58,63,121,0
2023-02-22,EV,Latvia,406,284,1,1,122,59,62,121,0
2023-02-23,EV,Latvia,411,276,1,1,135,68,66,134,0
2023-02-24,EV,Latvia,429,281,0,0,148,74,74,148,0
2023-02-25,EV,Latvia,414,284,0,0,130,64,66,130,0
2023-02-26,EV,Latvia,449,294,0,0,155,76,79,155,0
2023-02-27,EV,Latvia,435,268,3,3,167,84,80,164,0
2023-02-28,EV,Latvia,378,256,1,1,122,59,62,121,0
2023-03-01,EV,Latvia,405,278,1,1,127,64,62,126,0
2023-03-02,EV,Latvia,420,279,2,2,141,69,70,139,0
2023-03-03,EV,Latvia,445,286,3,3,159,80,76,156,0
2023-03-04,EV,Latvia,412,285,2,2,127,63,62,125,0
2023-03-05,EV,Latvia,446,298,0,0,148,74,74,148,0
2023-03-06,EV,Latvia,426,260,0,0,166,82,84,166,0
2023-03-07,EV,Latvia,372,244,0,0,128,62,66,128,0
2023-03-08,EV,Latvia,400,279,0,0,121,63,58,121,0
2023-03-09,EV,Latvia,452,298,2,2,154,76,76,152,0
2023-03-10,EV,Latvia,454,289,1,1,165,84,80,164,0
2023-03-11,EV,Latvia,408,268,2,2,140,68,70,138,0
2023-03-12,EV,Latvia,439,294,0,0,145,71,74,145,0
2023-03-13,EV,Latvia,432,269,0,0,163,85,78,163,0
2023-03-14,EV,Latvia,384,255,0,0,129,61,68,129,0
2023-03-15,EV,Latvia,407,269,1,1,138,71,66,137,0
2023-03-16,EV,Latvia,432,283,2,2,149,72,75,147,0
2023-03-17,EV,Latvia,447,275,0,0,172,89,83,172,0
2023-03-18,EV,Latvia,415,282,0,0,133,65,68,133,0
2023-03-19,EV,Latvia,440,290,0,0,150,75,75,150,0
2023-03-20,EV,Latvia,426,255,0,0,171,85,86,171,0
2023-03-21,EV,Latvia,384,256,1,1,128,63,64,127,0
2023-03-22,EV,Latvia,426,289,1,1,137,69,67,136,0
2023-03-23,EV,Latvia,435,288,1,1,147,70,76,146,0
2023-03-24,EV,Latvia,483,304,6,6,179,89,84,173,0
2023-03-25,EV,Latvia,408,279,0,0,129,67,62,129,0
2023-03-26,EV,Latvia,442,287,0,0,155,80,75,155,0
2023-03-27,EV,Latvia,415,263,2,2,152,74,76,150,0
2023-03-28,EV,Latvia,449,299,0,0,150,75,75,150,0
2023-03-29,EV,Latvia,482,324,1,1,158,77,80,157,0
2023-03-30,EV,Latvia,468,296,1,1,172,87,84,171,0
2023-03-31,EV,Latvia,487,321,1,1,166,82,83,165,0
2023-04-01,EV,Latvia,439,307,0,0,132,64,68,132,0
2023-04-02,EV,Latvia,487,325,1,1,162,83,78,161,0
2023-04-03,EV,Latvia,482,314,3,3,168,81,84,165,0
2023-04-04,EV,Latvia,443,291,3,3,152,74,75,149,0
2023-04-05,EV,Latvia,479,308,2,2,171,85,84,169,0
2023-04-06,EV,Latvia,478,295,3,3,183,90,90,180,0
2023-04-07,EV,Latvia,501,334,1,1,167,82,84,166,0
2023-04-08,EV,Latvia,455,311,1,1,144,71,72,143,0
2023-04-09,EV,Latvia,491,332,1,1,159,82,76,158,0
2023-04-10,EV,Latvia,501,334,1,1,167,80,86,166,0
2023-04-11,EV,Latvia,449,292,3,3,157,76,78,154,0
2023-04-12,EV,Latvia,489,312,3,3,177,87,87,174,0
2023-04-13,EV,Latvia,482,308,5,5,174,85,84,169,0
2023-04-14,EV,Latvia,511,336,5,5,175,86,84,170,0
2023-04-15,EV,Latvia,462,315,1,1,147,69,77,146,0
2023-04-16,EV,Latvia,502,334,0,0,168,85,83,168,0
2023-04-17,EV,Latvia,520,346,3,3,174,84,87,171,0
2023-04-18,EV,Latvia,473,314,5,5,159,77,77,154,0
2023-04-19,EV,Latvia,506,324,7,7,182,89,86,175,0
2023-04-20,EV,Latvia,511,338,4,4,173,84,85,169,0
2023-04-21,EV,Latvia,577,391,1,1,186,92,93,185,0
2023-04-22,EV,Latvia,498,350,1,1,148,72,75,147,0
2023-04-23,EV,Latvia,550,388,2,2,162,80,80,160,0
2023-04-24,EV,Latvia,529,356,3,3,173,85,85,170,0
2023-04-25,EV,Latvia,500,331,5,5,169,82,82,164,0
2023-04-26,EV,Latvia,521,346,5,5,175,86,84,170,0
2023-04-27,EV,Latvia,541,363,2,2,178,88,88,176,0
2023-04-28,EV,Latvia,570,391,1,1,179,91,87,178,0
2023-04-29,EV,Latvia,541,390,0,0,151,74,77,151,0
2023-04-30,EV,Latvia,573,402,0,0,171,88,83,171,0
2023-05-01,EV,Latvia,563,394,0,0,169,83,86,169,0
2023-05-02,EV,Latvia,549,380,2,2,169,83,84,167,0
2023-05-03,EV,Latvia,563,383,3,3,180,88,89,177,0
2023-05-04,EV,Latvia,570,397,0,0,173,88,85,173,0
2023-05-05,EV,Latvia,590,406,1,1,184,90,93,183,0
2023-05-06,EV,Latvia,558,400,1,1,158,77,80,157,0
2023-05-07,EV,Latvia,609,430,2,2,179,87,90,177,0
2023-05-08,EV,Latvia,606,410,6,6,196,93,97,190,0
2023-05-09,EV,Latvia,577,395,5,5,182,87,90,177,0
2023-05-10,EV,Latvia,603,416,4,4,187,95,88,183,0
2023-05-11,EV,Latvia,586,398,1,1,188,94,93,187,0
2023-05-12,EV,Latvia,600,415,3,3,185,88,94,182,0
2023-05-13,EV,Latvia,575,406,2,2,169,84,83,167,0
2023-05-14,EV,Latvia,609,426,2,2,183,91,90,181,0
2023-05-15,EV,Latvia,619,431,1,1,188,92,95,187,0
2023-05-16,EV,Latvia,556,369,5,5,187,91,91,182,0
2023-05-17,EV,Latvia,599,405,3,3,194,95,96,191,0
2023-05-18,EV,Latvia,598,403,3,3,195,97,95,192,0
2023-05-19,EV,Latvia,627,426,2,2,201,100,99,199,0
2023-05-20,EV,Latvia,599,422,4,4,177,88,85,173,0
2023-05-21,EV,Latvia,639,445,3,3,194,97,94,191,0
2023-05-22,EV,Latvia,588,401,1,1,187,90,96,186,0
2023-05-23,EV,Latvia,572,386,2,2,186,95,89,184,0
2023-05-24,EV,Latvia,595,398,2,2,197,100,95,195,0
2023-05-25,EV,Latvia,616,425,4,4,191,92,95,187,0
2023-05-26,EV,Latvia,649,456,3,3,193,94,96,190,0
2023-05-27,EV,Latvia,604,425,1,1,179,90,88,178,0
2023-05-28,EV,Latvia,658,468,0,0,190,95,95,190,0
2023-05-29,EV,Latvia,613,434,0,0,179,87,92,179,0
2023-05-30,EV,Latvia,601,411,3,3,190,95,92,187,0
2023-05-31,EV,Latvia,626,440,4,4,186,89,93,182,0
2023-06-01,EV,Latvia,639,438,1,1,201,100,100,200,0
2023-06-02,EV,Latvia,641,450,2,2,191,97,92,189,0
2023-06-03,EV,Latvia,636,453,2,2,183,91,90,181,0
2023-06-04,EV,Latvia,643,446,3,3,197,99,95,194,0
2023-06-05,EV,Latvia,635,448,1,1,187,89,97,186,0
2023-06-06,EV,Latvia,599,404,3,3,195,98,94,192,0
2023-06-07,EV,Latvia,621,438,2,2,183,90,91,181,0
2023-06-08,EV,Latvia,647,449,2,2,198,97,99,196,0
2023-06-09,EV,Latvia,648,458,3,3,190,94,93,187,0
2023-06-10,EV,Latvia,629,445,7,4,184,89,88,177,3
2023-06-11,EV,Latvia,661,467,2,2,194,99,93,192,0
2023-06-12,EV,Latvia,643,455,5,5,188,89,94,183,0
2023-06-13,EV,Latvia,650,453,6,6,197,98,93,191,0
2023-06-14,EV,Latvia,636,454,4,4,182,88,90,178,0
2023-06-15,EV,Latvia,642,447,2,1,195,96,97,193,1
2023-06-16,EV,Latvia,662,469,1,1,193,97,95,192,0
2023-06-17,EV,Latvia,618,435,3,3,183,92,88,180,0
2023-06-18,EV,Latvia,665,470,2,2,195,97,96,193,0
2023-06-19,EV,Latvia,644,449,5,5,195,95,95,190,0
2023-06-20,EV,Latvia,613,417,4,4,196,96,96,192,0
2023-06-21,EV,Latvia,637,431,2,2,206,103,101,204,0
2023-06-22,EV,Latvia,598,401,2,2,197,96,99,195,0
2023-06-23,EV,Latvia,637,450,3,2,187,92,92,184,1
2023-06-24,EV,Latvia,609,426,2,2,183,91,90,181,0
2023-06-25,EV,Latvia,632,439,1,1,193,97,95,192,0
2023-06-26,EV,Latvia,622,431,0,0,191,95,96,191,0
2023-06-27,EV,Latvia,601,411,0,0,190,97,93,190,0
2023-06-28,EV,Latvia,612,429,5,4,183,89,89,178,1
2023-06-29,EV,Latvia,612,418,5,5,194,93,96,189,0
2023-06-30,EV,Latvia,648,456,5,4,192,91,96,187,1
2023-07-01,EV,Latvia,611,436,1,1,175,89,85,174,0
2023-07-02,EV,Latvia,663,462,2,2,201,98,101,199,0
2023-07-03,EV,Latvia,633,446,3,3,187,93,91,184,0
2023-07-04,EV,Latvia,599,405,3,1,194,97,94,191,2
2023-07-05,EV,Latvia,622,445,3,1,177,90,84,174,2
2023-07-06,EV,Latvia,616,425,4,4,191,91,96,187,0
2023-07-07,EV,Latvia,662,463,4,4,199,97,98,195,0
2023-07-08,EV,Latvia,626,452,3,3,174,85,86,171,0
2023-07-09,EV,Latvia,653,456,1,1,197,99,97,196,0
2023-07-10,EV,Latvia,642,450,1,1,192,93,98,191,0
2023-07-11,EV,Latvia,635,436,3,3,199,95,101,196,0
2023-07-12,EV,Latvia,646,465,3,3,181,94,84,178,0
2023-07-13,EV,Latvia,636,441,6,6,195,93,96,189,0
2023-07-14,EV,Latvia,675,480,8,8,195,93,94,187,0
2023-07-15,EV,Latvia,628,442,0,0,186,95,91,186,0
2023-07-16,EV,Latvia,652,461,1,1,191,95,95,190,0
2023-07-17,EV,Latvia,638,457,1,1,181,89,91,180,0
2023-07-18,EV,Latvia,626,433,2,2,193,99,92,191,0
2023-07-19,EV,Latvia,633,457,1,1,176,88,87,175,0
2023-07-20,EV,Latvia,651,451,3,3,200,98,99,197,0
2023-07-21,EV,Latvia,665,471,3,3,194,95,96,191,0
2023-07-22,EV,Latvia,629,452,2,2,177,85,90,175,0
2023-07-23,EV,Latvia,670,480,0,0,190,97,93,190,0
2023-07-24,EV,Latvia,640,458,1,1,182,89,92,181,0
2023-07-25,EV,Latvia,631,443,1,1,188,95,92,187,0
2023-07-26,EV,Latvia,627,450,2,2,177,86,89,175,0
2023-07-27,EV,Latvia,642,440,4,3,202,99,99,198,1
2023-07-28,EV,Latvia,674,484,2,2,190,93,95,188,0
2023-07-29,EV,Latvia,644,457,3,3,187,90,94,184,0
2023-07-30,EV,Latvia,678,480,2,2,198,100,96,196,0
2023-07-31,EV,Latvia,653,471,0,0,182,90,92,182,0
2023-08-01,EV,Latvia,637,439,3,3,198,102,93,195,0
2023-08-02,EV,Latvia,634,457,3,3,177,86,88,174,0
2023-08-03,EV,Latvia,642,438,4,4,204,99,101,200,0
2023-08-04,EV,Latvia,657,474,2,2,183,89,92,181,0
2023-08-05,EV,Latvia,609,434,1,1,175,87,87,174,0
2023-08-06,EV,Latvia,676,479,0,0,197,101,96,197,0
2023-08-07,EV,Latvia,639,441,5,5,198,93,100,193,0
2023-08-08,EV,Latvia,658,454,1,1,204,101,102,203,0
2023-08-09,EV,Latvia,648,457,5,5,191,94,92,186,0
2023-08-10,EV,Latvia,649,446,2,2,203,101,100,201,0
2023-08-11,EV,Latvia,662,484,3,3,178,86,89,175,0
2023-08-12,EV,Latvia,663,479,3,3,184,93,88,181,0
2023-08-13,EV,Latvia,683,483,1,1,200,98,101,199,0
2023-08-14,EV,Latvia,637,449,2,2,188,94,92,186,0
2023-08-15,EV,Latvia,672,464,6,6,208,100,102,202,0
2023-08-16,EV,Latvia,658,476,5,5,182,91,86,177,0
2023-08-17,EV,Latvia,661,455,8,8,206,98,100,198,0
2023-08-18,EV,Latvia,674,476,2,2,198,98,98,196,0
2023-08-19,EV,Latvia,623,442,2,2,181,90,89,179,0
2023-08-20,EV,Latvia,672,467,2,2,205,105,98,203,0
2023-08-21,EV,Latvia,645,461,3,3,184,87,94,181,0
2023-08-22,EV,Latvia,638,453,1,1,185,95,89,184,0
2023-08-23,EV,Latvia,654,470,2,2,184,92,90,182,0
2023-08-24,EV,Latvia,670,480,0,0,190,96,94,190,0
2023-08-25,EV,Latvia,658,469,0,0,189,91,98,189,0
2023-08-26,EV,Latvia,622,450,2,2,172,87,83,170,0
2023-08-27,EV,Latvia,675,481,1,1,194,94,99,193,0
2023-08-28,EV,Latvia,634,444,5,5,190,93,92,185,0
2023-08-29,EV,Latvia,669,476,5,5,193,96,92,188,0
2023-08-30,EV,Latvia,636,453,4,4,183,91,88,179,0
2023-08-31,EV,Latvia,654,457,2,2,197,96,99,195,0
2023-09-01,EV,Latvia,680,493,2,2,187,95,90,185,0
2023-09-02,EV,Latvia,618,450,0,0,168,84,84,168,0
2023-09-03,EV,Latvia,673,481,0,0,192,96,96,192,0
2023-09-04,EV,Latvia,647,464,2,2,183,88,93,181,0
2023-09-05,EV,Latvia,642,444,1,1,198,101,96,197,0
2023-09-06,EV,Latvia,648,458,4,4,190,95,91,186,0
2023-09-07,EV,Latvia,649,458,1,1,191,94,96,190,0
2023-09-08,EV,Latvia,679,499,0,0,180,88,92,180,0
2023-09-09,EV,Latvia,627,443,2,2,184,90,92,182,0
2023-09-10,EV,Latvia,681,488,1,1,193,95,97,192,0
2023-09-11,EV,Latvia,654,456,3,3,198,96,99,195,0
2023-09-12,EV,Latvia,628,431,4,4,197,96,97,193,0
2023-09-13,EV,Latvia,632,449,4,4,183,91,88,179,0
2023-09-14,EV,Latvia,630,433,1,1,197,99,97,196,0
2023-09-15,EV,Latvia,658,469,3,3,189,93,93,186,0
2023-09-16,EV,Latvia,609,432,3,3,177,84,90,174,0
2023-09-17,EV,Latvia,647,450,2,2,197,98,97,195,0
2023-09-18,EV,Latvia,662,465,4,4,197,95,98,193,0
2023-09-19,EV,Latvia,591,404,4,4,187,93,90,183,0
2023-09-20,EV,Latvia,637,455,5,5,182,90,87,177,0
2023-09-21,EV,Latvia,638,443,9,9,195,93,93,186,0
2023-09-22,EV,Latvia,659,467,2,2,192,95,95,190,0
2023-09-23,EV,Latvia,614,445,0,0,169,86,83,169,0
2023-09-24,EV,Latvia,652,457,1,1,195,98,96,194,0
2023-09-25,EV,Latvia,639,455,2,2,184,89,93,182,0
2023-09-26,EV,Latvia,581,396,0,0,185,94,91,185,0
2023-09-27,EV,Latvia,648,468,1,0,180,88,91,179,1
2023-09-28,EV,Latvia,626,429,0,0,197,99,98,197,0
2023-09-29,EV,Latvia,665,469,0,0,196,97,99,196,0
2023-09-30,EV,Latvia,613,444,2,2,169,82,85,167,0
2023-10-01,EV,Latvia,622,425,0,0,197,97,100,197,0
2023-10-02,EV,Latvia,640,442,0,0,198,100,98,198,0
2023-01-01,EY,Lithuania,386,275,0,0,111,54,57,111,0
2023-01-02,EY,Lithuania,456,331,5,4,125,59,61,120,1
2023-01-03,EY,Lithuania,409,282,3,3,127,61,63,124,0
2023-01-04,EY,Lithuania,393,286,7,6,107,50,50,100,1
2023-01-05,EY,Lithuania,403,299,2,1,104,48,54,102,1
2023-01-06,EY,Lithuania,435,295,7,7,140,67,66,133,0
2023-01-07,EY,Lithuania,424,307,0,0,117,59,58,117,0
2023-01-08,EY,Lithuania,431,301,0,0,130,61,69,130,0
2023-01-09,EY,Lithuania,427,291,7,5,136,64,65,129,2
2023-01-10,EY,Lithuania,370,254,5,3,116,54,57,111,2
2023-01-11,EY,Lithuania,365,256,3,2,109,55,51,106,1
2023-01-12,EY,Lithuania,374,268,3,2,106,51,52,103,1
2023-01-13,EY,Lithuania,402,270,6,5,132,64,62,126,1
2023-01-14,EY,Lithuania,382,260,9,6,122,54,59,113,3
2023-01-15,EY,Lithuania,414,285,3,3,129,63,63,126,0
2023-01-16,EY,Lithuania,385,256,5,3,129,62,62,124,2
2023-01-17,EY,Lithuania,347,234,1,1,113,56,56,112,0
2023-01-18,EY,Lithuania,329,231,3,3,98,50,45,95,0
2023-01-19,EY,Lithuania,352,245,3,3,107,51,53,104,0
2023-01-20,EY,Lithuania,392,253,4,2,139,70,65,135,2
2023-01-21,EY,Lithuania,365,250,1,1,115,56,58,114,0
2023-01-22,EY,Lithuania,394,260,5,0,134,65,64,129,5
2023-01-23,EY,Lithuania,382,260,4,4,122,60,58,118,0
2023-01-24,EY,Lithuania,339,222,4,4,117,55,58,113,0
2023-01-25,EY,Lithuania,328,221,3,2,107,56,48,104,1
2023-01-26,EY,Lithuania,347,248,2,1,99,48,49,97,1
2023-01-27,EY,Lithuania,395,256,3,2,139,68,68,136,1
2023-01-28,EY,Lithuania,353,244,4,4,109,53,52,105,0
2023-01-29,EY,Lithuania,382,261,0,0,121,60,61,121,0
2023-01-30,EY,Lithuania,405,276,2,2,129,62,65,127,0
2023-01-31,EY,Lithuania,355,241,8,6,114,52,54,106,2
2023-02-01,EY,Lithuania,323,227,3,3,96,47,46,93,0
2023-02-02,EY,Lithuania,350,240,6,5,110,53,51,104,1
2023-02-03,EY,Lithuania,381,247,7,5,134,63,64,127,2
2023-02-04,EY,Lithuania,346,234,1,1,112,55,56,111,0
2023-02-05,EY,Lithuania,397,269,6,4,128,61,61,122,2
2023-02-06,EY,Lithuania,355,235,7,7,120,55,58,113,0
2023-02-07,EY,Lithuania,334,213,9,8,121,55,57,112,1
2023-02-08,EY,Lithuania,351,234,13,12,117,55,49,104,1
2023-02-09,EY,Lithuania,377,254,13,10,123,56,54,110,3
2023-02-10,EY,Lithuania,405,256,5,3,149,72,72,144,2
2023-02-11,EY,Lithuania,373,251,4,4,122,62,56,118,0
2023-02-12,EY,Lithuania,388,261,3,2,127,62,62,124,1
2023-02-13,EY,Lithuania,392,259,5,3,133,62,66,128,2
2023-02-14,EY,Lithuania,345,223,9,9,122,55,58,113,0
2023-02-15,EY,Lithuania,342,240,3,2,102,53,46,99,1
2023-02-16,EY,Lithuania,361,252,3,2,109,52,54,106,1
2023-02-17,EY,Lithuania,377,248,2,2,129,64,63,127,0
2023-02-18,EY,Lithuania,367,251,0,0,116,58,58,116,0
2023-02-19,EY,Lithuania,408,277,4,4,131,61,66,127,0
2023-02-20,EY,Lithuania,397,271,2,1,126,61,63,124,1
2023-02-21,EY,Lithuania,349,223,7,6,126,59,60,119,1
2023-02-22,EY,Lithuania,375,265,10,8,110,50,50,100,2
2023-02-23,EY,Lithuania,380,259,8,7,121,57,56,113,1
2023-02-24,EY,Lithuania,397,269,1,0,128,65,62,127,1
2023-02-25,EY,Lithuania,387,267,4,4,120,59,57,116,0
2023-02-26,EY,Lithuania,422,296,1,1,126,60,65,125,0
2023-02-27,EY,Lithuania,415,283,4,3,132,63,65,128,1
2023-02-28,EY,Lithuania,369,250,7,5,119,56,56,112,2
2023-03-01,EY,Lithuania,376,267,10,7,109,50,49,99,3
2023-03-02,EY,Lithuania,388,273,5,5,115,55,55,110,0
2023-03-03,EY,Lithuania,412,271,7,5,141,66,68,134,2
2023-03-04,EY,Lithuania,373,249,6,2,124,60,58,118,4
2023-03-05,EY,Lithuania,402,275,4,2,127,61,62,123,2
2023-03-06,EY,Lithuania,411,284,8,6,127,60,59,119,2
2023-03-07,EY,Lithuania,362,248,6,6,114,54,54,108,0
2023-03-08,EY,Lithuania,373,272,4,1,101,48,49,97,3
2023-03-09,EY,Lithuania,406,278,12,8,128,59,57,116,4
2023-03-10,EY,Lithuania,424,284,6,5,140,66,68,134,1
2023-03-11,EY,Lithuania,366,252,2,2,114,58,54,112,0
2023-03-12,EY,Lithuania,411,292,1,1,119,58,60,118,0
2023-03-13,EY,Lithuania,412,277,6,5,135,65,64,129,1
2023-03-14,EY,Lithuania,361,241,5,4,120,56,59,115,1
2023-03-15,EY,Lithuania,371,267,4,4,104,51,49,100,0
2023-03-16,EY,Lithuania,415,290,12,12,125,57,56,113,0
2023-03-17,EY,Lithuania,414,274,11,10,140,62,67,129,1
2023-03-18,EY,Lithuania,385,263,3,3,122,60,59,119,0
2023-03-19,EY,Lithuania,416,282,3,2,134,66,65,131,1
2023-03-20,EY,Lithuania,417,290,5,5,127,61,61,122,0
2023-03-21,EY,Lithuania,361,243,8,8,118,54,56,110,0
2023-03-22,EY,Lithuania,377,263,9,7,114,54,51,105,2
2023-03-23,EY,Lithuania,399,273,9,8,126,59,58,117,1
2023-03-24,EY,Lithuania,432,298,5,4,134,65,64,129,1
2023-03-25,EY,Lithuania,389,253,6,6,136,65,65,130,0
2023-03-26,EY,Lithuania,425,286,5,4,139,67,67,134,1
2023-03-27,EY,Lithuania,420,269,10,10,151,68,73,141,0
2023-03-28,EY,Lithuania,429,304,3,3,125,63,59,122,0
2023-03-29,EY,Lithuania,440,299,11,9,141,62,68,130,2
2023-03-30,EY,Lithuania,449,293,12,11,156,74,70,144,1
2023-03-31,EY,Lithuania,435,292,2,1,143,70,71,141,1
2023-04-01,EY,Lithuania,413,286,0,0,127,67,60,127,0
2023-04-02,EY,Lithuania,449,310,3,2,139,65,71,136,1
2023-04-03,EY,Lithuania,447,295,9,9,152,72,71,143,0
2023-04-04,EY,Lithuania,425,303,1,1,122,61,60,121,0
2023-04-05,EY,Lithuania,449,312,6,5,137,65,66,131,1
2023-04-06,EY,Lithuania,462,311,6,6,151,73,72,145,0
2023-04-07,EY,Lithuania,466,311,9,7,155,73,73,146,2
2023-04-08,EY,Lithuania,415,298,2,2,117,56,59,115,0
2023-04-09,EY,Lithuania,449,317,2,2,132,66,64,130,0
2023-04-10,EY,Lithuania,439,294,4,3,145,69,72,141,1
2023-04-11,EY,Lithuania,443,299,13,9,144,67,64,131,4
2023-04-12,EY,Lithuania,452,299,9,8,153,74,70,144,1
2023-04-13,EY,Lithuania,472,319,13,12,153,71,69,140,1
2023-04-14,EY,Lithuania,488,326,13,11,162,73,76,149,2
2023-04-15,EY,Lithuania,446,317,1,1,129,64,64,128,0
2023-04-16,EY,Lithuania,480,328,3,1,152,75,74,149,2
2023-04-17,EY,Lithuania,485,325,2,1,160,77,81,158,1
2023-04-18,EY,Lithuania,456,314,6,6,142,68,68,136,0
2023-04-19,EY,Lithuania,476,328,5,5,148,72,71,143,0
2023-04-20,EY,Lithuania,493,334,6,5,159,76,77,153,1
2023-04-21,EY,Lithuania,545,378,11,11,167,80,76,156,0
2023-04-22,EY,Lithuania,472,343,3,2,129,62,64,126,1
2023-04-23,EY,Lithuania,510,366,1,1,144,70,73,143,0
2023-04-24,EY,Lithuania,501,344,10,9,157,73,74,147,1
2023-04-25,EY,Lithuania,503,347,15,15,156,71,70,141,0
2023-04-26,EY,Lithuania,498,351,7,6,147,72,68,140,1
2023-04-27,EY,Lithuania,544,389,13,12,155,70,72,142,1
2023-04-28,EY,Lithuania,567,402,12,10,165,78,75,153,2
2023-04-29,EY,Lithuania,526,393,3,3,133,66,64,130,0
2023-04-30,EY,Lithuania,558,421,1,1,137,67,69,136,0
2023-05-01,EY,Lithuania,550,395,1,0,155,75,79,154,1
2023-05-02,EY,Lithuania,555,387,10,9,168,77,81,158,1
2023-05-03,EY,Lithuania,555,393,14,12,162,76,72,148,2
2023-05-04,EY,Lithuania,565,403,16,15,162,75,71,146,1
2023-05-05,EY,Lithuania,580,414,7,7,166,79,80,159,0
2023-05-06,EY,Lithuania,530,403,2,1,127,64,61,125,1
2023-05-07,EY,Lithuania,602,443,5,2,159,75,79,154,3
2023-05-08,EY,Lithuania,582,414,8,8,168,81,79,160,0
2023-05-09,EY,Lithuania,565,418,11,10,147,67,69,136,1
2023-05-10,EY,Lithuania,565,407,6,6,158,76,76,152,0
2023-05-11,EY,Lithuania,585,422,13,12,163,74,76,150,1
2023-05-12,EY,Lithuania,593,417,14,12,176,81,81,162,2
2023-05-13,EY,Lithuania,543,412,8,8,131,65,58,123,0
2023-05-14,EY,Lithuania,572,423,2,1,149,73,74,147,1
2023-05-15,EY,Lithuania,602,436,4,4,166,80,82,162,0
2023-05-16,EY,Lithuania,540,395,6,5,145,70,69,139,1
2023-05-17,EY,Lithuania,556,396,8,8,160,75,77,152,0
2023-05-18,EY,Lithuania,583,417,6,5,166,78,82,160,1
2023-05-19,EY,Lithuania,640,441,4,4,199,96,99,195,0
2023-05-20,EY,Lithuania,572,436,4,3,136,65,67,132,1
2023-05-21,EY,Lithuania,623,440,1,0,183,89,93,182,1
2023-05-22,EY,Lithuania,598,391,6,5,207,104,97,201,1
2023-05-23,EY,Lithuania,570,409,7,5,161,79,75,154,2
2023-05-24,EY,Lithuania,584,412,8,7,172,80,84,164,1
2023-05-25,EY,Lithuania,595,430,9,9,165,80,76,156,0
2023-05-26,EY,Lithuania,608,437,10,8,171,79,82,161,2
2023-05-27,EY,Lithuania,575,439,4,1,136,69,63,132,3
2023-05-28,EY,Lithuania,606,452,1,1,154,76,77,153,0
2023-05-29,EY,Lithuania,598,420,6,5,178,85,87,172,1
2023-05-30,EY,Lithuania,581,421,9,8,160,75,76,151,1
2023-05-31,EY,Lithuania,582,418,8,7,164,78,78,156,1
2023-06-01,EY,Lithuania,617,440,10,8,177,82,85,167,2
2023-06-02,EY,Lithuania,621,441,8,7,180,87,85,172,1
2023-06-03,EY,Lithuania,589,450,6,3,139,71,62,133,3
2023-06-04,EY,Lithuania,607,445,4,1,162,75,83,158,3
2023-06-05,EY,Lithuania,618,440,11,9,178,85,82,167,2
2023-06-06,EY,Lithuania,579,413,15,14,166,77,74,151,1
2023-06-07,EY,Lithuania,590,423,9,9,167,78,80,158,0
2023-06-08,EY,Lithuania,616,450,11,8,166,78,77,155,3
2023-06-09,EY,Lithuania,614,445,6,4,169,81,82,163,2
2023-06-10,EY,Lithuania,604,472,4,4,132,67,61,128,0
2023-06-11,EY,Lithuania,639,470,3,2,169,79,87,166,1
2023-06-12,EY,Lithuania,638,451,9,9,187,89,89,178,0
2023-06-13,EY,Lithuania,615,455,11,10,160,74,75,149,1
2023-06-14,EY,Lithuania,606,434,11,9,172,87,74,161,2
2023-06-15,EY,Lithuania,622,455,9,8,167,77,81,158,1
2023-06-16,EY,Lithuania,631,455,6,5,176,86,84,170,1
2023-06-17,EY,Lithuania,606,463,4,2,143,70,69,139,2
2023-06-18,EY,Lithuania,628,461,9,5,167,79,79,158,4
2023-06-19,EY,Lithuania,628,448,6,6,180,85,89,174,0
2023-06-20,EY,Lithuania,599,437,9,8,162,77,76,153,1
2023-06-21,EY,Lithuania,608,444,17,7,164,73,74,147,10
2023-06-22,EY,Lithuania,609,438,11,10,171,79,81,160,1
2023-06-23,EY,Lithuania,619,447,12,11,172,79,81,160,1
2023-06-24,EY,Lithuania,584,451,1,1,133,68,64,132,0
2023-06-25,EY,Lithuania,603,443,1,0,160,77,82,159,1
2023-06-26,EY,Lithuania,625,435,9,8,190,94,87,181,1
2023-06-27,EY,Lithuania,587,434,9,9,153,72,72,144,0
2023-06-28,EY,Lithuania,577,408,13,11,169,77,79,156,2
2023-06-29,EY,Lithuania,593,432,10,7,161,75,76,151,3
2023-06-30,EY,Lithuania,604,444,9,6,160,76,75,151,3
2023-07-01,EY,Lithuania,598,457,6,2,141,68,67,135,4
2023-07-02,EY,Lithuania,610,462,1,1,148,73,74,147,0
2023-07-03,EY,Lithuania,619,439,2,1,180,88,90,178,1
2023-07-04,EY,Lithuania,571,420,5,5,151,75,71,146,0
2023-07-05,EY,Lithuania,584,417,11,11,167,78,78,156,0
2023-07-06,EY,Lithuania,601,446,11,8,155,72,72,144,3
2023-07-07,EY,Lithuania,626,452,12,7,174,80,82,162,5
2023-07-08,EY,Lithuania,618,474,5,4,144,71,68,139,1
2023-07-09,EY,Lithuania,631,465,3,1,166,81,82,163,2
2023-07-10,EY,Lithuania,647,446,9,3,201,87,105,192,6
2023-07-11,EY,Lithuania,566,455,7,6,111,49,55,104,1
2023-07-12,EY,Lithuania,610,447,8,6,163,91,64,155,2
2023-07-13,EY,Lithuania,628,442,9,6,186,90,87,177,3
2023-07-14,EY,Lithuania,616,428,5,4,188,90,93,183,1
2023-07-15,EY,Lithuania,607,467,4,3,140,69,67,136,1
2023-07-16,EY,Lithuania,615,462,2,0,153,75,76,151,2
2023-07-17,EY,Lithuania,624,436,15,8,188,86,87,173,7
2023-07-18,EY,Lithuania,585,438,6,6,147,71,70,141,0
2023-07-19,EY,Lithuania,587,413,12,9,174,80,82,162,3
2023-07-20,EY,Lithuania,621,440,19,17,181,80,82,162,2
2023-07-21,EY,Lithuania,635,462,13,13,173,81,79,160,0
2023-07-22,EY,Lithuania,607,474,1,1,133,67,65,132,0
2023-07-23,EY,Lithuania,634,466,1,0,168,85,82,167,1
2023-07-24,EY,Lithuania,633,460,11,10,173,79,83,162,1
2023-07-25,EY,Lithuania,618,456,9,9,162,77,76,153,0
2023-07-26,EY,Lithuania,616,446,9,8,170,80,81,161,1
2023-07-27,EY,Lithuania,624,462,13,13,162,73,76,149,0
2023-07-28,EY,Lithuania,634,469,14,13,165,77,74,151,1
2023-07-29,EY,Lithuania,622,495,3,3,127,64,60,124,0
2023-07-30,EY,Lithuania,643,490,1,1,153,74,78,152,0
2023-07-31,EY,Lithuania,641,456,12,11,185,86,87,173,1
2023-08-01,EY,Lithuania,632,475,7,7,157,77,73,150,0
2023-08-02,EY,Lithuania,613,449,8,7,164,76,80,156,1
2023-08-03,EY,Lithuania,615,451,8,7,164,78,78,156,1
2023-08-04,EY,Lithuania,635,470,6,6,165,80,79,159,0
2023-08-05,EY,Lithuania,605,475,1,1,130,66,63,129,0
2023-08-06,EY,Lithuania,625,466,1,1,159,80,78,158,0
2023-08-07,EY,Lithuania,610,449,2,2,161,78,81,159,0
2023-08-08,EY,Lithuania,628,477,6,4,151,73,72,145,2
2023-08-09,EY,Lithuania,630,464,10,7,166,77,79,156,3
2023-08-10,EY,Lithuania,640,465,7,7,175,85,83,168,0
2023-08-11,EY,Lithuania,640,474,10,10,166,78,78,156,0
2023-08-12,EY,Lithuania,639,508,1,1,131,67,63,130,0
2023-08-13,EY,Lithuania,648,482,1,1,166,82,83,165,0
2023-08-14,EY,Lithuania,641,463,12,11,178,82,84,166,1
2023-08-15,EY,Lithuania,632,479,7,6,153,72,74,146,1
2023-08-16,EY,Lithuania,635,474,12,10,161,76,73,149,2
2023-08-17,EY,Lithuania,655,476,11,8,179,83,85,168,3
2023-08-18,EY,Lithuania,653,473,7,5,180,86,87,173,2
2023-08-19,EY,Lithuania,611,470,1,0,141,70,70,140,1
2023-08-20,EY,Lithuania,645,483,2,1,162,80,80,160,1
2023-08-21,EY,Lithuania,651,466,8,8,185,88,89,177,0
2023-08-22,EY,Lithuania,648,486,15,13,162,73,74,147,2
2023-08-23,EY,Lithuania,646,464,14,14,182,81,87,168,0
2023-08-24,EY,Lithuania,690,496,16,12,194,89,89,178,4
2023-08-25,EY,Lithuania,660,485,8,6,175,87,80,167,2
2023-08-26,EY,Lithuania,642,500,3,2,142,69,70,139,1
2023-08-27,EY,Lithuania,685,516,6,2,169,84,79,163,4
2023-08-28,EY,Lithuania,656,476,9,7,180,84,87,171,2
2023-08-29,EY,Lithuania,645,489,3,3,156,75,78,153,0
2023-08-30,EY,Lithuania,615,456,5,5,159,77,77,154,0
2023-08-31,EY,Lithuania,658,481,7,5,177,83,87,170,2
2023-09-01,EY,Lithuania,647,472,5,4,175,87,83,170,1
2023-09-02,EY,Lithuania,621,477,3,3,144,73,68,141,0
2023-09-03,EY,Lithuania,647,479,3,2,168,81,84,165,1
2023-09-04,EY,Lithuania,637,452,7,7,185,88,90,178,0
2023-09-05,EY,Lithuania,618,459,8,7,159,75,76,151,1
2023-09-06,EY,Lithuania,643,467,14,13,176,78,84,162,1
2023-09-07,EY,Lithuania,652,466,18,14,186,85,83,168,4
2023-09-08,EY,Lithuania,645,470,8,8,175,86,81,167,0
2023-09-09,EY,Lithuania,609,466,4,2,143,69,70,139,2
2023-09-10,EY,Lithuania,668,496,2,0,172,84,86,170,2
2023-09-11,EY,Lithuania,635,448,13,13,187,89,85,174,0
2023-09-12,EY,Lithuania,611,453,13,10,158,71,74,145,3
2023-09-13,EY,Lithuania,611,437,10,8,174,82,82,164,2
2023-09-14,EY,Lithuania,632,442,9,6,190,92,89,181,3
2023-09-15,EY,Lithuania,635,454,10,9,181,83,88,171,1
2023-09-16,EY,Lithuania,605,465,5,4,140,69,66,135,1
2023-09-17,EY,Lithuania,625,457,2,2,168,83,83,166,0
2023-09-18,EY,Lithuania,655,468,14,13,187,85,88,173,1
2023-09-19,EY,Lithuania,599,437,11,10,162,76,75,151,1
2023-09-20,EY,Lithuania,625,451,11,9,174,80,83,163,2
2023-09-21,EY,Lithuania,654,473,15,10,181,83,83,166,5
2023-09-22,EY,Lithuania,647,473,12,10,174,84,78,162,2
2023-09-23,EY,Lithuania,613,469,1,1,144,70,73,143,0
2023-09-24,EY,Lithuania,635,466,2,1,169,83,84,167,1
2023-09-25,EY,Lithuania,636,449,13,13,187,87,87,174,0
2023-09-26,EY,Lithuania,582,413,10,7,169,80,79,159,3
2023-09-27,EY,Lithuania,596,430,8,8,166,79,79,158,0
2023-09-28,EY,Lithuania,635,445,13,12,190,87,90,177,1
2023-09-29,EY,Lithuania,658,464,13,12,194,90,91,181,1
2023-09-30,EY,Lithuania,594,445,7,7,149,72,70,142,0
2023-10-01,EY,Lithuania,602,437,1,0,165,81,83,164,1
2023-10-02,EY,Lithuania,612,430,7,6,182,86,89,175,1
2023-01-01,LM,Malta,251,145,0,0,106,51,55,106,0
2023-01-02,LM,Malta,294,157,0,0,137,67,70,137,0
2023-01-03,LM,Malta,260,138,0,0,122,62,60,122,0
2023-01-04,LM,Malta,243,148,0,0,95,47,48,95,0
2023-01-05,LM,Malta,258,139,0,0,119,60,59,119,0
2023-01-06,LM,Malta,271,155,0,0,116,58,58,116,0
2023-01-07,LM,Malta,268,147,0,0,121,60,61,121,0
2023-01-08,LM,Malta,284,155,0,0,129,65,64,129,0
2023-01-09,LM,Malta,276,151,2,2,125,59,64,123,0
2023-01-10,LM,Malta,248,159,0,0,89,44,45,89,0
2023-01-11,LM,Malta,229,145,2,2,84,45,37,82,0
2023-01-12,LM,Malta,231,123,1,1,108,52,55,107,0
2023-01-13,LM,Malta,239,121,0,0,118,60,58,118,0
2023-01-14,LM,Malta,238,130,2,2,108,54,52,106,0
2023-01-15,LM,Malta,255,142,0,0,113,56,57,113,0
2023-01-16,LM,Malta,258,157,2,2,101,52,47,99,0
2023-01-17,LM,Malta,227,142,0,0,85,42,43,85,0
2023-01-18,LM,Malta,245,164,0,0,81,40,41,81,0
2023-01-19,LM,Malta,233,130,0,0,103,54,49,103,0
2023-01-20,LM,Malta,259,148,3,3,111,51,57,108,0
2023-01-21,LM,Malta,283,173,0,0,110,55,55,110,0
2023-01-22,LM,Malta,275,158,0,0,117,60,57,117,0
2023-01-23,LM,Malta,265,149,1,1,116,55,60,115,0
2023-01-24,LM,Malta,216,138,1,1,78,37,40,77,0
2023-01-25,LM,Malta,242,156,3,3,86,42,41,83,0
2023-01-26,LM,Malta,261,147,1,1,114,55,58,113,0
2023-01-27,LM,Malta,272,158,0,0,114,57,57,114,0
2023-01-28,LM,Malta,255,141,0,0,114,59,55,114,0
2023-01-29,LM,Malta,254,139,1,1,115,56,58,114,0
2023-01-30,LM,Malta,261,144,2,2,117,55,60,115,0
2023-01-31,LM,Malta,213,136,1,1,77,38,38,76,0
2023-02-01,LM,Malta,224,148,4,4,76,38,34,72,0
2023-02-02,LM,Malta,238,123,1,1,115,59,55,114,0
2023-02-03,LM,Malta,241,126,4,4,115,55,56,111,0
2023-02-04,LM,Malta,252,139,1,1,113,57,55,112,0
2023-02-05,LM,Malta,256,136,1,1,120,58,61,119,0
2023-02-06,LM,Malta,283,161,1,1,122,60,61,121,0
2023-02-07,LM,Malta,212,140,1,1,72,34,37,71,0
2023-02-08,LM,Malta,226,145,1,1,81,41,39,80,0
2023-02-09,LM,Malta,237,127,0,0,110,58,52,110,0
2023-02-10,LM,Malta,252,130,0,0,122,61,61,122,0
2023-02-11,LM,Malta,268,144,0,0,124,61,63,124,0
2023-02-12,LM,Malta,323,191,1,1,132,62,69,131,0
2023-02-13,LM,Malta,288,153,0,0,135,71,64,135,0
2023-02-14,LM,Malta,218,138,1,1,80,39,40,79,0
2023-02-15,LM,Malta,231,146,0,0,85,42,43,85,0
2023-02-16,LM,Malta,260,144,3,3,116,56,57,113,0
2023-02-17,LM,Malta,267,145,2,2,122,60,60,120,0
2023-02-18,LM,Malta,265,136,3,3,129,64,62,126,0
2023-02-19,LM,Malta,303,171,1,1,132,65,66,131,0
2023-02-20,LM,Malta,295,155,5,5,140,68,67,135,0
2023-02-21,LM,Malta,256,150,7,7,106,50,49,99,0
2023-02-22,LM,Malta,239,149,3,3,90,43,44,87,0
2023-02-23,LM,Malta,260,145,3,3,115,56,56,112,0
2023-02-24,LM,Malta,273,147,3,3,126,63,60,123,0
2023-02-25,LM,Malta,293,170,2,2,123,62,59,121,0
2023-02-26,LM,Malta,317,194,0,0,123,62,61,123,0
2023-02-27,LM,Malta,319,190,3,3,129,64,62,126,0
2023-02-28,LM,Malta,259,169,2,2,90,41,47,88,0
2023-03-01,LM,Malta,294,184,4,4,110,54,52,106,0
2023-03-02,LM,Malta,305,190,4,4,115,57,54,111,0
2023-03-03,LM,Malta,287,169,1,1,118,57,60,117,0
2023-03-04,LM,Malta,293,168,0,0,125,63,62,125,0
2023-03-05,LM,Malta,323,195,0,0,128,64,64,128,0
2023-03-06,LM,Malta,313,188,1,1,125,63,61,124,0
2023-03-07,LM,Malta,243,152,1,1,91,43,47,90,0
2023-03-08,LM,Malta,253,160,1,1,93,48,44,92,0
2023-03-09,LM,Malta,279,166,0,0,113,56,57,113,0
2023-03-10,LM,Malta,268,151,0,0,117,60,57,117,0
2023-03-11,LM,Malta,270,152,2,2,118,57,59,116,0
2023-03-12,LM,Malta,336,215,0,0,121,61,60,121,0
2023-03-13,LM,Malta,312,186,2,2,126,63,61,124,0
2023-03-14,LM,Malta,253,160,1,1,93,47,45,92,0
2023-03-15,LM,Malta,290,189,2,2,101,48,51,99,0
2023-03-16,LM,Malta,282,155,0,0,127,64,63,127,0
2023-03-17,LM,Malta,279,152,1,1,127,62,64,126,0
2023-03-18,LM,Malta,284,146,2,2,138,68,68,136,0
2023-03-19,LM,Malta,318,196,1,1,122,60,61,121,0
2023-03-20,LM,Malta,317,185,0,0,132,64,68,132,0
2023-03-21,LM,Malta,264,167,1,1,97,45,51,96,0
2023-03-22,LM,Malta,272,184,0,0,88,46,42,88,0
2023-03-23,LM,Malta,315,177,1,1,138,70,67,137,0
2023-03-24,LM,Malta,317,183,1,1,134,65,68,133,0
2023-03-25,LM,Malta,298,169,1,1,129,62,66,128,0
2023-03-26,LM,Malta,349,192,1,1,157,80,76,156,0
2023-03-27,LM,Malta,363,197,2,2,166,80,84,164,0
2023-03-28,LM,Malta,325,164,3,3,161,79,79,158,0
2023-03-29,LM,Malta,324,169,1,1,155,78,76,154,0
2023-03-30,LM,Malta,377,170,2,2,207,103,102,205,0
2023-03-31,LM,Malta,331,165,1,1,166,83,82,165,0
2023-04-01,LM,Malta,374,202,1,1,172,84,87,171,0
2023-04-02,LM,Malta,363,219,0,0,144,72,72,144,0
2023-04-03,LM,Malta,411,226,0,0,185,91,94,185,0
2023-04-04,LM,Malta,376,215,0,0,161,83,78,161,0
2023-04-05,LM,Malta,353,194,0,0,159,80,79,159,0
2023-04-06,LM,Malta,415,210,0,0,205,101,104,205,0
2023-04-07,LM,Malta,349,187,3,3,162,81,78,159,0
2023-04-08,LM,Malta,349,177,1,1,172,82,89,171,0
2023-04-09,LM,Malta,347,197,1,1,150,75,74,149,0
2023-04-10,LM,Malta,354,175,3,3,179,88,88,176,0
2023-04-11,LM,Malta,325,163,0,0,162,80,82,162,0
2023-04-12,LM,Malta,326,162,1,1,164,81,82,163,0
2023-04-13,LM,Malta,374,174,2,2,200,98,100,198,0
2023-04-14,LM,Malta,348,172,2,2,176,87,87,174,0
2023-04-15,LM,Malta,368,189,1,1,179,90,88,178,0
2023-04-16,LM,Malta,369,207,0,0,162,80,82,162,0
2023-04-17,LM,Malta,411,218,0,0,193,98,95,193,0
2023-04-18,LM,Malta,343,178,3,3,165,83,79,162,0
2023-04-19,LM,Malta,374,217,1,1,157,77,79,156,0
2023-04-20,LM,Malta,408,200,2,2,208,102,104,206,0
2023-04-21,LM,Malta,396,219,0,0,177,91,86,177,0
2023-04-22,LM,Malta,382,215,0,0,167,82,85,167,0
2023-04-23,LM,Malta,365,198,1,1,167,82,84,166,0
2023-04-24,LM,Malta,408,219,2,2,189,90,97,187,0
2023-04-25,LM,Malta,367,195,1,1,172,87,84,171,0
2023-04-26,LM,Malta,363,205,0,0,158,79,79,158,0
2023-04-27,LM,Malta,442,225,1,1,217,110,106,216,0
2023-04-28,LM,Malta,379,204,2,2,175,88,85,173,0
2023-04-29,LM,Malta,390,207,1,1,183,89,93,182,0
2023-04-30,LM,Malta,364,209,1,1,155,79,75,154,0
2023-05-01,LM,Malta,413,239,2,2,174,85,87,172,0
2023-05-02,LM,Malta,410,221,3,3,189,94,92,186,0
2023-05-03,LM,Malta,390,237,2,2,153,74,77,151,0
2023-05-04,LM,Malta,452,232,2,2,220,109,109,218,0
2023-05-05,LM,Malta,393,217,2,2,176,89,85,174,0
2023-05-06,LM,Malta,394,214,1,1,180,89,90,179,0
2023-05-07,LM,Malta,346,190,1,1,156,77,78,155,0
2023-05-08,LM,Malta,393,201,2,2,192,95,95,190,0
2023-05-09,LM,Malta,352,173,1,1,179,92,86,178,0
2023-05-10,LM,Malta,364,203,2,2,161,79,80,159,0
2023-05-11,LM,Malta,418,198,3,3,220,106,111,217,0
2023-05-12,LM,Malta,393,216,1,1,177,89,87,176,0
2023-05-13,LM,Malta,376,200,0,0,176,87,89,176,0
2023-05-14,LM,Malta,359,202,0,0,157,78,79,157,0
2023-05-15,LM,Malta,421,231,0,0,190,96,94,190,0
2023-05-16,LM,Malta,380,200,1,1,180,93,86,179,0
2023-05-17,LM,Malta,373,206,3,3,167,81,83,164,0
2023-05-18,LM,Malta,396,175,1,1,221,109,111,220,0
2023-05-19,LM,Malta,356,174,1,1,182,93,88,181,0
2023-05-20,LM,Malta,392,205,2,2,187,91,94,185,0
2023-05-21,LM,Malta,325,169,1,1,156,79,76,155,0
2023-05-22,LM,Malta,368,184,0,0,184,89,95,184,0
2023-05-23,LM,Malta,321,149,1,1,172,87,84,171,0
2023-05-24,LM,Malta,334,168,2,2,166,79,85,164,0
2023-05-25,LM,Malta,361,148,2,2,213,107,104,211,0
2023-05-26,LM,Malta,349,168,3,3,181,89,89,178,0
2023-05-27,LM,Malta,397,208,2,2,189,95,92,187,0
2023-05-28,LM,Malta,364,197,1,1,167,80,86,166,0
2023-05-29,LM,Malta,402,207,6,6,195,93,96,189,0
2023-05-30,LM,Malta,347,167,2,2,180,90,88,178,0
2023-05-31,LM,Malta,371,208,4,4,163,79,80,159,0
2023-06-01,LM,Malta,433,215,1,1,218,107,110,217,0
2023-06-02,LM,Malta,403,214,3,3,189,94,92,186,0
2023-06-03,LM,Malta,435,245,2,2,190,95,93,188,0
2023-06-04,LM,Malta,431,257,1,1,174,87,86,173,0
2023-06-05,LM,Malta,416,235,1,1,181,89,91,180,0
2023-06-06,LM,Malta,389,220,1,1,169,85,83,168,0
2023-06-07,LM,Malta,414,252,0,0,162,80,82,162,0
2023-06-08,LM,Malta,483,266,3,3,217,108,106,214,0
2023-06-09,LM,Malta,411,240,2,2,171,83,86,169,0
2023-06-10,LM,Malta,436,258,2,2,178,86,90,176,0
2023-06-11,LM,Malta,449,275,1,1,174,90,83,173,0
2023-06-12,LM,Malta,459,267,3,3,192,93,96,189,0
2023-06-13,LM,Malta,401,223,2,2,178,88,88,176,0
2023-06-14,LM,Malta,405,240,3,3,165,78,84,162,0
2023-06-15,LM,Malta,504,284,0,0,220,108,112,220,0
2023-06-16,LM,Malta,498,301,2,2,197,102,93,195,0
2023-06-17,LM,Malta,485,295,2,2,190,94,94,188,0
2023-06-18,LM,Malta,475,288,0,0,187,95,92,187,0
2023-06-19,LM,Malta,444,248,3,3,196,96,97,193,0
2023-06-20,LM,Malta,407,225,1,1,182,92,89,181,0
2023-06-21,LM,Malta,410,247,3,3,163,78,82,160,0
2023-06-22,LM,Malta,452,243,3,3,209,105,101,206,0
2023-06-23,LM,Malta,441,247,3,3,194,95,96,191,0
2023-06-24,LM,Malta,463,262,4,4,201,96,101,197,0
2023-06-25,LM,Malta,458,262,2,2,196,95,99,194,0
2023-06-26,LM,Malta,430,229,2,2,201,101,98,199,0
2023-06-27,LM,Malta,370,198,4,4,172,83,85,168,0
2023-06-28,LM,Malta,356,183,2,2,173,85,86,171,0
2023-06-29,LM,Malta,404,195,3,3,209,105,101,206,0
2023-06-30,LM,Malta,396,211,5,5,185,88,92,180,0
2023-07-01,LM,Malta,435,240,1,1,195,96,98,194,0
2023-07-02,LM,Malta,428,243,0,0,185,91,94,185,0
2023-07-03,LM,Malta,448,248,0,0,200,101,99,200,0
2023-07-04,LM,Malta,434,241,1,1,193,95,97,192,0
2023-07-05,LM,Malta,437,247,3,3,190,94,93,187,0
2023-07-06,LM,Malta,492,272,1,1,220,111,108,219,0
2023-07-07,LM,Malta,445,257,2,2,188,92,94,186,0
2023-07-08,LM,Malta,470,276,2,2,194,94,98,192,0
2023-07-09,LM,Malta,452,261,1,1,191,93,97,190,0
2023-07-10,LM,Malta,480,266,0,0,214,108,106,214,0
2023-07-11,LM,Malta,450,247,0,0,203,103,100,203,0
2023-07-12,LM,Malta,410,235,0,0,175,87,88,175,0
2023-07-13,LM,Malta,501,272,0,0,229,114,115,229,0
2023-07-14,LM,Malta,444,249,0,0,195,101,94,195,0
2023-07-15,LM,Malta,465,279,2,2,186,90,94,184,0
2023-07-16,LM,Malta,480,271,2,2,209,107,100,207,0
2023-07-17,LM,Malta,457,256,3,3,201,97,101,198,0
2023-07-18,LM,Malta,434,236,2,2,198,99,97,196,0
2023-07-19,LM,Malta,437,250,1,1,187,94,92,186,0
2023-07-20,LM,Malta,480,255,1,1,225,109,115,224,0
2023-07-21,LM,Malta,440,252,1,1,188,97,90,187,0
2023-07-22,LM,Malta,467,278,1,1,189,92,96,188,0
2023-07-23,LM,Malta,447,245,1,1,202,102,99,201,0
2023-07-24,LM,Malta,460,258,2,2,202,99,101,200,0
2023-07-25,LM,Malta,426,241,1,1,185,95,89,184,0
2023-07-26,LM,Malta,395,218,2,2,177,87,88,175,0
2023-07-27,LM,Malta,436,227,0,0,209,105,104,209,0
2023-07-28,LM,Malta,428,232,0,0,196,98,98,196,0
2023-07-29,LM,Malta,423,240,3,3,183,90,90,180,0
2023-07-30,LM,Malta,428,249,1,1,179,88,90,178,0
2023-07-31,LM,Malta,426,224,1,1,202,101,100,201,0
2023-08-01,LM,Malta,422,230,0,0,192,97,95,192,0
2023-08-02,LM,Malta,388,211,1,1,177,86,90,176,0
2023-08-03,LM,Malta,449,237,1,1,212,107,104,211,0
2023-08-04,LM,Malta,432,238,1,1,194,97,96,193,0
2023-08-05,LM,Malta,483,292,2,2,191,92,97,189,0
2023-08-06,LM,Malta,463,273,1,1,190,96,93,189,0
2023-08-07,LM,Malta,434,234,0,0,200,99,101,200,0
2023-08-08,LM,Malta,387,201,2,2,186,93,91,184,0
2023-08-09,LM,Malta,391,203,2,2,188,91,95,186,0
2023-08-10,LM,Malta,441,227,1,1,214,107,106,213,0
2023-08-11,LM,Malta,425,227,1,1,198,102,95,197,0
2023-08-12,LM,Malta,441,250,1,1,191,95,95,190,0
2023-08-13,LM,Malta,441,255,2,2,186,92,92,184,0
2023-08-14,LM,Malta,399,206,0,0,193,95,98,193,0
2023-08-15,LM,Malta,371,189,1,1,182,91,90,181,0
2023-08-16,LM,Malta,380,202,3,3,178,86,89,175,0
2023-08-17,LM,Malta,423,218,0,0,205,102,103,205,0
2023-08-18,LM,Malta,420,231,0,0,189,97,92,189,0
2023-08-19,LM,Malta,417,235,0,0,182,90,92,182,0
2023-08-20,LM,Malta,469,271,0,0,198,98,100,198,0
2023-08-21,LM,Malta,460,252,0,0,208,101,107,208,0
2023-08-22,LM,Malta,396,205,1,1,191,97,93,190,0
2023-08-23,LM,Malta,376,207,0,0,169,83,86,169,0
2023-08-24,LM,Malta,458,231,0,0,227,114,113,227,0
2023-08-25,LM,Malta,414,226,1,1,188,96,91,187,0
2023-08-26,LM,Malta,454,274,0,0,180,90,90,180,0
2023-08-27,LM,Malta,439,264,0,0,175,86,89,175,0
2023-08-28,LM,Malta,436,241,2,2,195,99,94,193,0
2023-08-29,LM,Malta,390,205,0,0,185,92,93,185,0
2023-08-30,LM,Malta,390,200,2,2,190,92,96,188,0
2023-08-31,LM,Malta,433,218,0,0,215,108,107,215,0
2023-09-01,LM,Malta,406,227,2,2,179,90,87,177,0
2023-09-02,LM,Malta,431,246,2,2,185,92,91,183,0
2023-09-03,LM,Malta,423,242,2,2,181,88,91,179,0
2023-09-04,LM,Malta,453,245,3,3,208,101,104,205,0
2023-09-05,LM,Malta,422,240,2,2,182,92,88,180,0
2023-09-06,LM,Malta,394,212,1,1,182,89,92,181,0
2023-09-07,LM,Malta,412,197,1,1,215,106,108,214,0
2023-09-08,LM,Malta,366,188,1,1,178,90,87,177,0
2023-09-09,LM,Malta,406,227,1,1,179,88,90,178,0
2023-09-10,LM,Malta,416,226,3,3,190,95,92,187,0
2023-09-11,LM,Malta,426,231,1,1,195,95,99,194,0
2023-09-12,LM,Malta,392,206,3,3,186,90,93,183,0
2023-09-13,LM,Malta,375,199,1,1,176,88,87,175,0
2023-09-14,LM,Malta,444,239,1,1,205,103,101,204,0
2023-09-15,LM,Malta,393,216,1,1,177,88,88,176,0
2023-09-16,LM,Malta,434,247,1,1,187,90,96,186,0
2023-09-17,LM,Malta,422,237,2,2,185,93,90,183,0
2023-09-18,LM,Malta,473,270,2,2,203,101,100,201,0
2023-09-19,LM,Malta,400,208,2,2,192,95,95,190,0
2023-09-20,LM,Malta,393,216,2,2,177,85,90,175,0
2023-09-21,LM,Malta,461,241,1,1,220,111,108,219,0
2023-09-22,LM,Malta,406,225,1,1,181,86,94,180,0
2023-09-23,LM,Malta,434,259,1,1,175,86,88,174,0
2023-09-24,LM,Malta,421,242,1,1,179,90,88,178,0
2023-09-25,LM,Malta,493,266,2,2,227,116,109,225,0
2023-09-26,LM,Malta,416,227,0,0,189,94,95,189,0
2023-09-27,LM,Malta,396,230,0,0,166,85,81,166,0
2023-09-28,LM,Malta,446,222,1,1,224,111,112,223,0
2023-09-29,LM,Malta,420,227,0,0,193,97,96,193,0
2023-09-30,LM,Malta,428,249,0,0,179,90,89,179,0
2023-10-01,LM,Malta,411,236,0,0,175,86,89,175,0
2023-10-02,LM,Malta,417,217,1,1,200,97,102,199,0
2023-01-01,LU,Moldova,46,-1,0,0,47,24,23,47,0
2023-01-02,LU,Moldova,51,0,0,0,51,25,26,51,0
2023-01-03,LU,Moldova,63,1,0,0,62,31,31,62,0
2023-01-04,LU,Moldova,66,-1,0,0,67,34,33,67,0
2023-01-05,LU,Moldova,78,1,0,0,77,38,39,77,0
2023-01-06,LU,Moldova,68,0,0,0,68,34,34,68,0
2023-01-07,LU,Moldova,63,1,0,0,62,30,32,62,0
2023-01-08,LU,Moldova,69,-2,0,0,71,37,34,71,0
2023-01-09,LU,Moldova,64,3,0,0,61,31,30,61,0
2023-01-10,LU,Moldova,60,-1,0,0,61,30,31,61,0
2023-01-11,LU,Moldova,60,-2,0,0,62,30,32,62,0
2023-01-12,LU,Moldova,67,1,0,0,66,34,32,66,0
2023-01-13,LU,Moldova,55,0,0,0,55,28,27,55,0
2023-01-14,LU,Moldova,66,4,0,0,62,31,31,62,0
2023-01-15,LU,Moldova,62,-5,0,0,67,33,34,67,0
2023-01-16,LU,Moldova,57,2,0,0,55,27,28,55,0
2023-01-17,LU,Moldova,59,1,0,0,58,29,29,58,0
2023-01-18,LU,Moldova,55,-2,0,0,57,28,29,57,0
2023-01-19,LU,Moldova,65,1,0,0,64,32,32,64,0
2023-01-20,LU,Moldova,60,1,0,0,59,32,27,59,0
2023-01-21,LU,Moldova,59,1,0,0,58,28,30,58,0
2023-01-22,LU,Moldova,63,-2,0,0,65,33,32,65,0
2023-01-23,LU,Moldova,52,2,0,0,50,25,25,50,0
2023-01-24,LU,Moldova,59,-1,0,0,60,28,32,60,0
2023-01-25,LU,Moldova,58,0,0,0,58,30,28,58,0
2023-01-26,LU,Moldova,71,0,0,0,71,35,36,71,0
2023-01-27,LU,Moldova,61,0,0,0,61,31,30,61,0
2023-01-28,LU,Moldova,60,4,0,0,56,29,27,56,0
2023-01-29,LU,Moldova,57,-5,0,0,62,29,33,62,0
2023-01-30,LU,Moldova,58,6,0,0,52,27,25,52,0
2023-01-31,LU,Moldova,52,-2,0,0,54,27,27,54,0
2023-02-01,LU,Moldova,56,-2,0,0,58,29,29,58,0
2023-02-02,LU,Moldova,63,2,0,0,61,31,30,61,0
2023-02-03,LU,Moldova,57,0,0,0,57,29,28,57,0
2023-02-04,LU,Moldova,53,0,0,0,53,26,27,53,0
2023-02-05,LU,Moldova,58,0,0,0,58,30,28,58,0
2023-02-06,LU,Moldova,54,1,0,0,53,26,27,53,0
2023-02-07,LU,Moldova,55,3,0,0,52,25,27,52,0
2023-02-08,LU,Moldova,55,-3,0,0,58,29,29,58,0
2023-02-09,LU,Moldova,66,-1,0,0,67,32,35,67,0
2023-02-10,LU,Moldova,67,3,1,1,64,33,30,63,0
2023-02-11,LU,Moldova,52,0,0,0,52,26,26,52,0
2023-02-12,LU,Moldova,57,-3,0,0,60,29,31,60,0
2023-02-13,LU,Moldova,60,4,0,0,56,28,28,56,0
2023-02-14,LU,Moldova,47,-2,0,0,49,25,24,49,0
2023-02-15,LU,Moldova,54,1,0,0,53,27,26,53,0
2023-02-16,LU,Moldova,61,-1,0,0,62,30,32,62,0
2023-02-17,LU,Moldova,52,0,0,0,52,26,26,52,0
2023-02-18,LU,Moldova,54,4,0,0,50,27,23,50,0
2023-02-19,LU,Moldova,57,-5,0,0,62,30,32,62,0
2023-02-20,LU,Moldova,54,2,0,0,52,27,25,52,0
2023-02-21,LU,Moldova,50,3,0,0,47,24,23,47,0
2023-02-22,LU,Moldova,51,-3,0,0,54,27,27,54,0
2023-02-23,LU,Moldova,58,1,0,0,57,28,29,57,0
2023-02-24,LU,Moldova,55,0,0,0,55,28,27,55,0
2023-02-25,LU,Moldova,55,0,0,0,55,27,28,55,0
2023-02-26,LU,Moldova,60,0,0,0,60,31,29,60,0
2023-02-27,LU,Moldova,58,1,0,0,57,28,29,57,0
2023-02-28,LU,Moldova,51,1,0,0,50,24,26,50,0
2023-03-01,LU,Moldova,51,-1,0,0,52,28,24,52,0
2023-03-02,LU,Moldova,51,-1,0,0,52,25,27,52,0
2023-03-03,LU,Moldova,51,2,0,0,49,25,24,49,0
2023-03-04,LU,Moldova,46,0,0,0,46,23,23,46,0
2023-03-05,LU,Moldova,56,-2,0,0,58,26,32,58,0
2023-03-06,LU,Moldova,49,2,0,0,47,26,21,47,0
2023-03-07,LU,Moldova,51,1,0,0,50,24,26,50,0
2023-03-08,LU,Moldova,58,0,0,0,58,30,28,58,0
2023-03-09,LU,Moldova,59,2,0,0,57,29,28,57,0
2023-03-10,LU,Moldova,41,2,0,0,39,19,20,39,0
2023-03-11,LU,Moldova,48,0,0,0,48,24,24,48,0
2023-03-12,LU,Moldova,55,-2,0,0,57,28,29,57,0
2023-03-13,LU,Moldova,48,0,0,0,48,23,25,48,0
2023-03-14,LU,Moldova,45,3,0,0,42,22,20,42,0
2023-03-15,LU,Moldova,49,-1,0,0,50,25,25,50,0
2023-03-16,LU,Moldova,55,1,0,0,54,26,28,54,0
2023-03-17,LU,Moldova,50,-1,0,0,51,26,25,51,0
2023-03-18,LU,Moldova,47,1,0,0,46,24,22,46,0
2023-03-19,LU,Moldova,39,-2,0,0,41,20,21,41,0
2023-03-20,LU,Moldova,39,0,0,0,39,19,20,39,0
2023-03-21,LU,Moldova,48,0,0,0,48,23,25,48,0
2023-03-22,LU,Moldova,55,1,0,0,54,29,25,54,0
2023-03-23,LU,Moldova,52,-1,0,0,53,26,27,53,0
2023-03-24,LU,Moldova,46,2,0,0,44,23,21,44,0
2023-03-25,LU,Moldova,48,0,0,0,48,23,25,48,0
2023-03-26,LU,Moldova,49,-3,0,0,52,26,26,52,0
2023-03-27,LU,Moldova,50,1,0,0,49,25,24,49,0
2023-03-28,LU,Moldova,41,-1,0,0,42,20,22,42,0
2023-03-29,LU,Moldova,49,1,0,0,48,25,23,48,0
2023-03-30,LU,Moldova,58,3,0,0,55,28,27,55,0
2023-03-31,LU,Moldova,47,-4,0,0,51,25,26,51,0
2023-04-01,LU,Moldova,43,4,0,0,39,19,20,39,0
2023-04-02,LU,Moldova,42,-1,0,0,43,21,22,43,0
2023-04-03,LU,Moldova,48,0,0,0,48,23,25,48,0
2023-04-04,LU,Moldova,51,1,0,0,50,26,24,50,0
2023-04-05,LU,Moldova,55,0,0,0,55,27,28,55,0
2023-04-06,LU,Moldova,58,-1,0,0,59,28,31,59,0
2023-04-07,LU,Moldova,67,-2,0,0,69,36,33,69,0
2023-04-08,LU,Moldova,52,3,0,0,49,24,25,49,0
2023-04-09,LU,Moldova,58,2,0,0,56,29,27,56,0
2023-04-10,LU,Moldova,50,-2,0,0,52,26,26,52,0
2023-04-11,LU,Moldova,55,2,0,0,53,26,27,53,0
2023-04-12,LU,Moldova,51,0,0,0,51,27,24,51,0
2023-04-13,LU,Moldova,59,-2,0,0,61,29,32,61,0
2023-04-14,LU,Moldova,59,-3,0,0,62,30,32,62,0
2023-04-15,LU,Moldova,69,5,0,0,64,33,31,64,0
2023-04-16,LU,Moldova,57,0,0,0,57,28,29,57,0
2023-04-17,LU,Moldova,56,1,0,0,55,28,27,55,0
2023-04-18,LU,Moldova,52,1,0,0,51,25,26,51,0
2023-04-19,LU,Moldova,52,-3,0,0,55,27,28,55,0
2023-04-20,LU,Moldova,57,4,0,0,53,27,26,53,0
2023-04-21,LU,Moldova,42,-2,0,0,44,22,22,44,0
2023-04-22,LU,Moldova,41,1,0,0,40,20,20,40,0
2023-04-23,LU,Moldova,42,0,0,0,42,22,20,42,0
2023-04-24,LU,Moldova,45,0,0,0,45,22,23,45,0
2023-04-25,LU,Moldova,49,1,0,0,48,24,24,48,0
2023-04-26,LU,Moldova,54,-2,0,0,56,28,28,56,0
2023-04-27,LU,Moldova,53,4,0,0,49,25,24,49,0
2023-04-28,LU,Moldova,46,-1,0,0,47,23,24,47,0
2023-04-29,LU,Moldova,56,-2,0,0,58,29,29,58,0
2023-04-30,LU,Moldova,48,0,0,0,48,24,24,48,0
2023-05-01,LU,Moldova,51,1,0,0,50,26,24,50,0
2023-05-02,LU,Moldova,56,2,0,0,54,25,29,54,0
2023-05-03,LU,Moldova,52,-1,0,0,53,27,26,53,0
2023-05-04,LU,Moldova,53,2,0,0,51,28,23,51,0
2023-05-05,LU,Moldova,48,-2,0,0,50,23,27,50,0
2023-05-06,LU,Moldova,48,0,0,0,48,24,24,48,0
2023-05-07,LU,Moldova,47,2,0,0,45,23,22,45,0
2023-05-08,LU,Moldova,45,2,0,0,43,23,20,43,0
2023-05-09,LU,Moldova,53,0,0,0,53,24,29,53,0
2023-05-10,LU,Moldova,48,-1,0,0,49,24,25,49,0
2023-05-11,LU,Moldova,51,2,0,0,49,26,23,49,0
2023-05-12,LU,Moldova,46,-4,0,0,50,24,26,50,0
2023-05-13,LU,Moldova,47,3,0,0,44,21,23,44,0
2023-05-14,LU,Moldova,42,-1,0,0,43,21,22,43,0
2023-05-15,LU,Moldova,56,1,0,0,55,29,26,55,0
2023-05-16,LU,Moldova,56,0,1,1,56,27,28,55,0
2023-05-17,LU,Moldova,55,0,0,0,55,27,28,55,0
2023-05-18,LU,Moldova,48,3,0,0,45,24,21,45,0
2023-05-19,LU,Moldova,58,-3,0,0,61,29,32,61,0
2023-05-20,LU,Moldova,55,1,0,0,54,28,26,54,0
2023-05-21,LU,Moldova,50,-1,0,0,51,25,26,51,0
2023-05-22,LU,Moldova,60,0,0,0,60,30,30,60,0
2023-05-23,LU,Moldova,57,1,0,0,56,26,30,56,0
2023-05-24,LU,Moldova,67,-1,0,0,68,36,32,68,0
2023-05-25,LU,Moldova,55,2,0,0,53,27,26,53,0
2023-05-26,LU,Moldova,55,-3,0,0,58,28,30,58,0
2023-05-27,LU,Moldova,57,-1,0,0,58,29,29,58,0
2023-05-28,LU,Moldova,58,3,0,0,55,27,28,55,0
2023-05-29,LU,Moldova,60,-2,0,0,62,32,30,62,0
2023-05-30,LU,Moldova,71,4,0,0,67,33,34,67,0
2023-05-31,LU,Moldova,90,1,0,0,89,43,46,89,0
2023-06-01,LU,Moldova,76,2,0,0,74,41,33,74,0
2023-06-02,LU,Moldova,69,-5,0,0,74,34,40,74,0
2023-06-03,LU,Moldova,63,3,0,0,60,31,29,60,0
2023-06-04,LU,Moldova,65,-2,0,0,67,31,36,67,0
2023-06-05,LU,Moldova,67,1,0,0,66,33,33,66,0
2023-06-06,LU,Moldova,71,-2,0,0,73,36,37,73,0
2023-06-07,LU,Moldova,76,1,0,0,75,38,37,75,0
2023-06-08,LU,Moldova,73,2,0,0,71,37,34,71,0
2023-06-09,LU,Moldova,58,1,0,0,57,28,29,57,0
2023-06-10,LU,Moldova,61,0,0,0,61,32,29,61,0
2023-06-11,LU,Moldova,55,0,0,0,55,25,30,55,0
2023-06-12,LU,Moldova,72,2,0,0,70,37,33,70,0
2023-06-13,LU,Moldova,70,-3,0,0,73,34,39,73,0
2023-06-14,LU,Moldova,76,1,0,0,75,38,37,75,0
2023-06-15,LU,Moldova,85,2,0,0,83,44,39,83,0
2023-06-16,LU,Moldova,68,-1,0,0,69,33,36,69,0
2023-06-17,LU,Moldova,72,2,0,0,70,36,34,70,0
2023-06-18,LU,Moldova,69,0,0,0,69,32,37,69,0
2023-06-19,LU,Moldova,74,-2,0,0,76,39,37,76,0
2023-06-20,LU,Moldova,80,4,0,0,76,38,38,76,0
2023-06-21,LU,Moldova,78,-5,0,0,83,38,45,83,0
2023-06-22,LU,Moldova,83,4,0,0,79,42,37,79,0
2023-06-23,LU,Moldova,69,-1,0,0,70,34,36,70,0
2023-06-24,LU,Moldova,78,3,0,0,75,38,37,75,0
2023-06-25,LU,Moldova,76,0,0,0,76,37,39,76,0
2023-06-26,LU,Moldova,75,2,0,0,73,38,35,73,0
2023-06-27,LU,Moldova,78,-2,0,0,80,39,41,80,0
2023-06-28,LU,Moldova,73,0,0,0,73,37,36,73,0
2023-06-29,LU,Moldova,84,3,0,0,81,42,39,81,0
2023-06-30,LU,Moldova,71,1,0,0,70,34,36,70,0
2023-07-01,LU,Moldova,68,-2,0,0,70,35,35,70,0
2023-07-02,LU,Moldova,73,0,0,0,73,36,37,73,0
2023-07-03,LU,Moldova,85,1,0,0,84,43,41,84,0
2023-07-04,LU,Moldova,80,-2,0,0,82,39,43,82,0
2023-07-05,LU,Moldova,84,3,0,0,81,42,39,81,0
2023-07-06,LU,Moldova,79,1,0,0,78,39,39,78,0
2023-07-07,LU,Moldova,70,-2,1,1,72,34,37,71,0
2023-07-08,LU,Moldova,78,4,0,0,74,39,35,74,0
2023-07-09,LU,Moldova,74,-3,0,0,77,38,39,77,0
2023-07-10,LU,Moldova,79,1,0,0,78,40,38,78,0
2023-07-11,LU,Moldova,79,-3,0,0,82,40,42,82,0
2023-07-12,LU,Moldova,73,4,0,0,69,36,33,69,0
2023-07-13,LU,Moldova,76,3,0,0,73,37,36,73,0
2023-07-14,LU,Moldova,72,-1,0,0,73,35,38,73,0
2023-07-15,LU,Moldova,74,0,0,0,74,37,37,74,0
2023-07-16,LU,Moldova,78,2,0,0,76,38,38,76,0
2023-07-17,LU,Moldova,79,2,0,0,77,38,39,77,0
2023-07-18,LU,Moldova,79,-4,0,0,83,40,43,83,0
2023-07-19,LU,Moldova,79,0,0,0,79,40,39,79,0
2023-07-20,LU,Moldova,83,1,0,0,82,41,41,82,0
2023-07-21,LU,Moldova,75,-1,1,1,76,38,37,75,0
2023-07-22,LU,Moldova,73,1,0,0,72,35,37,72,0
2023-07-23,LU,Moldova,84,0,0,0,84,42,42,84,0
2023-07-24,LU,Moldova,88,0,0,0,88,46,42,88,0
2023-07-25,LU,Moldova,78,4,0,0,74,36,38,74,0
2023-07-26,LU,Moldova,81,1,0,0,80,39,41,80,0
2023-07-27,LU,Moldova,85,-1,0,0,86,45,41,86,0
2023-07-28,LU,Moldova,72,-1,0,0,73,36,37,73,0
2023-07-29,LU,Moldova,79,1,0,0,78,40,38,78,0
2023-07-30,LU,Moldova,84,2,0,0,82,39,43,82,0
2023-07-31,LU,Moldova,78,-1,0,0,79,41,38,79,0
2023-08-01,LU,Moldova,91,4,0,0,87,42,45,87,0
2023-08-02,LU,Moldova,92,2,0,0,90,44,46,90,0
2023-08-03,LU,Moldova,84,-1,0,0,85,42,43,85,0
2023-08-04,LU,Moldova,82,2,1,1,80,40,39,79,0
2023-08-05,LU,Moldova,72,-2,0,0,74,39,35,74,0
2023-08-06,LU,Moldova,81,0,0,0,81,39,42,81,0
2023-08-07,LU,Moldova,89,1,0,0,88,43,45,88,0
2023-08-08,LU,Moldova,84,-1,0,0,85,43,42,85,0
2023-08-09,LU,Moldova,78,2,0,0,76,38,38,76,0
2023-08-10,LU,Moldova,87,0,0,0,87,45,42,87,0
2023-08-11,LU,Moldova,77,0,0,0,77,37,40,77,0
2023-08-12,LU,Moldova,82,-3,0,0,85,43,42,85,0
2023-08-13,LU,Moldova,89,4,0,0,85,43,42,85,0
2023-08-14,LU,Moldova,88,2,0,0,86,44,42,86,0
2023-08-15,LU,Moldova,79,-1,0,0,80,40,40,80,0
2023-08-16,LU,Moldova,77,1,0,0,76,38,38,76,0
2023-08-17,LU,Moldova,87,-1,0,0,88,43,45,88,0
2023-08-18,LU,Moldova,87,3,0,0,84,43,41,84,0
2023-08-19,LU,Moldova,76,-2,0,0,78,38,40,78,0
2023-08-20,LU,Moldova,84,3,0,0,81,41,40,81,0
2023-08-21,LU,Moldova,87,2,0,0,85,44,41,85,0
2023-08-22,LU,Moldova,85,-2,0,0,87,42,45,87,0
2023-08-23,LU,Moldova,86,0,0,0,86,44,42,86,0
2023-08-24,LU,Moldova,90,-1,0,0,91,45,46,91,0
2023-08-25,LU,Moldova,85,1,0,0,84,43,41,84,0
2023-08-26,LU,Moldova,78,-4,0,0,82,38,44,82,0
2023-08-27,LU,Moldova,88,4,0,0,84,43,41,84,0
2023-08-28,LU,Moldova,86,1,0,0,85,43,42,85,0
2023-08-29,LU,Moldova,94,-1,0,0,95,48,47,95,0
2023-08-30,LU,Moldova,88,2,0,0,86,42,44,86,0
2023-08-31,LU,Moldova,88,-1,0,0,89,45,44,89,0
2023-09-01,LU,Moldova,81,0,0,0,81,40,41,81,0
2023-09-02,LU,Moldova,81,0,0,0,81,42,39,81,0
2023-09-03,LU,Moldova,78,0,0,0,78,39,39,78,0
2023-09-04,LU,Moldova,80,-2,0,0,82,40,42,82,0
2023-09-05,LU,Moldova,86,3,0,0,83,43,40,83,0
2023-09-06,LU,Moldova,82,1,0,0,81,39,42,81,0
2023-09-07,LU,Moldova,82,1,0,0,81,42,39,81,0
2023-09-08,LU,Moldova,75,-3,0,0,78,39,39,78,0
2023-09-09,LU,Moldova,79,-4,0,0,83,42,41,83,0
2023-09-10,LU,Moldova,81,3,0,0,78,35,43,78,0
2023-09-11,LU,Moldova,102,3,1,1,99,50,48,98,0
2023-09-12,LU,Moldova,119,-11,0,0,130,62,68,130,0
2023-09-13,LU,Moldova,142,5,0,0,137,69,68,137,0
2023-09-14,LU,Moldova,121,4,0,0,117,62,55,117,0
2023-09-15,LU,Moldova,78,0,0,0,78,40,38,78,0
2023-09-16,LU,Moldova,79,0,0,0,79,40,39,79,0
2023-09-17,LU,Moldova,76,0,0,0,76,38,38,76,0
2023-09-18,LU,Moldova,123,1,1,1,122,59,62,121,0
2023-09-19,LU,Moldova,143,-7,0,0,150,75,75,150,0
2023-09-20,LU,Moldova,105,8,0,0,97,50,47,97,0
2023-09-21,LU,Moldova,82,-1,0,0,83,43,40,83,0
2023-09-22,LU,Moldova,81,1,0,0,80,40,40,80,0
2023-09-23,LU,Moldova,66,-2,0,0,68,34,34,68,0
2023-09-24,LU,Moldova,81,0,0,0,81,40,41,81,0
2023-09-25,LU,Moldova,78,3,0,0,75,36,39,75,0
2023-09-26,LU,Moldova,81,-3,0,0,84,43,41,84,0
2023-09-27,LU,Moldova,79,0,0,0,79,39,40,79,0
2023-09-28,LU,Moldova,79,0,0,0,79,42,37,79,0
2023-09-29,LU,Moldova,81,-3,0,0,84,40,44,84,0
2023-09-30,LU,Moldova,78,2,0,0,76,39,37,76,0
2023-10-01,LU,Moldova,83,-3,0,0,86,41,45,86,0
2023-10-02,LU,Moldova,72,4,0,0,68,36,32,68,0
2023-01-01,GM,Morocco,1428,841,70,0,587,264,253,517,70
2023-01-02,GM,Morocco,1408,791,64,0,617,282,271,553,64
2023-01-03,GM,Morocco,1436,865,62,1,571,248,261,509,61
2023-01-04,GM,Morocco,1301,781,61,3,520,230,229,459,58
2023-01-05,GM,Morocco,1425,874,74,6,551,239,238,477,68
2023-01-06,GM,Morocco,1456,855,72,2,601,267,262,529,70
2023-01-07,GM,Morocco,1677,1102,51,0,575,260,264,524,51
2023-01-08,GM,Morocco,1479,919,58,0,560,256,246,502,58
2023-01-09,GM,Morocco,1293,769,56,1,524,231,237,468,55
2023-01-10,GM,Morocco,1117,676,70,0,441,188,183,371,70
2023-01-11,GM,Morocco,1047,615,76,1,432,182,174,356,75
2023-01-12,GM,Morocco,1097,664,51,1,433,188,194,382,50
2023-01-13,GM,Morocco,1261,723,71,3,538,235,232,467,68
2023-01-14,GM,Morocco,1475,952,52,4,523,236,235,471,48
2023-01-15,GM,Morocco,1358,854,64,1,504,223,217,440,63
2023-01-16,GM,Morocco,1152,669,49,0,483,214,220,434,49
2023-01-17,GM,Morocco,1003,620,52,1,383,166,165,331,51
2023-01-18,GM,Morocco,974,591,58,1,383,162,163,325,57
2023-01-19,GM,Morocco,1065,652,50,4,413,183,180,363,46
2023-01-20,GM,Morocco,1292,764,74,0,528,228,226,454,74
2023-01-21,GM,Morocco,1541,1008,61,1,533,235,237,472,60
2023-01-22,GM,Morocco,1345,844,61,0,501,222,218,440,61
2023-01-23,GM,Morocco,1160,672,59,4,488,210,219,429,55
2023-01-24,GM,Morocco,990,606,55,0,384,165,164,329,55
2023-01-25,GM,Morocco,1009,611,58,1,398,172,168,340,57
2023-01-26,GM,Morocco,1105,678,48,1,427,189,190,379,47
2023-01-27,GM,Morocco,1261,726,67,0,535,236,232,468,67
2023-01-28,GM,Morocco,1538,1018,53,0,520,236,231,467,53
2023-01-29,GM,Morocco,1319,817,60,2,502,217,225,442,58
2023-01-30,GM,Morocco,1158,673,56,2,485,212,217,429,54
2023-01-31,GM,Morocco,1025,626,60,2,399,171,168,339,58
2023-02-01,GM,Morocco,1039,618,69,1,421,179,173,352,68
2023-02-02,GM,Morocco,1137,692,64,2,445,190,191,381,62
2023-02-03,GM,Morocco,1327,761,84,3,566,237,245,482,81
2023-02-04,GM,Morocco,1562,1034,66,1,528,231,231,462,65
2023-02-05,GM,Morocco,1367,832,73,0,535,239,223,462,73
2023-02-06,GM,Morocco,1189,665,59,2,524,230,235,465,57
2023-02-07,GM,Morocco,1026,618,61,0,408,174,173,347,61
2023-02-08,GM,Morocco,1041,625,61,1,416,179,176,355,60
2023-02-09,GM,Morocco,1114,674,51,3,440,192,197,389,48
2023-02-10,GM,Morocco,1310,743,72,3,567,249,246,495,69
2023-02-11,GM,Morocco,1599,1045,60,1,554,246,248,494,59
2023-02-12,GM,Morocco,1417,857,63,0,560,256,241,497,63
2023-02-13,GM,Morocco,1211,692,53,4,519,235,231,466,49
2023-02-14,GM,Morocco,1155,707,58,1,448,192,198,390,57
2023-02-15,GM,Morocco,1067,619,56,1,448,196,196,392,55
2023-02-16,GM,Morocco,1184,723,47,0,461,209,205,414,47
2023-02-17,GM,Morocco,1367,757,76,1,610,264,270,534,75
2023-02-18,GM,Morocco,1688,1114,60,0,574,263,251,514,60
2023-02-19,GM,Morocco,1441,879,77,0,562,242,243,485,77
2023-02-20,GM,Morocco,1285,725,71,0,560,241,248,489,71
2023-02-21,GM,Morocco,1209,705,83,2,504,208,213,421,81
2023-02-22,GM,Morocco,1172,686,77,2,486,211,198,409,75
2023-02-23,GM,Morocco,1249,744,63,2,505,219,223,442,61
2023-02-24,GM,Morocco,1414,814,71,0,600,267,262,529,71
2023-02-25,GM,Morocco,1660,1101,50,0,559,254,255,509,50
2023-02-26,GM,Morocco,1492,940,65,0,552,246,241,487,65
2023-02-27,GM,Morocco,1270,727,52,0,543,245,246,491,52
2023-02-28,GM,Morocco,1214,738,52,1,476,210,214,424,51
2023-03-01,GM,Morocco,1166,692,58,1,474,208,208,416,57
2023-03-02,GM,Morocco,1252,749,54,1,503,223,226,449,53
2023-03-03,GM,Morocco,1411,773,80,5,638,281,277,558,75
2023-03-04,GM,Morocco,1664,1080,63,1,584,264,257,521,62
2023-03-05,GM,Morocco,1481,935,62,0,546,244,240,484,62
2023-03-06,GM,Morocco,1277,722,59,0,555,244,252,496,59
2023-03-07,GM,Morocco,1162,697,71,0,465,196,198,394,71
2023-03-08,GM,Morocco,1103,650,67,0,453,191,195,386,67
2023-03-09,GM,Morocco,1206,700,67,0,506,214,225,439,67
2023-03-10,GM,Morocco,1367,773,82,1,594,262,250,512,81
2023-03-11,GM,Morocco,1623,1046,55,1,577,268,254,522,54
2023-03-12,GM,Morocco,1404,850,71,0,554,241,242,483,71
2023-03-13,GM,Morocco,1310,741,80,1,569,242,247,489,79
2023-03-14,GM,Morocco,1205,716,62,0,489,212,215,427,62
2023-03-15,GM,Morocco,1141,668,71,2,473,200,202,402,69
2023-03-16,GM,Morocco,1265,751,69,0,514,222,223,445,69
2023-03-17,GM,Morocco,1442,813,75,0,629,279,275,554,75
2023-03-18,GM,Morocco,1603,1030,58,2,573,260,255,515,56
2023-03-19,GM,Morocco,1408,833,77,1,575,253,245,498,76
2023-03-20,GM,Morocco,1288,720,67,2,568,247,254,501,65
2023-03-21,GM,Morocco,1172,694,70,4,478,205,203,408,66
2023-03-22,GM,Morocco,1141,669,70,1,472,203,199,402,69
2023-03-23,GM,Morocco,1197,735,53,4,462,207,202,409,49
2023-03-24,GM,Morocco,1322,763,73,1,559,241,245,486,72
2023-03-25,GM,Morocco,1577,1029,52,0,548,251,245,496,52
2023-03-26,GM,Morocco,1305,804,71,0,501,218,212,430,71
2023-03-27,GM,Morocco,1062,603,51,3,459,203,205,408,48
2023-03-28,GM,Morocco,1116,669,55,2,447,203,189,392,53
2023-03-29,GM,Morocco,1107,664,56,1,443,190,197,387,55
2023-03-30,GM,Morocco,1169,736,55,3,433,187,191,378,52
2023-03-31,GM,Morocco,1222,713,67,1,509,218,224,442,66
2023-04-01,GM,Morocco,1543,995,54,1,548,247,247,494,53
2023-04-02,GM,Morocco,1333,837,54,0,496,219,223,442,54
2023-04-03,GM,Morocco,1170,672,62,2,498,213,223,436,60
2023-04-04,GM,Morocco,1219,696,68,5,523,231,224,455,63
2023-04-05,GM,Morocco,1176,715,57,1,461,203,201,404,56
2023-04-06,GM,Morocco,1228,758,50,3,470,208,212,420,47
2023-04-07,GM,Morocco,1264,723,81,2,541,231,229,460,79
2023-04-08,GM,Morocco,1530,980,62,0,550,248,240,488,62
2023-04-09,GM,Morocco,1334,834,63,0,500,220,217,437,63
2023-04-10,GM,Morocco,1186,670,63,6,516,226,227,453,57
2023-04-11,GM,Morocco,1161,688,57,4,473,212,204,416,53
2023-04-12,GM,Morocco,1134,676,62,9,458,196,200,396,53
2023-04-13,GM,Morocco,1214,727,60,8,487,215,212,427,52
2023-04-14,GM,Morocco,1237,704,76,5,533,231,226,457,71
2023-04-15,GM,Morocco,1450,904,60,2,546,243,243,486,58
2023-04-16,GM,Morocco,1336,822,57,0,514,228,229,457,57
2023-04-17,GM,Morocco,1144,631,73,3,513,224,216,440,70
2023-04-18,GM,Morocco,1199,699,60,6,500,217,223,440,54
2023-04-19,GM,Morocco,1159,658,70,4,501,222,209,431,66
2023-04-20,GM,Morocco,1191,694,55,1,497,217,225,442,54
2023-04-21,GM,Morocco,1214,666,61,2,548,238,249,487,59
2023-04-22,GM,Morocco,1430,862,57,0,568,260,251,511,57
2023-04-23,GM,Morocco,1358,804,66,0,554,241,247,488,66
2023-04-24,GM,Morocco,1170,625,58,2,545,251,236,487,56
2023-04-25,GM,Morocco,1196,655,66,4,541,237,238,475,62
2023-04-26,GM,Morocco,1205,654,74,4,551,234,243,477,70
2023-04-27,GM,Morocco,1249,668,73,7,581,256,252,508,66
2023-04-28,GM,Morocco,1255,671,82,2,584,251,251,502,80
2023-04-29,GM,Morocco,1421,825,57,1,596,267,272,539,56
2023-04-30,GM,Morocco,1321,745,76,2,576,252,248,500,74
2023-05-01,GM,Morocco,1122,577,61,0,545,243,241,484,61
2023-05-02,GM,Morocco,1214,645,81,2,569,246,242,488,79
2023-05-03,GM,Morocco,1219,633,68,3,586,255,263,518,65
2023-05-04,GM,Morocco,1250,667,67,2,583,259,257,516,65
2023-05-05,GM,Morocco,1200,598,75,2,602,259,268,527,73
2023-05-06,GM,Morocco,1326,741,61,0,585,260,264,524,61
2023-05-07,GM,Morocco,1253,671,81,0,582,256,245,501,81
2023-05-08,GM,Morocco,1162,601,61,7,561,247,253,500,54
2023-05-09,GM,Morocco,1189,604,98,4,585,248,239,487,94
2023-05-10,GM,Morocco,1174,616,70,7,558,246,242,488,63
2023-05-11,GM,Morocco,1183,636,64,4,547,243,240,483,60
2023-05-12,GM,Morocco,1158,580,88,10,578,242,248,490,78
2023-05-13,GM,Morocco,1310,733,77,3,577,250,250,500,74
2023-05-14,GM,Morocco,1188,638,61,0,550,248,241,489,61
2023-05-15,GM,Morocco,1124,571,79,4,553,236,238,474,75
2023-05-16,GM,Morocco,1110,573,77,9,537,229,231,460,68
2023-05-17,GM,Morocco,1129,586,69,3,543,236,238,474,66
2023-05-18,GM,Morocco,1189,640,61,0,549,245,243,488,61
2023-05-19,GM,Morocco,1161,578,96,9,583,244,243,487,87
2023-05-20,GM,Morocco,1272,701,63,2,571,253,255,508,61
2023-05-21,GM,Morocco,1233,644,68,0,589,268,253,521,68
2023-05-22,GM,Morocco,1125,590,61,5,535,230,244,474,56
2023-05-23,GM,Morocco,1135,589,66,7,546,237,243,480,59
2023-05-24,GM,Morocco,1149,601,70,11,548,244,234,478,59
2023-05-25,GM,Morocco,1171,623,85,11,548,228,235,463,74
2023-05-26,GM,Morocco,1130,553,91,8,577,246,240,486,83
2023-05-27,GM,Morocco,1291,719,65,1,572,253,254,507,64
2023-05-28,GM,Morocco,1229,657,67,1,572,250,255,505,66
2023-05-29,GM,Morocco,1170,594,98,10,576,237,241,478,88
2023-05-30,GM,Morocco,1165,607,88,7,558,232,238,470,81
2023-05-31,GM,Morocco,1199,634,67,3,565,254,244,498,64
2023-06-01,GM,Morocco,1208,668,59,3,540,236,245,481,56
2023-06-02,GM,Morocco,1191,604,78,5,587,253,256,509,73
2023-06-03,GM,Morocco,1318,726,60,1,592,260,272,532,59
2023-06-04,GM,Morocco,1256,672,68,3,584,264,252,516,65
2023-06-05,GM,Morocco,1190,606,74,4,584,253,257,510,70
2023-06-06,GM,Morocco,1137,596,82,7,541,235,224,459,75
2023-06-07,GM,Morocco,1192,610,58,6,582,266,258,524,52
2023-06-08,GM,Morocco,1186,628,74,3,558,242,242,484,71
2023-06-09,GM,Morocco,1204,595,100,6,609,256,253,509,94
2023-06-10,GM,Morocco,1288,695,63,2,593,259,271,530,61
2023-06-11,GM,Morocco,1250,659,68,0,591,266,257,523,68
2023-06-12,GM,Morocco,1174,589,72,4,585,253,260,513,68
2023-06-13,GM,Morocco,1171,600,76,4,571,248,247,495,72
2023-06-14,GM,Morocco,1220,613,88,5,607,260,259,519,83
2023-06-15,GM,Morocco,1235,657,68,4,578,254,256,510,64
2023-06-16,GM,Morocco,1217,614,86,1,603,260,257,517,85
2023-06-17,GM,Morocco,1339,733,62,2,606,274,270,544,60
2023-06-18,GM,Morocco,1265,680,67,1,585,264,254,518,66
2023-06-19,GM,Morocco,1212,610,84,4,602,258,260,518,80
2023-06-20,GM,Morocco,1233,636,74,1,597,257,266,523,73
2023-06-21,GM,Morocco,1278,662,73,2,616,277,266,543,71
2023-06-22,GM,Morocco,1262,669,77,1,593,255,261,516,76
2023-06-23,GM,Morocco,1243,619,89,1,624,272,263,535,88
2023-06-24,GM,Morocco,1383,748,64,2,635,279,292,571,62
2023-06-25,GM,Morocco,1302,679,70,0,623,281,272,553,70
2023-06-26,GM,Morocco,1295,663,73,0,632,276,283,559,73
2023-06-27,GM,Morocco,1283,643,89,4,640,281,270,551,85
2023-06-28,GM,Morocco,1274,657,76,0,617,267,274,541,76
2023-06-29,GM,Morocco,1244,667,68,0,577,259,250,509,68
2023-06-30,GM,Morocco,1241,618,83,0,623,272,268,540,83
2023-07-01,GM,Morocco,1394,758,57,4,636,285,294,579,53
2023-07-02,GM,Morocco,1297,687,65,0,610,272,273,545,65
2023-07-03,GM,Morocco,1295,653,61,2,642,292,289,581,59
2023-07-04,GM,Morocco,1279,634,74,4,645,284,287,571,70
2023-07-05,GM,Morocco,1324,653,77,2,671,297,297,594,75
2023-07-06,GM,Morocco,1323,684,61,2,639,289,289,578,59
2023-07-07,GM,Morocco,1283,635,86,3,648,281,281,562,83
2023-07-08,GM,Morocco,1411,748,66,1,663,297,300,597,65
2023-07-09,GM,Morocco,1333,706,61,0,627,288,278,566,61
2023-07-10,GM,Morocco,1324,673,78,5,651,287,286,573,73
2023-07-11,GM,Morocco,1273,644,71,1,629,277,281,558,70
2023-07-12,GM,Morocco,1341,671,81,7,670,296,293,589,74
2023-07-13,GM,Morocco,1359,709,72,4,650,289,289,578,68
2023-07-14,GM,Morocco,1267,623,97,3,644,276,271,547,94
2023-07-15,GM,Morocco,1420,756,70,3,664,294,300,594,67
2023-07-16,GM,Morocco,1344,703,82,2,641,280,279,559,80
2023-07-17,GM,Morocco,1315,654,73,8,661,298,290,588,65
2023-07-18,GM,Morocco,1267,641,66,4,626,283,277,560,62
2023-07-19,GM,Morocco,1305,669,63,1,636,283,290,573,62
2023-07-20,GM,Morocco,1355,712,70,5,643,290,283,573,65
2023-07-21,GM,Morocco,1300,635,107,2,665,280,278,558,105
2023-07-22,GM,Morocco,1385,728,68,1,657,290,299,589,67
2023-07-23,GM,Morocco,1298,672,69,2,626,286,271,557,67
2023-07-24,GM,Morocco,1337,685,82,1,652,284,286,570,81
2023-07-25,GM,Morocco,1290,654,78,2,636,280,278,558,76
2023-07-26,GM,Morocco,1320,670,81,6,650,282,287,569,75
2023-07-27,GM,Morocco,1371,717,70,4,654,296,288,584,66
2023-07-28,GM,Morocco,1288,639,91,2,649,282,276,558,89
2023-07-29,GM,Morocco,1402,757,60,1,645,289,296,585,59
2023-07-30,GM,Morocco,1348,715,73,0,633,280,280,560,73
2023-07-31,GM,Morocco,1369,708,103,1,661,282,276,558,102
2023-08-01,GM,Morocco,1319,680,74,1,639,284,281,565,73
2023-08-02,GM,Morocco,1350,695,80,1,655,283,292,575,79
2023-08-03,GM,Morocco,1367,727,75,1,640,288,277,565,74
2023-08-04,GM,Morocco,1300,654,91,2,646,276,279,555,89
2023-08-05,GM,Morocco,1424,763,57,1,661,301,303,604,56
2023-08-06,GM,Morocco,1357,714,71,0,643,284,288,572,71
2023-08-07,GM,Morocco,1342,701,69,1,641,290,282,572,68
2023-08-08,GM,Morocco,1288,673,73,1,615,270,272,542,72
2023-08-09,GM,Morocco,1350,695,77,2,655,290,288,578,75
2023-08-10,GM,Morocco,1388,744,75,2,644,283,286,569,73
2023-08-11,GM,Morocco,1285,649,93,3,636,270,273,543,90
2023-08-12,GM,Morocco,1444,778,68,0,666,301,297,598,68
2023-08-13,GM,Morocco,1336,699,70,0,637,284,283,567,70
2023-08-14,GM,Morocco,1314,684,59,3,630,287,284,571,56
2023-08-15,GM,Morocco,1290,655,74,1,635,281,280,561,73
2023-08-16,GM,Morocco,1331,681,68,1,650,290,292,582,67
2023-08-17,GM,Morocco,1366,729,77,1,637,283,277,560,76
2023-08-18,GM,Morocco,1309,664,91,1,645,275,279,554,90
2023-08-19,GM,Morocco,1423,771,60,1,652,294,298,592,59
2023-08-20,GM,Morocco,1346,699,72,1,647,293,282,575,71
2023-08-21,GM,Morocco,1338,692,82,1,646,282,282,564,81
2023-08-22,GM,Morocco,1307,691,70,0,616,276,270,546,70
2023-08-23,GM,Morocco,1346,692,76,1,654,287,291,578,75
2023-08-24,GM,Morocco,1355,716,76,4,639,281,282,563,72
2023-08-25,GM,Morocco,1315,667,98,0,648,276,274,550,98
2023-08-26,GM,Morocco,1419,758,55,0,661,301,305,606,55
2023-08-27,GM,Morocco,1336,705,70,0,631,279,282,561,70
2023-08-28,GM,Morocco,1278,625,75,0,653,289,289,578,75
2023-08-29,GM,Morocco,1286,668,60,0,618,282,276,558,60
2023-08-30,GM,Morocco,1363,704,75,3,659,293,291,584,72
2023-08-31,GM,Morocco,1360,716,63,3,644,291,290,581,60
2023-09-01,GM,Morocco,1294,646,80,1,648,282,286,568,79
2023-09-02,GM,Morocco,1432,778,64,1,654,292,298,590,63
2023-09-03,GM,Morocco,1312,685,67,0,627,278,282,560,67
2023-09-04,GM,Morocco,1289,659,67,2,630,288,275,563,65
2023-09-05,GM,Morocco,1290,668,68,3,622,280,274,554,65
2023-09-06,GM,Morocco,1269,660,64,0,609,271,274,545,64
2023-09-07,GM,Morocco,1319,705,73,2,614,271,270,541,71
2023-09-08,GM,Morocco,1285,630,92,0,655,274,289,563,92
2023-09-09,GM,Morocco,1443,771,73,0,672,303,296,599,73
2023-09-10,GM,Morocco,1364,720,73,0,644,285,286,571,73
2023-09-11,GM,Morocco,1240,638,70,2,602,273,259,532,68
2023-09-12,GM,Morocco,1235,674,56,2,561,254,251,505,54
2023-09-13,GM,Morocco,1270,683,65,3,587,262,260,522,62
2023-09-14,GM,Morocco,1255,706,65,4,549,241,243,484,61
2023-09-15,GM,Morocco,1254,627,89,4,627,275,263,538,85
2023-09-16,GM,Morocco,1329,738,63,1,591,260,268,528,62
2023-09-17,GM,Morocco,1216,656,63,0,560,250,247,497,63
2023-09-18,GM,Morocco,1159,580,73,2,579,248,258,506,71
2023-09-19,GM,Morocco,1209,649,71,1,560,245,244,489,70
2023-09-20,GM,Morocco,1226,668,55,3,558,251,252,503,52
2023-09-21,GM,Morocco,1267,711,69,2,556,242,245,487,67
2023-09-22,GM,Morocco,1229,627,76,1,602,266,260,526,75
2023-09-23,GM,Morocco,1352,762,60,0,590,265,265,530,60
2023-09-24,GM,Morocco,1266,690,69,0,576,256,251,507,69
2023-09-25,GM,Morocco,1205,635,66,1,570,254,250,504,65
2023-09-26,GM,Morocco,1175,620,71,0,555,238,246,484,71
2023-09-27,GM,Morocco,1208,652,61,4,556,248,247,495,57
2023-09-28,GM,Morocco,1218,681,57,1,537,238,242,480,56
2023-09-29,GM,Morocco,1212,624,70,2,588,257,261,518,68
2023-09-30,GM,Morocco,1392,806,55,1,586,265,266,531,54
2023-10-01,GM,Morocco,1304,734,61,1,570,258,251,509,60
2023-10-02,GM,Morocco,1228,650,71,2,578,256,251,507,69
2023-01-01,EH,Netherlands,2595,1399,3,0,1196,594,599,1193,3
2023-01-02,EH,Netherlands,2877,1535,39,8,1342,656,647,1303,31
2023-01-03,EH,Netherlands,2697,1488,51,10,1209,586,572,1158,41
2023-01-04,EH,Netherlands,2674,1448,55,11,1226,582,589,1171,44
2023-01-05,EH,Netherlands,2779,1447,79,24,1332,627,626,1253,55
2023-01-06,EH,Netherlands,2900,1563,59,22,1337,640,638,1278,37
2023-01-07,EH,Netherlands,2721,1536,26,9,1185,579,580,1159,17
2023-01-08,EH,Netherlands,2897,1596,17,3,1301,636,648,1284,14
2023-01-09,EH,Netherlands,2731,1418,52,17,1313,633,628,1261,35
2023-01-10,EH,Netherlands,2401,1270,52,9,1131,543,536,1079,43
2023-01-11,EH,Netherlands,2541,1311,70,14,1230,577,583,1160,56
2023-01-12,EH,Netherlands,2635,1356,56,14,1279,607,616,1223,42
2023-01-13,EH,Netherlands,2834,1528,53,16,1306,630,623,1253,37
2023-01-14,EH,Netherlands,2426,1381,14,2,1045,517,514,1031,12
2023-01-15,EH,Netherlands,2759,1516,9,0,1243,611,623,1234,9
2023-01-16,EH,Netherlands,2681,1395,39,10,1286,627,620,1247,29
2023-01-17,EH,Netherlands,2355,1228,59,16,1127,537,531,1068,43
2023-01-18,EH,Netherlands,2416,1251,55,19,1165,550,560,1110,36
2023-01-19,EH,Netherlands,2599,1373,58,15,1226,584,584,1168,43
2023-01-20,EH,Netherlands,2790,1578,14,5,1212,598,600,1198,9
2023-01-21,EH,Netherlands,2426,1351,25,7,1075,528,522,1050,18
2023-01-22,EH,Netherlands,2711,1447,30,4,1264,611,623,1234,26
2023-01-23,EH,Netherlands,2657,1403,39,12,1254,607,608,1215,27
2023-01-24,EH,Netherlands,2298,1212,49,10,1086,516,521,1037,39
2023-01-25,EH,Netherlands,2392,1260,39,3,1132,554,539,1093,36
2023-01-26,EH,Netherlands,2624,1358,61,13,1266,605,600,1205,48
2023-01-27,EH,Netherlands,2687,1426,45,13,1261,608,608,1216,32
2023-01-28,EH,Netherlands,2415,1363,28,10,1052,513,511,1024,18
2023-01-29,EH,Netherlands,2701,1458,10,2,1243,610,623,1233,8
2023-01-30,EH,Netherlands,2694,1425,34,8,1269,617,618,1235,26
2023-01-31,EH,Netherlands,2372,1262,44,8,1110,533,533,1066,36
2023-02-01,EH,Netherlands,2469,1292,39,3,1177,575,563,1138,36
2023-02-02,EH,Netherlands,2665,1361,63,14,1304,617,624,1241,49
2023-02-03,EH,Netherlands,2806,1502,48,8,1304,628,628,1256,40
2023-02-04,EH,Netherlands,2500,1389,32,11,1111,546,533,1079,21
2023-02-05,EH,Netherlands,2719,1490,16,0,1229,598,615,1213,16
2023-02-06,EH,Netherlands,2741,1449,47,9,1292,621,624,1245,38
2023-02-07,EH,Netherlands,2452,1299,66,13,1153,545,542,1087,53
2023-02-08,EH,Netherlands,2554,1323,67,18,1231,587,577,1164,49
2023-02-09,EH,Netherlands,2709,1398,68,19,1311,617,626,1243,49
2023-02-10,EH,Netherlands,2911,1593,60,21,1318,629,629,1258,39
2023-02-11,EH,Netherlands,2610,1507,24,10,1103,545,534,1079,14
2023-02-12,EH,Netherlands,2831,1582,16,2,1249,604,629,1233,14
2023-02-13,EH,Netherlands,2741,1427,57,19,1314,631,626,1257,38
2023-02-14,EH,Netherlands,2425,1248,64,23,1177,551,562,1113,41
2023-02-15,EH,Netherlands,2716,1398,71,17,1318,625,622,1247,54
2023-02-16,EH,Netherlands,2876,1523,71,21,1353,643,639,1282,50
2023-02-17,EH,Netherlands,2740,1397,62,15,1343,644,637,1281,47
2023-02-18,EH,Netherlands,2765,1547,21,7,1218,600,597,1197,14
2023-02-19,EH,Netherlands,3029,1680,13,0,1349,665,671,1336,13
2023-02-20,EH,Netherlands,2895,1530,49,11,1365,652,664,1316,38
2023-02-21,EH,Netherlands,2662,1379,58,17,1283,615,610,1225,41
2023-02-22,EH,Netherlands,2830,1503,56,14,1327,640,631,1271,42
2023-02-23,EH,Netherlands,2862,1444,58,8,1418,676,684,1360,50
2023-02-24,EH,Netherlands,3022,1567,58,12,1455,693,704,1397,46
2023-02-25,EH,Netherlands,2708,1420,24,3,1288,644,620,1264,21
2023-02-26,EH,Netherlands,3010,1628,16,3,1382,676,690,1366,13
2023-02-27,EH,Netherlands,2841,1462,48,7,1379,662,669,1331,41
2023-02-28,EH,Netherlands,2667,1385,63,11,1282,615,604,1219,52
2023-03-01,EH,Netherlands,2809,1456,59,10,1353,645,649,1294,49
2023-03-02,EH,Netherlands,2859,1466,46,3,1393,671,676,1347,43
2023-03-03,EH,Netherlands,3052,1589,63,11,1463,699,701,1400,52
2023-03-04,EH,Netherlands,2730,1454,20,1,1276,629,627,1256,19
2023-03-05,EH,Netherlands,2971,1580,15,0,1391,680,696,1376,15
2023-03-06,EH,Netherlands,2884,1502,49,8,1382,667,666,1333,41
2023-03-07,EH,Netherlands,2619,1347,46,9,1272,615,611,1226,37
2023-03-08,EH,Netherlands,2804,1427,52,12,1377,668,657,1325,40
2023-03-09,EH,Netherlands,2954,1530,45,10,1424,682,697,1379,35
2023-03-10,EH,Netherlands,2969,1644,11,5,1325,658,656,1314,6
2023-03-11,EH,Netherlands,2822,1559,42,5,1263,611,610,1221,37
2023-03-12,EH,Netherlands,3062,1678,25,3,1384,677,682,1359,22
2023-03-13,EH,Netherlands,2686,1378,49,10,1308,627,632,1259,39
2023-03-14,EH,Netherlands,2642,1364,69,14,1278,612,597,1209,55
2023-03-15,EH,Netherlands,2909,1519,81,23,1390,648,661,1309,58
2023-03-16,EH,Netherlands,2901,1462,84,18,1439,678,677,1355,66
2023-03-17,EH,Netherlands,2939,1514,66,21,1425,685,674,1359,45
2023-03-18,EH,Netherlands,2658,1455,32,10,1203,590,581,1171,22
2023-03-19,EH,Netherlands,2946,1575,9,4,1371,672,690,1362,5
2023-03-20,EH,Netherlands,3069,1660,50,8,1409,674,685,1359,42
2023-03-21,EH,Netherlands,2728,1414,81,14,1314,622,611,1233,67
2023-03-22,EH,Netherlands,2861,1488,78,29,1373,654,641,1295,49
2023-03-23,EH,Netherlands,2966,1547,80,22,1419,671,668,1339,58
2023-03-24,EH,Netherlands,3198,1795,59,21,1403,672,672,1344,38
2023-03-25,EH,Netherlands,2711,1532,29,7,1179,578,572,1150,22
2023-03-26,EH,Netherlands,3059,1686,23,3,1373,663,687,1350,20
2023-03-27,EH,Netherlands,2904,1432,64,19,1472,702,706,1408,45
2023-03-28,EH,Netherlands,3168,1702,96,24,1466,688,682,1370,72
2023-03-29,EH,Netherlands,3292,1787,68,13,1505,714,723,1437,55
2023-03-30,EH,Netherlands,3296,1757,76,12,1539,732,731,1463,64
2023-03-31,EH,Netherlands,3358,1798,59,12,1560,749,752,1501,47
2023-04-01,EH,Netherlands,3038,1717,18,2,1321,659,644,1303,16
2023-04-02,EH,Netherlands,3263,1807,36,3,1456,705,715,1420,33
2023-04-03,EH,Netherlands,3368,1797,67,14,1571,754,750,1504,53
2023-04-04,EH,Netherlands,3248,1720,74,11,1528,726,728,1454,63
2023-04-05,EH,Netherlands,3382,1829,60,13,1553,747,746,1493,47
2023-04-06,EH,Netherlands,3424,1812,76,17,1612,771,765,1536,59
2023-04-07,EH,Netherlands,3253,1722,63,17,1531,740,728,1468,46
2023-04-08,EH,Netherlands,2996,1639,33,10,1357,661,663,1324,23
2023-04-09,EH,Netherlands,3113,1699,13,1,1414,702,699,1401,12
2023-04-10,EH,Netherlands,3225,1698,35,3,1527,743,749,1492,32
2023-04-11,EH,Netherlands,3253,1685,78,13,1568,737,753,1490,65
2023-04-12,EH,Netherlands,3191,1668,62,22,1523,727,734,1461,40
2023-04-13,EH,Netherlands,3273,1749,70,19,1524,736,718,1454,51
2023-04-14,EH,Netherlands,3343,1720,62,21,1623,779,782,1561,41
2023-04-15,EH,Netherlands,3045,1688,31,5,1357,668,658,1326,26
2023-04-16,EH,Netherlands,3278,1815,24,3,1463,707,732,1439,21
2023-04-17,EH,Netherlands,3328,1773,49,17,1555,761,745,1506,32
2023-04-18,EH,Netherlands,3243,1710,64,14,1533,737,732,1469,50
2023-04-19,EH,Netherlands,3435,1824,69,19,1611,777,765,1542,50
2023-04-20,EH,Netherlands,3268,1653,62,9,1615,762,791,1553,53
2023-04-21,EH,Netherlands,3338,1677,63,15,1661,811,787,1598,48
2023-04-22,EH,Netherlands,3093,1663,19,0,1430,703,708,1411,19
2023-04-23,EH,Netherlands,3331,1792,15,0,1539,760,764,1524,15
2023-04-24,EH,Netherlands,3259,1667,48,13,1592,776,768,1544,35
2023-04-25,EH,Netherlands,3284,1666,80,15,1618,762,776,1538,65
2023-04-26,EH,Netherlands,3373,1719,75,23,1654,798,781,1579,52
2023-04-27,EH,Netherlands,3402,1771,36,4,1631,792,803,1595,32
2023-04-28,EH,Netherlands,3407,1735,63,20,1672,803,806,1609,43
2023-04-29,EH,Netherlands,3175,1724,24,8,1451,720,707,1427,16
2023-04-30,EH,Netherlands,3244,1696,18,4,1548,751,779,1530,14
2023-05-01,EH,Netherlands,3399,1788,54,17,1611,783,774,1557,37
2023-05-02,EH,Netherlands,3399,1779,86,17,1620,770,764,1534,69
2023-05-03,EH,Netherlands,3459,1841,59,15,1618,776,783,1559,44
2023-05-04,EH,Netherlands,3584,1905,70,11,1679,812,797,1609,59
2023-05-05,EH,Netherlands,3514,1876,34,6,1638,796,808,1604,28
2023-05-06,EH,Netherlands,3200,1709,24,7,1491,724,743,1467,17
2023-05-07,EH,Netherlands,3343,1767,14,2,1576,781,781,1562,12
2023-05-08,EH,Netherlands,3423,1808,35,12,1615,797,783,1580,23
2023-05-09,EH,Netherlands,3356,1761,55,10,1595,764,776,1540,45
2023-05-10,EH,Netherlands,3400,1829,43,17,1571,766,762,1528,26
2023-05-11,EH,Netherlands,3565,1881,67,14,1684,809,808,1617,53
2023-05-12,EH,Netherlands,3554,1853,71,16,1701,822,808,1630,55
2023-05-13,EH,Netherlands,3245,1780,27,8,1465,719,719,1438,19
2023-05-14,EH,Netherlands,3391,1806,31,7,1585,775,779,1554,24
2023-05-15,EH,Netherlands,3561,1867,44,7,1694,826,824,1650,37
2023-05-16,EH,Netherlands,3466,1805,80,16,1661,789,792,1581,64
2023-05-17,EH,Netherlands,3658,1942,85,15,1716,820,811,1631,70
2023-05-18,EH,Netherlands,3513,1837,55,0,1676,815,806,1621,55
2023-05-19,EH,Netherlands,3369,1775,46,9,1594,770,778,1548,37
2023-05-20,EH,Netherlands,3121,1663,23,5,1458,722,713,1435,18
2023-05-21,EH,Netherlands,3407,1817,24,4,1590,780,786,1566,20
2023-05-22,EH,Netherlands,3546,1859,48,8,1687,813,826,1639,40
2023-05-23,EH,Netherlands,3468,1817,55,8,1651,793,803,1596,47
2023-05-24,EH,Netherlands,3644,1932,69,9,1712,831,812,1643,60
2023-05-25,EH,Netherlands,3615,1926,45,6,1689,822,822,1644,39
2023-05-26,EH,Netherlands,3637,1953,54,13,1684,823,807,1630,41
2023-05-27,EH,Netherlands,3338,1866,19,8,1472,729,724,1453,11
2023-05-28,EH,Netherlands,3363,1816,13,4,1547,762,772,1534,9
2023-05-29,EH,Netherlands,3587,1942,24,2,1645,804,817,1621,22
2023-05-30,EH,Netherlands,3535,1884,75,20,1651,790,786,1576,55
2023-05-31,EH,Netherlands,3636,1964,75,23,1672,798,799,1597,52
2023-06-01,EH,Netherlands,3698,1975,69,15,1723,834,820,1654,54
2023-06-02,EH,Netherlands,3655,1977,49,11,1678,816,813,1629,38
2023-06-03,EH,Netherlands,3344,1854,24,5,1490,734,732,1466,19
2023-06-04,EH,Netherlands,3537,1967,14,3,1570,770,786,1556,11
2023-06-05,EH,Netherlands,3640,1954,60,18,1686,813,813,1626,42
2023-06-06,EH,Netherlands,3660,2023,74,15,1637,782,781,1563,59
2023-06-07,EH,Netherlands,3808,2109,76,22,1699,824,799,1623,54
2023-06-08,EH,Netherlands,3699,2009,58,11,1690,815,817,1632,47
2023-06-09,EH,Netherlands,3726,2040,60,11,1686,814,812,1626,49
2023-06-10,EH,Netherlands,3369,1868,26,7,1501,734,741,1475,19
2023-06-11,EH,Netherlands,3611,2015,27,5,1596,777,792,1569,22
2023-06-12,EH,Netherlands,3485,1795,72,18,1690,812,806,1618,54
2023-06-13,EH,Netherlands,3468,1803,78,17,1665,785,802,1587,61
2023-06-14,EH,Netherlands,3620,1923,92,24,1697,811,794,1605,68
2023-06-15,EH,Netherlands,3599,1866,105,20,1733,823,805,1628,85
2023-06-16,EH,Netherlands,3628,1883,64,7,1745,834,847,1681,57
2023-06-17,EH,Netherlands,3407,1885,43,13,1522,746,733,1479,30
2023-06-18,EH,Netherlands,3534,1914,25,1,1620,792,803,1595,24
2023-06-19,EH,Netherlands,3588,1843,57,17,1745,843,845,1688,40
2023-06-20,EH,Netherlands,3507,1923,77,20,1584,746,761,1507,57
2023-06-21,EH,Netherlands,3620,1930,87,23,1690,803,800,1603,64
2023-06-22,EH,Netherlands,3715,2011,71,13,1704,820,813,1633,58
2023-06-23,EH,Netherlands,3757,2024,61,16,1733,841,831,1672,45
2023-06-24,EH,Netherlands,3430,1935,25,4,1495,734,736,1470,21
2023-06-25,EH,Netherlands,3653,1996,19,2,1657,824,814,1638,17
2023-06-26,EH,Netherlands,3592,1917,58,10,1675,807,810,1617,48
2023-06-27,EH,Netherlands,3669,1978,73,12,1691,808,810,1618,61
2023-06-28,EH,Netherlands,3809,2128,58,13,1681,811,812,1623,45
2023-06-29,EH,Netherlands,3793,2069,82,16,1724,819,823,1642,66
2023-06-30,EH,Netherlands,3768,2070,49,11,1698,825,824,1649,38
2023-07-01,EH,Netherlands,3439,1902,19,4,1537,758,760,1518,15
2023-07-02,EH,Netherlands,3753,2072,21,2,1681,826,834,1660,19
2023-07-03,EH,Netherlands,3751,2014,58,4,1737,841,838,1679,54
2023-07-04,EH,Netherlands,3611,1987,62,12,1624,769,793,1562,50
2023-07-05,EH,Netherlands,3274,2009,41,2,1265,624,600,1224,39
2023-07-06,EH,Netherlands,3835,2088,62,19,1747,844,841,1685,43
2023-07-07,EH,Netherlands,3952,2134,69,13,1818,872,877,1749,56
2023-07-08,EH,Netherlands,3577,2021,22,3,1556,769,765,1534,19
2023-07-09,EH,Netherlands,3720,2083,11,1,1637,814,812,1626,10
2023-07-10,EH,Netherlands,3773,1997,56,13,1776,852,868,1720,43
2023-07-11,EH,Netherlands,3773,2049,63,10,1724,840,821,1661,53
2023-07-12,EH,Netherlands,3746,2033,63,13,1713,821,829,1650,50
2023-07-13,EH,Netherlands,3815,2071,65,9,1744,838,841,1679,56
2023-07-14,EH,Netherlands,3876,2093,45,7,1783,871,867,1738,38
2023-07-15,EH,Netherlands,3482,1959,27,4,1523,754,742,1496,23
2023-07-16,EH,Netherlands,3603,1929,10,0,1674,828,836,1664,10
2023-07-17,EH,Netherlands,3778,2049,51,10,1729,840,838,1678,41
2023-07-18,EH,Netherlands,3717,2034,83,21,1683,805,795,1600,62
2023-07-19,EH,Netherlands,3759,2043,56,13,1716,829,831,1660,43
2023-07-20,EH,Netherlands,3763,2030,56,15,1733,833,844,1677,41
2023-07-21,EH,Netherlands,3818,2080,41,7,1738,856,841,1697,34
2023-07-22,EH,Netherlands,3499,1903,24,4,1596,787,785,1572,20
2023-07-23,EH,Netherlands,3716,2039,12,1,1677,826,839,1665,11
2023-07-24,EH,Netherlands,3678,1958,48,7,1720,838,834,1672,41
2023-07-25,EH,Netherlands,3572,1887,62,11,1685,809,814,1623,51
2023-07-26,EH,Netherlands,3798,2051,57,19,1747,847,843,1690,38
2023-07-27,EH,Netherlands,3744,2055,46,14,1689,821,822,1643,32
2023-07-28,EH,Netherlands,3878,2139,60,23,1739,830,849,1679,37
2023-07-29,EH,Netherlands,3505,1946,25,7,1559,779,755,1534,18
2023-07-30,EH,Netherlands,3646,1977,21,4,1669,821,827,1648,17
2023-07-31,EH,Netherlands,3652,1929,56,18,1723,832,835,1667,38
2023-08-01,EH,Netherlands,3562,1896,59,11,1666,799,808,1607,48
2023-08-02,EH,Netherlands,3643,1974,52,16,1669,813,804,1617,36
2023-08-03,EH,Netherlands,3666,1944,56,18,1722,832,834,1666,38
2023-08-04,EH,Netherlands,3728,2009,55,19,1719,832,832,1664,36
2023-08-05,EH,Netherlands,3439,1898,25,3,1541,761,755,1516,22
2023-08-06,EH,Netherlands,3603,1960,19,6,1643,812,812,1624,13
2023-08-07,EH,Netherlands,3632,1898,48,13,1734,839,847,1686,35
2023-08-08,EH,Netherlands,3629,1969,52,11,1660,802,806,1608,41
2023-08-09,EH,Netherlands,3831,2118,55,18,1713,831,827,1658,37
2023-08-10,EH,Netherlands,3822,2074,61,11,1748,846,841,1687,50
2023-08-11,EH,Netherlands,3828,2063,62,13,1765,854,849,1703,49
2023-08-12,EH,Netherlands,3510,1955,29,3,1555,765,761,1526,26
2023-08-13,EH,Netherlands,3651,1996,20,2,1655,814,821,1635,18
2023-08-14,EH,Netherlands,3653,1935,57,22,1718,830,831,1661,35
2023-08-15,EH,Netherlands,3629,1927,82,24,1702,809,811,1620,58
2023-08-16,EH,Netherlands,3664,1986,58,16,1678,817,803,1620,42
2023-08-17,EH,Netherlands,3640,1930,54,12,1710,824,832,1656,42
2023-08-18,EH,Netherlands,3697,1964,61,21,1733,832,840,1672,40
2023-08-19,EH,Netherlands,3469,1922,16,0,1547,769,762,1531,16
2023-08-20,EH,Netherlands,3671,1998,20,2,1673,819,834,1653,18
2023-08-21,EH,Netherlands,3690,1923,62,18,1767,853,852,1705,44
2023-08-22,EH,Netherlands,3622,1897,79,25,1725,823,823,1646,54
2023-08-23,EH,Netherlands,3669,1971,47,10,1698,825,826,1651,37
2023-08-24,EH,Netherlands,3749,2026,54,11,1723,833,836,1669,43
2023-08-25,EH,Netherlands,3745,2066,33,6,1679,818,828,1646,27
2023-08-26,EH,Netherlands,3445,1863,14,0,1582,782,786,1568,14
2023-08-27,EH,Netherlands,3587,1916,7,0,1671,831,833,1664,7
2023-08-28,EH,Netherlands,3143,1530,47,13,1613,779,787,1566,34
2023-08-29,EH,Netherlands,3654,1947,53,11,1707,840,814,1654,42
2023-08-30,EH,Netherlands,3720,1972,39,6,1748,852,857,1709,33
2023-08-31,EH,Netherlands,3827,2102,43,11,1725,852,830,1682,32
2023-09-01,EH,Netherlands,3758,1992,42,8,1766,857,867,1724,34
2023-09-02,EH,Netherlands,3441,1882,29,7,1559,772,758,1530,22
2023-09-03,EH,Netherlands,3666,1974,34,6,1692,826,832,1658,28
2023-09-04,EH,Netherlands,3783,2010,49,7,1773,863,861,1724,42
2023-09-05,EH,Netherlands,3697,2019,64,9,1678,803,811,1614,55
2023-09-06,EH,Netherlands,3722,1990,59,12,1732,840,833,1673,47
2023-09-07,EH,Netherlands,3782,2033,48,6,1749,848,853,1701,42
2023-09-08,EH,Netherlands,3866,2120,47,7,1746,846,853,1699,40
2023-09-09,EH,Netherlands,3357,1907,19,3,1450,721,710,1431,16
2023-09-10,EH,Netherlands,3698,2023,19,2,1675,817,839,1656,17
2023-09-11,EH,Netherlands,3728,1962,46,6,1766,871,849,1720,40
2023-09-12,EH,Netherlands,3749,2019,64,12,1730,827,839,1666,52
2023-09-13,EH,Netherlands,3794,2047,52,11,1747,846,849,1695,41
2023-09-14,EH,Netherlands,3880,2059,56,8,1821,888,877,1765,48
2023-09-15,EH,Netherlands,3817,2038,42,7,1779,869,868,1737,35
2023-09-16,EH,Netherlands,3512,1930,29,7,1582,781,772,1553,22
2023-09-17,EH,Netherlands,3708,2003,20,1,1705,832,853,1685,19
2023-09-18,EH,Netherlands,3743,2016,34,4,1727,855,838,1693,30
2023-09-19,EH,Netherlands,3644,1954,46,5,1690,817,827,1644,41
2023-09-20,EH,Netherlands,3742,1994,49,4,1748,849,850,1699,45
2023-09-21,EH,Netherlands,3782,2021,55,8,1761,861,845,1706,47
2023-09-22,EH,Netherlands,3788,2017,49,10,1771,858,864,1722,39
2023-09-23,EH,Netherlands,3420,1862,24,7,1558,767,767,1534,17
2023-09-24,EH,Netherlands,3652,1993,13,0,1659,819,827,1646,13
2023-09-25,EH,Netherlands,3649,1909,47,12,1740,851,842,1693,35
2023-09-26,EH,Netherlands,3531,1769,63,20,1762,846,853,1699,43
2023-09-27,EH,Netherlands,3776,2018,54,8,1758,852,852,1704,46
2023-09-28,EH,Netherlands,3787,2013,59,9,1774,856,859,1715,50
2023-09-29,EH,Netherlands,3806,2034,55,9,1772,864,853,1717,46
2023-09-30,EH,Netherlands,3474,1892,29,2,1582,775,778,1553,27
2023-10-01,EH,Netherlands,3619,1962,16,1,1657,813,828,1641,15
2023-10-02,EH,Netherlands,3618,1872,48,5,1746,850,848,1698,43
2023-01-01,LW,North Macedonia,426,379,0,0,47,22,25,47,0
2023-01-02,LW,North Macedonia,466,439,0,0,27,12,15,27,0
2023-01-03,LW,North Macedonia,431,405,0,0,26,14,12,26,0
2023-01-04,LW,North Macedonia,479,431,0,0,48,22,26,48,0
2023-01-05,LW,North Macedonia,487,432,0,0,55,27,28,55,0
2023-01-06,LW,North Macedonia,440,381,0,0,59,30,29,59,0
2023-01-07,LW,North Macedonia,422,379,1,0,43,20,22,42,1
2023-01-08,LW,North Macedonia,470,413,0,0,57,29,28,57,0
2023-01-09,LW,North Macedonia,389,341,0,0,48,25,23,48,0
2023-01-10,LW,North Macedonia,294,257,0,0,37,18,19,37,0
2023-01-11,LW,North Macedonia,341,293,0,0,48,24,24,48,0
2023-01-12,LW,North Macedonia,412,367,0,0,45,21,24,45,0
2023-01-13,LW,North Macedonia,429,379,0,0,50,26,24,50,0
2023-01-14,LW,North Macedonia,418,383,0,0,35,17,18,35,0
2023-01-15,LW,North Macedonia,488,436,0,0,52,26,26,52,0
2023-01-16,LW,North Macedonia,386,328,0,0,58,29,29,58,0
2023-01-17,LW,North Macedonia,318,284,0,0,34,17,17,34,0
2023-01-18,LW,North Macedonia,301,255,0,0,46,23,23,46,0
2023-01-19,LW,North Macedonia,322,281,0,0,41,20,21,41,0
2023-01-20,LW,North Macedonia,368,313,0,0,55,29,26,55,0
2023-01-21,LW,North Macedonia,350,316,0,0,34,16,18,34,0
2023-01-22,LW,North Macedonia,409,357,0,0,52,26,26,52,0
2023-01-23,LW,North Macedonia,346,288,0,0,58,29,29,58,0
2023-01-24,LW,North Macedonia,344,301,0,0,43,22,21,43,0
2023-01-25,LW,North Macedonia,402,364,0,0,38,19,19,38,0
2023-01-26,LW,North Macedonia,381,339,0,0,42,21,21,42,0
2023-01-27,LW,North Macedonia,365,315,0,0,50,26,24,50,0
2023-01-28,LW,North Macedonia,386,353,0,0,33,16,17,33,0
2023-01-29,LW,North Macedonia,480,433,0,0,47,23,24,47,0
2023-01-30,LW,North Macedonia,433,380,0,0,53,27,26,53,0
2023-01-31,LW,North Macedonia,402,368,0,0,34,17,17,34,0
2023-02-01,LW,North Macedonia,412,374,0,0,38,19,19,38,0
2023-02-02,LW,North Macedonia,455,417,0,0,38,19,19,38,0
2023-02-03,LW,North Macedonia,495,445,0,0,50,25,25,50,0
2023-02-04,LW,North Macedonia,396,364,0,0,32,16,16,32,0
2023-02-05,LW,North Macedonia,479,435,0,0,44,21,23,44,0
2023-02-06,LW,North Macedonia,443,387,0,0,56,28,28,56,0
2023-02-07,LW,North Macedonia,397,361,0,0,36,18,18,36,0
2023-02-08,LW,North Macedonia,382,349,0,0,33,17,16,33,0
2023-02-09,LW,North Macedonia,459,425,0,0,34,16,18,34,0
2023-02-10,LW,North Macedonia,463,412,0,0,51,27,24,51,0
2023-02-11,LW,North Macedonia,436,405,0,0,31,15,16,31,0
2023-02-12,LW,North Macedonia,490,443,0,0,47,23,24,47,0
2023-02-13,LW,North Macedonia,416,365,0,0,51,26,25,51,0
2023-02-14,LW,North Macedonia,365,324,0,0,41,19,22,41,0
2023-02-15,LW,North Macedonia,414,371,0,0,43,24,19,43,0
2023-02-16,LW,North Macedonia,433,396,0,0,37,17,20,37,0
2023-02-17,LW,North Macedonia,392,339,0,0,53,27,26,53,0
2023-02-18,LW,North Macedonia,436,401,0,0,35,18,17,35,0
2023-02-19,LW,North Macedonia,464,414,0,0,50,24,26,50,0
2023-02-20,LW,North Macedonia,386,334,0,0,52,27,25,52,0
2023-02-21,LW,North Macedonia,304,265,0,0,39,19,20,39,0
2023-02-22,LW,North Macedonia,373,329,0,0,44,22,22,44,0
2023-02-23,LW,North Macedonia,437,398,0,0,39,20,19,39,0
2023-02-24,LW,North Macedonia,459,407,0,0,52,26,26,52,0
2023-02-25,LW,North Macedonia,404,370,0,0,34,17,17,34,0
2023-02-26,LW,North Macedonia,478,439,0,0,39,19,20,39,0
2023-02-27,LW,North Macedonia,403,343,0,0,60,29,31,60,0
2023-02-28,LW,North Macedonia,420,379,0,0,41,20,21,41,0
2023-03-01,LW,North Macedonia,473,424,0,0,49,25,24,49,0
2023-03-02,LW,North Macedonia,442,404,0,0,38,19,19,38,0
2023-03-03,LW,North Macedonia,469,416,0,0,53,27,26,53,0
2023-03-04,LW,North Macedonia,432,397,0,0,35,18,17,35,0
2023-03-05,LW,North Macedonia,510,463,0,0,47,23,24,47,0
2023-03-06,LW,North Macedonia,425,371,0,0,54,27,27,54,0
2023-03-07,LW,North Macedonia,390,351,0,0,39,19,20,39,0
2023-03-08,LW,North Macedonia,446,397,0,0,49,25,24,49,0
2023-03-09,LW,North Macedonia,429,386,0,0,43,21,22,43,0
2023-03-10,LW,North Macedonia,425,370,0,0,55,28,27,55,0
2023-03-11,LW,North Macedonia,391,356,0,0,35,18,17,35,0
2023-03-12,LW,North Macedonia,536,487,0,0,49,24,25,49,0
2023-03-13,LW,North Macedonia,464,415,0,0,49,25,24,49,0
2023-03-14,LW,North Macedonia,434,397,0,0,37,19,18,37,0
2023-03-15,LW,North Macedonia,437,392,0,0,45,21,24,45,0
2023-03-16,LW,North Macedonia,367,326,0,0,41,21,20,41,0
2023-03-17,LW,North Macedonia,567,517,1,0,50,25,24,49,1
2023-03-18,LW,North Macedonia,570,533,0,0,37,18,19,37,0
2023-03-19,LW,North Macedonia,582,531,0,0,51,26,25,51,0
2023-03-20,LW,North Macedonia,539,488,0,0,51,26,25,51,0
2023-03-21,LW,North Macedonia,465,428,0,0,37,18,19,37,0
2023-03-22,LW,North Macedonia,496,447,0,0,49,24,25,49,0
2023-03-23,LW,North Macedonia,473,427,0,0,46,23,23,46,0
2023-03-24,LW,North Macedonia,479,428,0,0,51,27,24,51,0
2023-03-25,LW,North Macedonia,475,432,2,0,43,19,22,41,2
2023-03-26,LW,North Macedonia,623,563,0,0,60,29,31,60,0
2023-03-27,LW,North Macedonia,412,359,0,0,53,27,26,53,0
2023-03-28,LW,North Macedonia,480,419,0,0,61,30,31,61,0
2023-03-29,LW,North Macedonia,592,538,0,0,54,27,27,54,0
2023-03-30,LW,North Macedonia,650,598,0,0,52,27,25,52,0
2023-03-31,LW,North Macedonia,666,606,0,0,60,31,29,60,0
2023-04-01,LW,North Macedonia,762,705,0,0,57,27,30,57,0
2023-04-02,LW,North Macedonia,682,621,0,0,61,31,30,61,0
2023-04-03,LW,North Macedonia,627,570,0,0,57,29,28,57,0
2023-04-04,LW,North Macedonia,623,556,0,0,67,33,34,67,0
2023-04-05,LW,North Macedonia,656,595,0,0,61,29,32,61,0
2023-04-06,LW,North Macedonia,567,513,0,0,54,27,27,54,0
2023-04-07,LW,North Macedonia,704,642,0,0,62,31,31,62,0
2023-04-08,LW,North Macedonia,733,678,0,0,55,28,27,55,0
2023-04-09,LW,North Macedonia,672,614,0,0,58,28,30,58,0
2023-04-10,LW,North Macedonia,638,576,0,0,62,31,31,62,0
2023-04-11,LW,North Macedonia,637,569,0,0,68,36,32,68,0
2023-04-12,LW,North Macedonia,738,680,0,0,58,28,30,58,0
2023-04-13,LW,North Macedonia,594,535,0,0,59,29,30,59,0
2023-04-14,LW,North Macedonia,663,600,0,0,63,33,30,63,0
2023-04-15,LW,North Macedonia,772,715,0,0,57,28,29,57,0
2023-04-16,LW,North Macedonia,732,677,0,0,55,28,27,55,0
2023-04-17,LW,North Macedonia,635,572,0,0,63,30,33,63,0
2023-04-18,LW,North Macedonia,614,558,0,0,56,29,27,56,0
2023-04-19,LW,North Macedonia,627,569,0,0,58,29,29,58,0
2023-04-20,LW,North Macedonia,621,563,0,0,58,29,29,58,0
2023-04-21,LW,North Macedonia,687,626,0,0,61,32,29,61,0
2023-04-22,LW,North Macedonia,770,717,0,0,53,25,28,53,0
2023-04-23,LW,North Macedonia,774,708,0,0,66,33,33,66,0
2023-04-24,LW,North Macedonia,663,601,0,0,62,31,31,62,0
2023-04-25,LW,North Macedonia,579,515,0,0,64,32,32,64,0
2023-04-26,LW,North Macedonia,610,554,0,0,56,28,28,56,0
2023-04-27,LW,North Macedonia,661,602,0,0,59,30,29,59,0
2023-04-28,LW,North Macedonia,803,734,0,0,69,34,35,69,0
2023-04-29,LW,North Macedonia,853,797,0,0,56,28,28,56,0
2023-04-30,LW,North Macedonia,868,802,0,0,66,32,34,66,0
2023-05-01,LW,North Macedonia,668,606,0,0,62,32,30,62,0
2023-05-02,LW,North Macedonia,702,638,0,0,64,32,32,64,0
2023-05-03,LW,North Macedonia,781,716,0,0,65,33,32,65,0
2023-05-04,LW,North Macedonia,768,713,0,0,55,28,27,55,0
2023-05-05,LW,North Macedonia,773,705,0,0,68,33,35,68,0
2023-05-06,LW,North Macedonia,941,880,0,0,61,30,31,61,0
2023-05-07,LW,North Macedonia,905,836,0,0,69,35,34,69,0
2023-05-08,LW,North Macedonia,748,687,0,0,61,31,30,61,0
2023-05-09,LW,North Macedonia,679,613,0,0,66,32,34,66,0
2023-05-10,LW,North Macedonia,745,680,0,0,65,33,32,65,0
2023-05-11,LW,North Macedonia,716,653,1,0,63,28,34,62,1
2023-05-12,LW,North Macedonia,805,727,2,1,78,40,36,76,1
2023-05-13,LW,North Macedonia,898,837,1,1,61,30,30,60,0
2023-05-14,LW,North Macedonia,836,772,0,0,64,32,32,64,0
2023-05-15,LW,North Macedonia,721,660,0,0,61,32,29,61,0
2023-05-16,LW,North Macedonia,717,649,0,0,68,32,36,68,0
2023-05-17,LW,North Macedonia,778,709,0,0,69,35,34,69,0
2023-05-18,LW,North Macedonia,816,760,0,0,56,28,28,56,0
2023-05-19,LW,North Macedonia,866,797,0,0,69,35,34,69,0
2023-05-20,LW,North Macedonia,1052,991,0,0,61,30,31,61,0
2023-05-21,LW,North Macedonia,939,876,0,0,63,32,31,63,0
2023-05-22,LW,North Macedonia,894,829,0,0,65,33,32,65,0
2023-05-23,LW,North Macedonia,886,822,0,0,64,31,33,64,0
2023-05-24,LW,North Macedonia,929,863,0,0,66,34,32,66,0
2023-05-25,LW,North Macedonia,954,897,0,0,57,29,28,57,0
2023-05-26,LW,North Macedonia,934,864,0,0,70,35,35,70,0
2023-05-27,LW,North Macedonia,1034,972,0,0,62,30,32,62,0
2023-05-28,LW,North Macedonia,1029,963,0,0,66,33,33,66,0
2023-05-29,LW,North Macedonia,906,836,0,0,70,36,34,70,0
2023-05-30,LW,North Macedonia,877,812,0,0,65,31,34,65,0
2023-05-31,LW,North Macedonia,965,890,0,0,75,38,37,75,0
2023-06-01,LW,North Macedonia,920,859,0,0,61,31,30,61,0
2023-06-02,LW,North Macedonia,908,841,0,0,67,34,33,67,0
2023-06-03,LW,North Macedonia,1070,999,0,0,71,34,37,71,0
2023-06-04,LW,North Macedonia,1005,936,0,0,69,33,36,69,0
2023-06-05,LW,North Macedonia,864,793,0,0,71,38,33,71,0
2023-06-06,LW,North Macedonia,884,821,0,0,63,29,34,63,0
2023-06-07,LW,North Macedonia,954,874,0,0,80,40,40,80,0
2023-06-08,LW,North Macedonia,916,855,0,0,61,33,28,61,0
2023-06-09,LW,North Macedonia,913,842,0,0,71,35,36,71,0
2023-06-10,LW,North Macedonia,988,916,0,0,72,34,38,72,0
2023-06-11,LW,North Macedonia,1051,982,0,0,69,35,34,69,0
2023-06-12,LW,North Macedonia,979,915,0,0,64,34,30,64,0
2023-06-13,LW,North Macedonia,964,897,0,0,67,31,36,67,0
2023-06-14,LW,North Macedonia,1043,960,0,0,83,41,42,83,0
2023-06-15,LW,North Macedonia,964,894,0,0,70,36,34,70,0
2023-06-16,LW,North Macedonia,940,868,0,0,72,37,35,72,0
2023-06-17,LW,North Macedonia,1067,991,0,0,76,37,39,76,0
2023-06-18,LW,North Macedonia,1043,970,0,0,73,36,37,73,0
2023-06-19,LW,North Macedonia,976,899,0,0,77,41,36,77,0
2023-06-20,LW,North Macedonia,911,843,0,0,68,32,36,68,0
2023-06-21,LW,North Macedonia,1014,932,0,0,82,40,42,82,0
2023-06-22,LW,North Macedonia,892,821,0,0,71,37,34,71,0
2023-06-23,LW,North Macedonia,944,871,0,0,73,36,37,73,0
2023-06-24,LW,North Macedonia,1076,999,0,0,77,38,39,77,0
2023-06-25,LW,North Macedonia,1090,1019,0,0,71,35,36,71,0
2023-06-26,LW,North Macedonia,1040,965,0,0,75,41,34,75,0
2023-06-27,LW,North Macedonia,1012,946,0,0,66,31,35,66,0
2023-06-28,LW,North Macedonia,1061,974,0,0,87,42,45,87,0
2023-06-29,LW,North Macedonia,1050,983,0,0,67,35,32,67,0
2023-06-30,LW,North Macedonia,1013,937,0,0,76,38,38,76,0
2023-07-01,LW,North Macedonia,1091,1013,0,0,78,38,40,78,0
2023-07-02,LW,North Macedonia,1078,1008,0,0,70,35,35,70,0
2023-07-03,LW,North Macedonia,1056,983,0,0,73,39,34,73,0
2023-07-04,LW,North Macedonia,991,926,0,0,65,31,34,65,0
2023-07-05,LW,North Macedonia,1030,938,0,0,92,44,48,92,0
2023-07-06,LW,North Macedonia,1087,1019,0,0,68,36,32,68,0
2023-07-07,LW,North Macedonia,1003,920,0,0,83,41,42,83,0
2023-07-08,LW,North Macedonia,1092,1015,0,0,77,38,39,77,0
2023-07-09,LW,North Macedonia,1079,1013,0,0,66,33,33,66,0
2023-07-10,LW,North Macedonia,1053,976,0,0,77,43,34,77,0
2023-07-11,LW,North Macedonia,1022,947,0,0,75,35,40,75,0
2023-07-12,LW,North Macedonia,1104,1027,0,0,77,37,40,77,0
2023-07-13,LW,North Macedonia,1017,947,0,0,70,37,33,70,0
2023-07-14,LW,North Macedonia,1096,1004,0,0,92,45,47,92,0
2023-07-15,LW,North Macedonia,1133,1059,0,0,74,38,36,74,0
2023-07-16,LW,North Macedonia,1101,1023,0,0,78,36,42,78,0
2023-07-17,LW,North Macedonia,1023,939,0,0,84,45,39,84,0
2023-07-18,LW,North Macedonia,987,907,0,0,80,38,42,80,0
2023-07-19,LW,North Macedonia,1060,969,1,0,91,44,46,90,1
2023-07-20,LW,North Macedonia,1067,992,0,0,75,39,36,75,0
2023-07-21,LW,North Macedonia,1038,953,0,0,85,44,41,85,0
2023-07-22,LW,North Macedonia,1115,1038,0,0,77,36,41,77,0
2023-07-23,LW,North Macedonia,1133,1056,0,0,77,38,39,77,0
2023-07-24,LW,North Macedonia,1008,926,0,0,82,44,38,82,0
2023-07-25,LW,North Macedonia,923,845,1,0,78,36,41,77,1
2023-07-26,LW,North Macedonia,1096,1007,0,0,89,46,43,89,0
2023-07-27,LW,North Macedonia,1052,977,0,0,75,37,38,75,0
2023-07-28,LW,North Macedonia,1019,932,0,0,87,43,44,87,0
2023-07-29,LW,North Macedonia,1157,1080,0,0,77,38,39,77,0
2023-07-30,LW,North Macedonia,1069,994,0,0,75,38,37,75,0
2023-07-31,LW,North Macedonia,1031,954,0,0,77,43,34,77,0
2023-08-01,LW,North Macedonia,1033,953,0,0,80,36,44,80,0
2023-08-02,LW,North Macedonia,1128,1042,0,0,86,42,44,86,0
2023-08-03,LW,North Macedonia,1056,985,0,0,71,36,35,71,0
2023-08-04,LW,North Macedonia,996,907,0,0,89,45,44,89,0
2023-08-05,LW,North Macedonia,1041,962,0,0,79,39,40,79,0
2023-08-06,LW,North Macedonia,1002,929,0,0,73,38,35,73,0
2023-08-07,LW,North Macedonia,950,866,0,0,84,43,41,84,0
2023-08-08,LW,North Macedonia,1020,939,0,0,81,38,43,81,0
2023-08-09,LW,North Macedonia,1072,984,0,0,88,43,45,88,0
2023-08-10,LW,North Macedonia,1077,1010,0,0,67,34,33,67,0
2023-08-11,LW,North Macedonia,1108,1019,0,0,89,45,44,89,0
2023-08-12,LW,North Macedonia,1160,1085,0,0,75,38,37,75,0
2023-08-13,LW,North Macedonia,1119,1041,0,0,78,37,41,78,0
2023-08-14,LW,North Macedonia,1033,949,0,0,84,45,39,84,0
2023-08-15,LW,North Macedonia,1039,957,0,0,82,39,43,82,0
2023-08-16,LW,North Macedonia,1093,1006,0,0,87,43,44,87,0
2023-08-17,LW,North Macedonia,1000,932,0,0,68,35,33,68,0
2023-08-18,LW,North Macedonia,1013,931,0,0,82,41,41,82,0
2023-08-19,LW,North Macedonia,1119,1039,2,0,80,39,39,78,2
2023-08-20,LW,North Macedonia,1120,1046,1,0,74,36,37,73,1
2023-08-21,LW,North Macedonia,1047,968,0,0,79,42,37,79,0
2023-08-22,LW,North Macedonia,1068,995,0,0,73,34,39,73,0
2023-08-23,LW,North Macedonia,1051,960,0,0,91,45,46,91,0
2023-08-24,LW,North Macedonia,1033,969,0,0,64,32,32,64,0
2023-08-25,LW,North Macedonia,1070,991,0,0,79,41,38,79,0
2023-08-26,LW,North Macedonia,1154,1079,0,0,75,37,38,75,0
2023-08-27,LW,North Macedonia,1175,1102,0,0,73,36,37,73,0
2023-08-28,LW,North Macedonia,877,798,0,0,79,41,38,79,0
2023-08-29,LW,North Macedonia,1070,998,0,0,72,34,38,72,0
2023-08-30,LW,North Macedonia,1075,982,0,0,93,46,47,93,0
2023-08-31,LW,North Macedonia,988,918,0,0,70,37,33,70,0
2023-09-01,LW,North Macedonia,1056,971,0,0,85,42,43,85,0
2023-09-02,LW,North Macedonia,1144,1069,0,0,75,37,38,75,0
2023-09-03,LW,North Macedonia,1098,1027,0,0,71,36,35,71,0
2023-09-04,LW,North Macedonia,1041,969,0,0,72,39,33,72,0
2023-09-05,LW,North Macedonia,1017,952,0,0,65,30,35,65,0
2023-09-06,LW,North Macedonia,1097,1012,0,0,85,42,43,85,0
2023-09-07,LW,North Macedonia,1083,1011,0,0,72,37,35,72,0
2023-09-08,LW,North Macedonia,1074,999,0,0,75,37,38,75,0
2023-09-09,LW,North Macedonia,1142,1066,0,0,76,37,39,76,0
2023-09-10,LW,North Macedonia,1123,1046,0,0,77,37,40,77,0
2023-09-11,LW,North Macedonia,1015,938,0,0,77,43,34,77,0
2023-09-12,LW,North Macedonia,961,897,0,0,64,30,34,64,0
2023-09-13,LW,North Macedonia,1037,946,0,0,91,44,47,91,0
2023-09-14,LW,North Macedonia,930,859,0,0,71,37,34,71,0
2023-09-15,LW,North Macedonia,966,886,1,1,80,39,40,79,0
2023-09-16,LW,North Macedonia,1074,994,1,1,80,39,40,79,0
2023-09-17,LW,North Macedonia,1012,942,0,0,70,35,35,70,0
2023-09-18,LW,North Macedonia,948,869,0,0,79,42,37,79,0
2023-09-19,LW,North Macedonia,1004,930,0,0,74,35,39,74,0
2023-09-20,LW,North Macedonia,1055,975,0,0,80,39,41,80,0
2023-09-21,LW,North Macedonia,964,895,0,0,69,36,33,69,0
2023-09-22,LW,North Macedonia,968,887,0,0,81,41,40,81,0
2023-09-23,LW,North Macedonia,980,909,0,0,71,34,37,71,0
2023-09-24,LW,North Macedonia,999,935,0,0,64,33,31,64,0
2023-09-25,LW,North Macedonia,885,811,0,0,74,39,35,74,0
2023-09-26,LW,North Macedonia,944,865,0,0,79,36,43,79,0
2023-09-27,LW,North Macedonia,950,878,0,0,72,36,36,72,0
2023-09-28,LW,North Macedonia,956,884,0,0,72,37,35,72,0
2023-09-29,LW,North Macedonia,1000,927,0,0,73,36,37,73,0
2023-09-30,LW,North Macedonia,1074,1002,0,0,72,34,38,72,0
2023-10-01,LW,North Macedonia,1056,989,0,0,67,36,31,67,0
2023-10-02,LW,North Macedonia,933,862,0,0,71,36,35,71,0
2023-01-01,EN,Norway,1127,201,491,2,926,214,221,435,489
2023-01-02,EN,Norway,1553,206,832,6,1347,260,255,515,826
2023-01-03,EN,Norway,1458,191,823,10,1267,222,222,444,813
2023-01-04,EN,Norway,1392,183,777,4,1209,216,216,432,773
2023-01-05,EN,Norway,1434,175,784,4,1259,238,237,475,780
2023-01-06,EN,Norway,1316,180,665,7,1136,233,238,471,658
2023-01-07,EN,Norway,810,163,254,2,647,200,193,393,252
2023-01-08,EN,Norway,1244,256,522,4,988,226,240,466,518
2023-01-09,EN,Norway,1454,223,786,7,1231,224,221,445,779
2023-01-10,EN,Norway,1363,181,825,5,1182,180,177,357,820
2023-01-11,EN,Norway,1437,207,816,19,1230,207,207,414,797
2023-01-12,EN,Norway,1466,199,840,2,1267,213,214,427,838
2023-01-13,EN,Norway,1465,203,786,6,1262,236,240,476,780
2023-01-14,EN,Norway,783,185,253,6,598,175,170,345,247
2023-01-15,EN,Norway,1220,229,581,3,991,201,209,410,578
2023-01-16,EN,Norway,1430,171,809,10,1259,225,225,450,799
2023-01-17,EN,Norway,1386,150,851,3,1236,195,190,385,848
2023-01-18,EN,Norway,1404,194,809,3,1210,198,203,401,806
2023-01-19,EN,Norway,1456,191,837,12,1265,213,215,428,825
2023-01-20,EN,Norway,1564,184,882,18,1380,246,252,498,864
2023-01-21,EN,Norway,801,154,277,11,647,190,180,370,266
2023-01-22,EN,Norway,1193,198,573,3,995,208,214,422,570
2023-01-23,EN,Norway,1426,182,803,21,1244,225,216,441,782
2023-01-24,EN,Norway,1228,156,728,13,1072,172,172,344,715
2023-01-25,EN,Norway,1425,130,873,11,1295,213,209,422,862
2023-01-26,EN,Norway,1515,184,870,18,1331,231,230,461,852
2023-01-27,EN,Norway,1506,178,825,19,1328,251,252,503,806
2023-01-28,EN,Norway,779,142,287,15,637,175,175,350,272
2023-01-29,EN,Norway,1275,217,617,15,1058,213,228,441,602
2023-01-30,EN,Norway,1472,164,851,11,1308,233,224,457,840
2023-01-31,EN,Norway,1344,171,805,13,1173,185,183,368,792
2023-02-01,EN,Norway,1400,165,833,21,1235,200,202,402,812
2023-02-02,EN,Norway,1496,161,895,20,1335,219,221,440,875
2023-02-03,EN,Norway,1530,169,852,12,1361,255,254,509,840
2023-02-04,EN,Norway,783,155,268,10,628,181,179,360,258
2023-02-05,EN,Norway,1181,159,589,8,1022,212,221,433,581
2023-02-06,EN,Norway,1503,174,862,20,1329,236,231,467,842
2023-02-07,EN,Norway,1318,120,799,25,1198,202,197,399,774
2023-02-08,EN,Norway,1264,136,701,14,1128,209,218,427,687
2023-02-09,EN,Norway,1360,178,752,20,1182,217,213,430,732
2023-02-10,EN,Norway,1485,189,770,14,1296,258,268,526,756
2023-02-11,EN,Norway,854,181,305,19,673,187,181,368,286
2023-02-12,EN,Norway,1205,190,563,15,1015,220,232,452,548
2023-02-13,EN,Norway,1540,157,890,22,1383,246,247,493,868
2023-02-14,EN,Norway,1417,147,863,13,1270,202,205,407,850
2023-02-15,EN,Norway,1437,152,846,8,1285,218,221,439,838
2023-02-16,EN,Norway,1584,200,890,16,1384,250,244,494,874
2023-02-17,EN,Norway,1429,168,798,6,1261,230,233,463,792
2023-02-18,EN,Norway,864,144,286,14,720,220,214,434,272
2023-02-19,EN,Norway,1272,192,604,11,1080,236,240,476,593
2023-02-20,EN,Norway,1423,181,773,9,1242,237,232,469,764
2023-02-21,EN,Norway,1458,149,861,31,1309,221,227,448,830
2023-02-22,EN,Norway,1464,149,833,10,1315,238,244,482,823
2023-02-23,EN,Norway,1492,181,817,29,1311,249,245,494,788
2023-02-24,EN,Norway,1495,172,803,11,1323,260,260,520,792
2023-02-25,EN,Norway,862,156,273,17,706,215,218,433,256
2023-02-26,EN,Norway,1273,178,607,9,1095,245,243,488,598
2023-02-27,EN,Norway,1442,147,769,33,1295,262,264,526,736
2023-02-28,EN,Norway,1401,112,826,22,1289,231,232,463,804
2023-03-01,EN,Norway,1482,133,867,25,1349,240,242,482,842
2023-03-02,EN,Norway,1526,137,873,28,1389,260,256,516,845
2023-03-03,EN,Norway,1484,167,799,28,1317,258,260,518,771
2023-03-04,EN,Norway,846,150,285,18,696,204,207,411,267
2023-03-05,EN,Norway,1307,176,639,17,1131,244,248,492,622
2023-03-06,EN,Norway,1508,154,843,24,1354,257,254,511,819
2023-03-07,EN,Norway,1499,161,897,26,1338,221,220,441,871
2023-03-08,EN,Norway,1487,185,841,27,1302,230,231,461,814
2023-03-09,EN,Norway,1636,187,911,25,1449,269,269,538,886
2023-03-10,EN,Norway,1585,209,844,22,1376,264,268,532,822
2023-03-11,EN,Norway,881,192,289,14,689,203,197,400,275
2023-03-12,EN,Norway,1408,229,678,12,1179,248,253,501,666
2023-03-13,EN,Norway,1581,199,871,10,1382,253,258,511,861
2023-03-14,EN,Norway,1469,168,859,20,1301,220,222,442,839
2023-03-15,EN,Norway,1633,194,937,26,1439,254,248,502,911
2023-03-16,EN,Norway,1613,168,906,18,1445,272,267,539,888
2023-03-17,EN,Norway,1533,184,816,4,1349,263,270,533,812
2023-03-18,EN,Norway,937,202,312,1,735,209,214,423,311
2023-03-19,EN,Norway,1324,228,614,1,1096,242,240,482,613
2023-03-20,EN,Norway,1613,161,910,19,1452,273,269,542,891
2023-03-21,EN,Norway,1483,155,870,5,1328,229,229,458,865
2023-03-22,EN,Norway,1524,170,864,8,1354,242,248,490,856
2023-03-23,EN,Norway,1649,194,917,17,1455,270,268,538,900
2023-03-24,EN,Norway,1572,184,842,3,1388,275,271,546,839
2023-03-25,EN,Norway,859,173,291,11,686,196,199,395,280
2023-03-26,EN,Norway,1350,213,635,15,1137,248,254,502,620
2023-03-27,EN,Norway,1658,188,923,30,1470,274,273,547,893
2023-03-28,EN,Norway,1650,175,892,20,1475,287,296,583,872
2023-03-29,EN,Norway,1707,177,946,21,1530,293,291,584,925
2023-03-30,EN,Norway,1731,219,935,11,1512,286,291,577,924
2023-03-31,EN,Norway,1708,218,866,13,1490,312,312,624,853
2023-04-01,EN,Norway,1029,221,326,14,808,247,235,482,312
2023-04-02,EN,Norway,1313,198,566,11,1115,272,277,549,555
2023-04-03,EN,Norway,1588,196,835,23,1392,282,275,557,812
2023-04-04,EN,Norway,1537,189,802,18,1348,270,276,546,784
2023-04-05,EN,Norway,1550,212,776,18,1338,284,278,562,758
2023-04-06,EN,Norway,1196,198,496,3,998,250,252,502,493
2023-04-07,EN,Norway,926,185,252,3,741,246,243,489,249
2023-04-08,EN,Norway,869,203,221,14,666,222,223,445,207
2023-04-09,EN,Norway,1227,199,521,2,1028,253,254,507,519
2023-04-10,EN,Norway,1562,216,772,14,1346,281,293,574,758
2023-04-11,EN,Norway,1726,222,915,2,1504,297,292,589,913
2023-04-12,EN,Norway,1756,227,928,20,1529,299,302,601,908
2023-04-13,EN,Norway,1774,239,961,11,1535,285,289,574,950
2023-04-14,EN,Norway,1743,245,897,18,1498,299,302,601,879
2023-04-15,EN,Norway,950,209,295,8,741,225,221,446,287
2023-04-16,EN,Norway,1350,179,646,15,1171,260,265,525,631
2023-04-17,EN,Norway,1773,191,985,27,1582,298,299,597,958
2023-04-18,EN,Norway,1725,152,989,27,1573,292,292,584,962
2023-04-19,EN,Norway,1692,175,949,27,1517,285,283,568,922
2023-04-20,EN,Norway,1708,168,969,33,1540,277,294,571,936
2023-04-21,EN,Norway,1723,171,928,30,1552,317,307,624,898
2023-04-22,EN,Norway,961,148,368,16,813,222,223,445,352
2023-04-23,EN,Norway,1379,189,667,9,1190,257,266,523,658
2023-04-24,EN,Norway,1747,182,969,9,1565,300,296,596,960
2023-04-25,EN,Norway,1654,206,911,19,1448,267,270,537,892
2023-04-26,EN,Norway,1809,218,977,32,1591,309,305,614,945
2023-04-27,EN,Norway,1782,175,1008,28,1607,298,301,599,980
2023-04-28,EN,Norway,1762,212,929,22,1550,314,307,621,907
2023-04-29,EN,Norway,932,169,317,22,763,226,220,446,295
2023-04-30,EN,Norway,1305,188,597,17,1117,258,262,520,580
2023-05-01,EN,Norway,1545,223,757,1,1322,284,281,565,756
2023-05-02,EN,Norway,1724,201,937,30,1523,292,294,586,907
2023-05-03,EN,Norway,1735,187,946,33,1548,298,304,602,913
2023-05-04,EN,Norway,1724,188,966,21,1536,284,286,570,945
2023-05-05,EN,Norway,1762,185,934,25,1577,322,321,643,909
2023-05-06,EN,Norway,995,182,351,20,813,230,232,462,331
2023-05-07,EN,Norway,1478,233,688,13,1245,276,281,557,675
2023-05-08,EN,Norway,1750,209,928,27,1541,307,306,613,901
2023-05-09,EN,Norway,1703,229,897,24,1474,287,290,577,873
2023-05-10,EN,Norway,1742,227,913,33,1515,301,301,602,880
2023-05-11,EN,Norway,1692,215,894,32,1477,290,293,583,862
2023-05-12,EN,Norway,1802,219,946,42,1583,317,320,637,904
2023-05-13,EN,Norway,1076,178,367,13,898,269,262,531,354
2023-05-14,EN,Norway,1460,227,661,6,1233,281,291,572,655
2023-05-15,EN,Norway,1747,237,882,17,1510,313,315,628,865
2023-05-16,EN,Norway,1698,219,872,14,1479,303,304,607,858
2023-05-17,EN,Norway,1244,224,494,1,1020,264,262,526,493
2023-05-18,EN,Norway,1423,254,621,21,1169,277,271,548,600
2023-05-19,EN,Norway,1407,185,653,19,1222,280,289,569,634
2023-05-20,EN,Norway,1022,174,303,13,848,269,276,545,290
2023-05-21,EN,Norway,1547,235,710,11,1312,293,309,602,699
2023-05-22,EN,Norway,1792,220,946,21,1572,314,312,626,925
2023-05-23,EN,Norway,1847,204,999,24,1643,320,324,644,975
2023-05-24,EN,Norway,1866,215,972,15,1651,338,341,679,957
2023-05-25,EN,Norway,1845,235,987,11,1610,316,307,623,976
2023-05-26,EN,Norway,1824,232,930,14,1592,330,332,662,916
2023-05-27,EN,Norway,1071,173,358,11,898,272,268,540,347
2023-05-28,EN,Norway,1308,212,550,3,1096,271,275,546,547
2023-05-29,EN,Norway,1623,215,778,11,1408,311,319,630,767
2023-05-30,EN,Norway,1811,228,929,14,1583,330,324,654,915
2023-05-31,EN,Norway,1847,229,928,13,1618,339,351,690,915
2023-06-01,EN,Norway,1838,233,965,10,1605,325,315,640,955
2023-06-02,EN,Norway,1819,229,920,18,1590,333,337,670,902
2023-06-03,EN,Norway,1105,189,354,14,916,278,284,562,340
2023-06-04,EN,Norway,1514,217,684,12,1297,304,309,613,672
2023-06-05,EN,Norway,1871,224,975,23,1647,334,338,672,952
2023-06-06,EN,Norway,1816,223,966,12,1593,315,312,627,954
2023-06-07,EN,Norway,1856,212,970,17,1644,336,338,674,953
2023-06-08,EN,Norway,1825,210,983,17,1615,318,314,632,966
2023-06-09,EN,Norway,1802,202,928,11,1600,345,327,672,917
2023-06-10,EN,Norway,1116,193,360,10,923,281,282,563,350
2023-06-11,EN,Norway,1500,237,634,3,1263,311,318,629,631
2023-06-12,EN,Norway,1871,251,941,18,1620,342,337,679,923
2023-06-13,EN,Norway,1855,232,966,23,1623,327,330,657,943
2023-06-14,EN,Norway,1845,219,945,18,1626,337,344,681,927
2023-06-15,EN,Norway,1859,232,978,10,1627,320,329,649,968
2023-06-16,EN,Norway,1852,262,916,8,1590,341,333,674,908
2023-06-17,EN,Norway,1145,220,336,16,925,292,297,589,320
2023-06-18,EN,Norway,1565,288,653,11,1277,308,316,624,642
2023-06-19,EN,Norway,1877,234,969,18,1643,344,330,674,951
2023-06-20,EN,Norway,1799,215,911,12,1584,336,337,673,899
2023-06-21,EN,Norway,1841,241,928,11,1600,333,339,672,917
2023-06-22,EN,Norway,1884,222,944,19,1662,358,360,718,925
2023-06-23,EN,Norway,1837,265,864,18,1572,360,348,708,846
2023-06-24,EN,Norway,1144,185,339,14,959,305,315,620,325
2023-06-25,EN,Norway,1558,262,629,12,1296,333,334,667,617
2023-06-26,EN,Norway,1789,285,805,11,1504,346,353,699,794
2023-06-27,EN,Norway,1805,242,851,16,1563,355,357,712,835
2023-06-28,EN,Norway,1804,228,858,21,1576,357,361,718,837
2023-06-29,EN,Norway,1831,254,880,17,1577,351,346,697,863
2023-06-30,EN,Norway,1742,258,747,11,1484,370,367,737,736
2023-07-01,EN,Norway,1233,247,326,8,986,332,328,660,318
2023-07-02,EN,Norway,1537,291,563,8,1246,342,341,683,555
2023-07-03,EN,Norway,1745,255,764,7,1490,365,361,726,757
2023-07-04,EN,Norway,1725,258,752,9,1467,360,355,715,743
2023-07-05,EN,Norway,1751,275,762,17,1476,354,360,714,745
2023-07-06,EN,Norway,1745,299,750,4,1446,350,346,696,746
2023-07-07,EN,Norway,1752,270,751,14,1482,363,368,731,737
2023-07-08,EN,Norway,1221,221,318,13,1000,342,340,682,305
2023-07-09,EN,Norway,1496,264,554,4,1232,340,338,678,550
2023-07-10,EN,Norway,1746,281,752,5,1465,358,355,713,747
2023-07-11,EN,Norway,1722,255,753,11,1467,356,358,714,742
2023-07-12,EN,Norway,1729,255,746,7,1474,366,362,728,739
2023-07-13,EN,Norway,1782,291,783,14,1491,351,357,708,769
2023-07-14,EN,Norway,1752,271,741,15,1481,373,367,740,726
2023-07-15,EN,Norway,1198,270,307,9,928,312,309,621,298
2023-07-16,EN,Norway,1507,277,561,4,1230,334,335,669,557
2023-07-17,EN,Norway,1755,248,788,4,1507,358,361,719,784
2023-07-18,EN,Norway,1711,243,767,13,1468,350,351,701,754
2023-07-19,EN,Norway,1692,240,735,11,1452,359,358,717,724
2023-07-20,EN,Norway,1724,249,784,15,1475,346,345,691,769
2023-07-21,EN,Norway,1752,277,748,7,1475,366,361,727,741
2023-07-22,EN,Norway,1192,234,301,10,958,327,330,657,291
2023-07-23,EN,Norway,1479,255,564,8,1224,324,336,660,556
2023-07-24,EN,Norway,1727,287,737,12,1440,353,350,703,725
2023-07-25,EN,Norway,1777,290,765,17,1487,359,363,722,748
2023-07-26,EN,Norway,1783,290,760,10,1493,369,364,733,750
2023-07-27,EN,Norway,1773,289,768,15,1484,357,359,716,753
2023-07-28,EN,Norway,1718,249,727,16,1469,368,374,742,711
2023-07-29,EN,Norway,1205,236,305,15,969,334,330,664,290
2023-07-30,EN,Norway,1523,288,545,7,1235,341,349,690,538
2023-07-31,EN,Norway,1785,280,776,12,1505,361,368,729,764
2023-08-01,EN,Norway,1807,281,799,20,1526,362,365,727,779
2023-08-02,EN,Norway,1741,261,766,14,1480,360,354,714,752
2023-08-03,EN,Norway,1777,295,769,8,1482,357,356,713,761
2023-08-04,EN,Norway,1745,285,743,7,1460,364,353,717,736
2023-08-05,EN,Norway,1204,261,293,10,943,325,325,650,283
2023-08-06,EN,Norway,1578,340,545,5,1238,341,352,693,540
2023-08-07,EN,Norway,1836,331,791,1,1505,361,353,714,790
2023-08-08,EN,Norway,1736,305,736,10,1431,343,352,695,726
2023-08-09,EN,Norway,1664,211,769,8,1453,341,343,684,761
2023-08-10,EN,Norway,1723,228,797,10,1495,354,344,698,787
2023-08-11,EN,Norway,1745,232,780,12,1513,363,370,733,768
2023-08-12,EN,Norway,1198,231,335,10,967,317,315,632,325
2023-08-13,EN,Norway,1506,243,603,6,1263,330,330,660,597
2023-08-14,EN,Norway,1741,241,814,14,1500,343,343,686,800
2023-08-15,EN,Norway,1709,225,799,6,1484,341,344,685,793
2023-08-16,EN,Norway,1739,253,799,20,1486,341,346,687,779
2023-08-17,EN,Norway,1751,242,849,18,1509,331,329,660,831
2023-08-18,EN,Norway,1768,260,824,20,1508,336,348,684,804
2023-08-19,EN,Norway,1099,199,322,11,900,295,283,578,311
2023-08-20,EN,Norway,1459,250,587,1,1209,307,315,622,586
2023-08-21,EN,Norway,1820,251,908,20,1569,330,331,661,888
2023-08-22,EN,Norway,1841,249,917,18,1592,339,336,675,899
2023-08-23,EN,Norway,1827,271,896,19,1556,331,329,660,877
2023-08-24,EN,Norway,1836,277,919,15,1559,321,319,640,904
2023-08-25,EN,Norway,1794,260,866,11,1534,332,336,668,855
2023-08-26,EN,Norway,1144,249,316,9,895,292,287,579,307
2023-08-27,EN,Norway,1542,289,627,12,1253,314,312,626,615
2023-08-28,EN,Norway,1912,342,942,15,1570,315,313,628,927
2023-08-29,EN,Norway,1880,279,936,13,1601,337,328,665,923
2023-08-30,EN,Norway,1898,283,919,11,1615,343,353,696,908
2023-08-31,EN,Norway,1918,307,945,12,1611,334,332,666,933
2023-09-01,EN,Norway,1795,280,868,12,1515,326,321,647,856
2023-09-02,EN,Norway,1118,235,312,14,883,285,286,571,298
2023-09-03,EN,Norway,1542,275,627,9,1267,319,321,640,618
2023-09-04,EN,Norway,1852,242,941,11,1610,331,338,669,930
2023-09-05,EN,Norway,1830,238,943,10,1592,326,323,649,933
2023-09-06,EN,Norway,1865,215,965,15,1650,347,338,685,950
2023-09-07,EN,Norway,1757,244,902,24,1513,305,306,611,878
2023-09-08,EN,Norway,1722,242,845,19,1480,318,317,635,826
2023-09-09,EN,Norway,1035,191,290,9,844,278,276,554,281
2023-09-10,EN,Norway,1505,230,623,13,1275,323,329,652,610
2023-09-11,EN,Norway,1754,245,877,5,1509,317,315,632,872
2023-09-12,EN,Norway,1837,232,957,16,1605,324,324,648,941
2023-09-13,EN,Norway,1901,236,975,14,1665,344,346,690,961
2023-09-14,EN,Norway,1848,244,948,8,1604,332,324,656,940
2023-09-15,EN,Norway,1830,241,899,10,1589,336,354,690,889
2023-09-16,EN,Norway,1061,203,312,8,858,271,275,546,304
2023-09-17,EN,Norway,1502,245,636,16,1257,312,309,621,620
2023-09-18,EN,Norway,1846,291,906,4,1555,325,324,649,902
2023-09-19,EN,Norway,1834,252,939,13,1582,324,319,643,926
2023-09-20,EN,Norway,1827,244,932,16,1583,325,326,651,916
2023-09-21,EN,Norway,1858,258,941,7,1600,330,329,659,934
2023-09-22,EN,Norway,1861,290,901,17,1571,334,336,670,884
2023-09-23,EN,Norway,1057,201,297,8,856,284,275,559,289
2023-09-24,EN,Norway,1483,228,646,16,1255,301,308,609,630
2023-09-25,EN,Norway,1811,234,931,9,1577,322,324,646,922
2023-09-26,EN,Norway,1771,179,957,17,1592,320,315,635,940
2023-09-27,EN,Norway,1809,223,938,16,1586,326,322,648,922
2023-09-28,EN,Norway,1810,263,930,18,1547,304,313,617,912
2023-09-29,EN,Norway,1906,296,922,15,1610,346,342,688,907
2023-09-30,EN,Norway,1101,210,304,12,891,295,292,587,292
2023-10-01,EN,Norway,1470,225,608,4,1245,319,318,637,604
2023-10-02,EN,Norway,1739,212,876,10,1527,326,325,651,866
2023-01-01,EP,Poland,1381,608,70,1,773,352,351,703,69
2023-01-02,EP,Poland,1547,608,105,12,939,416,418,834,93
2023-01-03,EP,Poland,1353,526,88,9,827,368,371,739,79
2023-01-04,EP,Poland,1369,556,94,34,813,359,360,719,60
2023-01-05,EP,Poland,1422,519,107,13,903,403,393,796,94
2023-01-06,EP,Poland,1522,603,83,9,919,417,419,836,74
2023-01-07,EP,Poland,1521,631,89,10,890,399,402,801,79
2023-01-08,EP,Poland,1517,635,85,8,882,395,402,797,77
2023-01-09,EP,Poland,1442,550,104,12,892,389,399,788,92
2023-01-10,EP,Poland,1287,511,109,20,776,334,333,667,89
2023-01-11,EP,Poland,1305,537,108,25,768,331,329,660,83
2023-01-12,EP,Poland,1404,544,137,27,860,366,357,723,110
2023-01-13,EP,Poland,1582,593,141,26,989,418,430,848,115
2023-01-14,EP,Poland,1448,623,78,22,825,375,372,747,56
2023-01-15,EP,Poland,1423,584,84,10,839,378,377,755,74
2023-01-16,EP,Poland,1412,508,117,26,904,391,396,787,91
2023-01-17,EP,Poland,1311,497,140,35,814,336,338,674,105
2023-01-18,EP,Poland,1233,491,83,9,742,328,331,659,74
2023-01-19,EP,Poland,1334,505,104,7,829,369,356,725,97
2023-01-20,EP,Poland,1501,555,109,15,946,414,423,837,94
2023-01-21,EP,Poland,1377,583,60,4,794,370,364,734,56
2023-01-22,EP,Poland,1398,570,76,3,828,374,378,752,73
2023-01-23,EP,Poland,1438,541,110,13,897,387,400,787,97
2023-01-24,EP,Poland,1221,481,108,11,740,324,308,632,97
2023-01-25,EP,Poland,1162,426,88,11,736,319,329,648,77
2023-01-26,EP,Poland,1337,518,120,21,819,350,349,699,99
2023-01-27,EP,Poland,1483,551,99,9,932,416,417,833,90
2023-01-28,EP,Poland,1387,577,73,11,810,370,367,737,62
2023-01-29,EP,Poland,1438,609,73,6,829,379,377,756,67
2023-01-30,EP,Poland,1383,509,80,3,874,392,402,794,77
2023-01-31,EP,Poland,1264,490,121,19,774,332,321,653,102
2023-02-01,EP,Poland,1223,452,97,20,771,335,339,674,77
2023-02-02,EP,Poland,1308,486,103,14,822,366,353,719,89
2023-02-03,EP,Poland,1468,534,109,19,934,412,413,825,90
2023-02-04,EP,Poland,1380,553,74,13,827,372,381,753,61
2023-02-05,EP,Poland,1438,575,89,14,863,389,385,774,75
2023-02-06,EP,Poland,1374,465,129,31,909,389,391,780,98
2023-02-07,EP,Poland,1222,434,112,19,788,341,335,676,93
2023-02-08,EP,Poland,1283,484,136,31,799,332,331,663,105
2023-02-09,EP,Poland,1409,530,145,32,879,371,363,734,113
2023-02-10,EP,Poland,1563,576,116,15,987,430,441,871,101
2023-02-11,EP,Poland,1440,610,61,1,830,382,387,769,60
2023-02-12,EP,Poland,1526,661,83,10,865,391,391,782,73
2023-02-13,EP,Poland,1459,557,105,15,902,398,399,797,90
2023-02-14,EP,Poland,1276,496,113,23,780,336,331,667,90
2023-02-15,EP,Poland,1339,496,130,25,843,353,360,713,105
2023-02-16,EP,Poland,1460,534,149,37,926,394,383,777,112
2023-02-17,EP,Poland,1480,546,114,22,934,407,413,820,92
2023-02-18,EP,Poland,1474,599,74,4,875,396,405,801,70
2023-02-19,EP,Poland,1468,593,79,13,875,401,395,796,66
2023-02-20,EP,Poland,1489,561,113,6,928,403,412,815,107
2023-02-21,EP,Poland,1269,471,99,16,798,352,347,699,83
2023-02-22,EP,Poland,1353,494,124,33,859,371,364,735,91
2023-02-23,EP,Poland,1429,527,147,27,902,382,373,755,120
2023-02-24,EP,Poland,1600,591,127,16,1009,441,441,882,111
2023-02-25,EP,Poland,1549,702,68,4,847,385,394,779,64
2023-02-26,EP,Poland,1521,641,80,11,880,402,398,800,69
2023-02-27,EP,Poland,1514,549,129,24,965,415,421,836,105
2023-02-28,EP,Poland,1300,469,138,34,831,346,347,693,104
2023-03-01,EP,Poland,1324,490,152,46,834,343,339,682,106
2023-03-02,EP,Poland,1417,512,127,32,905,391,387,778,95
2023-03-03,EP,Poland,1610,611,122,15,999,439,438,877,107
2023-03-04,EP,Poland,1494,656,67,5,838,390,381,771,62
2023-03-05,EP,Poland,1493,624,76,6,869,400,393,793,70
2023-03-06,EP,Poland,1553,611,111,19,942,408,423,831,92
2023-03-07,EP,Poland,1388,548,134,27,840,351,355,706,107
2023-03-08,EP,Poland,1394,569,129,24,825,346,350,696,105
2023-03-09,EP,Poland,1514,615,108,11,899,398,393,791,97
2023-03-10,EP,Poland,1658,637,126,25,1021,448,447,895,101
2023-03-11,EP,Poland,1520,672,78,4,848,386,384,770,74
2023-03-12,EP,Poland,1558,660,92,15,898,404,402,806,77
2023-03-13,EP,Poland,1510,566,119,22,944,409,416,825,97
2023-03-14,EP,Poland,1437,566,133,22,871,369,369,738,111
2023-03-15,EP,Poland,1408,574,124,28,834,353,357,710,96
2023-03-16,EP,Poland,1519,582,144,32,937,403,390,793,112
2023-03-17,EP,Poland,1642,618,141,20,1024,436,447,883,121
2023-03-18,EP,Poland,1505,649,92,27,856,386,378,764,65
2023-03-19,EP,Poland,1586,666,100,19,920,409,411,820,81
2023-03-20,EP,Poland,1518,561,134,28,957,405,418,823,106
2023-03-21,EP,Poland,1353,514,132,19,839,352,355,707,113
2023-03-22,EP,Poland,1415,568,130,27,847,361,356,717,103
2023-03-23,EP,Poland,1521,607,116,19,914,406,392,798,97
2023-03-24,EP,Poland,1635,606,141,25,1029,439,449,888,116
2023-03-25,EP,Poland,1494,651,75,12,843,385,383,768,63
2023-03-26,EP,Poland,1698,694,105,11,1004,458,441,899,94
2023-03-27,EP,Poland,1522,560,130,17,962,416,416,832,113
2023-03-28,EP,Poland,1667,685,119,9,982,423,440,863,110
2023-03-29,EP,Poland,1690,650,155,32,1040,447,438,885,123
2023-03-30,EP,Poland,1778,667,155,33,1111,475,481,956,122
2023-03-31,EP,Poland,1806,694,144,29,1112,490,478,968,115
2023-04-01,EP,Poland,1733,735,94,7,998,451,453,904,87
2023-04-02,EP,Poland,1744,754,99,6,990,445,446,891,93
2023-04-03,EP,Poland,1774,693,146,25,1081,466,469,935,121
2023-04-04,EP,Poland,1710,686,142,31,1024,439,443,882,111
2023-04-05,EP,Poland,1748,695,132,26,1053,467,454,921,106
2023-04-06,EP,Poland,1800,721,128,15,1079,470,481,951,113
2023-04-07,EP,Poland,1774,747,105,4,1027,460,462,922,101
2023-04-08,EP,Poland,1738,791,75,4,947,436,436,872,71
2023-04-09,EP,Poland,1735,782,86,1,953,437,430,867,85
2023-04-10,EP,Poland,1727,721,98,3,1006,452,456,908,95
2023-04-11,EP,Poland,1742,725,130,17,1017,434,453,887,113
2023-04-12,EP,Poland,1813,756,142,35,1057,459,456,915,107
2023-04-13,EP,Poland,1834,751,144,33,1083,471,468,939,111
2023-04-14,EP,Poland,1878,765,144,29,1113,489,480,969,115
2023-04-15,EP,Poland,1827,827,93,13,1000,452,455,907,80
2023-04-16,EP,Poland,1810,788,109,17,1022,455,458,913,92
2023-04-17,EP,Poland,1812,717,141,21,1095,467,487,954,120
2023-04-18,EP,Poland,1755,679,175,35,1076,450,451,901,140
2023-04-19,EP,Poland,1763,665,146,31,1098,484,468,952,115
2023-04-20,EP,Poland,1880,771,141,31,1109,490,478,968,110
2023-04-21,EP,Poland,1889,774,154,30,1115,477,484,961,124
2023-04-22,EP,Poland,1791,818,102,17,973,436,435,871,85
2023-04-23,EP,Poland,1879,843,112,14,1036,464,460,924,98
2023-04-24,EP,Poland,1797,735,134,21,1062,460,468,928,113
2023-04-25,EP,Poland,1804,764,147,17,1040,440,453,893,130
2023-04-26,EP,Poland,1847,694,153,33,1153,499,501,1000,120
2023-04-27,EP,Poland,1981,783,156,26,1198,525,517,1042,130
2023-04-28,EP,Poland,2042,831,152,32,1211,531,528,1059,120
2023-04-29,EP,Poland,1983,862,103,19,1121,512,506,1018,84
2023-04-30,EP,Poland,2025,876,117,17,1149,528,504,1032,100
2023-05-01,EP,Poland,1821,787,104,16,1034,466,464,930,88
2023-05-02,EP,Poland,1786,770,121,14,1016,438,457,895,107
2023-05-03,EP,Poland,1780,727,93,6,1053,479,481,960,87
2023-05-04,EP,Poland,1982,784,146,23,1198,530,522,1052,123
2023-05-05,EP,Poland,1958,806,123,21,1152,517,512,1029,102
2023-05-06,EP,Poland,2029,915,104,13,1114,504,506,1010,91
2023-05-07,EP,Poland,2157,947,109,11,1210,542,559,1101,98
2023-05-08,EP,Poland,1967,806,143,27,1161,503,515,1018,116
2023-05-09,EP,Poland,1932,836,167,29,1096,461,468,929,138
2023-05-10,EP,Poland,1935,804,141,23,1131,501,489,990,118
2023-05-11,EP,Poland,2076,852,160,25,1224,535,529,1064,135
2023-05-12,EP,Poland,2074,888,141,22,1186,526,519,1045,119
2023-05-13,EP,Poland,2072,1004,95,14,1068,486,487,973,81
2023-05-14,EP,Poland,2105,956,104,12,1149,527,518,1045,92
2023-05-15,EP,Poland,1962,834,132,22,1128,490,506,996,110
2023-05-16,EP,Poland,1935,835,157,37,1100,474,469,943,120
2023-05-17,EP,Poland,1926,806,124,24,1120,500,496,996,100
2023-05-18,EP,Poland,2100,909,150,36,1191,523,518,1041,114
2023-05-19,EP,Poland,2136,936,153,21,1200,526,521,1047,132
2023-05-20,EP,Poland,2176,1064,126,26,1112,490,496,986,100
2023-05-21,EP,Poland,2257,1058,120,18,1199,535,544,1079,102
2023-05-22,EP,Poland,2055,885,145,30,1170,516,509,1025,115
2023-05-23,EP,Poland,1940,860,140,20,1080,465,475,940,120
2023-05-24,EP,Poland,1982,825,149,32,1157,507,501,1008,117
2023-05-25,EP,Poland,2127,900,143,38,1227,543,541,1084,105
2023-05-26,EP,Poland,2176,960,135,26,1216,543,538,1081,109
2023-05-27,EP,Poland,2120,1023,105,20,1097,495,497,992,85
2023-05-28,EP,Poland,2202,1024,110,14,1178,533,535,1068,96
2023-05-29,EP,Poland,2092,909,144,28,1183,519,520,1039,116
2023-05-30,EP,Poland,2020,855,143,32,1165,506,516,1022,111
2023-05-31,EP,Poland,2060,864,145,30,1196,533,518,1051,115
2023-06-01,EP,Poland,2227,930,143,26,1297,580,574,1154,117
2023-06-02,EP,Poland,2245,931,150,30,1314,585,579,1164,120
2023-06-03,EP,Poland,2256,1066,101,16,1190,544,545,1089,85
2023-06-04,EP,Poland,2256,1009,113,14,1247,560,574,1134,99
2023-06-05,EP,Poland,2145,916,138,20,1229,544,547,1091,118
2023-06-06,EP,Poland,2091,859,138,27,1232,547,547,1094,111
2023-06-07,EP,Poland,2131,846,139,31,1285,573,573,1146,108
2023-06-08,EP,Poland,2133,891,112,14,1242,569,561,1130,98
2023-06-09,EP,Poland,2207,922,113,19,1285,585,587,1172,94
2023-06-10,EP,Poland,2238,1069,90,12,1169,542,537,1079,78
2023-06-11,EP,Poland,2345,1023,118,16,1322,591,613,1204,102
2023-06-12,EP,Poland,2222,938,139,17,1284,570,575,1145,122
2023-06-13,EP,Poland,2187,909,146,22,1278,556,576,1132,124
2023-06-14,EP,Poland,2267,931,134,12,1336,607,595,1202,122
2023-06-15,EP,Poland,2343,933,157,13,1410,623,630,1253,144
2023-06-16,EP,Poland,2406,1017,153,20,1389,627,609,1236,133
2023-06-17,EP,Poland,2321,1109,93,11,1212,563,556,1119,82
2023-06-18,EP,Poland,2392,1103,97,8,1289,592,600,1192,89
2023-06-19,EP,Poland,2306,997,133,18,1309,588,588,1176,115
2023-06-20,EP,Poland,2220,900,145,26,1320,587,588,1175,119
2023-06-21,EP,Poland,2337,995,138,28,1342,599,605,1204,110
2023-06-22,EP,Poland,2410,1026,158,23,1384,615,611,1226,135
2023-06-23,EP,Poland,2405,1029,132,15,1376,627,617,1244,117
2023-06-24,EP,Poland,2316,1106,92,9,1210,559,559,1118,83
2023-06-25,EP,Poland,2394,1080,109,19,1314,603,602,1205,90
2023-06-26,EP,Poland,2310,1038,132,19,1272,569,571,1140,113
2023-06-27,EP,Poland,2260,984,128,21,1276,564,584,1148,107
2023-06-28,EP,Poland,2267,932,137,21,1335,603,595,1198,116
2023-06-29,EP,Poland,2330,948,139,27,1382,631,612,1243,112
2023-06-30,EP,Poland,2410,1035,142,18,1375,612,621,1233,124
2023-07-01,EP,Poland,2368,1133,93,13,1235,579,563,1142,80
2023-07-02,EP,Poland,2442,1117,106,13,1325,605,614,1219,93
2023-07-03,EP,Poland,2317,1042,127,31,1275,571,577,1148,96
2023-07-04,EP,Poland,2290,999,144,24,1291,570,577,1147,120
2023-07-05,EP,Poland,2368,1023,132,22,1345,609,604,1213,110
2023-07-06,EP,Poland,2409,1024,144,35,1385,620,621,1241,109
2023-07-07,EP,Poland,2453,1077,146,25,1376,619,611,1230,121
2023-07-08,EP,Poland,2443,1208,98,11,1235,573,564,1137,87
2023-07-09,EP,Poland,2452,1127,103,4,1325,611,611,1222,99
2023-07-10,EP,Poland,2393,1102,133,28,1291,578,580,1158,105
2023-07-11,EP,Poland,2276,999,143,36,1277,568,566,1134,107
2023-07-12,EP,Poland,2324,1009,133,28,1315,594,588,1182,105
2023-07-13,EP,Poland,2345,990,119,16,1355,615,621,1236,103
2023-07-14,EP,Poland,2473,1073,138,22,1400,636,626,1262,116
2023-07-15,EP,Poland,2373,1144,95,6,1229,568,566,1134,89
2023-07-16,EP,Poland,2430,1125,101,11,1305,600,604,1204,90
2023-07-17,EP,Poland,2312,1043,124,20,1269,570,575,1145,104
2023-07-18,EP,Poland,2287,992,143,30,1295,569,583,1152,113
2023-07-19,EP,Poland,2369,1004,150,30,1365,608,607,1215,120
2023-07-20,EP,Poland,2383,1014,130,27,1369,622,617,1239,103
2023-07-21,EP,Poland,2427,1055,154,34,1372,610,608,1218,120
2023-07-22,EP,Poland,2352,1118,104,20,1234,566,564,1130,84
2023-07-23,EP,Poland,2460,1136,108,17,1324,612,604,1216,91
2023-07-24,EP,Poland,2344,1070,136,20,1274,564,574,1138,116
2023-07-25,EP,Poland,2320,1023,145,30,1297,576,576,1152,115
2023-07-26,EP,Poland,2389,1042,142,23,1347,602,603,1205,119
2023-07-27,EP,Poland,2449,1081,137,32,1368,610,621,1231,105
2023-07-28,EP,Poland,2435,1088,124,19,1347,614,609,1223,105
2023-07-29,EP,Poland,2377,1167,92,15,1210,560,558,1118,77
2023-07-30,EP,Poland,2466,1130,102,15,1336,615,619,1234,87
2023-07-31,EP,Poland,2320,1067,120,21,1253,570,563,1133,99
2023-08-01,EP,Poland,2310,1054,139,22,1256,556,561,1117,117
2023-08-02,EP,Poland,2320,1019,128,27,1301,585,588,1173,101
2023-08-03,EP,Poland,2365,1008,120,19,1357,615,622,1237,101
2023-08-04,EP,Poland,2435,1087,140,16,1348,608,600,1208,124
2023-08-05,EP,Poland,2353,1152,82,8,1201,558,561,1119,74
2023-08-06,EP,Poland,2503,1204,102,3,1299,599,598,1197,99
2023-08-07,EP,Poland,2395,1117,135,16,1278,572,571,1143,119
2023-08-08,EP,Poland,2305,1058,118,12,1247,562,567,1129,106
2023-08-09,EP,Poland,2287,964,142,23,1323,589,592,1181,119
2023-08-10,EP,Poland,2370,985,139,31,1385,628,618,1246,108
2023-08-11,EP,Poland,2398,1049,125,26,1349,609,615,1224,99
2023-08-12,EP,Poland,2367,1166,85,10,1201,559,557,1116,75
2023-08-13,EP,Poland,2437,1136,98,8,1301,597,606,1203,90
2023-08-14,EP,Poland,2268,1003,115,10,1265,580,570,1150,105
2023-08-15,EP,Poland,2167,962,102,8,1205,553,550,1103,94
2023-08-16,EP,Poland,2290,963,134,21,1327,594,599,1193,113
2023-08-17,EP,Poland,2304,951,129,26,1353,609,615,1224,103
2023-08-18,EP,Poland,2390,1044,141,19,1346,612,593,1205,122
2023-08-19,EP,Poland,2284,1078,105,22,1206,549,552,1101,83
2023-08-20,EP,Poland,2436,1126,99,11,1310,604,607,1211,88
2023-08-21,EP,Poland,2244,971,109,21,1273,579,585,1164,88
2023-08-22,EP,Poland,2200,913,147,26,1287,569,571,1140,121
2023-08-23,EP,Poland,2230,886,135,29,1344,604,605,1209,106
2023-08-24,EP,Poland,2352,958,140,25,1394,628,626,1254,115
2023-08-25,EP,Poland,2375,1013,146,25,1362,607,609,1216,121
2023-08-26,EP,Poland,2366,1162,89,14,1204,555,560,1115,75
2023-08-27,EP,Poland,2405,1076,116,10,1329,609,604,1213,106
2023-08-28,EP,Poland,2263,995,138,22,1268,568,562,1130,116
2023-08-29,EP,Poland,2187,905,136,21,1282,567,579,1146,115
2023-08-30,EP,Poland,2261,901,134,25,1360,616,610,1226,109
2023-08-31,EP,Poland,2360,953,155,24,1407,630,622,1252,131
2023-09-01,EP,Poland,2373,1006,151,30,1367,614,602,1216,121
2023-09-02,EP,Poland,2329,1107,99,14,1222,554,569,1123,85
2023-09-03,EP,Poland,2374,1033,112,12,1341,613,616,1229,100
2023-09-04,EP,Poland,2235,914,134,21,1321,594,593,1187,113
2023-09-05,EP,Poland,2186,881,138,18,1305,580,587,1167,120
2023-09-06,EP,Poland,2294,908,142,18,1386,627,617,1244,124
2023-09-07,EP,Poland,2342,921,148,23,1421,631,642,1273,125
2023-09-08,EP,Poland,2365,964,146,27,1401,635,620,1255,119
2023-09-09,EP,Poland,2312,1078,103,12,1234,567,564,1131,91
2023-09-10,EP,Poland,2382,1052,103,5,1330,604,623,1227,98
2023-09-11,EP,Poland,2240,924,145,25,1316,587,584,1171,120
2023-09-12,EP,Poland,2150,869,130,18,1281,576,575,1151,112
2023-09-13,EP,Poland,2208,871,127,14,1337,602,608,1210,113
2023-09-14,EP,Poland,2330,908,149,21,1422,633,640,1273,128
2023-09-15,EP,Poland,2397,1000,153,22,1397,626,618,1244,131
2023-09-16,EP,Poland,2284,1047,99,13,1237,568,570,1138,86
2023-09-17,EP,Poland,2434,1074,131,17,1360,617,612,1229,114
2023-09-18,EP,Poland,2314,974,136,17,1340,604,600,1204,119
2023-09-19,EP,Poland,2152,869,131,13,1283,573,579,1152,118
2023-09-20,EP,Poland,2284,922,138,15,1362,616,608,1224,123
2023-09-21,EP,Poland,2348,936,143,19,1412,630,639,1269,124
2023-09-22,EP,Poland,2372,1004,146,27,1368,620,602,1222,119
2023-09-23,EP,Poland,2289,1046,99,11,1243,570,574,1144,88
2023-09-24,EP,Poland,2370,1049,107,9,1321,607,607,1214,98
2023-09-25,EP,Poland,2274,937,143,26,1337,592,602,1194,117
2023-09-26,EP,Poland,2070,813,158,25,1257,550,549,1099,133
2023-09-27,EP,Poland,2263,891,144,25,1372,611,617,1228,119
2023-09-28,EP,Poland,2339,931,156,14,1408,627,625,1252,142
2023-09-29,EP,Poland,2352,1024,144,18,1328,599,585,1184,126
2023-09-30,EP,Poland,2325,1086,109,10,1239,565,565,1130,99
2023-10-01,EP,Poland,2363,1050,106,10,1313,592,615,1207,96
2023-10-02,EP,Poland,2169,893,112,12,1276,584,580,1164,100
2023-01-01,LP,Portugal,1856,857,160,0,999,423,416,839,160
2023-01-02,LP,Portugal,2123,955,204,1,1168,485,479,964,203
2023-01-03,LP,Portugal,2037,1023,179,3,1014,414,421,835,176
2023-01-04,LP,Portugal,1956,992,151,2,964,414,399,813,149
2023-01-05,LP,Portugal,1991,1006,154,1,985,414,417,831,153
2023-01-06,LP,Portugal,1992,923,163,1,1069,455,451,906,162
2023-01-07,LP,Portugal,2249,1170,145,0,1079,470,464,934,145
2023-01-08,LP,Portugal,1987,954,145,0,1033,441,447,888,145
2023-01-09,LP,Portugal,1894,861,150,0,1033,440,443,883,150
2023-01-10,LP,Portugal,1653,817,140,0,836,345,351,696,140
2023-01-11,LP,Portugal,1530,755,142,2,775,323,310,633,140
2023-01-12,LP,Portugal,1633,802,137,0,831,349,345,694,137
2023-01-13,LP,Portugal,1825,836,144,0,989,427,418,845,144
2023-01-14,LP,Portugal,1963,1054,132,4,909,386,391,777,128
2023-01-15,LP,Portugal,2014,1061,149,1,953,401,403,804,148
2023-01-16,LP,Portugal,1804,860,150,1,944,391,403,794,149
2023-01-17,LP,Portugal,1555,806,128,0,749,311,310,621,128
2023-01-18,LP,Portugal,1531,789,134,0,742,309,299,608,134
2023-01-19,LP,Portugal,1581,788,129,1,793,333,331,664,128
2023-01-20,LP,Portugal,1855,875,153,1,980,413,414,827,152
2023-01-21,LP,Portugal,2036,1115,137,3,921,389,395,784,134
2023-01-22,LP,Portugal,1882,950,143,2,932,396,393,789,141
2023-01-23,LP,Portugal,1742,802,148,0,940,394,398,792,148
2023-01-24,LP,Portugal,1532,803,123,0,729,297,309,606,123
2023-01-25,LP,Portugal,1504,764,138,2,740,309,293,602,136
2023-01-26,LP,Portugal,1723,890,139,3,833,342,352,694,136
2023-01-27,LP,Portugal,1879,905,149,1,974,417,408,825,148
2023-01-28,LP,Portugal,2068,1173,132,2,895,379,384,763,130
2023-01-29,LP,Portugal,1972,1021,140,2,951,407,404,811,138
2023-01-30,LP,Portugal,1836,882,149,0,954,397,408,805,149
2023-01-31,LP,Portugal,1587,819,141,2,768,311,316,627,139
2023-02-01,LP,Portugal,1554,777,130,1,777,331,316,647,129
2023-02-02,LP,Portugal,1684,852,135,3,832,351,346,697,132
2023-02-03,LP,Portugal,1882,877,151,1,1005,426,428,854,150
2023-02-04,LP,Portugal,2019,1094,130,4,925,399,396,795,126
2023-02-05,LP,Portugal,1869,916,133,1,953,405,415,820,132
2023-02-06,LP,Portugal,1845,839,154,2,1006,423,429,852,152
2023-02-07,LP,Portugal,1621,850,135,0,771,319,317,636,135
2023-02-08,LP,Portugal,1675,859,144,2,816,346,326,672,142
2023-02-09,LP,Portugal,1731,849,142,0,882,370,370,740,142
2023-02-10,LP,Portugal,2000,952,161,1,1048,441,446,887,160
2023-02-11,LP,Portugal,2213,1215,139,1,998,429,430,859,138
2023-02-12,LP,Portugal,2074,1055,138,1,1019,441,440,881,137
2023-02-13,LP,Portugal,1926,877,163,6,1049,434,452,886,157
2023-02-14,LP,Portugal,1772,882,131,3,890,384,375,759,128
2023-02-15,LP,Portugal,1733,816,147,4,917,385,385,770,143
2023-02-16,LP,Portugal,1796,863,148,4,933,389,396,785,144
2023-02-17,LP,Portugal,2047,978,168,7,1069,455,446,901,161
2023-02-18,LP,Portugal,2325,1242,142,3,1083,473,468,941,139
2023-02-19,LP,Portugal,2150,1087,141,2,1063,460,462,922,139
2023-02-20,LP,Portugal,1950,878,148,0,1072,458,466,924,148
2023-02-21,LP,Portugal,1834,924,146,0,910,382,382,764,146
2023-02-22,LP,Portugal,1748,800,152,0,948,400,396,796,152
2023-02-23,LP,Portugal,1958,977,150,1,981,417,414,831,149
2023-02-24,LP,Portugal,2107,1023,157,2,1084,465,462,927,155
2023-02-25,LP,Portugal,2332,1261,140,1,1071,468,463,931,139
2023-02-26,LP,Portugal,2200,1125,155,1,1075,458,462,920,154
2023-02-27,LP,Portugal,1992,921,164,0,1071,450,457,907,164
2023-02-28,LP,Portugal,1834,939,135,1,895,381,379,760,134
2023-03-01,LP,Portugal,1819,894,140,0,925,395,390,785,140
2023-03-02,LP,Portugal,1953,980,143,0,973,415,415,830,143
2023-03-03,LP,Portugal,2076,989,156,1,1087,468,463,931,155
2023-03-04,LP,Portugal,2298,1254,135,1,1044,458,451,909,134
2023-03-05,LP,Portugal,2117,1075,148,0,1042,444,450,894,148
2023-03-06,LP,Portugal,1945,870,144,0,1075,457,474,931,144
2023-03-07,LP,Portugal,1767,901,146,0,866,359,361,720,146
2023-03-08,LP,Portugal,1651,742,139,1,909,391,379,770,138
2023-03-09,LP,Portugal,1789,858,126,1,931,408,397,805,125
2023-03-10,LP,Portugal,1937,870,154,2,1067,454,459,913,152
2023-03-11,LP,Portugal,2185,1157,135,4,1028,446,447,893,131
2023-03-12,LP,Portugal,1993,940,147,2,1053,452,454,906,145
2023-03-13,LP,Portugal,1961,856,167,0,1105,459,479,938,167
2023-03-14,LP,Portugal,1788,871,145,3,917,383,389,772,142
2023-03-15,LP,Portugal,1732,817,145,1,915,395,375,770,144
2023-03-16,LP,Portugal,1805,843,148,2,962,403,411,814,146
2023-03-17,LP,Portugal,2024,927,162,1,1097,468,467,935,161
2023-03-18,LP,Portugal,2272,1195,140,1,1077,465,472,937,139
2023-03-19,LP,Portugal,2015,921,152,3,1094,476,466,942,149
2023-03-20,LP,Portugal,1881,801,166,2,1080,450,464,914,164
2023-03-21,LP,Portugal,1840,931,145,0,909,385,379,764,145
2023-03-22,LP,Portugal,1784,856,146,0,928,399,383,782,146
2023-03-23,LP,Portugal,1799,823,146,1,976,409,421,830,145
2023-03-24,LP,Portugal,2006,915,162,2,1091,461,468,929,160
2023-03-25,LP,Portugal,2216,1125,141,0,1091,475,475,950,141
2023-03-26,LP,Portugal,2127,946,162,1,1181,513,506,1019,161
2023-03-27,LP,Portugal,1917,780,168,0,1137,479,490,969,168
2023-03-28,LP,Portugal,1945,858,157,2,1087,460,470,930,155
2023-03-29,LP,Portugal,1963,849,164,2,1114,484,466,950,162
2023-03-30,LP,Portugal,2071,919,180,4,1152,486,486,972,176
2023-03-31,LP,Portugal,2074,879,178,1,1195,508,509,1017,177
2023-04-01,LP,Portugal,2324,1124,162,0,1200,522,516,1038,162
2023-04-02,LP,Portugal,2123,952,163,0,1171,502,506,1008,163
2023-04-03,LP,Portugal,1980,822,169,3,1158,486,503,989,166
2023-04-04,LP,Portugal,2027,877,186,4,1150,483,481,964,182
2023-04-05,LP,Portugal,2006,826,179,9,1180,508,493,1001,170
2023-04-06,LP,Portugal,2104,886,197,1,1218,510,511,1021,196
2023-04-07,LP,Portugal,2107,875,164,1,1232,534,534,1068,163
2023-04-08,LP,Portugal,2276,1034,159,0,1242,535,548,1083,159
2023-04-09,LP,Portugal,2226,977,175,0,1249,539,535,1074,175
2023-04-10,LP,Portugal,2104,846,180,0,1258,536,542,1078,180
2023-04-11,LP,Portugal,2019,845,179,1,1174,494,501,995,178
2023-04-12,LP,Portugal,2005,820,170,0,1185,519,496,1015,170
2023-04-13,LP,Portugal,2061,857,179,2,1204,512,513,1025,177
2023-04-14,LP,Portugal,2111,848,181,1,1263,539,543,1082,180
2023-04-15,LP,Portugal,2349,1042,167,0,1307,571,569,1140,167
2023-04-16,LP,Portugal,2288,981,182,0,1307,561,564,1125,182
2023-04-17,LP,Portugal,2106,832,180,1,1274,537,557,1094,179
2023-04-18,LP,Portugal,2062,879,185,1,1183,504,494,998,184
2023-04-19,LP,Portugal,2051,823,176,1,1228,531,521,1052,175
2023-04-20,LP,Portugal,2080,864,181,1,1216,517,518,1035,180
2023-04-21,LP,Portugal,2103,856,183,0,1247,533,531,1064,183
2023-04-22,LP,Portugal,2278,996,173,0,1282,552,557,1109,173
2023-04-23,LP,Portugal,2169,899,173,1,1270,548,549,1097,172
2023-04-24,LP,Portugal,2051,779,184,0,1272,541,547,1088,184
2023-04-25,LP,Portugal,1988,824,180,1,1164,491,493,984,179
2023-04-26,LP,Portugal,2008,814,173,1,1194,508,513,1021,172
2023-04-27,LP,Portugal,2086,839,191,2,1247,531,525,1056,189
2023-04-28,LP,Portugal,2015,758,186,0,1257,539,532,1071,186
2023-04-29,LP,Portugal,2183,920,162,0,1263,543,558,1101,162
2023-04-30,LP,Portugal,2164,877,177,0,1287,558,552,1110,177
2023-05-01,LP,Portugal,1891,700,177,0,1191,504,510,1014,177
2023-05-02,LP,Portugal,1933,759,182,0,1174,502,490,992,182
2023-05-03,LP,Portugal,1958,740,184,1,1218,516,518,1034,183
2023-05-04,LP,Portugal,2110,871,183,3,1239,523,533,1056,180
2023-05-05,LP,Portugal,2075,803,185,1,1272,546,541,1087,184
2023-05-06,LP,Portugal,2178,878,170,0,1300,562,568,1130,170
2023-05-07,LP,Portugal,2211,885,177,2,1326,582,567,1149,175
2023-05-08,LP,Portugal,1981,706,166,6,1275,551,558,1109,160
2023-05-09,LP,Portugal,1874,736,164,10,1138,486,488,974,154
2023-05-10,LP,Portugal,1970,740,173,3,1230,533,524,1057,170
2023-05-11,LP,Portugal,2028,763,195,3,1265,530,540,1070,192
2023-05-12,LP,Portugal,2108,817,202,3,1291,552,537,1089,199
2023-05-13,LP,Portugal,2179,874,175,3,1305,565,565,1130,172
2023-05-14,LP,Portugal,2101,787,190,3,1314,565,559,1124,187
2023-05-15,LP,Portugal,2052,743,196,2,1309,554,559,1113,194
2023-05-16,LP,Portugal,1972,776,190,4,1196,498,508,1006,186
2023-05-17,LP,Portugal,2069,818,184,1,1251,532,535,1067,183
2023-05-18,LP,Portugal,2158,825,199,1,1333,554,580,1134,198
2023-05-19,LP,Portugal,2044,773,191,0,1271,538,542,1080,191
2023-05-20,LP,Portugal,2108,767,181,2,1341,580,580,1160,179
2023-05-21,LP,Portugal,2105,743,180,0,1362,609,573,1182,180
2023-05-22,LP,Portugal,2086,771,185,1,1315,562,568,1130,184
2023-05-23,LP,Portugal,2000,793,186,2,1207,508,513,1021,184
2023-05-24,LP,Portugal,2025,787,185,2,1238,526,527,1053,183
2023-05-25,LP,Portugal,2092,808,187,0,1284,550,547,1097,187
2023-05-26,LP,Portugal,2028,771,182,0,1257,545,530,1075,182
2023-05-27,LP,Portugal,2235,896,174,0,1339,576,589,1165,174
2023-05-28,LP,Portugal,2072,832,169,0,1240,538,533,1071,169
2023-05-29,LP,Portugal,2074,728,180,0,1346,578,588,1166,180
2023-05-30,LP,Portugal,1904,766,175,0,1138,477,486,963,175
2023-05-31,LP,Portugal,2083,848,184,1,1235,533,518,1051,183
2023-06-01,LP,Portugal,2098,840,197,0,1258,525,536,1061,197
2023-06-02,LP,Portugal,2155,803,211,1,1352,577,564,1141,210
2023-06-03,LP,Portugal,2149,835,197,1,1314,556,561,1117,196
2023-06-04,LP,Portugal,2216,839,196,1,1377,597,584,1181,195
2023-06-05,LP,Portugal,2103,758,191,8,1345,572,582,1154,183
2023-06-06,LP,Portugal,1879,748,143,11,1131,490,498,988,132
2023-06-07,LP,Portugal,2130,769,231,1,1361,562,568,1130,230
2023-06-08,LP,Portugal,2190,823,209,2,1367,585,573,1158,207
2023-06-09,LP,Portugal,2159,794,219,0,1365,571,575,1146,219
2023-06-10,LP,Portugal,2251,864,200,0,1387,590,597,1187,200
2023-06-11,LP,Portugal,2268,859,210,0,1409,599,600,1199,210
2023-06-12,LP,Portugal,2199,808,211,1,1391,586,594,1180,210
2023-06-13,LP,Portugal,2194,887,192,0,1307,558,557,1115,192
2023-06-14,LP,Portugal,2143,821,208,2,1322,561,553,1114,206
2023-06-15,LP,Portugal,2179,824,213,2,1355,572,570,1142,211
2023-06-16,LP,Portugal,2208,807,221,2,1401,591,589,1180,219
2023-06-17,LP,Portugal,2315,912,202,0,1403,599,602,1201,202
2023-06-18,LP,Portugal,2196,826,204,0,1370,584,582,1166,204
2023-06-19,LP,Portugal,2237,794,212,0,1443,613,618,1231,212
2023-06-20,LP,Portugal,2063,795,208,3,1268,529,531,1060,205
2023-06-21,LP,Portugal,2274,909,215,2,1365,579,571,1150,213
2023-06-22,LP,Portugal,2233,840,226,1,1393,588,579,1167,225
2023-06-23,LP,Portugal,2150,803,197,0,1347,577,573,1150,197
2023-06-24,LP,Portugal,2346,933,217,3,1413,596,600,1196,214
2023-06-25,LP,Portugal,2353,974,183,7,1379,593,603,1196,176
2023-06-26,LP,Portugal,2285,828,216,3,1457,612,629,1241,213
2023-06-27,LP,Portugal,2123,793,208,4,1330,559,563,1122,204
2023-06-28,LP,Portugal,2198,828,205,1,1370,589,576,1165,204
2023-06-29,LP,Portugal,2237,847,213,0,1390,588,589,1177,213
2023-06-30,LP,Portugal,2273,844,217,1,1429,608,604,1212,216
2023-07-01,LP,Portugal,2385,972,197,2,1413,606,610,1216,195
2023-07-02,LP,Portugal,2355,898,213,3,1457,627,617,1244,210
2023-07-03,LP,Portugal,2283,779,210,2,1504,643,651,1294,208
2023-07-04,LP,Portugal,2144,793,204,0,1351,580,567,1147,204
2023-07-05,LP,Portugal,2193,814,208,1,1379,586,585,1171,207
2023-07-06,LP,Portugal,2296,884,213,0,1412,601,598,1199,213
2023-07-07,LP,Portugal,2252,832,219,3,1420,600,601,1201,216
2023-07-08,LP,Portugal,2345,893,219,0,1452,616,617,1233,219
2023-07-09,LP,Portugal,2332,886,207,0,1446,622,617,1239,207
2023-07-10,LP,Portugal,2390,894,213,0,1496,633,650,1283,213
2023-07-11,LP,Portugal,2198,819,207,2,1379,589,583,1172,205
2023-07-12,LP,Portugal,2216,807,207,0,1409,604,598,1202,207
2023-07-13,LP,Portugal,2299,838,210,0,1461,623,628,1251,210
2023-07-14,LP,Portugal,2292,860,221,0,1432,610,601,1211,221
2023-07-15,LP,Portugal,2426,983,225,1,1443,610,608,1218,224
2023-07-16,LP,Portugal,2337,887,206,0,1450,627,617,1244,206
2023-07-17,LP,Portugal,2295,797,220,0,1498,633,645,1278,220
2023-07-18,LP,Portugal,2220,813,213,0,1407,598,596,1194,213
2023-07-19,LP,Portugal,2277,868,200,0,1409,608,601,1209,200
2023-07-20,LP,Portugal,2459,1003,218,0,1456,618,620,1238,218
2023-07-21,LP,Portugal,2389,1034,216,2,1355,571,568,1139,214
2023-07-22,LP,Portugal,2495,1073,216,1,1422,600,606,1206,215
2023-07-23,LP,Portugal,2248,884,205,0,1364,585,574,1159,205
2023-07-24,LP,Portugal,2356,953,210,0,1403,593,600,1193,210
2023-07-25,LP,Portugal,2318,981,214,2,1337,560,563,1123,212
2023-07-26,LP,Portugal,2229,821,204,1,1408,606,598,1204,203
2023-07-27,LP,Portugal,2346,926,209,0,1420,602,609,1211,209
2023-07-28,LP,Portugal,2284,835,221,1,1449,615,613,1228,220
2023-07-29,LP,Portugal,2409,963,211,0,1446,612,623,1235,211
2023-07-30,LP,Portugal,2361,900,204,0,1461,633,624,1257,204
2023-07-31,LP,Portugal,2345,863,213,1,1482,630,639,1269,212
2023-08-01,LP,Portugal,2263,879,212,1,1384,588,584,1172,211
2023-08-02,LP,Portugal,2312,887,222,1,1425,599,604,1203,221
2023-08-03,LP,Portugal,2419,979,215,1,1440,612,613,1225,214
2023-08-04,LP,Portugal,2354,916,216,2,1438,620,602,1222,214
2023-08-05,LP,Portugal,2403,938,221,4,1465,619,625,1244,217
2023-08-06,LP,Portugal,2415,968,215,2,1447,615,617,1232,213
2023-08-07,LP,Portugal,2314,820,214,1,1494,636,644,1280,213
2023-08-08,LP,Portugal,2148,774,210,4,1374,582,582,1164,206
2023-08-09,LP,Portugal,2256,833,221,3,1423,605,597,1202,218
2023-08-10,LP,Portugal,2311,859,220,2,1452,618,614,1232,218
2023-08-11,LP,Portugal,2234,787,229,1,1447,611,607,1218,228
2023-08-12,LP,Portugal,2431,953,225,1,1478,624,629,1253,224
2023-08-13,LP,Portugal,2435,963,223,1,1472,624,625,1249,222
2023-08-14,LP,Portugal,2315,836,224,2,1479,627,628,1255,222
2023-08-15,LP,Portugal,2141,806,185,0,1335,573,577,1150,185
2023-08-16,LP,Portugal,2282,862,221,1,1420,606,593,1199,220
2023-08-17,LP,Portugal,2297,892,205,1,1405,604,596,1200,204
2023-08-18,LP,Portugal,2271,819,232,3,1452,606,614,1220,229
2023-08-19,LP,Portugal,2352,881,229,1,1471,619,623,1242,228
2023-08-20,LP,Portugal,2295,845,208,0,1450,629,613,1242,208
2023-08-21,LP,Portugal,2297,830,219,0,1467,619,629,1248,219
2023-08-22,LP,Portugal,2204,830,213,0,1374,580,581,1161,213
2023-08-23,LP,Portugal,2255,850,210,4,1405,605,590,1195,206
2023-08-24,LP,Portugal,2321,897,213,1,1424,611,600,1211,212
2023-08-25,LP,Portugal,2211,803,225,3,1408,588,595,1183,222
2023-08-26,LP,Portugal,2511,1055,211,2,1456,618,627,1245,209
2023-08-27,LP,Portugal,2427,982,214,1,1445,617,614,1231,213
2023-08-28,LP,Portugal,2241,841,213,0,1400,586,601,1187,213
2023-08-29,LP,Portugal,2472,1069,221,8,1403,589,593,1182,213
2023-08-30,LP,Portugal,2400,983,203,1,1417,616,598,1214,202
2023-08-31,LP,Portugal,2344,903,218,1,1441,612,611,1223,217
2023-09-01,LP,Portugal,2356,903,227,0,1453,610,616,1226,227
2023-09-02,LP,Portugal,2408,951,222,1,1457,616,619,1235,221
2023-09-03,LP,Portugal,2257,807,207,1,1450,622,621,1243,206
2023-09-04,LP,Portugal,2218,787,202,1,1431,606,623,1229,201
2023-09-05,LP,Portugal,2186,816,205,1,1370,585,580,1165,204
2023-09-06,LP,Portugal,2187,793,217,1,1394,590,587,1177,216
2023-09-07,LP,Portugal,2218,809,216,2,1409,596,597,1193,214
2023-09-08,LP,Portugal,2144,750,216,2,1394,589,589,1178,214
2023-09-09,LP,Portugal,2298,849,212,0,1449,616,621,1237,212
2023-09-10,LP,Portugal,2274,842,202,0,1432,613,617,1230,202
2023-09-11,LP,Portugal,2272,825,219,1,1447,611,617,1228,218
2023-09-12,LP,Portugal,2224,864,202,3,1360,580,578,1158,199
2023-09-13,LP,Portugal,2225,846,199,1,1379,595,585,1180,198
2023-09-14,LP,Portugal,2211,827,204,1,1384,589,591,1180,203
2023-09-15,LP,Portugal,2198,812,217,0,1386,587,582,1169,217
2023-09-16,LP,Portugal,2545,1101,216,4,1444,616,612,1228,212
2023-09-17,LP,Portugal,2343,932,205,1,1411,599,607,1206,204
2023-09-18,LP,Portugal,2279,825,207,0,1454,625,622,1247,207
2023-09-19,LP,Portugal,2169,838,200,3,1331,565,566,1131,197
2023-09-20,LP,Portugal,2135,758,190,0,1377,598,589,1187,190
2023-09-21,LP,Portugal,2226,833,207,0,1393,594,592,1186,207
2023-09-22,LP,Portugal,2202,795,222,0,1407,592,593,1185,222
2023-09-23,LP,Portugal,2373,932,211,5,1441,614,616,1230,206
2023-09-24,LP,Portugal,2208,814,200,2,1394,603,591,1194,198
2023-09-25,LP,Portugal,2136,735,210,1,1401,592,599,1191,209
2023-09-26,LP,Portugal,2028,735,195,3,1293,551,547,1098,192
2023-09-27,LP,Portugal,2351,999,192,2,1352,580,580,1160,190
2023-09-28,LP,Portugal,2253,852,222,3,1401,589,590,1179,219
2023-09-29,LP,Portugal,2207,790,213,2,1417,600,604,1204,211
2023-09-30,LP,Portugal,2268,841,207,2,1427,614,606,1220,205
2023-10-01,LP,Portugal,2223,851,185,1,1372,597,590,1187,184
2023-10-02,LP,Portugal,2105,752,179,2,1353,583,591,1174,177
2023-01-01,LR,Romania,1508,1168,13,4,340,160,167,327,9
2023-01-02,LR,Romania,1571,1129,38,5,442,201,203,404,33
2023-01-03,LR,Romania,1624,1166,52,3,458,204,202,406,49
2023-01-04,LR,Romania,1646,1154,55,7,492,215,222,437,48
2023-01-05,LR,Romania,1673,1214,53,7,459,204,202,406,46
2023-01-06,LR,Romania,1735,1226,65,14,509,220,224,444,51
2023-01-07,LR,Romania,1751,1336,29,5,415,190,196,386,24
2023-01-08,LR,Romania,1760,1299,39,2,461,213,209,422,37
2023-01-09,LR,Romania,1623,1160,51,1,463,203,209,412,50
2023-01-10,LR,Romania,1554,1146,50,3,408,180,178,358,47
2023-01-11,LR,Romania,1607,1186,66,2,421,171,184,355,64
2023-01-12,LR,Romania,1619,1200,60,1,419,187,172,359,59
2023-01-13,LR,Romania,1674,1204,59,8,470,205,206,411,51
2023-01-14,LR,Romania,1664,1282,36,4,382,175,171,346,32
2023-01-15,LR,Romania,1688,1262,39,3,426,190,197,387,36
2023-01-16,LR,Romania,1586,1129,69,14,457,192,196,388,55
2023-01-17,LR,Romania,1601,1185,65,10,416,172,179,351,55
2023-01-18,LR,Romania,1579,1147,80,16,432,172,180,352,64
2023-01-19,LR,Romania,1592,1185,75,12,407,168,164,332,63
2023-01-20,LR,Romania,1666,1185,70,5,481,209,202,411,65
2023-01-21,LR,Romania,1630,1253,35,6,377,173,169,342,29
2023-01-22,LR,Romania,1633,1214,36,6,419,187,196,383,30
2023-01-23,LR,Romania,1576,1137,62,7,439,187,190,377,55
2023-01-24,LR,Romania,1418,1057,39,6,361,161,161,322,33
2023-01-25,LR,Romania,1453,1047,72,11,406,164,170,334,61
2023-01-26,LR,Romania,1597,1171,86,6,426,171,169,340,80
2023-01-27,LR,Romania,1619,1152,57,1,467,206,204,410,56
2023-01-28,LR,Romania,1602,1237,23,0,365,173,169,342,23
2023-01-29,LR,Romania,1610,1209,32,2,401,182,187,369,30
2023-01-30,LR,Romania,1531,1089,59,9,442,193,190,383,50
2023-01-31,LR,Romania,1452,1047,67,6,405,169,169,338,61
2023-02-01,LR,Romania,1488,1062,85,7,426,168,173,341,78
2023-02-02,LR,Romania,1521,1108,70,10,413,174,169,343,60
2023-02-03,LR,Romania,1597,1123,72,6,474,199,203,402,66
2023-02-04,LR,Romania,1564,1209,23,1,355,169,163,332,22
2023-02-05,LR,Romania,1575,1177,34,6,398,179,185,364,28
2023-02-06,LR,Romania,1433,1000,60,7,433,183,190,373,53
2023-02-07,LR,Romania,1398,985,77,16,413,173,163,336,61
2023-02-08,LR,Romania,1429,1011,73,10,418,169,176,345,63
2023-02-09,LR,Romania,1555,1126,94,16,429,170,165,335,78
2023-02-10,LR,Romania,1643,1163,81,10,480,196,203,399,71
2023-02-11,LR,Romania,1622,1238,35,4,384,177,172,349,31
2023-02-12,LR,Romania,1705,1293,39,4,412,188,185,373,35
2023-02-13,LR,Romania,1569,1130,64,9,439,185,190,375,55
2023-02-14,LR,Romania,1513,1092,63,14,421,179,179,358,49
2023-02-15,LR,Romania,1552,1112,79,9,440,178,183,361,70
2023-02-16,LR,Romania,1599,1140,82,13,459,193,184,377,69
2023-02-17,LR,Romania,1538,1075,66,8,463,196,201,397,58
2023-02-18,LR,Romania,1707,1326,33,9,381,177,171,348,24
2023-02-19,LR,Romania,1671,1241,39,7,430,194,197,391,32
2023-02-20,LR,Romania,1545,1089,71,16,456,189,196,385,55
2023-02-21,LR,Romania,1450,1044,64,13,406,174,168,342,51
2023-02-22,LR,Romania,1524,1092,97,21,432,165,170,335,76
2023-02-23,LR,Romania,1494,1069,87,15,425,174,164,338,72
2023-02-24,LR,Romania,1634,1161,73,14,473,199,201,400,59
2023-02-25,LR,Romania,1655,1281,27,4,374,175,172,347,23
2023-02-26,LR,Romania,1695,1279,33,3,416,189,194,383,30
2023-02-27,LR,Romania,1560,1088,70,13,472,200,202,402,57
2023-02-28,LR,Romania,1477,1068,65,9,409,177,167,344,56
2023-03-01,LR,Romania,1512,1090,80,10,422,167,175,342,70
2023-03-02,LR,Romania,1536,1097,93,24,439,173,173,346,69
2023-03-03,LR,Romania,1715,1242,68,14,473,201,204,405,54
2023-03-04,LR,Romania,1676,1298,34,8,378,179,165,344,26
2023-03-05,LR,Romania,1712,1300,37,7,412,185,190,375,30
2023-03-06,LR,Romania,1605,1169,57,11,436,189,190,379,46
2023-03-07,LR,Romania,1532,1123,80,10,409,165,164,329,70
2023-03-08,LR,Romania,1542,1122,84,13,420,166,170,336,71
2023-03-09,LR,Romania,1676,1218,88,14,458,186,184,370,74
2023-03-10,LR,Romania,1696,1210,78,12,486,204,204,408,66
2023-03-11,LR,Romania,1684,1315,32,3,369,173,164,337,29
2023-03-12,LR,Romania,1744,1323,39,6,421,185,197,382,33
2023-03-13,LR,Romania,1567,1129,66,13,438,185,187,372,53
2023-03-14,LR,Romania,1621,1201,82,13,420,169,169,338,69
2023-03-15,LR,Romania,1552,1119,76,11,433,179,178,357,65
2023-03-16,LR,Romania,1635,1197,80,8,438,180,178,358,72
2023-03-17,LR,Romania,1686,1196,83,11,490,201,206,407,72
2023-03-18,LR,Romania,1605,1227,36,12,378,175,167,342,24
2023-03-19,LR,Romania,1602,1185,39,8,417,186,192,378,31
2023-03-20,LR,Romania,1519,1062,67,6,457,190,200,390,61
2023-03-21,LR,Romania,1511,1078,82,16,433,183,168,351,66
2023-03-22,LR,Romania,1585,1139,80,13,446,179,187,366,67
2023-03-23,LR,Romania,1681,1238,80,15,443,182,181,363,65
2023-03-24,LR,Romania,1696,1194,85,13,502,204,213,417,72
2023-03-25,LR,Romania,1631,1248,33,6,383,180,170,350,27
2023-03-26,LR,Romania,1711,1257,25,0,454,211,218,429,25
2023-03-27,LR,Romania,1444,991,66,9,453,193,194,387,57
2023-03-28,LR,Romania,1725,1273,59,7,452,195,198,393,52
2023-03-29,LR,Romania,1694,1195,78,9,499,206,215,421,69
2023-03-30,LR,Romania,1719,1207,82,18,512,221,209,430,64
2023-03-31,LR,Romania,1772,1246,70,6,526,229,227,456,64
2023-04-01,LR,Romania,1780,1378,28,4,402,189,185,374,24
2023-04-02,LR,Romania,1817,1364,31,2,453,210,212,422,29
2023-04-03,LR,Romania,1836,1291,65,8,545,236,244,480,57
2023-04-04,LR,Romania,1818,1344,51,2,474,215,208,423,49
2023-04-05,LR,Romania,1837,1324,70,9,513,219,224,443,61
2023-04-06,LR,Romania,1913,1372,79,3,541,233,229,462,76
2023-04-07,LR,Romania,1936,1391,74,9,545,236,235,471,65
2023-04-08,LR,Romania,1894,1461,33,8,433,202,198,400,25
2023-04-09,LR,Romania,1929,1449,35,6,480,219,226,445,29
2023-04-10,LR,Romania,1842,1317,72,12,525,226,227,453,60
2023-04-11,LR,Romania,1813,1310,72,8,503,220,211,431,64
2023-04-12,LR,Romania,1844,1292,82,14,552,232,238,470,68
2023-04-13,LR,Romania,1960,1390,70,10,570,251,249,500,60
2023-04-14,LR,Romania,1940,1421,61,7,519,229,229,458,54
2023-04-15,LR,Romania,1994,1565,31,4,429,199,199,398,27
2023-04-16,LR,Romania,1920,1456,22,2,464,221,221,442,20
2023-04-17,LR,Romania,1808,1326,45,4,482,218,219,437,41
2023-04-18,LR,Romania,1896,1387,66,11,509,220,223,443,55
2023-04-19,LR,Romania,1932,1380,97,21,552,227,228,455,76
2023-04-20,LR,Romania,1987,1431,86,15,556,242,228,470,71
2023-04-21,LR,Romania,1917,1389,80,13,528,223,225,448,67
2023-04-22,LR,Romania,1971,1546,33,5,425,195,197,392,28
2023-04-23,LR,Romania,2076,1588,44,5,488,220,224,444,39
2023-04-24,LR,Romania,1919,1381,76,11,538,227,235,462,65
2023-04-25,LR,Romania,1921,1438,65,8,483,210,208,418,57
2023-04-26,LR,Romania,1975,1430,88,15,545,230,227,457,73
2023-04-27,LR,Romania,2031,1496,87,16,535,229,219,448,71
2023-04-28,LR,Romania,2072,1526,85,12,546,229,232,461,73
2023-04-29,LR,Romania,2094,1657,36,7,437,202,199,401,29
2023-04-30,LR,Romania,2098,1616,40,7,482,219,223,442,33
2023-05-01,LR,Romania,1981,1496,49,7,485,215,221,436,42
2023-05-02,LR,Romania,1917,1413,78,16,504,214,212,426,62
2023-05-03,LR,Romania,1973,1427,93,21,546,226,227,453,72
2023-05-04,LR,Romania,2042,1490,92,15,552,233,227,460,77
2023-05-05,LR,Romania,2089,1528,93,13,561,237,231,468,80
2023-05-06,LR,Romania,2079,1659,33,3,420,194,193,387,30
2023-05-07,LR,Romania,2098,1623,42,2,475,214,219,433,40
2023-05-08,LR,Romania,1989,1429,77,12,560,242,241,483,65
2023-05-09,LR,Romania,1938,1426,80,10,512,215,217,432,70
2023-05-10,LR,Romania,2053,1503,95,16,550,228,227,455,79
2023-05-11,LR,Romania,2054,1510,79,9,544,234,231,465,70
2023-05-12,LR,Romania,2143,1572,82,10,571,245,244,489,72
2023-05-13,LR,Romania,2167,1749,26,5,418,198,194,392,21
2023-05-14,LR,Romania,2148,1666,34,4,482,224,224,448,30
2023-05-15,LR,Romania,1982,1450,67,6,532,230,235,465,61
2023-05-16,LR,Romania,1963,1486,65,15,477,206,206,412,50
2023-05-17,LR,Romania,2010,1476,81,10,534,227,226,453,71
2023-05-18,LR,Romania,2077,1527,91,13,550,234,225,459,78
2023-05-19,LR,Romania,2041,1502,75,6,539,230,234,464,69
2023-05-20,LR,Romania,2169,1708,35,2,461,218,208,426,33
2023-05-21,LR,Romania,2229,1729,45,8,500,222,233,455,37
2023-05-22,LR,Romania,2073,1538,70,8,535,231,234,465,62
2023-05-23,LR,Romania,1976,1477,84,12,499,204,211,415,72
2023-05-24,LR,Romania,2150,1601,97,18,549,227,225,452,79
2023-05-25,LR,Romania,2162,1618,95,10,544,226,223,449,85
2023-05-26,LR,Romania,2317,1766,75,10,551,243,233,476,65
2023-05-27,LR,Romania,2332,1886,29,5,446,208,209,417,24
2023-05-28,LR,Romania,2293,1803,32,3,490,231,227,458,29
2023-05-29,LR,Romania,2119,1579,67,9,540,234,239,473,58
2023-05-30,LR,Romania,2135,1630,77,15,505,213,215,428,62
2023-05-31,LR,Romania,2264,1700,77,16,564,238,249,487,61
2023-06-01,LR,Romania,2319,1783,49,7,536,246,241,487,42
2023-06-02,LR,Romania,2463,1920,52,6,543,247,244,491,46
2023-06-03,LR,Romania,2466,1995,26,5,471,225,220,445,21
2023-06-04,LR,Romania,2427,1924,31,5,503,233,239,472,26
2023-06-05,LR,Romania,2295,1718,53,7,577,259,265,524,46
2023-06-06,LR,Romania,2241,1706,67,9,535,236,232,468,58
2023-06-07,LR,Romania,2359,1764,75,7,595,261,259,520,68
2023-06-08,LR,Romania,2373,1763,81,15,610,264,265,529,66
2023-06-09,LR,Romania,2420,1812,77,6,608,268,263,531,71
2023-06-10,LR,Romania,2492,1998,31,7,494,236,227,463,24
2023-06-11,LR,Romania,2478,1932,39,1,546,250,257,507,38
2023-06-12,LR,Romania,2344,1735,75,8,609,267,267,534,67
2023-06-13,LR,Romania,2314,1768,74,12,546,236,236,472,62
2023-06-14,LR,Romania,2435,1838,89,10,597,252,256,508,79
2023-06-15,LR,Romania,2485,1829,97,9,656,279,280,559,88
2023-06-16,LR,Romania,2502,1886,67,5,616,273,276,549,62
2023-06-17,LR,Romania,2563,2061,40,10,502,235,227,462,30
2023-06-18,LR,Romania,2511,1962,41,5,549,254,254,508,36
2023-06-19,LR,Romania,2452,1820,69,5,632,280,283,563,64
2023-06-20,LR,Romania,2461,1888,78,12,573,247,248,495,66
2023-06-21,LR,Romania,2427,1819,76,9,608,268,264,532,67
2023-06-22,LR,Romania,2515,1883,76,6,632,278,278,556,70
2023-06-23,LR,Romania,2655,2025,85,9,630,272,273,545,76
2023-06-24,LR,Romania,2791,2276,33,2,515,244,238,482,31
2023-06-25,LR,Romania,2663,2086,50,3,577,259,268,527,47
2023-06-26,LR,Romania,2489,1867,77,13,622,270,275,545,64
2023-06-27,LR,Romania,2470,1875,68,12,595,264,263,527,56
2023-06-28,LR,Romania,2532,1936,79,9,596,255,262,517,70
2023-06-29,LR,Romania,2565,1912,87,12,653,284,282,566,75
2023-06-30,LR,Romania,2683,2066,80,11,617,275,262,537,69
2023-07-01,LR,Romania,2804,2293,31,6,511,238,242,480,25
2023-07-02,LR,Romania,2748,2164,44,3,584,269,271,540,41
2023-07-03,LR,Romania,2571,1915,63,13,656,297,296,593,50
2023-07-04,LR,Romania,2682,2088,67,12,594,262,265,527,55
2023-07-05,LR,Romania,2760,2159,68,4,601,267,266,533,64
2023-07-06,LR,Romania,2688,2023,85,13,665,288,292,580,72
2023-07-07,LR,Romania,2711,2084,64,7,627,284,279,563,57
2023-07-08,LR,Romania,2739,2232,31,5,507,240,236,476,26
2023-07-09,LR,Romania,2613,2044,45,7,569,258,266,524,38
2023-07-10,LR,Romania,2560,1939,53,5,621,286,282,568,48
2023-07-11,LR,Romania,2597,2023,61,10,574,258,255,513,51
2023-07-12,LR,Romania,2618,2015,75,10,603,266,262,528,65
2023-07-13,LR,Romania,2558,1933,71,10,625,277,277,554,61
2023-07-14,LR,Romania,2649,2026,66,10,623,276,281,557,56
2023-07-15,LR,Romania,2641,2150,31,10,491,229,231,460,21
2023-07-16,LR,Romania,2642,2089,38,8,553,254,261,515,30
2023-07-17,LR,Romania,2497,1881,58,11,616,283,275,558,47
2023-07-18,LR,Romania,2588,2033,54,9,555,249,252,501,45
2023-07-19,LR,Romania,2791,2183,70,8,608,265,273,538,62
2023-07-20,LR,Romania,2580,1964,67,7,616,272,277,549,60
2023-07-21,LR,Romania,2653,2033,74,9,620,277,269,546,65
2023-07-22,LR,Romania,2816,2307,34,4,509,241,234,475,30
2023-07-23,LR,Romania,2680,2121,43,7,559,256,260,516,36
2023-07-24,LR,Romania,2600,1988,62,14,612,276,274,550,48
2023-07-25,LR,Romania,2722,2167,60,8,555,248,247,495,52
2023-07-26,LR,Romania,2739,2122,52,10,617,281,284,565,42
2023-07-27,LR,Romania,2655,2043,74,13,612,269,269,538,61
2023-07-28,LR,Romania,2758,2153,60,8,605,273,272,545,52
2023-07-29,LR,Romania,2664,2158,29,7,506,240,237,477,22
2023-07-30,LR,Romania,2721,2162,43,7,559,254,262,516,36
2023-07-31,LR,Romania,2577,1960,62,10,617,276,279,555,52
2023-08-01,LR,Romania,2695,2102,76,14,593,259,258,517,62
2023-08-02,LR,Romania,2712,2060,85,17,652,284,283,567,68
2023-08-03,LR,Romania,2676,2033,88,15,643,277,278,555,73
2023-08-04,LR,Romania,2754,2135,61,4,619,281,277,558,57
2023-08-05,LR,Romania,2756,2252,41,3,504,235,228,463,38
2023-08-06,LR,Romania,2799,2230,47,6,569,258,264,522,41
2023-08-07,LR,Romania,2708,2070,70,10,638,284,284,568,60
2023-08-08,LR,Romania,2635,2068,76,11,567,248,243,491,65
2023-08-09,LR,Romania,2614,2015,75,9,599,260,264,524,66
2023-08-10,LR,Romania,2664,2038,79,8,626,271,276,547,71
2023-08-11,LR,Romania,2650,2029,80,16,621,271,270,541,64
2023-08-12,LR,Romania,2618,2123,33,9,495,236,226,462,24
2023-08-13,LR,Romania,2642,2080,46,7,562,254,262,516,39
2023-08-14,LR,Romania,2552,1940,53,6,612,280,279,559,47
2023-08-15,LR,Romania,2605,2059,41,5,546,255,250,505,36
2023-08-16,LR,Romania,2566,1990,44,6,576,267,265,532,38
2023-08-17,LR,Romania,2594,1981,76,9,613,268,269,537,67
2023-08-18,LR,Romania,2752,2137,70,9,615,270,275,545,61
2023-08-19,LR,Romania,2728,2235,29,6,493,232,232,464,23
2023-08-20,LR,Romania,2652,2080,45,6,572,263,264,527,39
2023-08-21,LR,Romania,2547,1937,54,10,610,275,281,556,44
2023-08-22,LR,Romania,2578,2001,63,7,577,258,256,514,56
2023-08-23,LR,Romania,2645,2049,55,7,596,270,271,541,48
2023-08-24,LR,Romania,2668,2045,75,6,623,270,278,548,69
2023-08-25,LR,Romania,2750,2138,57,9,612,279,276,555,48
2023-08-26,LR,Romania,2684,2183,34,7,501,237,230,467,27
2023-08-27,LR,Romania,2636,2051,49,7,585,267,269,536,42
2023-08-28,LR,Romania,2558,1949,49,6,609,281,279,560,43
2023-08-29,LR,Romania,2648,2071,64,6,577,256,257,513,58
2023-08-30,LR,Romania,2558,1970,55,6,588,268,265,533,49
2023-08-31,LR,Romania,2645,2013,74,12,632,279,279,558,62
2023-09-01,LR,Romania,2701,2060,71,15,641,284,286,570,56
2023-09-02,LR,Romania,2611,2105,33,5,506,237,236,473,28
2023-09-03,LR,Romania,2651,2060,69,32,591,260,262,522,37
2023-09-04,LR,Romania,2550,1917,56,7,633,282,295,577,49
2023-09-05,LR,Romania,2494,1930,67,7,564,250,247,497,60
2023-09-06,LR,Romania,2578,1943,78,13,635,278,279,557,65
2023-09-07,LR,Romania,2601,1946,84,10,655,287,284,571,74
2023-09-08,LR,Romania,2625,1989,74,10,636,282,280,562,64
2023-09-09,LR,Romania,2589,2070,62,31,519,230,227,457,31
2023-09-10,LR,Romania,2574,2000,46,8,574,261,267,528,38
2023-09-11,LR,Romania,2445,1828,58,7,617,279,280,559,51
2023-09-12,LR,Romania,2473,1902,60,13,571,255,256,511,47
2023-09-13,LR,Romania,2605,1983,79,14,622,273,270,543,65
2023-09-14,LR,Romania,2505,1865,86,10,640,277,277,554,76
2023-09-15,LR,Romania,2584,1955,70,7,629,284,275,559,63
2023-09-16,LR,Romania,2616,2125,30,7,491,231,230,461,23
2023-09-17,LR,Romania,2573,2007,46,5,566,259,261,520,41
2023-09-18,LR,Romania,2468,1850,65,13,618,272,281,553,52
2023-09-19,LR,Romania,2627,2060,68,12,567,250,249,499,56
2023-09-20,LR,Romania,2638,2014,88,13,624,270,266,536,75
2023-09-21,LR,Romania,2534,1917,78,7,617,269,270,539,71
2023-09-22,LR,Romania,2581,1957,72,11,624,271,281,552,61
2023-09-23,LR,Romania,2543,2065,35,6,478,224,219,443,29
2023-09-24,LR,Romania,2509,1966,41,4,543,247,255,502,37
2023-09-25,LR,Romania,2403,1811,69,12,592,264,259,523,57
2023-09-26,LR,Romania,2165,1617,74,14,548,235,239,474,60
2023-09-27,LR,Romania,2513,1919,90,14,594,248,256,504,76
2023-09-28,LR,Romania,2461,1857,94,21,604,263,247,510,73
2023-09-29,LR,Romania,2487,1915,89,11,572,244,239,483,78
2023-09-30,LR,Romania,2523,2061,33,6,462,219,210,429,27
2023-10-01,LR,Romania,2473,1942,47,7,531,238,246,484,40
2023-10-02,LR,Romania,2264,1713,66,13,551,239,246,485,53
2023-01-01,LY,Serbia & Montenegro,0,-193,16,0,193,89,88,177,16
2023-01-02,LY,Serbia & Montenegro,0,-243,17,0,243,115,111,226,17
2023-01-03,LY,Serbia & Montenegro,0,-185,21,1,185,76,88,164,20
2023-01-04,LY,Serbia & Montenegro,0,-199,22,0,199,92,85,177,22
2023-01-05,LY,Serbia & Montenegro,0,-203,18,1,203,95,90,185,17
2023-01-06,LY,Serbia & Montenegro,0,-233,17,0,233,108,108,216,17
2023-01-07,LY,Serbia & Montenegro,0,-188,17,1,188,83,88,171,16
2023-01-08,LY,Serbia & Montenegro,0,-246,23,0,246,116,107,223,23
2023-01-09,LY,Serbia & Montenegro,0,-223,16,0,223,99,108,207,16
2023-01-10,LY,Serbia & Montenegro,0,-188,18,0,188,82,88,170,18
2023-01-11,LY,Serbia & Montenegro,0,-192,19,0,192,90,83,173,19
2023-01-12,LY,Serbia & Montenegro,0,-213,19,3,213,100,94,194,16
2023-01-13,LY,Serbia & Montenegro,0,-239,23,5,239,109,107,216,18
2023-01-14,LY,Serbia & Montenegro,0,-179,18,1,179,78,83,161,17
2023-01-15,LY,Serbia & Montenegro,0,-213,24,3,213,95,94,189,21
2023-01-16,LY,Serbia & Montenegro,0,-219,18,1,219,98,103,201,17
2023-01-17,LY,Serbia & Montenegro,0,-172,21,5,172,74,77,151,16
2023-01-18,LY,Serbia & Montenegro,0,-192,24,5,192,90,78,168,19
2023-01-19,LY,Serbia & Montenegro,0,-201,20,2,201,91,90,181,18
2023-01-20,LY,Serbia & Montenegro,0,-226,18,0,226,99,109,208,18
2023-01-21,LY,Serbia & Montenegro,0,-176,18,1,176,78,80,158,17
2023-01-22,LY,Serbia & Montenegro,0,-204,20,0,204,93,91,184,20
2023-01-23,LY,Serbia & Montenegro,0,-230,23,6,230,102,105,207,17
2023-01-24,LY,Serbia & Montenegro,0,-181,24,5,181,77,80,157,19
2023-01-25,LY,Serbia & Montenegro,0,-187,24,5,187,85,78,163,19
2023-01-26,LY,Serbia & Montenegro,0,-201,16,0,201,94,91,185,16
2023-01-27,LY,Serbia & Montenegro,0,-224,17,0,224,103,104,207,17
2023-01-28,LY,Serbia & Montenegro,0,-177,21,0,177,76,80,156,21
2023-01-29,LY,Serbia & Montenegro,0,-188,19,0,188,86,83,169,19
2023-01-30,LY,Serbia & Montenegro,0,-227,21,6,227,101,105,206,15
2023-01-31,LY,Serbia & Montenegro,0,-170,27,9,170,70,73,143,18
2023-02-01,LY,Serbia & Montenegro,0,-194,25,3,194,89,80,169,22
2023-02-02,LY,Serbia & Montenegro,0,-186,21,3,186,79,86,165,18
2023-02-03,LY,Serbia & Montenegro,0,-218,21,5,218,102,95,197,16
2023-02-04,LY,Serbia & Montenegro,0,-158,18,0,158,69,71,140,18
2023-02-05,LY,Serbia & Montenegro,0,-184,19,0,184,85,80,165,19
2023-02-06,LY,Serbia & Montenegro,0,-220,20,5,220,97,103,200,15
2023-02-07,LY,Serbia & Montenegro,0,-176,26,6,176,72,78,150,20
2023-02-08,LY,Serbia & Montenegro,0,-186,29,8,186,83,74,157,21
2023-02-09,LY,Serbia & Montenegro,0,-194,25,7,194,84,85,169,18
2023-02-10,LY,Serbia & Montenegro,0,-241,21,5,241,110,110,220,16
2023-02-11,LY,Serbia & Montenegro,0,-179,22,0,179,77,80,157,22
2023-02-12,LY,Serbia & Montenegro,0,-204,19,0,204,95,90,185,19
2023-02-13,LY,Serbia & Montenegro,0,-226,20,5,226,100,106,206,15
2023-02-14,LY,Serbia & Montenegro,0,-194,27,6,194,80,87,167,21
2023-02-15,LY,Serbia & Montenegro,0,-198,21,0,198,93,84,177,21
2023-02-16,LY,Serbia & Montenegro,0,-187,17,1,187,86,84,170,16
2023-02-17,LY,Serbia & Montenegro,0,-222,23,1,222,102,97,199,22
2023-02-18,LY,Serbia & Montenegro,0,-194,21,1,194,79,94,173,20
2023-02-19,LY,Serbia & Montenegro,0,-236,20,1,236,112,104,216,19
2023-02-20,LY,Serbia & Montenegro,0,-223,18,1,223,100,105,205,17
2023-02-21,LY,Serbia & Montenegro,0,-177,17,0,177,77,83,160,17
2023-02-22,LY,Serbia & Montenegro,0,-201,23,3,201,92,86,178,20
2023-02-23,LY,Serbia & Montenegro,0,-189,19,2,189,86,84,170,17
2023-02-24,LY,Serbia & Montenegro,0,-239,19,2,239,111,109,220,17
2023-02-25,LY,Serbia & Montenegro,0,-195,20,0,195,86,89,175,20
2023-02-26,LY,Serbia & Montenegro,0,-205,18,2,205,94,93,187,16
2023-02-27,LY,Serbia & Montenegro,0,-232,16,0,232,106,110,216,16
2023-02-28,LY,Serbia & Montenegro,0,-179,19,2,179,78,82,160,17
2023-03-01,LY,Serbia & Montenegro,0,-189,24,4,189,85,80,165,20
2023-03-02,LY,Serbia & Montenegro,0,-201,22,6,201,90,89,179,16
2023-03-03,LY,Serbia & Montenegro,0,-236,19,2,236,111,106,217,17
2023-03-04,LY,Serbia & Montenegro,0,-174,20,0,174,74,80,154,20
2023-03-05,LY,Serbia & Montenegro,0,-211,18,0,211,101,92,193,18
2023-03-06,LY,Serbia & Montenegro,0,-222,17,2,222,102,103,205,15
2023-03-07,LY,Serbia & Montenegro,0,-164,21,4,164,67,76,143,17
2023-03-08,LY,Serbia & Montenegro,0,-199,25,4,199,90,84,174,21
2023-03-09,LY,Serbia & Montenegro,0,-204,19,3,204,94,91,185,16
2023-03-10,LY,Serbia & Montenegro,0,-226,23,6,226,100,103,203,17
2023-03-11,LY,Serbia & Montenegro,0,-186,17,0,186,87,82,169,17
2023-03-12,LY,Serbia & Montenegro,0,-216,18,0,216,97,101,198,18
2023-03-13,LY,Serbia & Montenegro,0,-229,20,5,229,105,104,209,15
2023-03-14,LY,Serbia & Montenegro,0,-184,17,0,184,80,87,167,17
2023-03-15,LY,Serbia & Montenegro,0,-202,23,3,202,94,85,179,20
2023-03-16,LY,Serbia & Montenegro,0,-193,19,2,193,86,88,174,17
2023-03-17,LY,Serbia & Montenegro,0,-233,21,3,233,106,106,212,18
2023-03-18,LY,Serbia & Montenegro,0,-185,23,3,185,80,82,162,20
2023-03-19,LY,Serbia & Montenegro,0,-215,18,0,215,99,98,197,18
2023-03-20,LY,Serbia & Montenegro,0,-251,19,1,251,116,116,232,18
2023-03-21,LY,Serbia & Montenegro,0,-201,20,3,201,85,96,181,17
2023-03-22,LY,Serbia & Montenegro,0,-222,28,6,222,102,92,194,22
2023-03-23,LY,Serbia & Montenegro,0,-206,21,4,206,92,93,185,17
2023-03-24,LY,Serbia & Montenegro,0,-252,21,3,252,115,116,231,18
2023-03-25,LY,Serbia & Montenegro,0,-185,20,0,185,82,83,165,20
2023-03-26,LY,Serbia & Montenegro,0,-211,18,1,211,99,94,193,17
2023-03-27,LY,Serbia & Montenegro,0,-247,20,0,247,113,114,227,20
2023-03-28,LY,Serbia & Montenegro,0,-217,21,3,217,96,100,196,18
2023-03-29,LY,Serbia & Montenegro,0,-230,27,4,230,107,96,203,23
2023-03-30,LY,Serbia & Montenegro,0,-256,26,8,256,115,115,230,18
2023-03-31,LY,Serbia & Montenegro,0,-269,25,3,269,119,125,244,22
2023-04-01,LY,Serbia & Montenegro,0,-197,19,0,197,87,91,178,19
2023-04-02,LY,Serbia & Montenegro,0,-239,19,0,239,114,106,220,19
2023-04-03,LY,Serbia & Montenegro,0,-286,22,4,286,131,133,264,18
2023-04-04,LY,Serbia & Montenegro,0,-202,13,0,202,97,92,189,13
2023-04-05,LY,Serbia & Montenegro,0,-218,17,0,218,98,103,201,17
2023-04-06,LY,Serbia & Montenegro,0,-249,24,5,249,114,111,225,19
2023-04-07,LY,Serbia & Montenegro,0,-269,21,0,269,122,126,248,21
2023-04-08,LY,Serbia & Montenegro,0,-203,19,0,203,91,93,184,19
2023-04-09,LY,Serbia & Montenegro,0,-233,18,0,233,105,110,215,18
2023-04-10,LY,Serbia & Montenegro,0,-276,27,7,276,128,121,249,20
2023-04-11,LY,Serbia & Montenegro,0,-218,19,5,218,96,103,199,14
2023-04-12,LY,Serbia & Montenegro,0,-224,21,2,224,103,100,203,19
2023-04-13,LY,Serbia & Montenegro,0,-261,26,4,261,121,114,235,22
2023-04-14,LY,Serbia & Montenegro,0,-276,23,2,276,129,124,253,21
2023-04-15,LY,Serbia & Montenegro,0,-208,19,0,208,92,97,189,19
2023-04-16,LY,Serbia & Montenegro,0,-229,14,0,229,107,108,215,14
2023-04-17,LY,Serbia & Montenegro,0,-288,25,0,288,131,132,263,25
2023-04-18,LY,Serbia & Montenegro,0,-234,25,4,234,103,106,209,21
2023-04-19,LY,Serbia & Montenegro,0,-240,23,3,240,109,108,217,20
2023-04-20,LY,Serbia & Montenegro,0,-264,22,3,264,121,121,242,19
2023-04-21,LY,Serbia & Montenegro,0,-298,24,2,298,135,139,274,22
2023-04-22,LY,Serbia & Montenegro,0,-220,21,2,220,101,98,199,19
2023-04-23,LY,Serbia & Montenegro,0,-257,19,1,257,118,120,238,18
2023-04-24,LY,Serbia & Montenegro,0,-282,16,0,282,135,131,266,16
2023-04-25,LY,Serbia & Montenegro,0,-234,19,0,234,105,110,215,19
2023-04-26,LY,Serbia & Montenegro,0,-240,22,3,240,111,107,218,19
2023-04-27,LY,Serbia & Montenegro,0,-288,30,4,288,132,126,258,26
2023-04-28,LY,Serbia & Montenegro,0,-340,40,7,340,148,152,300,33
2023-04-29,LY,Serbia & Montenegro,0,-233,26,5,233,106,101,207,21
2023-04-30,LY,Serbia & Montenegro,0,-252,19,2,252,117,116,233,17
2023-05-01,LY,Serbia & Montenegro,0,-279,20,0,279,129,130,259,20
2023-05-02,LY,Serbia & Montenegro,0,-237,24,0,237,100,113,213,24
2023-05-03,LY,Serbia & Montenegro,0,-257,25,3,257,120,112,232,22
2023-05-04,LY,Serbia & Montenegro,0,-285,22,5,285,134,129,263,17
2023-05-05,LY,Serbia & Montenegro,0,-298,26,4,298,133,139,272,22
2023-05-06,LY,Serbia & Montenegro,0,-236,20,2,236,105,111,216,18
2023-05-07,LY,Serbia & Montenegro,0,-264,24,1,264,122,118,240,23
2023-05-08,LY,Serbia & Montenegro,0,-297,20,1,297,139,138,277,19
2023-05-09,LY,Serbia & Montenegro,0,-256,24,5,256,112,120,232,19
2023-05-10,LY,Serbia & Montenegro,0,-264,22,3,264,124,118,242,19
2023-05-11,LY,Serbia & Montenegro,0,-273,19,0,273,131,123,254,19
2023-05-12,LY,Serbia & Montenegro,0,-311,24,0,311,143,144,287,24
2023-05-13,LY,Serbia & Montenegro,0,-252,18,1,252,114,120,234,17
2023-05-14,LY,Serbia & Montenegro,0,-281,26,3,281,130,125,255,23
2023-05-15,LY,Serbia & Montenegro,0,-305,22,0,305,140,143,283,22
2023-05-16,LY,Serbia & Montenegro,0,-253,20,2,253,116,117,233,18
2023-05-17,LY,Serbia & Montenegro,0,-277,24,4,277,127,126,253,20
2023-05-18,LY,Serbia & Montenegro,0,-320,19,0,320,152,149,301,19
2023-05-19,LY,Serbia & Montenegro,0,-308,24,1,308,140,144,284,23
2023-05-20,LY,Serbia & Montenegro,0,-262,21,1,262,121,120,241,20
2023-05-21,LY,Serbia & Montenegro,0,-304,20,1,304,143,141,284,19
2023-05-22,LY,Serbia & Montenegro,0,-335,24,3,335,158,153,311,21
2023-05-23,LY,Serbia & Montenegro,0,-267,26,6,267,120,121,241,20
2023-05-24,LY,Serbia & Montenegro,0,-281,23,1,281,127,131,258,22
2023-05-25,LY,Serbia & Montenegro,0,-345,25,3,345,161,159,320,22
2023-05-26,LY,Serbia & Montenegro,0,-308,27,3,308,144,137,281,24
2023-05-27,LY,Serbia & Montenegro,0,-272,23,0,272,120,129,249,23
2023-05-28,LY,Serbia & Montenegro,0,-274,16,1,274,130,128,258,15
2023-05-29,LY,Serbia & Montenegro,0,-346,24,5,346,163,159,322,19
2023-05-30,LY,Serbia & Montenegro,0,-283,22,3,283,127,134,261,19
2023-05-31,LY,Serbia & Montenegro,0,-284,23,2,284,133,128,261,21
2023-06-01,LY,Serbia & Montenegro,0,-349,29,4,349,161,159,320,25
2023-06-02,LY,Serbia & Montenegro,0,-328,29,5,328,149,150,299,24
2023-06-03,LY,Serbia & Montenegro,0,-290,25,1,290,132,133,265,24
2023-06-04,LY,Serbia & Montenegro,0,-319,23,1,319,151,145,296,22
2023-06-05,LY,Serbia & Montenegro,0,-357,27,2,357,161,169,330,25
2023-06-06,LY,Serbia & Montenegro,0,-281,22,1,281,126,133,259,21
2023-06-07,LY,Serbia & Montenegro,0,-299,26,5,299,138,135,273,21
2023-06-08,LY,Serbia & Montenegro,0,-363,26,4,363,171,166,337,22
2023-06-09,LY,Serbia & Montenegro,0,-357,29,5,357,165,163,328,24
2023-06-10,LY,Serbia & Montenegro,0,-319,27,0,319,145,147,292,27
2023-06-11,LY,Serbia & Montenegro,0,-348,22,0,348,166,160,326,22
2023-06-12,LY,Serbia & Montenegro,0,-373,25,3,373,173,175,348,22
2023-06-13,LY,Serbia & Montenegro,0,-328,26,3,328,151,151,302,23
2023-06-14,LY,Serbia & Montenegro,0,-336,39,8,336,146,151,297,31
2023-06-15,LY,Serbia & Montenegro,0,-374,24,3,374,179,171,350,21
2023-06-16,LY,Serbia & Montenegro,0,-367,29,0,367,166,172,338,29
2023-06-17,LY,Serbia & Montenegro,0,-327,27,0,327,152,148,300,27
2023-06-18,LY,Serbia & Montenegro,0,-371,29,0,371,172,170,342,29
2023-06-19,LY,Serbia & Montenegro,0,-368,31,3,368,165,172,337,28
2023-06-20,LY,Serbia & Montenegro,0,-330,36,6,330,144,150,294,30
2023-06-21,LY,Serbia & Montenegro,0,-350,35,4,350,161,154,315,31
2023-06-22,LY,Serbia & Montenegro,0,-375,29,3,375,174,172,346,26
2023-06-23,LY,Serbia & Montenegro,0,-373,32,5,373,171,170,341,27
2023-06-24,LY,Serbia & Montenegro,0,-332,29,3,332,152,151,303,26
2023-06-25,LY,Serbia & Montenegro,0,-366,34,1,366,164,168,332,33
2023-06-26,LY,Serbia & Montenegro,0,-411,37,4,411,185,189,374,33
2023-06-27,LY,Serbia & Montenegro,0,-344,40,4,344,150,154,304,36
2023-06-28,LY,Serbia & Montenegro,0,-351,37,5,351,158,156,314,32
2023-06-29,LY,Serbia & Montenegro,0,-407,33,3,407,192,182,374,30
2023-06-30,LY,Serbia & Montenegro,0,-396,33,2,396,180,183,363,31
2023-07-01,LY,Serbia & Montenegro,0,-364,37,3,364,161,166,327,34
2023-07-02,LY,Serbia & Montenegro,0,-391,34,1,391,179,178,357,33
2023-07-03,LY,Serbia & Montenegro,0,-400,30,5,400,182,188,370,25
2023-07-04,LY,Serbia & Montenegro,0,-375,40,6,375,170,165,335,34
2023-07-05,LY,Serbia & Montenegro,0,-373,44,6,373,163,166,329,38
2023-07-06,LY,Serbia & Montenegro,0,-401,37,10,401,186,178,364,27
2023-07-07,LY,Serbia & Montenegro,0,-395,40,6,395,175,180,355,34
2023-07-08,LY,Serbia & Montenegro,0,-363,35,6,363,157,171,328,29
2023-07-09,LY,Serbia & Montenegro,0,-392,39,1,392,179,174,353,38
2023-07-10,LY,Serbia & Montenegro,0,-416,34,3,416,199,183,382,31
2023-07-11,LY,Serbia & Montenegro,0,-345,33,4,345,152,160,312,29
2023-07-12,LY,Serbia & Montenegro,0,-365,44,4,365,156,165,321,40
2023-07-13,LY,Serbia & Montenegro,0,-389,32,5,389,179,178,357,27
2023-07-14,LY,Serbia & Montenegro,0,-413,38,5,413,194,181,375,33
2023-07-15,LY,Serbia & Montenegro,0,-368,31,1,368,165,172,337,30
2023-07-16,LY,Serbia & Montenegro,0,-385,34,0,385,175,176,351,34
2023-07-17,LY,Serbia & Montenegro,0,-417,32,5,417,191,194,385,27
2023-07-18,LY,Serbia & Montenegro,0,-376,38,6,376,169,169,338,32
2023-07-19,LY,Serbia & Montenegro,0,-364,42,6,364,160,162,322,36
2023-07-20,LY,Serbia & Montenegro,0,-408,37,8,408,192,179,371,29
2023-07-21,LY,Serbia & Montenegro,0,-403,42,9,403,179,182,361,33
2023-07-22,LY,Serbia & Montenegro,0,-367,33,0,367,165,169,334,33
2023-07-23,LY,Serbia & Montenegro,0,-434,43,1,434,196,195,391,42
2023-07-24,LY,Serbia & Montenegro,0,-421,33,0,421,195,193,388,33
2023-07-25,LY,Serbia & Montenegro,0,-359,32,1,359,166,161,327,31
2023-07-26,LY,Serbia & Montenegro,0,-371,35,1,371,162,174,336,34
2023-07-27,LY,Serbia & Montenegro,0,-413,31,4,413,192,190,382,27
2023-07-28,LY,Serbia & Montenegro,0,-427,42,3,427,193,192,385,39
2023-07-29,LY,Serbia & Montenegro,0,-376,30,2,376,172,174,346,28
2023-07-30,LY,Serbia & Montenegro,0,-396,36,1,396,178,182,360,35
2023-07-31,LY,Serbia & Montenegro,0,-413,29,0,413,191,193,384,29
2023-08-01,LY,Serbia & Montenegro,0,-396,35,1,396,185,176,361,34
2023-08-02,LY,Serbia & Montenegro,0,-389,38,0,389,179,172,351,38
2023-08-03,LY,Serbia & Montenegro,0,-394,29,0,394,183,182,365,29
2023-08-04,LY,Serbia & Montenegro,0,-419,37,3,419,191,191,382,34
2023-08-05,LY,Serbia & Montenegro,0,-345,31,1,345,160,154,314,30
2023-08-06,LY,Serbia & Montenegro,0,-389,35,0,389,174,180,354,35
2023-08-07,LY,Serbia & Montenegro,0,-418,26,2,418,195,197,392,24
2023-08-08,LY,Serbia & Montenegro,0,-391,46,6,391,170,175,345,40
2023-08-09,LY,Serbia & Montenegro,0,-401,48,8,401,176,177,353,40
2023-08-10,LY,Serbia & Montenegro,0,-411,35,6,411,191,185,376,29
2023-08-11,LY,Serbia & Montenegro,0,-428,40,4,428,191,197,388,36
2023-08-12,LY,Serbia & Montenegro,0,-373,29,0,373,174,170,344,29
2023-08-13,LY,Serbia & Montenegro,0,-382,35,0,382,174,173,347,35
2023-08-14,LY,Serbia & Montenegro,0,-410,35,3,410,188,187,375,32
2023-08-15,LY,Serbia & Montenegro,0,-372,37,3,372,164,171,335,34
2023-08-16,LY,Serbia & Montenegro,0,-388,47,6,388,173,168,341,41
2023-08-17,LY,Serbia & Montenegro,0,-373,35,7,373,173,165,338,28
2023-08-18,LY,Serbia & Montenegro,0,-417,42,7,417,186,189,375,35
2023-08-19,LY,Serbia & Montenegro,0,-364,32,1,364,161,171,332,31
2023-08-20,LY,Serbia & Montenegro,0,-384,36,2,384,175,173,348,34
2023-08-21,LY,Serbia & Montenegro,0,-395,38,7,395,179,178,357,31
2023-08-22,LY,Serbia & Montenegro,0,-366,46,11,366,160,160,320,35
2023-08-23,LY,Serbia & Montenegro,0,-367,46,8,367,159,162,321,38
2023-08-24,LY,Serbia & Montenegro,0,-383,37,7,383,179,167,346,30
2023-08-25,LY,Serbia & Montenegro,0,-411,43,9,411,183,185,368,34
2023-08-26,LY,Serbia & Montenegro,0,-351,30,2,351,156,165,321,28
2023-08-27,LY,Serbia & Montenegro,0,-371,32,1,371,171,168,339,31
2023-08-28,LY,Serbia & Montenegro,0,-409,28,1,409,185,196,381,27
2023-08-29,LY,Serbia & Montenegro,0,-360,37,2,360,160,163,323,35
2023-08-30,LY,Serbia & Montenegro,0,-373,38,5,373,168,167,335,33
2023-08-31,LY,Serbia & Montenegro,0,-406,34,5,406,188,184,372,29
2023-09-01,LY,Serbia & Montenegro,0,-421,46,12,421,190,185,375,34
2023-09-02,LY,Serbia & Montenegro,0,-350,29,1,350,157,164,321,28
2023-09-03,LY,Serbia & Montenegro,0,-395,33,0,395,181,181,362,33
2023-09-04,LY,Serbia & Montenegro,0,-398,35,6,398,183,180,363,29
2023-09-05,LY,Serbia & Montenegro,0,-344,40,9,344,149,155,304,31
2023-09-06,LY,Serbia & Montenegro,0,-344,40,7,344,151,153,304,33
2023-09-07,LY,Serbia & Montenegro,0,-412,32,6,412,193,187,380,26
2023-09-08,LY,Serbia & Montenegro,0,-400,38,9,400,181,181,362,29
2023-09-09,LY,Serbia & Montenegro,0,-352,31,0,352,157,164,321,31
2023-09-10,LY,Serbia & Montenegro,0,-389,31,0,389,183,175,358,31
2023-09-11,LY,Serbia & Montenegro,0,-419,37,7,419,189,193,382,30
2023-09-12,LY,Serbia & Montenegro,0,-343,38,9,343,153,152,305,29
2023-09-13,LY,Serbia & Montenegro,0,-377,46,9,377,169,162,331,37
2023-09-14,LY,Serbia & Montenegro,0,-388,35,11,388,176,177,353,24
2023-09-15,LY,Serbia & Montenegro,0,-403,37,7,403,186,180,366,30
2023-09-16,LY,Serbia & Montenegro,0,-347,26,2,347,157,164,321,24
2023-09-17,LY,Serbia & Montenegro,0,-377,29,0,377,174,174,348,29
2023-09-18,LY,Serbia & Montenegro,0,-377,24,0,377,174,179,353,24
2023-09-19,LY,Serbia & Montenegro,0,-326,22,0,326,154,150,304,22
2023-09-20,LY,Serbia & Montenegro,0,-362,39,12,362,164,159,323,27
2023-09-21,LY,Serbia & Montenegro,0,-374,30,5,374,172,172,344,25
2023-09-22,LY,Serbia & Montenegro,0,-389,30,1,389,180,179,359,29
2023-09-23,LY,Serbia & Montenegro,0,-310,23,4,310,141,146,287,19
2023-09-24,LY,Serbia & Montenegro,0,-333,25,0,333,152,156,308,25
2023-09-25,LY,Serbia & Montenegro,0,-365,32,7,365,164,169,333,25
2023-09-26,LY,Serbia & Montenegro,2983,2659,31,7,324,144,149,293,24
2023-09-27,LY,Serbia & Montenegro,2980,2650,40,11,330,148,142,290,29
2023-09-28,LY,Serbia & Montenegro,3007,2626,37,12,381,174,170,344,25
2023-09-29,LY,Serbia & Montenegro,3119,2778,33,7,341,152,156,308,26
2023-09-30,LY,Serbia & Montenegro,3453,3141,24,0,312,141,147,288,24
2023-10-01,LY,Serbia & Montenegro,3271,2952,25,1,319,152,142,294,24
2023-10-02,LY,Serbia & Montenegro,2974,2621,35,14,353,155,163,318,21
2023-01-01,LZ,Slovakia,979,936,1,0,43,21,21,42,1
2023-01-02,LZ,Slovakia,1006,946,2,0,60,28,30,58,2
2023-01-03,LZ,Slovakia,931,892,2,0,39,18,19,37,2
2023-01-04,LZ,Slovakia,932,897,3,0,35,16,16,32,3
2023-01-05,LZ,Slovakia,958,935,0,0,23,12,11,23,0
2023-01-06,LZ,Slovakia,1009,965,1,0,44,23,20,43,1
2023-01-07,LZ,Slovakia,986,940,1,0,46,22,23,45,1
2023-01-08,LZ,Slovakia,1010,965,1,1,45,20,24,44,0
2023-01-09,LZ,Slovakia,895,845,1,0,50,25,24,49,1
2023-01-10,LZ,Slovakia,903,871,3,1,32,15,14,29,2
2023-01-11,LZ,Slovakia,890,840,3,0,50,24,23,47,3
2023-01-12,LZ,Slovakia,934,895,6,1,39,17,16,33,5
2023-01-13,LZ,Slovakia,986,934,0,0,52,25,27,52,0
2023-01-14,LZ,Slovakia,993,960,2,0,33,18,13,31,2
2023-01-15,LZ,Slovakia,970,917,5,1,53,22,26,48,4
2023-01-16,LZ,Slovakia,890,840,1,0,50,23,26,49,1
2023-01-17,LZ,Slovakia,851,822,3,2,29,14,12,26,1
2023-01-18,LZ,Slovakia,899,850,4,1,49,24,21,45,3
2023-01-19,LZ,Slovakia,898,857,2,2,41,18,21,39,0
2023-01-20,LZ,Slovakia,1002,934,2,1,68,34,32,66,1
2023-01-21,LZ,Slovakia,966,933,1,0,33,17,15,32,1
2023-01-22,LZ,Slovakia,990,943,0,0,47,24,23,47,0
2023-01-23,LZ,Slovakia,869,822,4,2,47,21,22,43,2
2023-01-24,LZ,Slovakia,811,747,11,4,64,26,27,53,7
2023-01-25,LZ,Slovakia,829,753,12,4,76,32,32,64,8
2023-01-26,LZ,Slovakia,924,869,4,0,55,25,26,51,4
2023-01-27,LZ,Slovakia,969,904,5,1,65,28,32,60,4
2023-01-28,LZ,Slovakia,921,883,3,1,38,18,17,35,2
2023-01-29,LZ,Slovakia,1007,955,2,1,52,26,24,50,1
2023-01-30,LZ,Slovakia,877,830,4,1,47,22,21,43,3
2023-01-31,LZ,Slovakia,828,801,0,0,27,13,14,27,0
2023-02-01,LZ,Slovakia,838,790,0,0,48,23,25,48,0
2023-02-02,LZ,Slovakia,887,850,0,0,37,19,18,37,0
2023-02-03,LZ,Slovakia,980,914,0,0,66,32,34,66,0
2023-02-04,LZ,Slovakia,924,893,0,0,31,15,16,31,0
2023-02-05,LZ,Slovakia,934,879,2,0,55,26,27,53,2
2023-02-06,LZ,Slovakia,826,772,9,2,54,23,22,45,7
2023-02-07,LZ,Slovakia,798,738,11,5,60,23,26,49,6
2023-02-08,LZ,Slovakia,844,785,12,3,59,21,26,47,9
2023-02-09,LZ,Slovakia,858,786,19,5,72,25,28,53,14
2023-02-10,LZ,Slovakia,985,905,11,2,80,35,34,69,9
2023-02-11,LZ,Slovakia,958,919,0,0,39,22,17,39,0
2023-02-12,LZ,Slovakia,1090,1033,5,2,57,26,26,52,3
2023-02-13,LZ,Slovakia,930,878,6,3,52,23,23,46,3
2023-02-14,LZ,Slovakia,864,815,10,3,49,21,18,39,7
2023-02-15,LZ,Slovakia,913,837,14,8,76,30,32,62,6
2023-02-16,LZ,Slovakia,909,852,10,2,57,23,24,47,8
2023-02-17,LZ,Slovakia,966,896,5,1,70,35,30,65,4
2023-02-18,LZ,Slovakia,1038,996,2,0,42,18,22,40,2
2023-02-19,LZ,Slovakia,1051,1000,3,0,51,25,23,48,3
2023-02-20,LZ,Slovakia,868,815,5,0,53,25,23,48,5
2023-02-21,LZ,Slovakia,782,747,2,1,35,14,19,33,1
2023-02-22,LZ,Slovakia,859,803,3,2,56,24,29,53,1
2023-02-23,LZ,Slovakia,782,729,2,0,53,26,25,51,2
2023-02-24,LZ,Slovakia,912,837,2,1,75,37,36,73,1
2023-02-25,LZ,Slovakia,964,921,0,0,43,21,22,43,0
2023-02-26,LZ,Slovakia,1019,961,2,0,58,29,27,56,2
2023-02-27,LZ,Slovakia,784,731,2,2,53,26,25,51,0
2023-02-28,LZ,Slovakia,740,696,4,2,44,19,21,40,2
2023-03-01,LZ,Slovakia,800,728,15,7,72,26,31,57,8
2023-03-02,LZ,Slovakia,804,742,9,2,62,28,25,53,7
2023-03-03,LZ,Slovakia,1011,923,11,3,88,38,39,77,8
2023-03-04,LZ,Slovakia,924,891,2,0,33,17,14,31,2
2023-03-05,LZ,Slovakia,1006,956,0,0,50,26,24,50,0
2023-03-06,LZ,Slovakia,882,839,4,0,43,19,20,39,4
2023-03-07,LZ,Slovakia,832,794,1,0,38,17,20,37,1
2023-03-08,LZ,Slovakia,923,863,3,1,60,29,28,57,2
2023-03-09,LZ,Slovakia,990,942,6,0,48,19,23,42,6
2023-03-10,LZ,Slovakia,1060,990,5,2,70,33,32,65,3
2023-03-11,LZ,Slovakia,1042,1002,5,1,40,18,17,35,4
2023-03-12,LZ,Slovakia,1095,1024,7,5,71,31,33,64,2
2023-03-13,LZ,Slovakia,896,833,9,5,63,27,27,54,4
2023-03-14,LZ,Slovakia,940,880,15,11,60,22,23,45,4
2023-03-15,LZ,Slovakia,912,853,5,4,59,27,27,54,1
2023-03-16,LZ,Slovakia,985,904,18,9,81,31,32,63,9
2023-03-17,LZ,Slovakia,1050,968,14,7,82,37,31,68,7
2023-03-18,LZ,Slovakia,967,929,6,5,38,18,14,32,1
2023-03-19,LZ,Slovakia,1048,982,7,4,66,25,34,59,3
2023-03-20,LZ,Slovakia,910,835,12,6,75,29,34,63,6
2023-03-21,LZ,Slovakia,880,808,5,4,72,35,32,67,1
2023-03-22,LZ,Slovakia,952,873,5,3,79,35,39,74,2
2023-03-23,LZ,Slovakia,995,928,3,2,67,37,27,64,1
2023-03-24,LZ,Slovakia,1011,936,3,1,75,34,38,72,2
2023-03-25,LZ,Slovakia,1012,970,0,0,42,22,20,42,0
2023-03-26,LZ,Slovakia,1204,1142,8,2,62,26,28,54,6
2023-03-27,LZ,Slovakia,976,911,5,2,65,34,26,60,3
2023-03-28,LZ,Slovakia,1138,1087,1,0,51,26,24,50,1
2023-03-29,LZ,Slovakia,1035,947,12,3,88,34,42,76,9
2023-03-30,LZ,Slovakia,1123,1042,13,4,81,35,33,68,9
2023-03-31,LZ,Slovakia,1178,1103,7,1,75,33,35,68,6
2023-04-01,LZ,Slovakia,1202,1152,2,0,50,26,22,48,2
2023-04-02,LZ,Slovakia,1231,1181,1,0,50,21,28,49,1
2023-04-03,LZ,Slovakia,1118,1051,1,1,67,34,32,66,0
2023-04-04,LZ,Slovakia,1145,1076,10,5,69,30,29,59,5
2023-04-05,LZ,Slovakia,1238,1143,6,3,95,43,46,89,3
2023-04-06,LZ,Slovakia,1242,1172,4,1,70,36,30,66,3
2023-04-07,LZ,Slovakia,1264,1204,0,0,60,32,28,60,0
2023-04-08,LZ,Slovakia,1281,1237,0,0,44,24,20,44,0
2023-04-09,LZ,Slovakia,1271,1233,0,0,38,17,21,38,0
2023-04-10,LZ,Slovakia,1189,1132,0,0,57,27,30,57,0
2023-04-11,LZ,Slovakia,1224,1150,5,2,74,34,35,69,3
2023-04-12,LZ,Slovakia,1269,1191,8,4,78,34,36,70,4
2023-04-13,LZ,Slovakia,1287,1207,11,4,80,34,35,69,7
2023-04-14,LZ,Slovakia,1253,1188,5,1,65,30,30,60,4
2023-04-15,LZ,Slovakia,1362,1310,2,2,52,25,25,50,0
2023-04-16,LZ,Slovakia,1284,1241,0,0,43,22,21,43,0
2023-04-17,LZ,Slovakia,1178,1114,3,2,64,31,30,61,1
2023-04-18,LZ,Slovakia,1154,1087,6,4,67,32,29,61,2
2023-04-19,LZ,Slovakia,1201,1114,9,2,87,38,40,78,7
2023-04-20,LZ,Slovakia,1332,1257,5,3,75,37,33,70,2
2023-04-21,LZ,Slovakia,1325,1253,4,3,72,36,32,68,1
2023-04-22,LZ,Slovakia,1334,1278,3,1,56,27,26,53,2
2023-04-23,LZ,Slovakia,1379,1327,2,1,52,22,28,50,1
2023-04-24,LZ,Slovakia,1221,1152,5,4,69,35,29,64,1
2023-04-25,LZ,Slovakia,1333,1261,8,5,72,32,32,64,3
2023-04-26,LZ,Slovakia,1365,1286,8,5,79,33,38,71,3
2023-04-27,LZ,Slovakia,1472,1383,13,4,89,37,39,76,9
2023-04-28,LZ,Slovakia,1484,1406,5,2,78,36,37,73,3
2023-04-29,LZ,Slovakia,1495,1447,1,0,48,26,21,47,1
2023-04-30,LZ,Slovakia,1497,1445,7,0,52,19,26,45,7
2023-05-01,LZ,Slovakia,1320,1248,3,0,72,36,33,69,3
2023-05-02,LZ,Slovakia,1241,1181,8,0,60,27,25,52,8
2023-05-03,LZ,Slovakia,1311,1230,10,5,81,32,39,71,5
2023-05-04,LZ,Slovakia,1440,1363,19,7,77,28,30,58,12
2023-05-05,LZ,Slovakia,1481,1398,11,5,83,41,31,72,6
2023-05-06,LZ,Slovakia,1551,1497,1,0,54,27,26,53,1
2023-05-07,LZ,Slovakia,1596,1541,0,0,55,27,28,55,0
2023-05-08,LZ,Slovakia,1344,1278,1,0,66,32,33,65,1
2023-05-09,LZ,Slovakia,1322,1240,13,3,82,34,35,69,10
2023-05-10,LZ,Slovakia,1410,1311,11,3,99,39,49,88,8
2023-05-11,LZ,Slovakia,1483,1400,8,3,83,37,38,75,5
2023-05-12,LZ,Slovakia,1516,1440,4,4,76,36,36,72,0
2023-05-13,LZ,Slovakia,1662,1595,2,1,67,33,32,65,1
2023-05-14,LZ,Slovakia,1632,1573,8,0,59,24,27,51,8
2023-05-15,LZ,Slovakia,1335,1268,7,1,67,31,29,60,6
2023-05-16,LZ,Slovakia,1352,1280,7,4,72,35,30,65,3
2023-05-17,LZ,Slovakia,1324,1246,4,2,78,36,38,74,2
2023-05-18,LZ,Slovakia,1474,1396,6,4,78,35,37,72,2
2023-05-19,LZ,Slovakia,1488,1417,5,2,71,35,31,66,3
2023-05-20,LZ,Slovakia,1623,1568,2,1,55,24,29,53,1
2023-05-21,LZ,Slovakia,1675,1615,3,2,60,29,28,57,1
2023-05-22,LZ,Slovakia,1417,1332,8,2,85,39,38,77,6
2023-05-23,LZ,Slovakia,1320,1249,1,0,71,35,35,70,1
2023-05-24,LZ,Slovakia,1428,1322,9,5,106,47,50,97,4
2023-05-25,LZ,Slovakia,1549,1457,6,4,92,44,42,86,2
2023-05-26,LZ,Slovakia,1595,1512,6,2,83,39,38,77,4
2023-05-27,LZ,Slovakia,1665,1609,3,2,56,25,28,53,1
2023-05-28,LZ,Slovakia,1674,1611,2,2,63,31,30,61,0
2023-05-29,LZ,Slovakia,1476,1380,6,4,96,46,44,90,2
2023-05-30,LZ,Slovakia,1464,1380,6,5,84,39,39,78,1
2023-05-31,LZ,Slovakia,1561,1447,10,2,114,50,54,104,8
2023-06-01,LZ,Slovakia,1692,1596,3,1,96,49,44,93,2
2023-06-02,LZ,Slovakia,1740,1655,6,2,85,44,35,79,4
2023-06-03,LZ,Slovakia,1827,1773,0,0,54,25,29,54,0
2023-06-04,LZ,Slovakia,1800,1741,0,0,59,26,33,59,0
2023-06-05,LZ,Slovakia,1593,1506,8,1,87,37,42,79,7
2023-06-06,LZ,Slovakia,1645,1541,1,0,104,53,50,103,1
2023-06-07,LZ,Slovakia,1682,1557,7,2,125,58,60,118,5
2023-06-08,LZ,Slovakia,1705,1594,2,0,111,53,56,109,2
2023-06-09,LZ,Slovakia,1798,1694,3,1,104,54,47,101,2
2023-06-10,LZ,Slovakia,1900,1822,0,0,78,40,38,78,0
2023-06-11,LZ,Slovakia,1843,1748,1,0,95,43,51,94,1
2023-06-12,LZ,Slovakia,1589,1484,10,0,105,48,47,95,10
2023-06-13,LZ,Slovakia,1647,1551,9,6,96,44,43,87,3
2023-06-14,LZ,Slovakia,1743,1611,4,1,132,66,62,128,3
2023-06-15,LZ,Slovakia,1782,1653,8,1,129,62,59,121,7
2023-06-16,LZ,Slovakia,1829,1718,4,2,111,53,54,107,2
2023-06-17,LZ,Slovakia,1946,1840,4,0,106,53,49,102,4
2023-06-18,LZ,Slovakia,1953,1867,1,0,86,43,42,85,1
2023-06-19,LZ,Slovakia,1704,1586,8,4,118,52,58,110,4
2023-06-20,LZ,Slovakia,1747,1607,7,4,140,66,67,133,3
2023-06-21,LZ,Slovakia,1804,1658,5,5,146,68,73,141,0
2023-06-22,LZ,Slovakia,1842,1720,5,0,122,58,59,117,5
2023-06-23,LZ,Slovakia,2114,1983,4,0,131,66,61,127,4
2023-06-24,LZ,Slovakia,1958,1849,0,0,109,59,50,109,0
2023-06-25,LZ,Slovakia,2010,1907,3,2,103,44,56,100,1
2023-06-26,LZ,Slovakia,1854,1739,8,1,115,52,55,107,7
2023-06-27,LZ,Slovakia,1808,1684,9,5,124,59,56,115,4
2023-06-28,LZ,Slovakia,1996,1831,9,3,165,78,78,156,6
2023-06-29,LZ,Slovakia,1921,1780,7,0,141,67,67,134,7
2023-06-30,LZ,Slovakia,2111,1971,6,2,140,68,66,134,4
2023-07-01,LZ,Slovakia,2095,1989,1,0,106,53,52,105,1
2023-07-02,LZ,Slovakia,2065,1968,1,1,97,49,47,96,0
2023-07-03,LZ,Slovakia,1867,1751,1,0,116,59,56,115,1
2023-07-04,LZ,Slovakia,1904,1780,2,0,124,60,62,122,2
2023-07-05,LZ,Slovakia,1991,1846,4,1,145,69,72,141,3
2023-07-06,LZ,Slovakia,1967,1847,8,1,120,56,56,112,7
2023-07-07,LZ,Slovakia,2152,2024,8,2,128,60,60,120,6
2023-07-08,LZ,Slovakia,2126,2016,1,0,110,53,56,109,1
2023-07-09,LZ,Slovakia,2050,1951,4,3,99,47,48,95,1
2023-07-10,LZ,Slovakia,1973,1870,6,5,103,49,48,97,1
2023-07-11,LZ,Slovakia,1998,1876,8,4,122,57,57,114,4
2023-07-12,LZ,Slovakia,2076,1942,2,2,134,66,66,132,0
2023-07-13,LZ,Slovakia,2028,1903,10,4,125,59,56,115,6
2023-07-14,LZ,Slovakia,2102,1967,10,3,135,64,61,125,7
2023-07-15,LZ,Slovakia,2111,2002,1,1,109,52,56,108,0
2023-07-16,LZ,Slovakia,2103,2004,1,0,99,47,51,98,1
2023-07-17,LZ,Slovakia,1919,1813,5,4,106,50,51,101,1
2023-07-18,LZ,Slovakia,2079,1946,7,3,133,63,63,126,4
2023-07-19,LZ,Slovakia,2088,1921,5,3,167,80,82,162,2
2023-07-20,LZ,Slovakia,2000,1884,3,3,116,58,55,113,0
2023-07-21,LZ,Slovakia,2181,2058,2,2,123,59,62,121,0
2023-07-22,LZ,Slovakia,2055,1939,4,0,116,58,54,112,4
2023-07-23,LZ,Slovakia,2107,2015,0,0,92,48,44,92,0
2023-07-24,LZ,Slovakia,2054,1946,9,5,108,49,50,99,4
2023-07-25,LZ,Slovakia,2074,1943,5,2,131,62,64,126,3
2023-07-26,LZ,Slovakia,2090,1925,6,0,165,81,78,159,6
2023-07-27,LZ,Slovakia,2098,1981,7,1,117,54,56,110,6
2023-07-28,LZ,Slovakia,2165,2033,9,3,132,65,58,123,6
2023-07-29,LZ,Slovakia,2230,2115,4,1,115,56,55,111,3
2023-07-30,LZ,Slovakia,2128,2026,2,0,102,46,54,100,2
2023-07-31,LZ,Slovakia,1954,1849,6,5,105,52,47,99,1
2023-08-01,LZ,Slovakia,2050,1920,4,1,130,63,63,126,3
2023-08-02,LZ,Slovakia,2036,1887,5,5,149,69,75,144,0
2023-08-03,LZ,Slovakia,2006,1870,22,7,136,61,53,114,15
2023-08-04,LZ,Slovakia,2180,2058,3,1,122,59,60,119,2
2023-08-05,LZ,Slovakia,2055,1948,1,0,107,53,53,106,1
2023-08-06,LZ,Slovakia,2270,2168,0,0,102,53,49,102,0
2023-08-07,LZ,Slovakia,2082,1981,6,0,101,46,49,95,6
2023-08-08,LZ,Slovakia,2021,1905,7,4,116,54,55,109,3
2023-08-09,LZ,Slovakia,2063,1919,6,2,144,69,69,138,4
2023-08-10,LZ,Slovakia,1983,1871,9,5,112,51,52,103,4
2023-08-11,LZ,Slovakia,2063,1948,3,2,115,58,54,112,1
2023-08-12,LZ,Slovakia,2069,1962,4,1,107,52,51,103,3
2023-08-13,LZ,Slovakia,2126,2021,2,0,105,48,55,103,2
2023-08-14,LZ,Slovakia,1842,1749,3,2,93,44,46,90,1
2023-08-15,LZ,Slovakia,1904,1780,7,4,124,62,55,117,3
2023-08-16,LZ,Slovakia,2054,1881,8,5,173,77,88,165,3
2023-08-17,LZ,Slovakia,1943,1832,10,7,111,51,50,101,3
2023-08-18,LZ,Slovakia,2134,2009,6,2,125,60,59,119,4
2023-08-19,LZ,Slovakia,2093,1972,1,0,121,64,56,120,1
2023-08-20,LZ,Slovakia,2120,2027,7,0,93,41,45,86,7
2023-08-21,LZ,Slovakia,1842,1732,10,7,110,50,50,100,3
2023-08-22,LZ,Slovakia,1827,1699,12,2,128,59,57,116,10
2023-08-23,LZ,Slovakia,2042,1882,10,5,160,71,79,150,5
2023-08-24,LZ,Slovakia,1986,1870,7,4,116,57,52,109,3
2023-08-25,LZ,Slovakia,2267,2129,8,4,138,66,64,130,4
2023-08-26,LZ,Slovakia,2178,2064,1,0,114,56,57,113,1
2023-08-27,LZ,Slovakia,2038,1955,0,0,83,42,41,83,0
2023-08-28,LZ,Slovakia,1933,1826,3,0,107,54,50,104,3
2023-08-29,LZ,Slovakia,1875,1758,3,0,117,55,59,114,3
2023-08-30,LZ,Slovakia,1908,1760,2,1,148,73,73,146,1
2023-08-31,LZ,Slovakia,1981,1859,7,1,122,53,62,115,6
2023-09-01,LZ,Slovakia,2034,1898,2,0,136,59,75,134,2
2023-09-02,LZ,Slovakia,2036,1920,1,0,116,57,58,115,1
2023-09-03,LZ,Slovakia,1991,1893,0,0,98,51,47,98,0
2023-09-04,LZ,Slovakia,1815,1703,5,1,112,61,46,107,4
2023-09-05,LZ,Slovakia,1763,1647,4,4,116,58,54,112,0
2023-09-06,LZ,Slovakia,1869,1713,8,3,156,75,73,148,5
2023-09-07,LZ,Slovakia,1864,1741,18,7,123,49,56,105,11
2023-09-08,LZ,Slovakia,1962,1839,9,3,123,57,57,114,6
2023-09-09,LZ,Slovakia,2014,1902,3,0,112,57,52,109,3
2023-09-10,LZ,Slovakia,2018,1916,8,2,102,46,48,94,6
2023-09-11,LZ,Slovakia,1777,1681,9,7,96,44,43,87,2
2023-09-12,LZ,Slovakia,1794,1666,8,6,128,63,57,120,2
2023-09-13,LZ,Slovakia,1980,1835,6,3,145,68,71,139,3
2023-09-14,LZ,Slovakia,1791,1682,6,3,109,53,50,103,3
2023-09-15,LZ,Slovakia,1945,1830,5,0,115,57,53,110,5
2023-09-16,LZ,Slovakia,1960,1869,0,0,91,45,46,91,0
2023-09-17,LZ,Slovakia,2020,1932,3,0,88,41,44,85,3
2023-09-18,LZ,Slovakia,1842,1738,8,1,104,47,49,96,7
2023-09-19,LZ,Slovakia,1764,1650,9,2,114,54,51,105,7
2023-09-20,LZ,Slovakia,1831,1701,3,0,130,60,67,127,3
2023-09-21,LZ,Slovakia,1855,1758,4,0,97,46,47,93,4
2023-09-22,LZ,Slovakia,1896,1784,5,0,112,53,54,107,5
2023-09-23,LZ,Slovakia,1967,1882,2,0,85,43,40,83,2
2023-09-24,LZ,Slovakia,1943,1866,0,0,77,40,37,77,0
2023-09-25,LZ,Slovakia,1696,1609,4,2,87,41,42,83,2
2023-09-26,LZ,Slovakia,1608,1496,7,3,112,53,52,105,4
2023-09-27,LZ,Slovakia,1771,1656,8,4,115,52,55,107,4
2023-09-28,LZ,Slovakia,1835,1732,5,2,103,50,48,98,3
2023-09-29,LZ,Slovakia,1886,1789,6,1,97,44,47,91,5
2023-09-30,LZ,Slovakia,1966,1900,0,0,66,36,30,66,0
2023-10-01,LZ,Slovakia,1931,1873,0,0,58,25,33,58,0
2023-10-02,LZ,Slovakia,1671,1592,6,3,79,38,35,73,3
2023-01-01,LJ,Slovenia,896,868,0,0,28,14,14,28,0
2023-01-02,LJ,Slovenia,941,897,0,0,44,21,23,44,0
2023-01-03,LJ,Slovenia,893,844,3,0,49,25,21,46,3
2023-01-04,LJ,Slovenia,963,903,6,3,60,26,28,54,3
2023-01-05,LJ,Slovenia,934,878,5,1,56,26,25,51,4
2023-01-06,LJ,Slovenia,1004,956,7,3,48,21,20,41,4
2023-01-07,LJ,Slovenia,986,953,1,1,33,17,15,32,0
2023-01-08,LJ,Slovenia,1076,1038,0,0,38,16,22,38,0
2023-01-09,LJ,Slovenia,895,844,1,0,51,26,24,50,1
2023-01-10,LJ,Slovenia,732,676,5,5,56,28,23,51,0
2023-01-11,LJ,Slovenia,769,711,8,7,58,23,27,50,1
2023-01-12,LJ,Slovenia,751,701,5,1,50,23,22,45,4
2023-01-13,LJ,Slovenia,899,849,1,1,50,22,27,49,0
2023-01-14,LJ,Slovenia,876,825,4,2,51,25,22,47,2
2023-01-15,LJ,Slovenia,935,902,2,0,33,14,17,31,2
2023-01-16,LJ,Slovenia,821,778,0,0,43,22,21,43,0
2023-01-17,LJ,Slovenia,725,677,0,0,48,25,23,48,0
2023-01-18,LJ,Slovenia,736,687,1,1,49,23,25,48,0
2023-01-19,LJ,Slovenia,771,726,0,0,45,22,23,45,0
2023-01-20,LJ,Slovenia,880,825,3,1,55,26,26,52,2
2023-01-21,LJ,Slovenia,781,749,2,1,32,17,13,30,1
2023-01-22,LJ,Slovenia,819,785,0,0,34,16,18,34,0
2023-01-23,LJ,Slovenia,778,732,1,0,46,20,25,45,1
2023-01-24,LJ,Slovenia,664,617,0,0,47,27,20,47,0
2023-01-25,LJ,Slovenia,755,697,1,1,58,27,30,57,0
2023-01-26,LJ,Slovenia,691,648,0,0,43,23,20,43,0
2023-01-27,LJ,Slovenia,815,764,3,2,51,24,24,48,1
2023-01-28,LJ,Slovenia,780,753,2,2,27,14,11,25,0
2023-01-29,LJ,Slovenia,889,849,1,0,40,17,22,39,1
2023-01-30,LJ,Slovenia,798,738,5,1,60,26,29,55,4
2023-01-31,LJ,Slovenia,694,644,6,5,50,24,20,44,1
2023-02-01,LJ,Slovenia,776,724,7,3,52,22,23,45,4
2023-02-02,LJ,Slovenia,761,711,3,2,50,24,23,47,1
2023-02-03,LJ,Slovenia,941,887,1,1,54,26,27,53,0
2023-02-04,LJ,Slovenia,894,863,1,1,31,17,13,30,0
2023-02-05,LJ,Slovenia,911,868,0,0,43,20,23,43,0
2023-02-06,LJ,Slovenia,858,800,5,2,58,28,25,53,3
2023-02-07,LJ,Slovenia,808,756,8,5,52,24,20,44,3
2023-02-08,LJ,Slovenia,767,731,2,1,36,18,16,34,1
2023-02-09,LJ,Slovenia,800,747,4,4,53,24,25,49,0
2023-02-10,LJ,Slovenia,941,880,4,3,61,29,28,57,1
2023-02-11,LJ,Slovenia,864,818,4,4,46,19,23,42,0
2023-02-12,LJ,Slovenia,884,839,4,4,45,19,22,41,0
2023-02-13,LJ,Slovenia,850,788,8,1,62,26,28,54,7
2023-02-14,LJ,Slovenia,739,681,9,2,58,25,24,49,7
2023-02-15,LJ,Slovenia,795,740,6,5,55,23,26,49,1
2023-02-16,LJ,Slovenia,839,778,12,5,61,26,23,49,7
2023-02-17,LJ,Slovenia,792,722,6,3,70,32,32,64,3
2023-02-18,LJ,Slovenia,955,904,5,4,51,23,23,46,1
2023-02-19,LJ,Slovenia,992,947,1,1,45,22,22,44,0
2023-02-20,LJ,Slovenia,846,792,9,3,54,25,20,45,6
2023-02-21,LJ,Slovenia,771,717,12,6,54,20,22,42,6
2023-02-22,LJ,Slovenia,785,728,6,2,57,24,27,51,4
2023-02-23,LJ,Slovenia,810,758,4,4,52,27,21,48,0
2023-02-24,LJ,Slovenia,950,898,2,2,52,25,25,50,0
2023-02-25,LJ,Slovenia,920,890,0,0,30,14,16,30,0
2023-02-26,LJ,Slovenia,964,924,0,0,40,18,22,40,0
2023-02-27,LJ,Slovenia,884,827,1,1,57,28,28,56,0
2023-02-28,LJ,Slovenia,758,713,0,0,45,22,23,45,0
2023-03-01,LJ,Slovenia,814,759,2,0,55,25,28,53,2
2023-03-02,LJ,Slovenia,814,762,4,2,52,26,22,48,2
2023-03-03,LJ,Slovenia,963,906,2,1,57,29,26,55,1
2023-03-04,LJ,Slovenia,907,855,2,1,52,22,28,50,1
2023-03-05,LJ,Slovenia,973,915,1,0,58,29,28,57,1
2023-03-06,LJ,Slovenia,876,816,2,2,60,30,28,58,0
2023-03-07,LJ,Slovenia,748,706,0,0,42,23,19,42,0
2023-03-08,LJ,Slovenia,863,808,2,1,55,27,26,53,1
2023-03-09,LJ,Slovenia,867,808,2,2,59,31,26,57,0
2023-03-10,LJ,Slovenia,998,932,6,2,66,26,34,60,4
2023-03-11,LJ,Slovenia,920,878,3,1,42,21,18,39,2
2023-03-12,LJ,Slovenia,993,944,5,3,49,22,22,44,2
2023-03-13,LJ,Slovenia,899,836,7,3,63,29,27,56,4
2023-03-14,LJ,Slovenia,897,851,0,0,46,23,23,46,0
2023-03-15,LJ,Slovenia,913,846,6,3,67,28,33,61,3
2023-03-16,LJ,Slovenia,806,751,2,0,55,28,25,53,2
2023-03-17,LJ,Slovenia,1074,1001,6,4,73,33,34,67,2
2023-03-18,LJ,Slovenia,1007,952,2,2,55,27,26,53,0
2023-03-19,LJ,Slovenia,1103,1049,4,1,54,24,26,50,3
2023-03-20,LJ,Slovenia,998,937,2,2,61,31,28,59,0
2023-03-21,LJ,Slovenia,862,813,3,1,49,24,22,46,2
2023-03-22,LJ,Slovenia,863,799,6,4,64,28,30,58,2
2023-03-23,LJ,Slovenia,874,817,6,5,57,26,25,51,1
2023-03-24,LJ,Slovenia,1062,996,5,2,66,30,31,61,3
2023-03-25,LJ,Slovenia,992,950,3,1,42,18,21,39,2
2023-03-26,LJ,Slovenia,1109,1058,0,0,51,25,26,51,0
2023-03-27,LJ,Slovenia,904,856,1,1,48,23,24,47,0
2023-03-28,LJ,Slovenia,1052,984,7,2,68,30,31,61,5
2023-03-29,LJ,Slovenia,1113,1045,4,2,68,32,32,64,2
2023-03-30,LJ,Slovenia,1183,1115,1,1,68,34,33,67,0
2023-03-31,LJ,Slovenia,1321,1258,2,0,63,32,29,61,2
2023-04-01,LJ,Slovenia,1449,1396,1,1,53,25,27,52,0
2023-04-02,LJ,Slovenia,1409,1353,1,0,56,26,29,55,1
2023-04-03,LJ,Slovenia,1318,1257,2,0,61,29,30,59,2
2023-04-04,LJ,Slovenia,1274,1207,3,0,67,32,32,64,3
2023-04-05,LJ,Slovenia,1284,1207,8,5,77,37,32,69,3
2023-04-06,LJ,Slovenia,1224,1150,8,3,74,33,33,66,5
2023-04-07,LJ,Slovenia,1377,1313,5,5,64,28,31,59,0
2023-04-08,LJ,Slovenia,1436,1401,0,0,35,15,20,35,0
2023-04-09,LJ,Slovenia,1275,1231,0,0,44,22,22,44,0
2023-04-10,LJ,Slovenia,1318,1245,3,0,73,37,33,70,3
2023-04-11,LJ,Slovenia,1292,1230,10,1,62,26,26,52,9
2023-04-12,LJ,Slovenia,1314,1253,2,2,61,30,29,59,0
2023-04-13,LJ,Slovenia,1310,1264,0,0,46,23,23,46,0
2023-04-14,LJ,Slovenia,1367,1309,0,0,58,28,30,58,0
2023-04-15,LJ,Slovenia,1485,1443,0,0,42,22,20,42,0
2023-04-16,LJ,Slovenia,1387,1337,0,0,50,24,26,50,0
2023-04-17,LJ,Slovenia,1274,1215,1,1,59,30,28,58,0
2023-04-18,LJ,Slovenia,1191,1138,1,1,53,28,24,52,0
2023-04-19,LJ,Slovenia,1210,1150,2,2,60,26,32,58,0
2023-04-20,LJ,Slovenia,1218,1152,0,0,66,32,34,66,0
2023-04-21,LJ,Slovenia,1322,1247,1,1,75,37,37,74,0
2023-04-22,LJ,Slovenia,1481,1434,0,0,47,23,24,47,0
2023-04-23,LJ,Slovenia,1455,1394,2,1,61,32,27,59,1
2023-04-24,LJ,Slovenia,1263,1194,1,1,69,35,33,68,0
2023-04-25,LJ,Slovenia,1251,1189,1,0,62,30,31,61,1
2023-04-26,LJ,Slovenia,1247,1177,3,0,70,35,32,67,3
2023-04-27,LJ,Slovenia,1306,1244,0,0,62,31,31,62,0
2023-04-28,LJ,Slovenia,1442,1360,6,0,82,37,39,76,6
2023-04-29,LJ,Slovenia,1571,1530,0,0,41,21,20,41,0
2023-04-30,LJ,Slovenia,1515,1469,2,1,46,23,21,44,1
2023-05-01,LJ,Slovenia,1361,1313,0,0,48,24,24,48,0
2023-05-02,LJ,Slovenia,1370,1317,0,0,53,24,29,53,0
2023-05-03,LJ,Slovenia,1345,1280,0,0,65,32,33,65,0
2023-05-04,LJ,Slovenia,1406,1313,9,0,93,41,43,84,9
2023-05-05,LJ,Slovenia,1470,1397,4,1,73,34,35,69,3
2023-05-06,LJ,Slovenia,1600,1555,0,0,45,23,22,45,0
2023-05-07,LJ,Slovenia,1548,1489,3,1,59,28,28,56,2
2023-05-08,LJ,Slovenia,1457,1387,4,2,70,35,31,66,2
2023-05-09,LJ,Slovenia,1451,1367,9,2,84,33,42,75,7
2023-05-10,LJ,Slovenia,1402,1334,2,1,68,32,34,66,1
2023-05-11,LJ,Slovenia,1385,1325,1,0,60,32,27,59,1
2023-05-12,LJ,Slovenia,1555,1488,0,0,67,34,33,67,0
2023-05-13,LJ,Slovenia,1734,1692,0,0,42,21,21,42,0
2023-05-14,LJ,Slovenia,1702,1653,0,0,49,23,26,49,0
2023-05-15,LJ,Slovenia,1591,1515,0,0,76,41,35,76,0
2023-05-16,LJ,Slovenia,1487,1423,0,0,64,32,32,64,0
2023-05-17,LJ,Slovenia,1563,1491,0,0,72,36,36,72,0
2023-05-18,LJ,Slovenia,1541,1462,6,2,79,33,40,73,4
2023-05-19,LJ,Slovenia,1598,1514,3,1,84,39,42,81,2
2023-05-20,LJ,Slovenia,1744,1692,2,2,52,26,24,50,0
2023-05-21,LJ,Slovenia,1643,1579,3,1,64,32,29,61,2
2023-05-22,LJ,Slovenia,1438,1355,5,1,83,37,41,78,4
2023-05-23,LJ,Slovenia,1475,1404,2,1,71,35,34,69,1
2023-05-24,LJ,Slovenia,1554,1484,0,0,70,37,33,70,0
2023-05-25,LJ,Slovenia,1546,1459,4,3,87,39,44,83,1
2023-05-26,LJ,Slovenia,1682,1589,5,3,93,44,44,88,2
2023-05-27,LJ,Slovenia,1826,1761,1,1,65,32,32,64,0
2023-05-28,LJ,Slovenia,1724,1661,6,1,63,26,31,57,5
2023-05-29,LJ,Slovenia,1731,1657,6,0,74,38,30,68,6
2023-05-30,LJ,Slovenia,1612,1532,6,2,80,37,37,74,4
2023-05-31,LJ,Slovenia,1654,1585,1,1,69,33,35,68,0
2023-06-01,LJ,Slovenia,1695,1620,0,0,75,37,38,75,0
2023-06-02,LJ,Slovenia,1732,1641,3,1,91,44,44,88,2
2023-06-03,LJ,Slovenia,1807,1760,2,0,47,22,23,45,2
2023-06-04,LJ,Slovenia,1738,1680,0,0,58,29,29,58,0
2023-06-05,LJ,Slovenia,1634,1581,2,0,53,25,26,51,2
2023-06-06,LJ,Slovenia,1737,1664,3,3,73,35,35,70,0
2023-06-07,LJ,Slovenia,1712,1639,4,1,73,36,33,69,3
2023-06-08,LJ,Slovenia,1776,1712,0,0,64,31,33,64,0
2023-06-09,LJ,Slovenia,1858,1782,1,1,76,37,38,75,0
2023-06-10,LJ,Slovenia,1917,1863,0,0,54,26,28,54,0
2023-06-11,LJ,Slovenia,1931,1859,0,0,72,38,34,72,0
2023-06-12,LJ,Slovenia,1704,1623,2,0,81,41,38,79,2
2023-06-13,LJ,Slovenia,1708,1630,3,2,78,36,39,75,1
2023-06-14,LJ,Slovenia,1693,1611,1,1,82,39,42,81,0
2023-06-15,LJ,Slovenia,1719,1652,2,1,67,31,34,65,1
2023-06-16,LJ,Slovenia,1772,1685,3,2,87,42,42,84,1
2023-06-17,LJ,Slovenia,1931,1871,5,3,60,27,28,55,2
2023-06-18,LJ,Slovenia,1851,1781,2,2,70,35,33,68,0
2023-06-19,LJ,Slovenia,1695,1616,0,0,79,43,36,79,0
2023-06-20,LJ,Slovenia,1679,1600,2,1,79,39,38,77,1
2023-06-21,LJ,Slovenia,1604,1520,0,0,84,43,41,84,0
2023-06-22,LJ,Slovenia,1655,1577,1,1,78,38,39,77,0
2023-06-23,LJ,Slovenia,1662,1572,0,0,90,46,44,90,0
2023-06-24,LJ,Slovenia,1985,1912,3,0,73,35,35,70,3
2023-06-25,LJ,Slovenia,1912,1846,2,0,66,34,30,64,2
2023-06-26,LJ,Slovenia,1728,1654,6,2,74,35,33,68,4
2023-06-27,LJ,Slovenia,1774,1705,5,2,69,31,33,64,3
2023-06-28,LJ,Slovenia,1682,1609,4,2,73,33,36,69,2
2023-06-29,LJ,Slovenia,1746,1659,7,1,87,37,43,80,6
2023-06-30,LJ,Slovenia,1828,1740,4,0,88,43,41,84,4
2023-07-01,LJ,Slovenia,1937,1883,0,0,54,26,28,54,0
2023-07-02,LJ,Slovenia,1940,1875,1,1,65,36,28,64,0
2023-07-03,LJ,Slovenia,1813,1740,2,0,73,37,34,71,2
2023-07-04,LJ,Slovenia,1765,1688,3,2,77,35,39,74,1
2023-07-05,LJ,Slovenia,1721,1631,3,0,90,41,46,87,3
2023-07-06,LJ,Slovenia,1916,1844,8,2,72,33,31,64,6
2023-07-07,LJ,Slovenia,1936,1847,4,0,89,41,44,85,4
2023-07-08,LJ,Slovenia,1983,1917,0,0,66,30,36,66,0
2023-07-09,LJ,Slovenia,2092,2022,0,0,70,37,33,70,0
2023-07-10,LJ,Slovenia,1810,1718,7,0,92,45,40,85,7
2023-07-11,LJ,Slovenia,1801,1722,7,0,79,38,34,72,7
2023-07-12,LJ,Slovenia,1802,1709,10,1,93,42,41,83,9
2023-07-13,LJ,Slovenia,1725,1670,0,0,55,28,27,55,0
2023-07-14,LJ,Slovenia,1966,1881,3,3,85,38,44,82,0
2023-07-15,LJ,Slovenia,1962,1907,1,0,55,30,24,54,1
2023-07-16,LJ,Slovenia,2053,1995,0,0,58,29,29,58,0
2023-07-17,LJ,Slovenia,1816,1741,4,0,75,36,35,71,4
2023-07-18,LJ,Slovenia,1584,1505,2,0,79,38,39,77,2
2023-07-19,LJ,Slovenia,1646,1550,8,2,96,42,46,88,6
2023-07-20,LJ,Slovenia,1785,1709,2,1,76,38,36,74,1
2023-07-21,LJ,Slovenia,1860,1784,0,0,76,36,40,76,0
2023-07-22,LJ,Slovenia,2053,1984,0,0,69,37,32,69,0
2023-07-23,LJ,Slovenia,2093,2017,5,0,76,33,38,71,5
2023-07-24,LJ,Slovenia,1744,1659,6,1,85,41,38,79,5
2023-07-25,LJ,Slovenia,1690,1631,0,0,59,30,29,59,0
2023-07-26,LJ,Slovenia,1837,1747,5,2,90,38,47,85,3
2023-07-27,LJ,Slovenia,1888,1806,4,1,82,42,36,78,3
2023-07-28,LJ,Slovenia,1969,1885,2,0,84,40,42,82,2
2023-07-29,LJ,Slovenia,2035,1980,0,0,55,29,26,55,0
2023-07-30,LJ,Slovenia,1933,1859,0,0,74,34,40,74,0
2023-07-31,LJ,Slovenia,1881,1799,1,1,82,42,39,81,0
2023-08-01,LJ,Slovenia,1854,1786,1,1,68,33,34,67,0
2023-08-02,LJ,Slovenia,1862,1782,0,0,80,40,40,80,0
2023-08-03,LJ,Slovenia,1845,1771,0,0,74,39,35,74,0
2023-08-04,LJ,Slovenia,1741,1676,0,0,65,32,33,65,0
2023-08-05,LJ,Slovenia,1993,1931,0,0,62,32,30,62,0
2023-08-06,LJ,Slovenia,1851,1790,1,1,61,28,32,60,0
2023-08-07,LJ,Slovenia,1785,1704,1,1,81,37,43,80,0
2023-08-08,LJ,Slovenia,1864,1779,2,1,85,44,39,83,1
2023-08-09,LJ,Slovenia,1826,1742,7,3,84,38,39,77,4
2023-08-10,LJ,Slovenia,1828,1760,1,1,68,35,32,67,0
2023-08-11,LJ,Slovenia,1950,1873,2,2,77,34,41,75,0
2023-08-12,LJ,Slovenia,1996,1927,1,1,69,34,34,68,0
2023-08-13,LJ,Slovenia,1938,1865,3,3,73,35,35,70,0
2023-08-14,LJ,Slovenia,1730,1654,2,0,76,39,35,74,2
2023-08-15,LJ,Slovenia,1778,1719,2,2,59,30,27,57,0
2023-08-16,LJ,Slovenia,1769,1683,5,2,86,42,39,81,3
2023-08-17,LJ,Slovenia,1781,1715,1,0,66,33,32,65,1
2023-08-18,LJ,Slovenia,1858,1784,3,2,74,35,36,71,1
2023-08-19,LJ,Slovenia,1984,1909,0,0,75,37,38,75,0
2023-08-20,LJ,Slovenia,1940,1886,1,0,54,26,27,53,1
2023-08-21,LJ,Slovenia,1734,1654,2,0,80,39,39,78,2
2023-08-22,LJ,Slovenia,1852,1770,6,1,82,39,37,76,5
2023-08-23,LJ,Slovenia,1735,1656,1,0,79,37,41,78,1
2023-08-24,LJ,Slovenia,1721,1627,16,2,94,42,36,78,14
2023-08-25,LJ,Slovenia,1805,1712,2,2,93,43,48,91,0
2023-08-26,LJ,Slovenia,1894,1828,2,2,66,32,32,64,0
2023-08-27,LJ,Slovenia,2059,1978,4,3,81,39,38,77,1
2023-08-28,LJ,Slovenia,1619,1540,0,0,79,38,41,79,0
2023-08-29,LJ,Slovenia,1894,1808,0,0,86,45,41,86,0
2023-08-30,LJ,Slovenia,1815,1735,0,0,80,39,41,80,0
2023-08-31,LJ,Slovenia,1759,1681,3,1,78,36,39,75,2
2023-09-01,LJ,Slovenia,1826,1736,4,3,90,45,41,86,1
2023-09-02,LJ,Slovenia,2020,1955,0,0,65,29,36,65,0
2023-09-03,LJ,Slovenia,1882,1818,1,1,64,32,31,63,0
2023-09-04,LJ,Slovenia,1703,1625,2,2,78,38,38,76,0
2023-09-05,LJ,Slovenia,1686,1604,5,2,82,40,37,77,3
2023-09-06,LJ,Slovenia,1704,1625,7,3,79,36,36,72,4
2023-09-07,LJ,Slovenia,1736,1666,7,4,70,31,32,63,3
2023-09-08,LJ,Slovenia,1820,1741,1,1,79,38,40,78,0
2023-09-09,LJ,Slovenia,1995,1939,1,0,56,28,27,55,1
2023-09-10,LJ,Slovenia,1968,1884,2,0,84,42,40,82,2
2023-09-11,LJ,Slovenia,1715,1633,3,1,82,39,40,79,2
2023-09-12,LJ,Slovenia,1759,1673,3,2,86,42,41,83,1
2023-09-13,LJ,Slovenia,1738,1650,1,1,88,43,44,87,0
2023-09-14,LJ,Slovenia,1728,1654,3,3,74,37,34,71,0
2023-09-15,LJ,Slovenia,1717,1620,4,0,97,40,53,93,4
2023-09-16,LJ,Slovenia,1945,1876,3,1,69,34,32,66,2
2023-09-17,LJ,Slovenia,1794,1725,1,0,69,37,31,68,1
2023-09-18,LJ,Slovenia,1688,1606,3,1,82,42,37,79,2
2023-09-19,LJ,Slovenia,1775,1690,0,0,85,42,43,85,0
2023-09-20,LJ,Slovenia,1736,1650,5,3,86,41,40,81,2
2023-09-21,LJ,Slovenia,1677,1616,0,0,61,31,30,61,0
2023-09-22,LJ,Slovenia,1736,1668,1,0,68,35,32,67,1
2023-09-23,LJ,Slovenia,1874,1826,0,0,48,24,24,48,0
2023-09-24,LJ,Slovenia,1840,1770,0,0,70,31,39,70,0
2023-09-25,LJ,Slovenia,1569,1500,2,2,69,34,33,67,0
2023-09-26,LJ,Slovenia,1663,1583,3,1,80,38,39,77,2
2023-09-27,LJ,Slovenia,1600,1503,4,1,97,46,47,93,3
2023-09-28,LJ,Slovenia,1680,1605,1,1,75,39,35,74,0
2023-09-29,LJ,Slovenia,1722,1647,2,2,75,37,36,73,0
2023-09-30,LJ,Slovenia,1938,1874,0,0,64,34,30,64,0
2023-10-01,LJ,Slovenia,1915,1843,2,1,72,32,38,70,1
2023-10-02,LJ,Slovenia,1606,1541,2,1,65,33,30,63,1
2023-01-01,LE,Spain,4681,1251,903,1,3430,1275,1252,2527,902
2023-01-02,LE,Spain,5215,1378,1041,2,3837,1422,1374,2796,1039
2023-01-03,LE,Spain,4915,1316,1017,11,3599,1299,1283,2582,1006
2023-01-04,LE,Spain,4760,1188,1045,21,3572,1260,1267,2527,1024
2023-01-05,LE,Spain,4806,1217,967,16,3589,1303,1319,2622,951
2023-01-06,LE,Spain,5009,1339,976,3,3670,1344,1350,2694,973
2023-01-07,LE,Spain,5212,1328,955,9,3884,1469,1460,2929,946
2023-01-08,LE,Spain,5243,1271,1120,6,3972,1437,1415,2852,1114
2023-01-09,LE,Spain,4843,1260,1080,24,3583,1260,1243,2503,1056
2023-01-10,LE,Spain,4126,1009,968,21,3117,1072,1077,2149,947
2023-01-11,LE,Spain,3959,923,1016,36,3036,1000,1020,2020,980
2023-01-12,LE,Spain,4334,1025,1066,40,3309,1116,1127,2243,1026
2023-01-13,LE,Spain,4789,1205,1153,24,3584,1208,1223,2431,1129
2023-01-14,LE,Spain,4683,1150,962,17,3533,1281,1290,2571,945
2023-01-15,LE,Spain,4788,1181,1027,11,3607,1299,1281,2580,1016
2023-01-16,LE,Spain,4474,1139,1044,17,3335,1159,1132,2291,1027
2023-01-17,LE,Spain,3791,918,952,21,2873,965,956,1921,931
2023-01-18,LE,Spain,3798,867,991,27,2931,963,977,1940,964
2023-01-19,LE,Spain,4100,926,1073,32,3174,1037,1064,2101,1041
2023-01-20,LE,Spain,4769,1184,1192,32,3585,1192,1201,2393,1160
2023-01-21,LE,Spain,4646,1172,946,10,3474,1264,1264,2528,936
2023-01-22,LE,Spain,4725,1142,1070,13,3583,1264,1249,2513,1057
2023-01-23,LE,Spain,4451,1105,1090,36,3346,1134,1122,2256,1054
2023-01-24,LE,Spain,3820,894,992,40,2926,969,965,1934,952
2023-01-25,LE,Spain,3852,852,1054,55,3000,977,969,1946,999
2023-01-26,LE,Spain,4219,970,1078,46,3249,1071,1100,2171,1032
2023-01-27,LE,Spain,4758,1129,1190,30,3629,1221,1218,2439,1160
2023-01-28,LE,Spain,4566,1121,958,20,3445,1239,1248,2487,938
2023-01-29,LE,Spain,4722,1132,1056,10,3590,1278,1256,2534,1046
2023-01-30,LE,Spain,4530,1142,1084,39,3388,1147,1157,2304,1045
2023-01-31,LE,Spain,3888,937,1009,59,2951,969,973,1942,950
2023-02-01,LE,Spain,4011,920,1050,51,3091,1021,1020,2041,999
2023-02-02,LE,Spain,4292,1009,1031,48,3283,1122,1130,2252,983
2023-02-03,LE,Spain,4910,1179,1231,32,3731,1252,1248,2500,1199
2023-02-04,LE,Spain,4771,1163,998,22,3608,1307,1303,2610,976
2023-02-05,LE,Spain,4903,1179,1140,21,3724,1304,1280,2584,1119
2023-02-06,LE,Spain,4676,1188,1111,39,3488,1194,1183,2377,1072
2023-02-07,LE,Spain,3921,946,968,33,2975,1001,1006,2007,935
2023-02-08,LE,Spain,4033,944,1000,38,3089,1048,1041,2089,962
2023-02-09,LE,Spain,4424,1072,1044,49,3352,1150,1158,2308,995
2023-02-10,LE,Spain,5106,1247,1227,34,3859,1309,1323,2632,1193
2023-02-11,LE,Spain,4980,1254,985,24,3726,1357,1384,2741,961
2023-02-12,LE,Spain,5102,1260,1095,16,3842,1389,1358,2747,1079
2023-02-13,LE,Spain,4858,1211,1115,32,3647,1261,1271,2532,1083
2023-02-14,LE,Spain,4353,1088,1031,38,3265,1133,1101,2234,993
2023-02-15,LE,Spain,4387,1080,1061,40,3307,1108,1138,2246,1021
2023-02-16,LE,Spain,4779,1144,1114,43,3635,1248,1273,2521,1071
2023-02-17,LE,Spain,5262,1293,1287,30,3969,1339,1343,2682,1257
2023-02-18,LE,Spain,5388,1372,1071,25,4016,1465,1480,2945,1046
2023-02-19,LE,Spain,5371,1330,1170,26,4041,1441,1430,2871,1144
2023-02-20,LE,Spain,5058,1240,1171,40,3818,1333,1314,2647,1131
2023-02-21,LE,Spain,4524,1122,1093,43,3402,1164,1145,2309,1050
2023-02-22,LE,Spain,4558,1137,1107,41,3421,1153,1161,2314,1066
2023-02-23,LE,Spain,4846,1201,1097,34,3645,1270,1278,2548,1063
2023-02-24,LE,Spain,5445,1392,1272,32,4053,1388,1393,2781,1240
2023-02-25,LE,Spain,5282,1383,1007,12,3899,1441,1451,2892,995
2023-02-26,LE,Spain,5413,1352,1140,12,4061,1451,1470,2921,1128
2023-02-27,LE,Spain,5069,1322,1107,25,3747,1324,1316,2640,1082
2023-02-28,LE,Spain,4574,1177,1033,26,3397,1199,1165,2364,1007
2023-03-01,LE,Spain,4673,1192,1107,38,3481,1183,1191,2374,1069
2023-03-02,LE,Spain,4979,1263,1150,38,3716,1282,1284,2566,1112
2023-03-03,LE,Spain,5572,1398,1276,33,4174,1442,1456,2898,1243
2023-03-04,LE,Spain,5297,1359,1056,21,3938,1439,1443,2882,1035
2023-03-05,LE,Spain,5340,1317,1150,16,4023,1444,1429,2873,1134
2023-03-06,LE,Spain,5105,1323,1132,24,3782,1334,1316,2650,1108
2023-03-07,LE,Spain,4406,1076,1048,43,3330,1151,1131,2282,1005
2023-03-08,LE,Spain,4430,1083,1096,52,3347,1119,1132,2251,1044
2023-03-09,LE,Spain,4742,1160,1112,34,3582,1230,1240,2470,1078
2023-03-10,LE,Spain,5140,1247,1239,26,3893,1320,1334,2654,1213
2023-03-11,LE,Spain,5141,1275,1044,20,3866,1407,1415,2822,1024
2023-03-12,LE,Spain,5267,1267,1166,26,4000,1424,1410,2834,1140
2023-03-13,LE,Spain,5110,1307,1195,54,3803,1323,1285,2608,1141
2023-03-14,LE,Spain,4580,1170,1049,40,3410,1180,1181,2361,1009
2023-03-15,LE,Spain,4573,1112,1125,39,3461,1153,1183,2336,1086
2023-03-16,LE,Spain,4913,1168,1163,52,3745,1299,1283,2582,1111
2023-03-17,LE,Spain,5378,1328,1274,30,4050,1377,1399,2776,1244
2023-03-18,LE,Spain,5256,1327,1002,14,3929,1461,1466,2927,988
2023-03-19,LE,Spain,5369,1284,1169,16,4085,1465,1451,2916,1153
2023-03-20,LE,Spain,5152,1234,1187,32,3918,1379,1352,2731,1155
2023-03-21,LE,Spain,4657,1132,1120,53,3525,1207,1198,2405,1067
2023-03-22,LE,Spain,4627,1122,1124,43,3505,1178,1203,2381,1081
2023-03-23,LE,Spain,4859,1130,1179,47,3729,1271,1279,2550,1132
2023-03-24,LE,Spain,5369,1267,1293,34,4102,1393,1416,2809,1259
2023-03-25,LE,Spain,5277,1277,1056,10,4000,1462,1482,2944,1046
2023-03-26,LE,Spain,5642,1264,1208,21,4378,1584,1586,3170,1187
2023-03-27,LE,Spain,5309,1208,1235,35,4101,1441,1425,2866,1200
2023-03-28,LE,Spain,5349,1158,1176,54,4191,1506,1509,3015,1122
2023-03-29,LE,Spain,5403,1193,1235,38,4210,1489,1486,2975,1197
2023-03-30,LE,Spain,5753,1214,1297,31,4539,1624,1618,3242,1266
2023-03-31,LE,Spain,6029,1286,1328,15,4743,1698,1717,3415,1313
2023-04-01,LE,Spain,6301,1379,1143,7,4922,1879,1900,3779,1136
2023-04-02,LE,Spain,6036,1309,1214,10,4727,1762,1751,3513,1204
2023-04-03,LE,Spain,5845,1290,1241,27,4555,1665,1649,3314,1214
2023-04-04,LE,Spain,5747,1290,1189,23,4457,1630,1638,3268,1166
2023-04-05,LE,Spain,5929,1264,1337,32,4665,1651,1677,3328,1305
2023-04-06,LE,Spain,6081,1313,1248,10,4768,1737,1783,3520,1238
2023-04-07,LE,Spain,6033,1353,1136,15,4680,1762,1782,3544,1121
2023-04-08,LE,Spain,6285,1367,1149,21,4918,1884,1885,3769,1128
2023-04-09,LE,Spain,6199,1372,1280,11,4827,1766,1781,3547,1269
2023-04-10,LE,Spain,6207,1346,1305,23,4861,1815,1741,3556,1282
2023-04-11,LE,Spain,5931,1295,1198,29,4636,1733,1705,3438,1169
2023-04-12,LE,Spain,5765,1276,1241,33,4489,1627,1621,3248,1208
2023-04-13,LE,Spain,6064,1350,1290,30,4714,1710,1714,3424,1260
2023-04-14,LE,Spain,6343,1423,1299,26,4920,1799,1822,3621,1273
2023-04-15,LE,Spain,6381,1434,1091,13,4947,1934,1922,3856,1078
2023-04-16,LE,Spain,6324,1468,1241,17,4856,1828,1787,3615,1224
2023-04-17,LE,Spain,6022,1402,1248,23,4620,1698,1674,3372,1225
2023-04-18,LE,Spain,5832,1344,1167,19,4488,1656,1665,3321,1148
2023-04-19,LE,Spain,5840,1391,1263,40,4449,1586,1600,3186,1223
2023-04-20,LE,Spain,6092,1401,1308,31,4691,1690,1693,3383,1277
2023-04-21,LE,Spain,6267,1444,1341,31,4823,1723,1759,3482,1310
2023-04-22,LE,Spain,6310,1461,1098,10,4849,1864,1887,3751,1088
2023-04-23,LE,Spain,6310,1474,1225,10,4836,1823,1788,3611,1215
2023-04-24,LE,Spain,6031,1409,1256,27,4622,1694,1672,3366,1229
2023-04-25,LE,Spain,5877,1364,1196,28,4513,1665,1652,3317,1168
2023-04-26,LE,Spain,5895,1354,1301,31,4541,1606,1634,3240,1270
2023-04-27,LE,Spain,6256,1447,1355,26,4809,1715,1739,3454,1329
2023-04-28,LE,Spain,6502,1422,1390,27,5080,1795,1895,3690,1363
2023-04-29,LE,Spain,6432,1466,1162,11,4966,1904,1900,3804,1151
2023-04-30,LE,Spain,6310,1475,1208,12,4835,1825,1802,3627,1196
2023-05-01,LE,Spain,5935,1285,1250,6,4650,1727,1673,3400,1244
2023-05-02,LE,Spain,6077,1371,1227,38,4706,1746,1733,3479,1189
2023-05-03,LE,Spain,6021,1435,1266,31,4586,1676,1644,3320,1235
2023-05-04,LE,Spain,6343,1485,1366,44,4858,1734,1758,3492,1322
2023-05-05,LE,Spain,6449,1450,1353,41,4999,1796,1850,3646,1312
2023-05-06,LE,Spain,6495,1483,1118,21,5012,1942,1952,3894,1097
2023-05-07,LE,Spain,6478,1539,1234,13,4939,1869,1836,3705,1221
2023-05-08,LE,Spain,6296,1460,1262,30,4836,1801,1773,3574,1232
2023-05-09,LE,Spain,6189,1342,1230,54,4847,1794,1823,3617,1176
2023-05-10,LE,Spain,6133,1416,1289,39,4717,1736,1692,3428,1250
2023-05-11,LE,Spain,6277,1449,1342,44,4828,1742,1744,3486,1298
2023-05-12,LE,Spain,6439,1441,1317,34,4998,1833,1848,3681,1283
2023-05-13,LE,Spain,6499,1474,1112,26,5025,1953,1960,3913,1086
2023-05-14,LE,Spain,6459,1502,1219,13,4957,1880,1858,3738,1206
2023-05-15,LE,Spain,6231,1441,1268,46,4790,1767,1755,3522,1222
2023-05-16,LE,Spain,6159,1362,1198,35,4797,1802,1797,3599,1163
2023-05-17,LE,Spain,6261,1415,1301,46,4846,1750,1795,3545,1255
2023-05-18,LE,Spain,6485,1491,1321,35,4994,1816,1857,3673,1286
2023-05-19,LE,Spain,6356,1381,1311,19,4975,1835,1829,3664,1292
2023-05-20,LE,Spain,6538,1485,1095,10,5053,1980,1978,3958,1085
2023-05-21,LE,Spain,6641,1520,1205,3,5121,1988,1928,3916,1202
2023-05-22,LE,Spain,6236,1423,1241,21,4813,1809,1763,3572,1220
2023-05-23,LE,Spain,6185,1357,1166,23,4828,1828,1834,3662,1143
2023-05-24,LE,Spain,6093,1397,1259,25,4696,1714,1723,3437,1234
2023-05-25,LE,Spain,6344,1430,1276,31,4914,1808,1830,3638,1245
2023-05-26,LE,Spain,6545,1367,1310,21,5178,1901,1967,3868,1289
2023-05-27,LE,Spain,6761,1496,1155,8,5265,2044,2066,4110,1147
2023-05-28,LE,Spain,6475,1424,1217,2,5051,1925,1909,3834,1215
2023-05-29,LE,Spain,6451,1481,1226,31,4970,1906,1838,3744,1195
2023-05-30,LE,Spain,6327,1350,1221,37,4977,1895,1861,3756,1184
2023-05-31,LE,Spain,6300,1394,1280,40,4906,1807,1819,3626,1240
2023-06-01,LE,Spain,6513,1396,1313,31,5117,1870,1934,3804,1282
2023-06-02,LE,Spain,6581,1444,1316,30,5137,1892,1929,3821,1286
2023-06-03,LE,Spain,6698,1431,1113,14,5267,2072,2082,4154,1099
2023-06-04,LE,Spain,6734,1533,1237,10,5201,2022,1942,3964,1227
2023-06-05,LE,Spain,6490,1486,1263,25,5004,1874,1867,3741,1238
2023-06-06,LE,Spain,6009,1315,1146,46,4694,1779,1769,3548,1100
2023-06-07,LE,Spain,6326,1438,1207,38,4888,1843,1838,3681,1169
2023-06-08,LE,Spain,6565,1508,1267,31,5057,1869,1921,3790,1236
2023-06-09,LE,Spain,6678,1487,1310,33,5191,1931,1950,3881,1277
2023-06-10,LE,Spain,6788,1529,1065,12,5259,2106,2088,4194,1053
2023-06-11,LE,Spain,6774,1566,1222,9,5208,2009,1977,3986,1213
2023-06-12,LE,Spain,6468,1553,1261,23,4915,1832,1822,3654,1238
2023-06-13,LE,Spain,6558,1520,1202,51,5038,1921,1915,3836,1151
2023-06-14,LE,Spain,6446,1516,1250,38,4930,1835,1845,3680,1212
2023-06-15,LE,Spain,6785,1558,1351,43,5227,1926,1950,3876,1308
2023-06-16,LE,Spain,6978,1528,1406,34,5450,2002,2042,4044,1372
2023-06-17,LE,Spain,6976,1546,1143,21,5430,2156,2131,4287,1122
2023-06-18,LE,Spain,6802,1536,1278,7,5266,1999,1989,3988,1271
2023-06-19,LE,Spain,6741,1576,1347,30,5165,1920,1898,3818,1317
2023-06-20,LE,Spain,6690,1489,1282,38,5201,1966,1953,3919,1244
2023-06-21,LE,Spain,6679,1535,1342,37,5144,1893,1909,3802,1305
2023-06-22,LE,Spain,6947,1597,1371,34,5350,1974,2005,3979,1337
2023-06-23,LE,Spain,6969,1511,1396,33,5458,2011,2051,4062,1363
2023-06-24,LE,Spain,7059,1591,1139,19,5468,2165,2164,4329,1120
2023-06-25,LE,Spain,7035,1596,1274,9,5439,2092,2073,4165,1265
2023-06-26,LE,Spain,6873,1606,1343,29,5267,1982,1942,3924,1314
2023-06-27,LE,Spain,6809,1527,1289,55,5282,2009,1984,3993,1234
2023-06-28,LE,Spain,6683,1500,1369,47,5183,1897,1917,3814,1322
2023-06-29,LE,Spain,6934,1548,1376,44,5386,1999,2011,4010,1332
2023-06-30,LE,Spain,7090,1532,1434,33,5558,2037,2087,4124,1401
2023-07-01,LE,Spain,7272,1569,1198,25,5703,2263,2242,4505,1173
2023-07-02,LE,Spain,7270,1593,1353,17,5677,2157,2167,4324,1336
2023-07-03,LE,Spain,7069,1603,1405,30,5466,2055,2006,4061,1375
2023-07-04,LE,Spain,7002,1540,1314,37,5462,2071,2077,4148,1277
2023-07-05,LE,Spain,6932,1572,1407,42,5360,1978,1975,3953,1365
2023-07-06,LE,Spain,7202,1611,1431,44,5591,2077,2083,4160,1387
2023-07-07,LE,Spain,7292,1547,1469,30,5745,2117,2159,4276,1439
2023-07-08,LE,Spain,7335,1610,1213,15,5725,2265,2247,4512,1198
2023-07-09,LE,Spain,7306,1609,1345,13,5697,2176,2176,4352,1332
2023-07-10,LE,Spain,7185,1633,1440,31,5552,2069,2043,4112,1409
2023-07-11,LE,Spain,7042,1555,1343,37,5487,2075,2069,4144,1306
2023-07-12,LE,Spain,7086,1595,1437,44,5491,2031,2023,4054,1393
2023-07-13,LE,Spain,7211,1650,1427,33,5561,2061,2073,4134,1394
2023-07-14,LE,Spain,7263,1605,1441,18,5658,2097,2120,4217,1423
2023-07-15,LE,Spain,7299,1604,1207,18,5695,2253,2235,4488,1189
2023-07-16,LE,Spain,7286,1630,1331,6,5656,2180,2145,4325,1325
2023-07-17,LE,Spain,7190,1684,1424,30,5506,2035,2047,4082,1394
2023-07-18,LE,Spain,7097,1590,1328,31,5507,2091,2088,4179,1297
2023-07-19,LE,Spain,7030,1586,1425,48,5444,2013,2006,4019,1377
2023-07-20,LE,Spain,7303,1672,1438,34,5631,2089,2104,4193,1404
2023-07-21,LE,Spain,7184,1516,1439,36,5668,2094,2135,4229,1403
2023-07-22,LE,Spain,7449,1630,1217,7,5819,2301,2301,4602,1210
2023-07-23,LE,Spain,7174,1515,1332,9,5659,2171,2156,4327,1323
2023-07-24,LE,Spain,7077,1585,1411,29,5492,2043,2038,4081,1382
2023-07-25,LE,Spain,7015,1536,1316,26,5479,2088,2075,4163,1290
2023-07-26,LE,Spain,7077,1616,1381,36,5461,2046,2034,4080,1345
2023-07-27,LE,Spain,7215,1638,1409,38,5577,2076,2092,4168,1371
2023-07-28,LE,Spain,7348,1628,1465,30,5720,2117,2138,4255,1435
2023-07-29,LE,Spain,7401,1619,1224,17,5782,2274,2284,4558,1207
2023-07-30,LE,Spain,7363,1631,1329,16,5732,2217,2186,4403,1313
2023-07-31,LE,Spain,7193,1639,1397,20,5554,2089,2068,4157,1377
2023-08-01,LE,Spain,7175,1628,1320,36,5547,2120,2107,4227,1284
2023-08-02,LE,Spain,7096,1676,1356,38,5420,2033,2031,4064,1318
2023-08-03,LE,Spain,7212,1664,1376,28,5548,2088,2084,4172,1348
2023-08-04,LE,Spain,7226,1630,1382,18,5596,2083,2131,4214,1364
2023-08-05,LE,Spain,7430,1648,1207,17,5782,2294,2281,4575,1190
2023-08-06,LE,Spain,7267,1608,1301,17,5659,2182,2176,4358,1284
2023-08-07,LE,Spain,7170,1655,1391,27,5515,2076,2048,4124,1364
2023-08-08,LE,Spain,6986,1539,1300,42,5447,2081,2066,4147,1258
2023-08-09,LE,Spain,6971,1635,1351,36,5336,1989,1996,3985,1315
2023-08-10,LE,Spain,7172,1665,1374,44,5507,2062,2071,4133,1330
2023-08-11,LE,Spain,7234,1585,1435,30,5649,2087,2127,4214,1405
2023-08-12,LE,Spain,7444,1638,1249,18,5806,2287,2270,4557,1231
2023-08-13,LE,Spain,7207,1640,1288,17,5567,2152,2127,4279,1271
2023-08-14,LE,Spain,7033,1627,1352,15,5406,2025,2029,4054,1337
2023-08-15,LE,Spain,6912,1559,1235,31,5353,2079,2039,4118,1204
2023-08-16,LE,Spain,6892,1606,1337,34,5286,1969,1980,3949,1303
2023-08-17,LE,Spain,7169,1689,1373,34,5480,2050,2057,4107,1339
2023-08-18,LE,Spain,7152,1642,1389,29,5510,2061,2060,4121,1360
2023-08-19,LE,Spain,7322,1634,1215,21,5688,2242,2231,4473,1194
2023-08-20,LE,Spain,7258,1652,1305,23,5606,2157,2144,4301,1282
2023-08-21,LE,Spain,7036,1610,1370,23,5426,2043,2013,4056,1347
2023-08-22,LE,Spain,6964,1589,1266,27,5375,2054,2055,4109,1239
2023-08-23,LE,Spain,6926,1632,1339,29,5294,1975,1980,3955,1310
2023-08-24,LE,Spain,7171,1705,1381,28,5466,2028,2057,4085,1353
2023-08-25,LE,Spain,7187,1624,1419,25,5563,2053,2091,4144,1394
2023-08-26,LE,Spain,7294,1676,1188,16,5618,2235,2195,4430,1172
2023-08-27,LE,Spain,6876,1668,1231,24,5208,1986,1991,3977,1207
2023-08-28,LE,Spain,6794,1584,1399,27,5210,1897,1914,3811,1372
2023-08-29,LE,Spain,7091,1612,1297,39,5479,2104,2078,4182,1258
2023-08-30,LE,Spain,7090,1637,1364,35,5453,2040,2049,4089,1329
2023-08-31,LE,Spain,7191,1657,1392,40,5534,2075,2067,4142,1352
2023-09-01,LE,Spain,7237,1663,1420,18,5574,2064,2090,4154,1402
2023-09-02,LE,Spain,7233,1676,1177,16,5557,2191,2189,4380,1161
2023-09-03,LE,Spain,7139,1620,1293,5,5519,2133,2093,4226,1288
2023-09-04,LE,Spain,6943,1618,1379,20,5325,1973,1973,3946,1359
2023-09-05,LE,Spain,6851,1554,1316,31,5297,1986,1995,3981,1285
2023-09-06,LE,Spain,6843,1556,1417,28,5287,1940,1930,3870,1389
2023-09-07,LE,Spain,7030,1587,1431,40,5443,1991,2021,4012,1391
2023-09-08,LE,Spain,7020,1545,1433,26,5475,2019,2023,4042,1407
2023-09-09,LE,Spain,7084,1584,1173,17,5500,2162,2165,4327,1156
2023-09-10,LE,Spain,7124,1578,1354,17,5546,2116,2076,4192,1337
2023-09-11,LE,Spain,6773,1533,1357,18,5240,1947,1936,3883,1339
2023-09-12,LE,Spain,6711,1502,1298,35,5209,1955,1956,3911,1263
2023-09-13,LE,Spain,6670,1484,1356,36,5186,1905,1925,3830,1320
2023-09-14,LE,Spain,6930,1546,1393,39,5384,1983,2008,3991,1354
2023-09-15,LE,Spain,6858,1481,1349,14,5377,1992,2036,4028,1335
2023-09-16,LE,Spain,6969,1559,1149,18,5410,2140,2121,4261,1131
2023-09-17,LE,Spain,6918,1498,1312,13,5420,2074,2034,4108,1299
2023-09-18,LE,Spain,6788,1562,1348,19,5226,1938,1940,3878,1329
2023-09-19,LE,Spain,6647,1472,1274,34,5175,1968,1933,3901,1240
2023-09-20,LE,Spain,6764,1519,1375,38,5245,1924,1946,3870,1337
2023-09-21,LE,Spain,6837,1519,1364,34,5318,1979,1975,3954,1330
2023-09-22,LE,Spain,7051,1511,1473,32,5540,2003,2064,4067,1441
2023-09-23,LE,Spain,6961,1568,1159,19,5393,2121,2113,4234,1140
2023-09-24,LE,Spain,6939,1527,1301,7,5412,2068,2043,4111,1294
2023-09-25,LE,Spain,6688,1505,1338,30,5183,1934,1911,3845,1308
2023-09-26,LE,Spain,6522,1381,1311,49,5141,1929,1901,3830,1262
2023-09-27,LE,Spain,6692,1480,1437,51,5212,1873,1902,3775,1386
2023-09-28,LE,Spain,6835,1518,1433,46,5317,1928,1956,3884,1387
2023-09-29,LE,Spain,6978,1498,1424,32,5480,2000,2056,4056,1392
2023-09-30,LE,Spain,7009,1540,1155,27,5469,2173,2141,4314,1128
2023-10-01,LE,Spain,6942,1523,1324,21,5419,2072,2023,4095,1303
2023-10-02,LE,Spain,6652,1478,1325,30,5174,1923,1926,3849,1295
2023-01-01,ES,Sweden,1316,777,98,1,539,214,227,441,97
2023-01-02,ES,Sweden,1601,824,229,2,777,274,274,548,227
2023-01-03,ES,Sweden,1437,690,232,10,747,255,260,515,222
2023-01-04,ES,Sweden,1471,763,226,7,708,242,240,482,219
2023-01-05,ES,Sweden,1459,730,204,4,729,260,265,525,200
2023-01-06,ES,Sweden,1361,700,148,0,661,255,258,513,148
2023-01-07,ES,Sweden,1200,697,62,3,503,224,217,441,59
2023-01-08,ES,Sweden,1556,791,197,3,765,280,288,568,194
2023-01-09,ES,Sweden,1588,758,285,6,830,277,268,545,279
2023-01-10,ES,Sweden,1374,632,283,4,742,233,226,459,279
2023-01-11,ES,Sweden,1417,657,285,8,760,234,241,475,277
2023-01-12,ES,Sweden,1567,730,326,12,837,255,256,511,314
2023-01-13,ES,Sweden,1621,784,303,9,837,268,266,534,294
2023-01-14,ES,Sweden,1125,649,88,2,476,196,192,388,86
2023-01-15,ES,Sweden,1438,761,200,1,677,231,246,477,199
2023-01-16,ES,Sweden,1569,711,319,11,858,274,265,539,308
2023-01-17,ES,Sweden,1386,650,298,11,736,224,214,438,287
2023-01-18,ES,Sweden,1481,715,309,16,766,225,232,457,293
2023-01-19,ES,Sweden,1568,714,348,15,854,249,257,506,333
2023-01-20,ES,Sweden,1614,764,318,13,850,269,263,532,305
2023-01-21,ES,Sweden,1058,587,94,1,471,187,190,377,93
2023-01-22,ES,Sweden,1378,681,219,4,697,236,242,478,215
2023-01-23,ES,Sweden,1504,679,311,11,825,262,252,514,300
2023-01-24,ES,Sweden,1344,594,309,10,750,218,223,441,299
2023-01-25,ES,Sweden,1435,645,316,22,790,233,241,474,294
2023-01-26,ES,Sweden,1549,658,358,19,891,264,269,533,339
2023-01-27,ES,Sweden,1551,674,317,11,877,285,275,560,306
2023-01-28,ES,Sweden,1101,633,84,3,468,196,188,384,81
2023-01-29,ES,Sweden,1461,757,211,4,704,240,253,493,207
2023-01-30,ES,Sweden,1639,770,336,19,869,268,265,533,317
2023-01-31,ES,Sweden,1427,636,350,15,791,221,220,441,335
2023-02-01,ES,Sweden,1526,733,330,15,793,232,231,463,315
2023-02-02,ES,Sweden,1540,660,349,17,880,262,269,531,332
2023-02-03,ES,Sweden,1583,729,320,16,854,268,266,534,304
2023-02-04,ES,Sweden,1126,621,84,2,505,215,206,421,82
2023-02-05,ES,Sweden,1457,735,222,4,722,245,255,500,218
2023-02-06,ES,Sweden,1554,741,300,13,813,262,251,513,287
2023-02-07,ES,Sweden,1418,640,316,10,778,230,232,462,306
2023-02-08,ES,Sweden,1521,734,329,9,787,226,232,458,320
2023-02-09,ES,Sweden,1623,734,357,14,889,263,269,532,343
2023-02-10,ES,Sweden,1738,814,345,18,924,296,283,579,327
2023-02-11,ES,Sweden,1269,744,89,8,525,219,217,436,81
2023-02-12,ES,Sweden,1537,793,228,5,744,249,267,516,223
2023-02-13,ES,Sweden,1644,780,327,14,864,274,263,537,313
2023-02-14,ES,Sweden,1427,647,328,20,780,223,229,452,308
2023-02-15,ES,Sweden,1558,737,336,9,821,245,240,485,327
2023-02-16,ES,Sweden,1680,765,362,15,915,272,281,553,347
2023-02-17,ES,Sweden,1560,709,304,13,851,276,271,547,291
2023-02-18,ES,Sweden,1330,778,98,2,552,230,224,454,96
2023-02-19,ES,Sweden,1576,801,241,6,775,262,272,534,235
2023-02-20,ES,Sweden,1659,796,301,14,863,286,276,562,287
2023-02-21,ES,Sweden,1509,690,328,12,819,239,252,491,316
2023-02-22,ES,Sweden,1587,737,334,18,850,259,257,516,316
2023-02-23,ES,Sweden,1661,780,337,3,881,271,273,544,334
2023-02-24,ES,Sweden,1655,748,305,7,907,297,305,602,298
2023-02-25,ES,Sweden,1308,672,110,9,636,268,258,526,101
2023-02-26,ES,Sweden,1508,739,224,6,769,269,276,545,218
2023-02-27,ES,Sweden,1611,722,305,14,889,295,289,584,291
2023-02-28,ES,Sweden,1427,636,291,12,791,251,249,500,279
2023-03-01,ES,Sweden,1529,693,333,18,836,252,251,503,315
2023-03-02,ES,Sweden,1600,729,336,19,871,262,273,535,317
2023-03-03,ES,Sweden,1720,806,319,16,914,299,296,595,303
2023-03-04,ES,Sweden,1359,735,104,8,624,254,266,520,96
2023-03-05,ES,Sweden,1606,806,226,4,800,290,284,574,222
2023-03-06,ES,Sweden,1770,800,361,23,970,308,301,609,338
2023-03-07,ES,Sweden,1515,717,301,11,798,248,249,497,290
2023-03-08,ES,Sweden,1655,789,331,19,866,269,266,535,312
2023-03-09,ES,Sweden,1729,808,353,11,921,284,284,568,342
2023-03-10,ES,Sweden,1671,742,338,16,929,293,298,591,322
2023-03-11,ES,Sweden,1324,761,99,5,563,231,233,464,94
2023-03-12,ES,Sweden,1620,848,223,4,772,276,273,549,219
2023-03-13,ES,Sweden,1679,800,313,3,879,286,280,566,310
2023-03-14,ES,Sweden,1588,738,334,15,850,260,256,516,319
2023-03-15,ES,Sweden,1702,794,365,21,908,266,277,543,344
2023-03-16,ES,Sweden,1761,761,403,27,1000,298,299,597,376
2023-03-17,ES,Sweden,1730,820,320,13,910,296,294,590,307
2023-03-18,ES,Sweden,1272,712,98,1,560,231,231,462,97
2023-03-19,ES,Sweden,1589,813,228,4,776,272,276,548,224
2023-03-20,ES,Sweden,1682,787,330,14,895,287,278,565,316
2023-03-21,ES,Sweden,1580,715,354,21,865,257,254,511,333
2023-03-22,ES,Sweden,1696,780,384,19,916,268,264,532,365
2023-03-23,ES,Sweden,1764,802,387,23,962,284,291,575,364
2023-03-24,ES,Sweden,1778,853,338,11,925,296,291,587,327
2023-03-25,ES,Sweden,1250,700,100,0,550,223,227,450,100
2023-03-26,ES,Sweden,1605,810,244,0,795,274,277,551,244
2023-03-27,ES,Sweden,1674,753,328,8,921,302,291,593,320
2023-03-28,ES,Sweden,1754,785,336,19,969,309,324,633,317
2023-03-29,ES,Sweden,1831,854,357,10,977,311,309,620,347
2023-03-30,ES,Sweden,1903,906,371,16,997,313,313,626,355
2023-03-31,ES,Sweden,1846,893,318,20,953,320,315,635,298
2023-04-01,ES,Sweden,1284,679,109,3,605,244,252,496,106
2023-04-02,ES,Sweden,1650,821,228,5,829,301,300,601,223
2023-04-03,ES,Sweden,1732,789,310,14,943,319,314,633,296
2023-04-04,ES,Sweden,1620,740,312,26,880,283,285,568,286
2023-04-05,ES,Sweden,1848,870,328,27,978,319,331,650,301
2023-04-06,ES,Sweden,1744,816,288,8,928,321,319,640,280
2023-04-07,ES,Sweden,1348,699,117,6,649,269,263,532,111
2023-04-08,ES,Sweden,1246,696,67,4,550,243,240,483,63
2023-04-09,ES,Sweden,1526,810,185,3,716,262,269,531,182
2023-04-10,ES,Sweden,1692,873,211,3,819,310,298,608,208
2023-04-11,ES,Sweden,1770,843,319,22,927,299,309,608,297
2023-04-12,ES,Sweden,1911,925,350,18,986,317,319,636,332
2023-04-13,ES,Sweden,1879,900,329,14,979,324,326,650,315
2023-04-14,ES,Sweden,1773,832,325,14,941,307,309,616,311
2023-04-15,ES,Sweden,1275,667,89,7,608,258,261,519,82
2023-04-16,ES,Sweden,1617,786,226,13,831,298,307,605,213
2023-04-17,ES,Sweden,1916,851,366,22,1065,356,343,699,344
2023-04-18,ES,Sweden,1735,757,341,12,978,314,323,637,329
2023-04-19,ES,Sweden,1783,790,345,13,993,326,322,648,332
2023-04-20,ES,Sweden,1859,810,376,14,1049,340,333,673,362
2023-04-21,ES,Sweden,1802,837,332,15,965,316,317,633,317
2023-04-22,ES,Sweden,1319,750,105,9,569,234,230,464,96
2023-04-23,ES,Sweden,1649,854,221,5,795,286,288,574,216
2023-04-24,ES,Sweden,1889,877,352,23,1012,326,334,660,329
2023-04-25,ES,Sweden,1841,889,340,13,952,307,305,612,327
2023-04-26,ES,Sweden,1896,921,339,22,975,316,320,636,317
2023-04-27,ES,Sweden,1960,923,358,24,1037,337,342,679,334
2023-04-28,ES,Sweden,1938,942,335,12,996,332,329,661,323
2023-04-29,ES,Sweden,1370,770,113,5,600,246,241,487,108
2023-04-30,ES,Sweden,1568,829,174,3,739,275,290,565,171
2023-05-01,ES,Sweden,1699,885,206,6,814,310,298,608,200
2023-05-02,ES,Sweden,1779,808,317,12,971,327,327,654,305
2023-05-03,ES,Sweden,1835,822,367,24,1013,319,327,646,343
2023-05-04,ES,Sweden,1841,786,371,9,1055,342,342,684,362
2023-05-05,ES,Sweden,1810,803,321,16,1007,337,349,686,305
2023-05-06,ES,Sweden,1309,713,105,5,596,248,243,491,100
2023-05-07,ES,Sweden,1698,842,223,4,856,315,318,633,219
2023-05-08,ES,Sweden,1960,922,343,21,1038,353,342,695,322
2023-05-09,ES,Sweden,1872,867,347,16,1005,324,334,658,331
2023-05-10,ES,Sweden,1949,915,366,11,1034,337,331,668,355
2023-05-11,ES,Sweden,1947,861,372,9,1086,356,358,714,363
2023-05-12,ES,Sweden,1958,877,347,20,1081,366,368,734,327
2023-05-13,ES,Sweden,1422,808,90,1,614,267,257,524,89
2023-05-14,ES,Sweden,1796,950,213,3,846,313,320,633,210
2023-05-15,ES,Sweden,1841,867,295,16,974,340,339,679,279
2023-05-16,ES,Sweden,1906,899,335,16,1007,333,339,672,319
2023-05-17,ES,Sweden,1940,938,318,16,1002,348,336,684,302
2023-05-18,ES,Sweden,1687,913,169,6,774,303,302,605,163
2023-05-19,ES,Sweden,1663,861,196,8,802,301,305,606,188
2023-05-20,ES,Sweden,1410,792,88,5,618,268,262,530,83
2023-05-21,ES,Sweden,1809,902,223,6,907,340,344,684,217
2023-05-22,ES,Sweden,2006,946,347,22,1060,352,361,713,325
2023-05-23,ES,Sweden,1978,946,360,25,1032,337,335,672,335
2023-05-24,ES,Sweden,2087,993,392,25,1094,353,349,702,367
2023-05-25,ES,Sweden,2100,983,381,19,1117,361,375,736,362
2023-05-26,ES,Sweden,2007,940,341,28,1067,363,363,726,313
2023-05-27,ES,Sweden,1564,913,102,3,651,276,273,549,99
2023-05-28,ES,Sweden,1801,928,227,2,873,325,321,646,225
2023-05-29,ES,Sweden,1949,911,335,21,1038,358,345,703,314
2023-05-30,ES,Sweden,2001,949,361,16,1052,337,354,691,345
2023-05-31,ES,Sweden,2116,1017,392,23,1099,354,353,707,369
2023-06-01,ES,Sweden,2026,915,402,24,1111,360,349,709,378
2023-06-02,ES,Sweden,1976,879,360,22,1097,367,370,737,338
2023-06-03,ES,Sweden,1598,926,106,5,672,287,279,566,101
2023-06-04,ES,Sweden,1793,926,191,2,867,335,341,676,189
2023-06-05,ES,Sweden,1907,986,251,15,921,339,331,670,236
2023-06-06,ES,Sweden,1781,934,199,8,847,320,328,648,191
2023-06-07,ES,Sweden,2051,985,342,26,1066,360,364,724,316
2023-06-08,ES,Sweden,2033,981,340,24,1052,353,359,712,316
2023-06-09,ES,Sweden,1982,896,344,9,1086,366,376,742,335
2023-06-10,ES,Sweden,1553,838,106,0,715,310,299,609,106
2023-06-11,ES,Sweden,1796,904,203,6,892,345,344,689,197
2023-06-12,ES,Sweden,2003,949,320,14,1054,376,358,734,306
2023-06-13,ES,Sweden,1974,937,340,26,1037,350,347,697,314
2023-06-14,ES,Sweden,2084,987,372,17,1097,352,373,725,355
2023-06-15,ES,Sweden,2210,1052,405,23,1158,380,373,753,382
2023-06-16,ES,Sweden,2200,1111,339,17,1089,371,379,750,322
2023-06-17,ES,Sweden,1625,937,87,2,688,303,298,601,85
2023-06-18,ES,Sweden,1937,1046,209,6,891,337,345,682,203
2023-06-19,ES,Sweden,2195,1109,338,22,1086,380,368,748,316
2023-06-20,ES,Sweden,2049,1014,328,17,1035,350,357,707,311
2023-06-21,ES,Sweden,2168,1097,337,24,1071,372,362,734,313
2023-06-22,ES,Sweden,2168,1113,305,18,1055,372,378,750,287
2023-06-23,ES,Sweden,1815,1104,83,1,711,315,313,628,82
2023-06-24,ES,Sweden,1634,958,79,2,676,300,297,597,77
2023-06-25,ES,Sweden,1932,1064,213,5,868,325,330,655,208
2023-06-26,ES,Sweden,2157,1113,307,13,1044,370,367,737,294
2023-06-27,ES,Sweden,2095,1057,344,25,1038,345,349,694,319
2023-06-28,ES,Sweden,2118,1103,338,15,1015,343,334,677,323
2023-06-29,ES,Sweden,2165,1094,332,12,1071,372,367,739,320
2023-06-30,ES,Sweden,2145,1125,303,14,1020,360,357,717,289
2023-07-01,ES,Sweden,1746,1021,104,2,725,306,315,621,102
2023-07-02,ES,Sweden,1941,1103,165,0,838,337,336,673,165
2023-07-03,ES,Sweden,1987,1075,227,9,912,341,344,685,218
2023-07-04,ES,Sweden,1924,1039,230,15,885,331,324,655,215
2023-07-05,ES,Sweden,1972,1047,242,15,925,340,343,683,227
2023-07-06,ES,Sweden,2022,1070,246,12,952,344,362,706,234
2023-07-07,ES,Sweden,2035,1064,231,8,971,374,366,740,223
2023-07-08,ES,Sweden,1671,935,102,2,736,321,313,634,100
2023-07-09,ES,Sweden,1888,1025,180,2,863,341,342,683,178
2023-07-10,ES,Sweden,2008,1085,224,7,923,347,352,699,217
2023-07-11,ES,Sweden,1926,1009,237,12,917,343,337,680,225
2023-07-12,ES,Sweden,2012,1059,255,19,953,353,345,698,236
2023-07-13,ES,Sweden,2032,1064,245,9,968,365,358,723,236
2023-07-14,ES,Sweden,2038,1094,232,10,944,355,357,712,222
2023-07-15,ES,Sweden,1660,952,113,7,708,299,296,595,106
2023-07-16,ES,Sweden,1908,1074,178,2,834,324,332,656,176
2023-07-17,ES,Sweden,1980,1061,216,7,919,348,355,703,209
2023-07-18,ES,Sweden,1890,990,234,11,900,335,331,666,223
2023-07-19,ES,Sweden,1942,1038,231,14,904,338,335,673,217
2023-07-20,ES,Sweden,1930,1011,232,13,919,338,349,687,219
2023-07-21,ES,Sweden,1955,1059,215,11,896,340,341,681,204
2023-07-22,ES,Sweden,1676,965,104,7,711,307,300,607,97
2023-07-23,ES,Sweden,1878,1061,171,1,817,315,331,646,170
2023-07-24,ES,Sweden,1960,1060,224,14,900,345,331,676,210
2023-07-25,ES,Sweden,1902,1012,227,12,890,333,330,663,215
2023-07-26,ES,Sweden,1953,1053,233,9,900,331,336,667,224
2023-07-27,ES,Sweden,1990,1057,234,7,933,347,352,699,227
2023-07-28,ES,Sweden,1930,1029,197,9,901,356,348,704,188
2023-07-29,ES,Sweden,1639,964,86,1,675,294,295,589,85
2023-07-30,ES,Sweden,1889,1058,169,1,831,326,336,662,168
2023-07-31,ES,Sweden,1998,1090,239,12,908,335,334,669,227
2023-08-01,ES,Sweden,1889,1025,216,7,864,325,323,648,209
2023-08-02,ES,Sweden,1944,1072,213,6,872,328,331,659,207
2023-08-03,ES,Sweden,2010,1083,245,8,927,337,345,682,237
2023-08-04,ES,Sweden,2016,1079,230,15,937,352,355,707,215
2023-08-05,ES,Sweden,1663,947,116,8,716,301,299,600,108
2023-08-06,ES,Sweden,1839,994,173,2,845,336,336,672,171
2023-08-07,ES,Sweden,2056,1144,220,9,912,352,340,692,211
2023-08-08,ES,Sweden,1904,1044,217,5,860,324,319,643,212
2023-08-09,ES,Sweden,1913,1012,240,18,901,332,329,661,222
2023-08-10,ES,Sweden,1919,962,268,8,957,340,349,689,260
2023-08-11,ES,Sweden,1989,1059,241,18,930,345,344,689,223
2023-08-12,ES,Sweden,1644,948,114,3,696,290,292,582,111
2023-08-13,ES,Sweden,1898,1013,204,6,885,338,343,681,198
2023-08-14,ES,Sweden,1964,1005,271,16,959,343,345,688,255
2023-08-15,ES,Sweden,1906,977,277,19,929,324,328,652,258
2023-08-16,ES,Sweden,1941,957,310,21,984,343,331,674,289
2023-08-17,ES,Sweden,1873,878,302,16,995,345,348,693,286
2023-08-18,ES,Sweden,1953,950,316,18,1003,346,341,687,298
2023-08-19,ES,Sweden,1530,847,124,3,683,277,282,559,121
2023-08-20,ES,Sweden,1933,1062,199,3,871,336,336,672,196
2023-08-21,ES,Sweden,2018,1042,272,15,976,355,349,704,257
2023-08-22,ES,Sweden,1951,957,322,20,994,335,337,672,302
2023-08-23,ES,Sweden,1970,958,328,17,1012,344,340,684,311
2023-08-24,ES,Sweden,1982,945,341,12,1037,350,346,696,329
2023-08-25,ES,Sweden,2031,1015,300,15,1016,357,359,716,285
2023-08-26,ES,Sweden,1603,939,99,3,664,281,284,565,96
2023-08-27,ES,Sweden,1931,1039,211,6,892,335,346,681,205
2023-08-28,ES,Sweden,1998,1017,303,13,981,342,336,678,290
2023-08-29,ES,Sweden,1924,933,308,23,991,343,340,683,285
2023-08-30,ES,Sweden,2031,1026,317,21,1005,335,353,688,296
2023-08-31,ES,Sweden,2107,1018,357,19,1089,368,364,732,338
2023-09-01,ES,Sweden,2102,1066,319,17,1036,360,357,717,302
2023-09-02,ES,Sweden,1605,920,99,5,685,293,293,586,94
2023-09-03,ES,Sweden,1909,1006,205,3,903,346,352,698,202
2023-09-04,ES,Sweden,2067,1033,313,6,1034,367,354,721,307
2023-09-05,ES,Sweden,1984,964,337,20,1020,340,343,683,317
2023-09-06,ES,Sweden,2041,1020,345,15,1021,332,344,676,330
2023-09-07,ES,Sweden,2074,955,372,20,1119,375,372,747,352
2023-09-08,ES,Sweden,2106,1014,352,15,1092,372,368,740,337
2023-09-09,ES,Sweden,1568,885,121,6,683,283,279,562,115
2023-09-10,ES,Sweden,1841,942,217,7,899,338,344,682,210
2023-09-11,ES,Sweden,2055,1029,311,10,1026,357,358,715,301
2023-09-12,ES,Sweden,1965,954,341,11,1011,334,336,670,330
2023-09-13,ES,Sweden,2059,965,359,9,1094,367,368,735,350
2023-09-14,ES,Sweden,2118,996,367,12,1122,377,378,755,355
2023-09-15,ES,Sweden,2137,1042,336,18,1095,381,378,759,318
2023-09-16,ES,Sweden,1584,913,117,4,671,280,274,554,113
2023-09-17,ES,Sweden,1837,932,217,5,905,341,347,688,212
2023-09-18,ES,Sweden,2080,1051,323,16,1029,356,350,706,307
2023-09-19,ES,Sweden,2007,993,339,10,1014,333,342,675,329
2023-09-20,ES,Sweden,2041,988,346,16,1053,356,351,707,330
2023-09-21,ES,Sweden,2139,1019,374,18,1120,369,377,746,356
2023-09-22,ES,Sweden,2099,1037,338,19,1062,365,359,724,319
2023-09-23,ES,Sweden,1631,953,112,3,678,282,284,566,109
2023-09-24,ES,Sweden,1856,974,207,5,882,332,343,675,202
2023-09-25,ES,Sweden,2030,990,328,15,1040,360,352,712,313
2023-09-26,ES,Sweden,1919,900,338,26,1019,345,336,681,312
2023-09-27,ES,Sweden,2060,1008,362,15,1052,345,345,690,347
2023-09-28,ES,Sweden,2092,1017,363,13,1075,353,359,712,350
2023-09-29,ES,Sweden,2079,1034,317,15,1045,367,361,728,302
2023-09-30,ES,Sweden,1636,950,107,5,686,285,294,579,102
2023-10-01,ES,Sweden,1919,1023,218,5,896,339,339,678,213
2023-10-02,ES,Sweden,1983,990,317,14,993,340,336,676,303
2023-01-01,LS,Switzerland,2288,1235,14,0,1053,525,514,1039,14
2023-01-02,LS,Switzerland,2660,1356,38,0,1304,636,630,1266,38
2023-01-03,LS,Switzerland,2248,1173,22,0,1075,522,531,1053,22
2023-01-04,LS,Switzerland,2200,1126,44,1,1074,512,518,1030,43
2023-01-05,LS,Switzerland,2334,1239,36,0,1095,525,534,1059,36
2023-01-06,LS,Switzerland,2540,1326,42,4,1214,592,580,1172,38
2023-01-07,LS,Switzerland,2541,1266,27,0,1275,630,618,1248,27
2023-01-08,LS,Switzerland,2583,1310,22,0,1273,614,637,1251,22
2023-01-09,LS,Switzerland,2205,1157,27,1,1048,523,498,1021,26
2023-01-10,LS,Switzerland,1844,923,43,2,921,445,433,878,41
2023-01-11,LS,Switzerland,1851,944,37,1,907,434,436,870,36
2023-01-12,LS,Switzerland,2035,1023,34,0,1012,490,488,978,34
2023-01-13,LS,Switzerland,2210,1124,32,1,1086,522,532,1054,31
2023-01-14,LS,Switzerland,2152,1085,34,1,1067,518,515,1033,33
2023-01-15,LS,Switzerland,2345,1153,18,0,1192,583,591,1174,18
2023-01-16,LS,Switzerland,2159,987,41,4,1172,535,596,1131,37
2023-01-17,LS,Switzerland,1783,844,35,4,939,442,462,904,31
2023-01-18,LS,Switzerland,1808,857,31,6,951,481,439,920,25
2023-01-19,LS,Switzerland,2100,979,59,7,1121,535,527,1062,52
2023-01-20,LS,Switzerland,2440,1076,54,5,1364,679,631,1310,49
2023-01-21,LS,Switzerland,2111,1058,29,2,1053,507,517,1024,27
2023-01-22,LS,Switzerland,2413,1249,25,1,1164,574,565,1139,24
2023-01-23,LS,Switzerland,2112,1098,41,2,1014,490,483,973,39
2023-01-24,LS,Switzerland,1816,942,37,2,874,414,423,837,35
2023-01-25,LS,Switzerland,1869,910,57,1,959,460,442,902,56
2023-01-26,LS,Switzerland,2107,1045,47,2,1062,492,523,1015,45
2023-01-27,LS,Switzerland,2342,1173,49,0,1169,559,561,1120,49
2023-01-28,LS,Switzerland,2180,1106,24,1,1074,520,530,1050,23
2023-01-29,LS,Switzerland,2454,1223,48,2,1231,605,578,1183,46
2023-01-30,LS,Switzerland,2174,1107,57,3,1067,512,498,1010,54
2023-01-31,LS,Switzerland,1793,940,55,3,853,409,389,798,52
2023-02-01,LS,Switzerland,1918,966,38,1,952,445,469,914,37
2023-02-02,LS,Switzerland,2203,1125,34,3,1078,518,526,1044,31
2023-02-03,LS,Switzerland,2466,1254,41,1,1212,581,590,1171,40
2023-02-04,LS,Switzerland,2235,1164,24,1,1071,520,527,1047,23
2023-02-05,LS,Switzerland,2467,1270,23,0,1197,604,570,1174,23
2023-02-06,LS,Switzerland,2302,1221,33,0,1081,527,521,1048,33
2023-02-07,LS,Switzerland,1904,977,43,0,927,444,440,884,43
2023-02-08,LS,Switzerland,1983,1036,38,2,947,458,451,909,36
2023-02-09,LS,Switzerland,2334,1149,56,3,1185,558,571,1129,53
2023-02-10,LS,Switzerland,2729,1334,53,2,1395,665,677,1342,51
2023-02-11,LS,Switzerland,2661,1252,49,1,1409,661,699,1360,48
2023-02-12,LS,Switzerland,2710,1405,34,2,1305,645,626,1271,32
2023-02-13,LS,Switzerland,2486,1325,47,1,1161,571,543,1114,46
2023-02-14,LS,Switzerland,2175,1176,45,4,999,475,479,954,41
2023-02-15,LS,Switzerland,2234,1147,62,7,1087,512,513,1025,55
2023-02-16,LS,Switzerland,2404,1181,61,3,1223,575,587,1162,58
2023-02-17,LS,Switzerland,2478,1172,66,2,1306,626,614,1240,64
2023-02-18,LS,Switzerland,2872,1413,38,1,1459,721,700,1421,37
2023-02-19,LS,Switzerland,2839,1392,45,2,1447,708,694,1402,43
2023-02-20,LS,Switzerland,2523,1333,53,1,1190,569,568,1137,52
2023-02-21,LS,Switzerland,2148,1144,41,1,1004,490,473,963,40
2023-02-22,LS,Switzerland,2276,1174,54,1,1102,520,528,1048,53
2023-02-23,LS,Switzerland,2459,1298,43,0,1161,560,558,1118,43
2023-02-24,LS,Switzerland,2698,1420,43,0,1278,615,620,1235,43
2023-02-25,LS,Switzerland,2711,1391,34,1,1320,634,652,1286,33
2023-02-26,LS,Switzerland,2815,1459,30,4,1356,675,651,1326,26
2023-02-27,LS,Switzerland,2509,1350,37,1,1159,566,556,1122,36
2023-02-28,LS,Switzerland,2248,1205,41,5,1043,505,497,1002,36
2023-03-01,LS,Switzerland,2352,1239,36,1,1113,534,543,1077,35
2023-03-02,LS,Switzerland,2471,1274,59,2,1197,570,568,1138,57
2023-03-03,LS,Switzerland,2723,1428,62,6,1295,609,624,1233,56
2023-03-04,LS,Switzerland,2725,1413,47,4,1312,628,637,1265,43
2023-03-05,LS,Switzerland,2812,1437,34,0,1375,688,653,1341,34
2023-03-06,LS,Switzerland,2501,1364,33,2,1137,549,555,1104,31
2023-03-07,LS,Switzerland,2089,1095,52,2,994,471,471,942,50
2023-03-08,LS,Switzerland,2154,1071,37,2,1083,525,521,1046,35
2023-03-09,LS,Switzerland,2435,1232,49,1,1203,580,574,1154,48
2023-03-10,LS,Switzerland,2466,1227,28,0,1239,608,603,1211,28
2023-03-11,LS,Switzerland,2398,1235,21,1,1163,573,569,1142,20
2023-03-12,LS,Switzerland,2531,1252,32,1,1279,623,624,1247,31
2023-03-13,LS,Switzerland,2476,1273,55,5,1203,583,565,1148,50
2023-03-14,LS,Switzerland,2314,1269,29,2,1045,514,502,1016,27
2023-03-15,LS,Switzerland,2301,1175,40,4,1126,542,544,1086,36
2023-03-16,LS,Switzerland,2627,1386,52,5,1241,582,607,1189,47
2023-03-17,LS,Switzerland,2738,1446,57,5,1292,628,607,1235,52
2023-03-18,LS,Switzerland,2503,1309,50,2,1194,582,562,1144,48
2023-03-19,LS,Switzerland,2666,1385,31,1,1281,624,626,1250,30
2023-03-20,LS,Switzerland,2500,1291,53,3,1209,581,575,1156,50
2023-03-21,LS,Switzerland,2290,1225,45,3,1065,508,512,1020,42
2023-03-22,LS,Switzerland,2296,1211,42,5,1085,524,519,1043,37
2023-03-23,LS,Switzerland,2436,1255,52,3,1181,553,576,1129,49
2023-03-24,LS,Switzerland,2525,1320,40,0,1205,599,566,1165,40
2023-03-25,LS,Switzerland,2521,1377,31,2,1144,556,557,1113,29
2023-03-26,LS,Switzerland,2603,1438,26,3,1165,564,575,1139,23
2023-03-27,LS,Switzerland,2214,1089,55,5,1125,532,538,1070,50
2023-03-28,LS,Switzerland,2356,1307,46,2,1049,510,493,1003,44
2023-03-29,LS,Switzerland,2531,1417,48,1,1114,529,537,1066,47
2023-03-30,LS,Switzerland,2679,1433,65,2,1246,590,591,1181,63
2023-03-31,LS,Switzerland,2852,1599,31,1,1253,625,597,1222,30
2023-04-01,LS,Switzerland,2779,1655,21,1,1124,559,544,1103,20
2023-04-02,LS,Switzerland,2753,1570,21,1,1183,572,590,1162,20
2023-04-03,LS,Switzerland,2733,1531,55,6,1202,573,574,1147,49
2023-04-04,LS,Switzerland,2636,1484,59,10,1152,554,539,1093,49
2023-04-05,LS,Switzerland,2813,1566,70,3,1247,595,582,1177,67
2023-04-06,LS,Switzerland,3024,1660,66,7,1364,656,642,1298,59
2023-04-07,LS,Switzerland,3011,1726,27,0,1285,643,615,1258,27
2023-04-08,LS,Switzerland,2800,1683,23,0,1117,548,546,1094,23
2023-04-09,LS,Switzerland,2806,1669,21,0,1137,559,557,1116,21
2023-04-10,LS,Switzerland,3072,1767,43,0,1305,619,643,1262,43
2023-04-11,LS,Switzerland,2714,1591,34,1,1123,546,543,1089,33
2023-04-12,LS,Switzerland,2812,1678,24,1,1134,556,554,1110,23
2023-04-13,LS,Switzerland,2756,1549,46,4,1207,579,582,1161,42
2023-04-14,LS,Switzerland,3144,1807,53,4,1337,643,641,1284,49
2023-04-15,LS,Switzerland,3005,1870,24,0,1135,560,551,1111,24
2023-04-16,LS,Switzerland,3133,1898,27,1,1235,602,606,1208,26
2023-04-17,LS,Switzerland,3060,1820,44,2,1240,596,600,1196,42
2023-04-18,LS,Switzerland,2948,1776,48,0,1172,562,562,1124,48
2023-04-19,LS,Switzerland,3041,1797,51,1,1244,585,608,1193,50
2023-04-20,LS,Switzerland,3037,1839,29,1,1198,591,578,1169,28
2023-04-21,LS,Switzerland,3229,1920,50,6,1309,633,626,1259,44
2023-04-22,LS,Switzerland,3009,1843,33,2,1166,564,569,1133,31
2023-04-23,LS,Switzerland,3126,1870,23,1,1256,607,626,1233,22
2023-04-24,LS,Switzerland,3129,1870,37,2,1259,617,605,1222,35
2023-04-25,LS,Switzerland,2763,1633,27,3,1130,550,553,1103,24
2023-04-26,LS,Switzerland,3029,1809,46,2,1220,597,577,1174,44
2023-04-27,LS,Switzerland,3075,1798,55,5,1277,618,604,1222,50
2023-04-28,LS,Switzerland,3270,1897,53,4,1373,664,656,1320,49
2023-04-29,LS,Switzerland,3034,1896,30,2,1138,561,547,1108,28
2023-04-30,LS,Switzerland,2958,1788,24,1,1170,555,591,1146,23
2023-05-01,LS,Switzerland,2719,1555,40,2,1164,556,568,1124,38
2023-05-02,LS,Switzerland,2922,1772,46,3,1150,553,551,1104,43
2023-05-03,LS,Switzerland,3136,1907,43,5,1229,591,595,1186,38
2023-05-04,LS,Switzerland,3119,1850,46,3,1269,612,611,1223,43
2023-05-05,LS,Switzerland,3300,1972,59,1,1328,649,620,1269,58
2023-05-06,LS,Switzerland,3145,2022,43,4,1123,544,536,1080,39
2023-05-07,LS,Switzerland,3171,1975,20,2,1196,570,606,1176,18
2023-05-08,LS,Switzerland,3176,1890,49,4,1286,629,608,1237,45
2023-05-09,LS,Switzerland,2929,1800,28,3,1129,543,558,1101,25
2023-05-10,LS,Switzerland,3169,1955,29,1,1214,601,584,1185,28
2023-05-11,LS,Switzerland,3070,1850,37,5,1220,592,591,1183,32
2023-05-12,LS,Switzerland,3334,2003,43,2,1331,641,647,1288,41
2023-05-13,LS,Switzerland,3110,2031,14,0,1079,534,531,1065,14
2023-05-14,LS,Switzerland,3326,2084,26,1,1242,598,618,1216,25
2023-05-15,LS,Switzerland,3317,2052,52,6,1265,614,599,1213,46
2023-05-16,LS,Switzerland,3154,1961,40,2,1193,574,579,1153,38
2023-05-17,LS,Switzerland,3407,2077,42,5,1330,664,624,1288,37
2023-05-18,LS,Switzerland,3172,1905,34,1,1267,630,603,1233,33
2023-05-19,LS,Switzerland,2980,1812,26,0,1168,569,573,1142,26
2023-05-20,LS,Switzerland,3130,2009,35,3,1121,532,554,1086,32
2023-05-21,LS,Switzerland,3536,2121,35,1,1415,647,733,1380,34
2023-05-22,LS,Switzerland,3419,2025,52,2,1394,667,675,1342,50
2023-05-23,LS,Switzerland,3192,1958,44,0,1234,600,590,1190,44
2023-05-24,LS,Switzerland,3290,1955,59,2,1335,641,635,1276,57
2023-05-25,LS,Switzerland,3345,1967,51,2,1378,697,630,1327,49
2023-05-26,LS,Switzerland,3706,2222,51,0,1484,739,694,1433,51
2023-05-27,LS,Switzerland,3293,2137,36,1,1156,566,554,1120,35
2023-05-28,LS,Switzerland,3354,2192,24,5,1162,569,569,1138,19
2023-05-29,LS,Switzerland,3505,2127,39,1,1378,650,689,1339,38
2023-05-30,LS,Switzerland,3265,2012,51,2,1253,593,609,1202,49
2023-05-31,LS,Switzerland,3250,1993,58,3,1257,608,591,1199,55
2023-06-01,LS,Switzerland,3349,2046,58,3,1303,618,627,1245,55
2023-06-02,LS,Switzerland,3528,2150,58,1,1378,667,653,1320,57
2023-06-03,LS,Switzerland,3378,2212,28,0,1166,572,566,1138,28
2023-06-04,LS,Switzerland,3312,2040,30,0,1272,604,638,1242,30
2023-06-05,LS,Switzerland,3446,2093,40,4,1353,667,646,1313,36
2023-06-06,LS,Switzerland,3019,1799,55,2,1220,589,576,1165,53
2023-06-07,LS,Switzerland,3395,2079,56,4,1316,628,632,1260,52
2023-06-08,LS,Switzerland,3399,2093,41,0,1306,641,624,1265,41
2023-06-09,LS,Switzerland,3524,2179,41,3,1345,657,647,1304,38
2023-06-10,LS,Switzerland,3510,2318,35,4,1192,582,575,1157,31
2023-06-11,LS,Switzerland,3639,2282,28,0,1357,648,681,1329,28
2023-06-12,LS,Switzerland,3585,2218,44,3,1367,657,666,1323,41
2023-06-13,LS,Switzerland,3342,2099,48,2,1243,595,600,1195,46
2023-06-14,LS,Switzerland,3449,2169,49,3,1280,612,619,1231,46
2023-06-15,LS,Switzerland,3576,2192,46,2,1384,682,656,1338,44
2023-06-16,LS,Switzerland,3792,2333,67,3,1459,699,693,1392,64
2023-06-17,LS,Switzerland,3471,2249,44,5,1222,591,587,1178,39
2023-06-18,LS,Switzerland,3549,2212,29,4,1337,644,664,1308,25
2023-06-19,LS,Switzerland,3628,2247,39,2,1381,675,667,1342,37
2023-06-20,LS,Switzerland,3156,1961,46,1,1195,566,583,1149,45
2023-06-21,LS,Switzerland,3653,2354,50,1,1299,625,624,1249,49
2023-06-22,LS,Switzerland,3529,2160,43,3,1369,664,662,1326,40
2023-06-23,LS,Switzerland,3716,2252,54,4,1464,697,713,1410,50
2023-06-24,LS,Switzerland,3502,2215,29,2,1287,636,622,1258,27
2023-06-25,LS,Switzerland,3625,2247,32,1,1378,670,676,1346,31
2023-06-26,LS,Switzerland,3539,2161,35,6,1378,679,664,1343,29
2023-06-27,LS,Switzerland,3308,2097,50,8,1211,581,580,1161,42
2023-06-28,LS,Switzerland,3510,2192,48,7,1318,635,635,1270,41
2023-06-29,LS,Switzerland,3474,2081,41,1,1393,685,667,1352,40
2023-06-30,LS,Switzerland,3408,2168,29,1,1240,606,605,1211,28
2023-07-01,LS,Switzerland,3657,2347,33,2,1310,633,644,1277,31
2023-07-02,LS,Switzerland,3790,2351,31,1,1439,691,717,1408,30
2023-07-03,LS,Switzerland,3716,2283,50,4,1433,692,691,1383,46
2023-07-04,LS,Switzerland,3461,2188,48,9,1273,622,603,1225,39
2023-07-05,LS,Switzerland,3611,2258,54,9,1353,648,651,1299,45
2023-07-06,LS,Switzerland,3626,2247,36,3,1379,681,662,1343,33
2023-07-07,LS,Switzerland,3714,2259,55,2,1455,702,698,1400,53
2023-07-08,LS,Switzerland,3598,2302,27,1,1296,640,629,1269,26
2023-07-09,LS,Switzerland,3711,2343,31,1,1368,664,673,1337,30
2023-07-10,LS,Switzerland,3718,2364,36,4,1354,654,664,1318,32
2023-07-11,LS,Switzerland,3237,2043,36,2,1194,580,578,1158,34
2023-07-12,LS,Switzerland,3493,2233,28,1,1260,613,619,1232,27
2023-07-13,LS,Switzerland,3763,2392,36,3,1371,676,659,1335,33
2023-07-14,LS,Switzerland,3787,2318,49,5,1469,703,717,1420,44
2023-07-15,LS,Switzerland,3480,2152,37,2,1328,652,639,1291,35
2023-07-16,LS,Switzerland,3869,2461,35,3,1408,683,690,1373,32
2023-07-17,LS,Switzerland,3734,2293,49,1,1441,683,709,1392,48
2023-07-18,LS,Switzerland,3485,2175,47,1,1310,635,628,1263,46
2023-07-19,LS,Switzerland,3772,2501,37,2,1271,619,615,1234,35
2023-07-20,LS,Switzerland,3657,2296,44,2,1361,677,640,1317,42
2023-07-21,LS,Switzerland,3691,2336,39,1,1355,653,663,1316,38
2023-07-22,LS,Switzerland,3756,2427,38,1,1329,644,647,1291,37
2023-07-23,LS,Switzerland,3770,2372,28,1,1398,680,690,1370,27
2023-07-24,LS,Switzerland,3466,2151,41,6,1315,641,633,1274,35
2023-07-25,LS,Switzerland,3547,2337,35,1,1210,593,582,1175,34
2023-07-26,LS,Switzerland,3636,2336,55,3,1300,628,617,1245,52
2023-07-27,LS,Switzerland,3651,2258,39,0,1393,670,684,1354,39
2023-07-28,LS,Switzerland,3645,2255,47,0,1390,676,667,1343,47
2023-07-29,LS,Switzerland,3783,2433,29,1,1350,667,654,1321,28
2023-07-30,LS,Switzerland,3932,2524,26,3,1408,685,697,1382,23
2023-07-31,LS,Switzerland,3762,2323,49,2,1439,696,694,1390,47
2023-08-01,LS,Switzerland,3509,2291,33,2,1218,590,595,1185,31
2023-08-02,LS,Switzerland,3587,2299,42,0,1288,622,624,1246,42
2023-08-03,LS,Switzerland,3498,2198,58,3,1300,626,616,1242,55
2023-08-04,LS,Switzerland,3560,2243,38,1,1317,635,644,1279,37
2023-08-05,LS,Switzerland,3768,2455,42,5,1313,639,632,1271,37
2023-08-06,LS,Switzerland,3753,2409,25,2,1344,655,664,1319,23
2023-08-07,LS,Switzerland,3578,2201,52,4,1377,662,663,1325,48
2023-08-08,LS,Switzerland,3323,2092,47,3,1231,589,595,1184,44
2023-08-09,LS,Switzerland,3447,2176,34,1,1271,623,614,1237,33
2023-08-10,LS,Switzerland,3503,2202,38,2,1301,641,622,1263,36
2023-08-11,LS,Switzerland,3626,2301,27,2,1325,652,646,1298,25
2023-08-12,LS,Switzerland,3668,2364,35,1,1304,625,644,1269,34
2023-08-13,LS,Switzerland,3677,2335,27,0,1342,648,667,1315,27
2023-08-14,LS,Switzerland,3527,2187,44,4,1340,658,638,1296,40
2023-08-15,LS,Switzerland,3525,2311,35,1,1214,580,599,1179,34
2023-08-16,LS,Switzerland,3597,2292,43,6,1305,631,631,1262,37
2023-08-17,LS,Switzerland,3524,2236,46,1,1288,624,618,1242,45
2023-08-18,LS,Switzerland,3640,2271,28,0,1369,673,668,1341,28
2023-08-19,LS,Switzerland,3609,2324,22,1,1285,635,628,1263,21
2023-08-20,LS,Switzerland,3773,2363,30,0,1410,676,704,1380,30
2023-08-21,LS,Switzerland,3580,2185,37,0,1395,673,685,1358,37
2023-08-22,LS,Switzerland,3435,2142,41,3,1293,623,629,1252,38
2023-08-23,LS,Switzerland,3636,2291,46,0,1345,664,635,1299,46
2023-08-24,LS,Switzerland,3518,2152,57,3,1366,663,646,1309,54
2023-08-25,LS,Switzerland,3654,2289,35,2,1365,670,660,1330,33
2023-08-26,LS,Switzerland,3538,2303,25,0,1235,608,602,1210,25
2023-08-27,LS,Switzerland,3454,2107,26,1,1347,659,662,1321,25
2023-08-28,LS,Switzerland,3294,2021,34,2,1273,622,617,1239,32
2023-08-29,LS,Switzerland,3390,2138,30,1,1252,606,616,1222,29
2023-08-30,LS,Switzerland,3657,2260,55,7,1397,669,673,1342,48
2023-08-31,LS,Switzerland,3593,2223,49,4,1370,663,658,1321,45
2023-09-01,LS,Switzerland,3866,2382,40,2,1484,729,715,1444,38
2023-09-02,LS,Switzerland,3627,2365,37,5,1262,612,613,1225,32
2023-09-03,LS,Switzerland,3885,2470,30,1,1415,681,704,1385,29
2023-09-04,LS,Switzerland,3771,2358,45,5,1413,688,680,1368,40
2023-09-05,LS,Switzerland,3430,2135,43,3,1295,626,626,1252,40
2023-09-06,LS,Switzerland,3576,2224,55,4,1352,653,644,1297,51
2023-09-07,LS,Switzerland,3659,2223,60,3,1436,690,686,1376,57
2023-09-08,LS,Switzerland,3612,2164,55,1,1448,711,682,1393,54
2023-09-09,LS,Switzerland,3583,2338,32,1,1245,606,607,1213,31
2023-09-10,LS,Switzerland,3792,2365,33,1,1427,679,715,1394,32
2023-09-11,LS,Switzerland,3656,2252,50,5,1404,679,675,1354,45
2023-09-12,LS,Switzerland,3364,2130,36,1,1234,603,595,1198,35
2023-09-13,LS,Switzerland,3429,2139,32,3,1290,625,633,1258,29
2023-09-14,LS,Switzerland,3500,2116,43,4,1384,679,662,1341,39
2023-09-15,LS,Switzerland,3739,2262,44,0,1477,723,710,1433,44
2023-09-16,LS,Switzerland,3459,2212,42,3,1247,608,597,1205,39
2023-09-17,LS,Switzerland,3737,2335,36,1,1402,666,700,1366,35
2023-09-18,LS,Switzerland,3551,2170,34,3,1381,674,673,1347,31
2023-09-19,LS,Switzerland,3280,2036,44,4,1244,595,605,1200,40
2023-09-20,LS,Switzerland,3466,2145,47,4,1321,643,631,1274,43
2023-09-21,LS,Switzerland,3447,2086,41,2,1361,663,657,1320,39
2023-09-22,LS,Switzerland,3665,2249,33,2,1416,698,685,1383,31
2023-09-23,LS,Switzerland,3489,2289,23,0,1200,584,593,1177,23
2023-09-24,LS,Switzerland,3654,2286,30,3,1368,664,674,1338,27
2023-09-25,LS,Switzerland,3595,2203,65,3,1392,665,662,1327,62
2023-09-26,LS,Switzerland,3239,1983,32,2,1256,615,609,1224,30
2023-09-27,LS,Switzerland,3474,2184,41,3,1290,626,623,1249,38
2023-09-28,LS,Switzerland,3651,2228,52,3,1423,681,690,1371,49
2023-09-29,LS,Switzerland,3656,2202,46,6,1454,717,691,1408,40
2023-09-30,LS,Switzerland,3579,2302,31,1,1277,618,628,1246,30
2023-10-01,LS,Switzerland,3773,2353,27,4,1420,687,706,1393,23
2023-10-02,LS,Switzerland,3577,2189,48,7,1388,668,672,1340,41
2023-01-01,LT,Türkiye,3566,1289,725,0,2277,796,756,1552,725
2023-01-02,LT,Türkiye,3564,1282,731,2,2282,752,799,1551,729
2023-01-03,LT,Türkiye,3544,1308,675,6,2236,795,766,1561,669
2023-01-04,LT,Türkiye,3577,1320,705,6,2257,776,776,1552,699
2023-01-05,LT,Türkiye,3645,1334,734,2,2311,785,792,1577,732
2023-01-06,LT,Türkiye,3820,1349,805,5,2471,848,818,1666,800
2023-01-07,LT,Türkiye,3818,1368,737,6,2450,855,858,1713,731
2023-01-08,LT,Türkiye,3909,1418,774,3,2491,846,871,1717,771
2023-01-09,LT,Türkiye,3479,1271,758,3,2208,713,737,1450,755
2023-01-10,LT,Türkiye,3306,1215,685,4,2091,703,703,1406,681
2023-01-11,LT,Türkiye,3358,1245,695,5,2113,711,707,1418,690
2023-01-12,LT,Türkiye,3501,1268,750,9,2233,744,739,1483,741
2023-01-13,LT,Türkiye,3639,1298,848,2,2341,757,736,1493,846
2023-01-14,LT,Türkiye,3614,1328,751,2,2286,761,774,1535,749
2023-01-15,LT,Türkiye,3778,1417,817,5,2361,771,773,1544,812
2023-01-16,LT,Türkiye,3333,1195,753,4,2138,678,707,1385,749
2023-01-17,LT,Türkiye,3270,1215,712,3,2055,676,667,1343,709
2023-01-18,LT,Türkiye,3320,1226,749,7,2094,672,673,1345,742
2023-01-19,LT,Türkiye,3490,1261,799,4,2229,722,708,1430,795
2023-01-20,LT,Türkiye,3588,1237,845,6,2351,763,743,1506,839
2023-01-21,LT,Türkiye,3683,1290,808,0,2393,787,798,1585,808
2023-01-22,LT,Türkiye,3760,1338,840,2,2422,795,787,1582,838
2023-01-23,LT,Türkiye,3355,1188,800,2,2167,677,690,1367,798
2023-01-24,LT,Türkiye,3173,1114,742,3,2059,655,662,1317,739
2023-01-25,LT,Türkiye,3297,1191,769,4,2106,669,668,1337,765
2023-01-26,LT,Türkiye,3457,1253,768,5,2204,718,718,1436,763
2023-01-27,LT,Türkiye,3483,1200,839,6,2283,724,720,1444,833
2023-01-28,LT,Türkiye,3602,1279,804,1,2323,756,763,1519,803
2023-01-29,LT,Türkiye,3639,1331,805,3,2308,751,752,1503,802
2023-01-30,LT,Türkiye,3301,1179,792,1,2122,653,677,1330,791
2023-01-31,LT,Türkiye,3218,1184,721,2,2034,658,655,1313,719
2023-02-01,LT,Türkiye,3309,1169,773,1,2140,697,670,1367,772
2023-02-02,LT,Türkiye,3458,1229,766,1,2229,728,735,1463,765
2023-02-03,LT,Türkiye,3625,1236,850,4,2389,775,764,1539,846
2023-02-04,LT,Türkiye,3686,1282,824,5,2404,789,791,1580,819
2023-02-05,LT,Türkiye,3294,1308,658,4,1986,631,697,1328,654
2023-02-06,LT,Türkiye,3132,1150,739,0,1982,624,619,1243,739
2023-02-07,LT,Türkiye,3474,1168,981,3,2306,653,672,1325,978
2023-02-08,LT,Türkiye,3548,1149,1080,0,2399,656,663,1319,1080
2023-02-09,LT,Türkiye,3831,1289,1137,2,2542,727,678,1405,1135
2023-02-10,LT,Türkiye,4009,1295,1173,1,2714,790,751,1541,1172
2023-02-11,LT,Türkiye,4032,1356,1067,2,2676,801,808,1609,1065
2023-02-12,LT,Türkiye,4040,1381,1044,0,2659,798,817,1615,1044
2023-02-13,LT,Türkiye,3629,1234,974,4,2395,713,708,1421,970
2023-02-14,LT,Türkiye,3523,1206,909,0,2317,713,695,1408,909
2023-02-15,LT,Türkiye,3700,1255,927,3,2445,761,757,1518,924
2023-02-16,LT,Türkiye,3768,1325,895,3,2443,770,778,1548,892
2023-02-17,LT,Türkiye,3613,1156,945,3,2457,765,747,1512,942
2023-02-18,LT,Türkiye,3947,1421,864,3,2526,834,828,1662,861
2023-02-19,LT,Türkiye,3924,1435,891,7,2489,797,801,1598,884
2023-02-20,LT,Türkiye,3574,1257,862,2,2317,725,730,1455,860
2023-02-21,LT,Türkiye,3419,1213,824,4,2206,689,693,1382,820
2023-02-22,LT,Türkiye,3643,1285,883,8,2358,745,730,1475,875
2023-02-23,LT,Türkiye,3676,1287,862,4,2389,759,768,1527,858
2023-02-24,LT,Türkiye,3782,1302,912,1,2480,791,777,1568,911
2023-02-25,LT,Türkiye,3859,1363,849,1,2496,821,826,1647,848
2023-02-26,LT,Türkiye,3955,1439,887,2,2516,815,814,1629,885
2023-02-27,LT,Türkiye,3520,1249,853,2,2271,702,716,1418,851
2023-02-28,LT,Türkiye,3448,1236,792,2,2212,712,708,1420,790
2023-03-01,LT,Türkiye,3586,1309,775,1,2277,754,748,1502,774
2023-03-02,LT,Türkiye,3638,1308,779,1,2330,777,774,1551,778
2023-03-03,LT,Türkiye,3759,1333,843,2,2426,795,788,1583,841
2023-03-04,LT,Türkiye,3803,1415,783,3,2388,801,804,1605,780
2023-03-05,LT,Türkiye,3885,1420,822,3,2465,826,817,1643,819
2023-03-06,LT,Türkiye,3472,1256,764,2,2216,717,735,1452,762
2023-03-07,LT,Türkiye,3328,1233,736,5,2095,681,678,1359,731
2023-03-08,LT,Türkiye,3476,1304,746,1,2172,717,709,1426,745
2023-03-09,LT,Türkiye,3614,1318,771,4,2296,755,770,1525,767
2023-03-10,LT,Türkiye,3678,1302,822,3,2376,792,762,1554,819
2023-03-11,LT,Türkiye,3700,1351,744,2,2349,793,812,1605,742
2023-03-12,LT,Türkiye,3932,1422,833,2,2510,843,834,1677,831
2023-03-13,LT,Türkiye,3491,1263,787,2,2228,714,727,1441,785
2023-03-14,LT,Türkiye,3393,1296,693,4,2097,707,697,1404,689
2023-03-15,LT,Türkiye,3499,1267,742,6,2232,733,757,1490,736
2023-03-16,LT,Türkiye,3657,1300,783,3,2357,795,779,1574,780
2023-03-17,LT,Türkiye,3762,1297,855,0,2465,819,791,1610,855
2023-03-18,LT,Türkiye,3829,1405,757,1,2424,826,841,1667,756
2023-03-19,LT,Türkiye,3982,1451,845,0,2531,851,835,1686,845
2023-03-20,LT,Türkiye,3654,1286,817,3,2368,765,786,1551,814
2023-03-21,LT,Türkiye,3499,1301,742,3,2198,727,729,1456,739
2023-03-22,LT,Türkiye,3555,1319,752,4,2236,746,738,1484,748
2023-03-23,LT,Türkiye,3585,1335,751,4,2250,746,753,1499,747
2023-03-24,LT,Türkiye,3700,1331,807,3,2369,796,766,1562,804
2023-03-25,LT,Türkiye,3678,1360,716,0,2318,803,799,1602,716
2023-03-26,LT,Türkiye,3913,1407,784,1,2506,849,873,1722,783
2023-03-27,LT,Türkiye,3316,1099,793,3,2217,709,715,1424,790
2023-03-28,LT,Türkiye,3611,1346,707,6,2265,779,779,1558,701
2023-03-29,LT,Türkiye,3585,1336,701,2,2249,772,776,1548,699
2023-03-30,LT,Türkiye,3733,1398,716,3,2335,825,794,1619,713
2023-03-31,LT,Türkiye,3968,1385,811,2,2583,895,877,1772,809
2023-04-01,LT,Türkiye,4156,1462,784,3,2694,949,961,1910,781
2023-04-02,LT,Türkiye,4185,1506,733,2,2679,966,980,1946,731
2023-04-03,LT,Türkiye,3862,1360,780,5,2502,858,864,1722,775
2023-04-04,LT,Türkiye,3766,1411,672,1,2355,845,838,1683,671
2023-04-05,LT,Türkiye,3858,1398,724,2,2460,871,865,1736,722
2023-04-06,LT,Türkiye,3765,1319,654,3,2446,893,899,1792,651
2023-04-07,LT,Türkiye,4062,1412,780,3,2650,942,928,1870,777
2023-04-08,LT,Türkiye,4107,1498,727,4,2609,933,949,1882,723
2023-04-09,LT,Türkiye,4055,1439,727,1,2616,954,935,1889,726
2023-04-10,LT,Türkiye,3770,1311,736,1,2459,856,867,1723,735
2023-04-11,LT,Türkiye,3657,1319,659,1,2338,841,838,1679,658
2023-04-12,LT,Türkiye,3798,1362,728,2,2436,858,850,1708,726
2023-04-13,LT,Türkiye,4021,1446,788,4,2575,892,895,1787,784
2023-04-14,LT,Türkiye,4233,1396,915,3,2837,971,951,1922,912
2023-04-15,LT,Türkiye,4399,1543,864,3,2856,992,1000,1992,861
2023-04-16,LT,Türkiye,4329,1491,850,2,2838,993,995,1988,848
2023-04-17,LT,Türkiye,4077,1415,892,2,2662,887,883,1770,890
2023-04-18,LT,Türkiye,3997,1393,908,6,2604,848,848,1696,902
2023-04-19,LT,Türkiye,4224,1430,1006,4,2794,890,898,1788,1002
2023-04-20,LT,Türkiye,4297,1389,1013,13,2908,958,937,1895,1000
2023-04-21,LT,Türkiye,4279,1405,945,3,2874,968,961,1929,942
2023-04-22,LT,Türkiye,4621,1468,985,15,3153,1076,1092,2168,970
2023-04-23,LT,Türkiye,4797,1542,1036,4,3255,1103,1116,2219,1032
2023-04-24,LT,Türkiye,4326,1354,1004,1,2972,981,987,1968,1003
2023-04-25,LT,Türkiye,4203,1322,881,3,2881,997,1003,2000,878
2023-04-26,LT,Türkiye,4249,1308,904,8,2941,1021,1016,2037,896
2023-04-27,LT,Türkiye,4359,1332,915,4,3027,1061,1051,2112,911
2023-04-28,LT,Türkiye,4606,1423,931,2,3183,1128,1124,2252,929
2023-04-29,LT,Türkiye,4800,1547,925,1,3253,1165,1163,2328,924
2023-04-30,LT,Türkiye,4758,1507,917,3,3251,1156,1178,2334,914
2023-05-01,LT,Türkiye,4500,1416,977,1,3084,1048,1059,2107,976
2023-05-02,LT,Türkiye,4276,1388,920,5,2888,989,979,1968,915
2023-05-03,LT,Türkiye,4421,1445,954,2,2976,1004,1018,2022,952
2023-05-04,LT,Türkiye,4474,1443,929,6,3031,1055,1047,2102,923
2023-05-05,LT,Türkiye,4584,1399,990,6,3185,1099,1096,2195,984
2023-05-06,LT,Türkiye,4790,1546,975,4,3244,1137,1132,2269,971
2023-05-07,LT,Türkiye,4831,1545,938,5,3286,1170,1178,2348,933
2023-05-08,LT,Türkiye,4450,1412,969,3,3038,1031,1038,2069,966
2023-05-09,LT,Türkiye,4306,1386,918,4,2920,1006,996,2002,914
2023-05-10,LT,Türkiye,4495,1491,957,7,3004,1009,1038,2047,950
2023-05-11,LT,Türkiye,4490,1436,944,5,3054,1062,1048,2110,939
2023-05-12,LT,Türkiye,4605,1413,983,4,3192,1109,1100,2209,979
2023-05-13,LT,Türkiye,4818,1540,957,2,3278,1162,1159,2321,955
2023-05-14,LT,Türkiye,4777,1569,902,2,3208,1150,1156,2306,900
2023-05-15,LT,Türkiye,4406,1409,922,2,2997,1032,1043,2075,920
2023-05-16,LT,Türkiye,4279,1424,898,6,2855,981,976,1957,892
2023-05-17,LT,Türkiye,4430,1467,923,3,2963,1023,1017,2040,920
2023-05-18,LT,Türkiye,4503,1438,928,3,3065,1064,1073,2137,925
2023-05-19,LT,Türkiye,4473,1371,947,5,3102,1083,1072,2155,942
2023-05-20,LT,Türkiye,4899,1578,948,1,3321,1186,1187,2373,947
2023-05-21,LT,Türkiye,4970,1637,978,1,3333,1176,1179,2355,977
2023-05-22,LT,Türkiye,4497,1482,944,5,3015,1034,1037,2071,939
2023-05-23,LT,Türkiye,4432,1504,904,3,2928,1009,1015,2024,901
2023-05-24,LT,Türkiye,4527,1545,873,7,2982,1057,1052,2109,866
2023-05-25,LT,Türkiye,4637,1475,918,6,3162,1130,1114,2244,912
2023-05-26,LT,Türkiye,4777,1434,987,3,3343,1184,1172,2356,984
2023-05-27,LT,Türkiye,5023,1526,985,3,3497,1243,1269,2512,982
2023-05-28,LT,Türkiye,4982,1580,958,2,3402,1227,1217,2444,956
2023-05-29,LT,Türkiye,4685,1443,952,2,3242,1139,1151,2290,950
2023-05-30,LT,Türkiye,4610,1434,913,2,3176,1130,1133,2263,911
2023-05-31,LT,Türkiye,4751,1525,935,1,3226,1150,1141,2291,934
2023-06-01,LT,Türkiye,4918,1528,931,2,3390,1229,1230,2459,929
2023-06-02,LT,Türkiye,4992,1489,987,1,3503,1257,1259,2516,986
2023-06-03,LT,Türkiye,5326,1585,980,2,3741,1356,1405,2761,978
2023-06-04,LT,Türkiye,5245,1606,938,1,3639,1373,1328,2701,937
2023-06-05,LT,Türkiye,4912,1451,962,1,3461,1255,1244,2499,961
2023-06-06,LT,Türkiye,4794,1515,914,3,3279,1175,1190,2365,911
2023-06-07,LT,Türkiye,4986,1569,909,2,3417,1256,1252,2508,907
2023-06-08,LT,Türkiye,5083,1558,928,2,3525,1285,1312,2597,926
2023-06-09,LT,Türkiye,5222,1517,965,1,3705,1349,1391,2740,964
2023-06-10,LT,Türkiye,5469,1562,946,2,3907,1439,1522,2961,944
2023-06-11,LT,Türkiye,5482,1584,943,5,3898,1561,1394,2955,938
2023-06-12,LT,Türkiye,4998,1476,958,7,3522,1279,1285,2564,951
2023-06-13,LT,Türkiye,4838,1513,912,2,3325,1201,1212,2413,910
2023-06-14,LT,Türkiye,5050,1557,927,1,3493,1283,1283,2566,926
2023-06-15,LT,Türkiye,5210,1623,949,4,3587,1323,1315,2638,945
2023-06-16,LT,Türkiye,5101,1461,971,2,3640,1337,1332,2669,969
2023-06-17,LT,Türkiye,5400,1590,977,1,3810,1409,1424,2833,976
2023-06-18,LT,Türkiye,5383,1666,936,3,3717,1394,1387,2781,933
2023-06-19,LT,Türkiye,5077,1510,985,3,3567,1283,1299,2582,982
2023-06-20,LT,Türkiye,5032,1577,938,0,3455,1266,1251,2517,938
2023-06-21,LT,Türkiye,5249,1619,984,7,3630,1321,1325,2646,977
2023-06-22,LT,Türkiye,5310,1557,1010,4,3753,1377,1366,2743,1006
2023-06-23,LT,Türkiye,5483,1584,1092,5,3899,1405,1402,2807,1087
2023-06-24,LT,Türkiye,5720,1662,1075,5,4058,1480,1503,2983,1070
2023-06-25,LT,Türkiye,5667,1688,1026,2,3979,1483,1470,2953,1024
2023-06-26,LT,Türkiye,5474,1606,1072,2,3868,1405,1391,2796,1070
2023-06-27,LT,Türkiye,5402,1640,1073,5,3762,1340,1349,2689,1068
2023-06-28,LT,Türkiye,5407,1643,1010,2,3764,1375,1379,2754,1008
2023-06-29,LT,Türkiye,5424,1655,995,2,3769,1388,1386,2774,993
2023-06-30,LT,Türkiye,5522,1646,1014,0,3876,1439,1423,2862,1014
2023-07-01,LT,Türkiye,5815,1710,1057,1,4105,1511,1537,3048,1056
2023-07-02,LT,Türkiye,5840,1740,1062,3,4100,1521,1517,3038,1059
2023-07-03,LT,Türkiye,5574,1637,1034,1,3937,1452,1451,2903,1033
2023-07-04,LT,Türkiye,5489,1688,974,1,3801,1418,1409,2827,973
2023-07-05,LT,Türkiye,5590,1701,946,4,3889,1466,1477,2943,942
2023-07-06,LT,Türkiye,5591,1703,902,4,3888,1494,1492,2986,898
2023-07-07,LT,Türkiye,5619,1667,963,5,3952,1506,1483,2989,958
2023-07-08,LT,Türkiye,5711,1716,912,2,3995,1532,1551,3083,910
2023-07-09,LT,Türkiye,5713,1765,907,5,3948,1523,1518,3041,902
2023-07-10,LT,Türkiye,5471,1631,954,4,3840,1447,1439,2886,950
2023-07-11,LT,Türkiye,5363,1626,879,3,3737,1419,1439,2858,876
2023-07-12,LT,Türkiye,5606,1735,929,4,3871,1476,1466,2942,925
2023-07-13,LT,Türkiye,5512,1656,879,3,3856,1487,1490,2977,876
2023-07-14,LT,Türkiye,5663,1707,942,2,3956,1507,1507,3014,940
2023-07-15,LT,Türkiye,5788,1690,923,3,4098,1585,1590,3175,920
2023-07-16,LT,Türkiye,5777,1742,898,0,4035,1584,1553,3137,898
2023-07-17,LT,Türkiye,5427,1608,920,3,3819,1441,1458,2899,917
2023-07-18,LT,Türkiye,5383,1658,866,3,3725,1422,1437,2859,863
2023-07-19,LT,Türkiye,5510,1702,898,1,3808,1457,1453,2910,897
2023-07-20,LT,Türkiye,5623,1718,896,1,3905,1506,1503,3009,895
2023-07-21,LT,Türkiye,5601,1658,952,7,3943,1494,1497,2991,945
2023-07-22,LT,Türkiye,5759,1716,903,0,4043,1574,1566,3140,903
2023-07-23,LT,Türkiye,5685,1795,886,1,3890,1503,1501,3004,885
2023-07-24,LT,Türkiye,5450,1615,936,3,3835,1445,1454,2899,933
2023-07-25,LT,Türkiye,5387,1630,866,2,3757,1441,1450,2891,864
2023-07-26,LT,Türkiye,5555,1708,891,4,3847,1485,1471,2956,887
2023-07-27,LT,Türkiye,5626,1742,890,2,3884,1499,1495,2994,888
2023-07-28,LT,Türkiye,5617,1686,930,7,3931,1504,1497,3001,923
2023-07-29,LT,Türkiye,5715,1696,893,3,4019,1560,1566,3126,890
2023-07-30,LT,Türkiye,5705,1717,883,1,3988,1556,1549,3105,882
2023-07-31,LT,Türkiye,5448,1625,917,2,3823,1443,1463,2906,915
2023-08-01,LT,Türkiye,5583,1706,920,5,3877,1482,1475,2957,915
2023-08-02,LT,Türkiye,5658,1750,919,3,3908,1501,1488,2989,916
2023-08-03,LT,Türkiye,5689,1741,963,2,3948,1498,1487,2985,961
2023-08-04,LT,Türkiye,5666,1656,1004,1,4010,1498,1508,3006,1003
2023-08-05,LT,Türkiye,5790,1611,979,3,4179,1596,1604,3200,976
2023-08-06,LT,Türkiye,5788,1750,947,2,4038,1552,1539,3091,945
2023-08-07,LT,Türkiye,5564,1652,959,2,3912,1473,1480,2953,957
2023-08-08,LT,Türkiye,5502,1687,917,4,3815,1442,1456,2898,913
2023-08-09,LT,Türkiye,5643,1681,944,4,3962,1504,1514,3018,940
2023-08-10,LT,Türkiye,5703,1747,958,3,3956,1496,1502,2998,955
2023-08-11,LT,Türkiye,5697,1669,989,3,4028,1532,1507,3039,986
2023-08-12,LT,Türkiye,5806,1686,942,1,4120,1584,1594,3178,941
2023-08-13,LT,Türkiye,5785,1757,939,3,4028,1545,1544,3089,936
2023-08-14,LT,Türkiye,5539,1676,961,3,3863,1451,1451,2902,958
2023-08-15,LT,Türkiye,5497,1658,917,5,3839,1466,1456,2922,912
2023-08-16,LT,Türkiye,5638,1718,965,6,3920,1475,1480,2955,959
2023-08-17,LT,Türkiye,5675,1717,945,4,3958,1511,1502,3013,941
2023-08-18,LT,Türkiye,5702,1674,977,6,4028,1527,1524,3051,971
2023-08-19,LT,Türkiye,5882,1727,954,4,4155,1591,1610,3201,950
2023-08-20,LT,Türkiye,5810,1778,969,5,4032,1532,1531,3063,964
2023-08-21,LT,Türkiye,5516,1646,969,3,3870,1447,1454,2901,966
2023-08-22,LT,Türkiye,5493,1721,911,8,3772,1435,1426,2861,903
2023-08-23,LT,Türkiye,5552,1653,917,3,3899,1498,1484,2982,914
2023-08-24,LT,Türkiye,5561,1648,950,1,3913,1482,1481,2963,949
2023-08-25,LT,Türkiye,5674,1661,995,6,4013,1505,1513,3018,989
2023-08-26,LT,Türkiye,5842,1723,948,0,4119,1588,1583,3171,948
2023-08-27,LT,Türkiye,5747,1775,929,1,3972,1519,1524,3043,928
2023-08-28,LT,Türkiye,5308,1569,957,3,3739,1389,1393,2782,954
2023-08-29,LT,Türkiye,5435,1627,956,3,3808,1425,1427,2852,953
2023-08-30,LT,Türkiye,5600,1651,973,2,3949,1491,1485,2976,971
2023-08-31,LT,Türkiye,5531,1696,925,2,3835,1440,1470,2910,923
2023-09-01,LT,Türkiye,5626,1618,1018,6,4008,1507,1483,2990,1012
2023-09-02,LT,Türkiye,5685,1666,959,0,4019,1537,1523,3060,959
2023-09-03,LT,Türkiye,5705,1743,977,4,3962,1491,1494,2985,973
2023-09-04,LT,Türkiye,5300,1580,983,6,3720,1365,1372,2737,977
2023-09-05,LT,Türkiye,5240,1636,931,5,3604,1334,1339,2673,926
2023-09-06,LT,Türkiye,5504,1736,960,7,3768,1397,1411,2808,953
2023-09-07,LT,Türkiye,5510,1719,986,5,3791,1408,1397,2805,981
2023-09-08,LT,Türkiye,5415,1620,974,4,3795,1416,1405,2821,970
2023-09-09,LT,Türkiye,5647,1720,956,3,3927,1489,1482,2971,953
2023-09-10,LT,Türkiye,5578,1767,940,1,3811,1438,1433,2871,939
2023-09-11,LT,Türkiye,5268,1602,987,6,3666,1346,1333,2679,981
2023-09-12,LT,Türkiye,5162,1680,908,2,3482,1277,1297,2574,906
2023-09-13,LT,Türkiye,5334,1712,944,7,3622,1349,1329,2678,937
2023-09-14,LT,Türkiye,5346,1649,964,2,3697,1366,1367,2733,962
2023-09-15,LT,Türkiye,5376,1592,976,4,3784,1411,1397,2808,972
2023-09-16,LT,Türkiye,5496,1671,936,2,3825,1432,1457,2889,934
2023-09-17,LT,Türkiye,5404,1668,952,5,3736,1397,1387,2784,947
2023-09-18,LT,Türkiye,5119,1627,920,4,3492,1281,1291,2572,916
2023-09-19,LT,Türkiye,5044,1693,868,5,3351,1238,1245,2483,863
2023-09-20,LT,Türkiye,5194,1646,905,7,3548,1321,1322,2643,898
2023-09-21,LT,Türkiye,5153,1603,905,2,3550,1319,1326,2645,903
2023-09-22,LT,Türkiye,5276,1638,924,5,3638,1362,1352,2714,919
2023-09-23,LT,Türkiye,5342,1649,892,4,3693,1397,1404,2801,888
2023-09-24,LT,Türkiye,5153,1577,890,5,3576,1350,1336,2686,885
2023-09-25,LT,Türkiye,4815,1372,931,1,3443,1254,1258,2512,930
2023-09-26,LT,Türkiye,4699,1351,853,2,3348,1247,1248,2495,851
2023-09-27,LT,Türkiye,5138,1697,881,3,3441,1282,1278,2560,878
2023-09-28,LT,Türkiye,5157,1696,904,2,3461,1276,1281,2557,902
2023-09-29,LT,Türkiye,5343,1661,950,2,3682,1382,1350,2732,948
2023-09-30,LT,Türkiye,5480,1720,901,1,3760,1422,1437,2859,900
2023-10-01,LT,Türkiye,5307,1759,879,2,3548,1319,1350,2669,877
2023-10-02,LT,Türkiye,5045,1604,887,1,3441,1284,1270,2554,886
2023-01-01,UK,Ukraine,0,0,0,0,0,0,0,0,0
2023-01-02,UK,Ukraine,0,0,0,0,0,0,0,0,0
2023-01-03,UK,Ukraine,0,0,0,0,0,0,0,0,0
2023-01-04,UK,Ukraine,3,3,0,0,0,0,0,0,0
2023-01-05,UK,Ukraine,6,6,0,0,0,0,0,0,0
2023-01-06,UK,Ukraine,3,3,0,0,0,0,0,0,0
2023-01-07,UK,Ukraine,4,4,0,0,0,0,0,0,0
2023-01-08,UK,Ukraine,11,11,0,0,0,0,0,0,0
2023-01-09,UK,Ukraine,5,5,0,0,0,0,0,0,0
2023-01-10,UK,Ukraine,5,5,0,0,0,0,0,0,0
2023-01-11,UK,Ukraine,6,6,0,0,0,0,0,0,0
2023-01-12,UK,Ukraine,3,3,0,0,0,0,0,0,0
2023-01-13,UK,Ukraine,3,3,0,0,0,0,0,0,0
2023-01-14,UK,Ukraine,4,4,0,0,0,0,0,0,0
2023-01-15,UK,Ukraine,3,3,0,0,0,0,0,0,0
2023-01-16,UK,Ukraine,2,2,0,0,0,0,0,0,0
2023-01-17,UK,Ukraine,0,0,0,0,0,0,0,0,0
2023-01-18,UK,Ukraine,3,3,0,0,0,0,0,0,0
2023-01-19,UK,Ukraine,2,2,0,0,0,0,0,0,0
2023-01-20,UK,Ukraine,3,3,0,0,0,0,0,0,0
2023-01-21,UK,Ukraine,2,2,0,0,0,0,0,0,0
2023-01-22,UK,Ukraine,4,4,0,0,0,0,0,0,0
2023-01-23,UK,Ukraine,7,7,0,0,0,0,0,0,0
2023-01-24,UK,Ukraine,2,1,0,0,1,0,1,1,0
2023-01-25,UK,Ukraine,5,4,0,0,1,1,0,1,0
2023-01-26,UK,Ukraine,4,4,0,0,0,0,0,0,0
2023-01-27,UK,Ukraine,3,3,0,0,0,0,0,0,0
2023-01-28,UK,Ukraine,3,3,0,0,0,0,0,0,0
2023-01-29,UK,Ukraine,6,6,0,0,0,0,0,0,0
2023-01-30,UK,Ukraine,4,4,0,0,0,0,0,0,0
2023-01-31,UK,Ukraine,2,2,0,0,0,0,0,0,0
2023-02-01,UK,Ukraine,3,3,0,0,0,0,0,0,0
2023-02-02,UK,Ukraine,2,2,0,0,0,0,0,0,0
2023-02-03,UK,Ukraine,2,2,0,0,0,0,0,0,0
2023-02-04,UK,Ukraine,3,3,0,0,0,0,0,0,0
2023-02-05,UK,Ukraine,6,6,0,0,0,0,0,0,0
2023-02-06,UK,Ukraine,5,5,0,0,0,0,0,0,0
2023-02-07,UK,Ukraine,7,4,0,0,3,3,0,3,0
2023-02-08,UK,Ukraine,3,3,0,0,0,0,0,0,0
2023-02-09,UK,Ukraine,4,4,0,0,0,0,0,0,0
2023-02-10,UK,Ukraine,2,2,0,0,0,0,0,0,0
2023-02-11,UK,Ukraine,4,4,0,0,0,0,0,0,0
2023-02-12,UK,Ukraine,4,4,0,0,0,0,0,0,0
2023-02-13,UK,Ukraine,1,1,0,0,0,0,0,0,0
2023-02-14,UK,Ukraine,5,3,0,0,2,1,1,2,0
2023-02-15,UK,Ukraine,4,4,0,0,0,0,0,0,0
2023-02-16,UK,Ukraine,7,7,0,0,0,0,0,0,0
2023-02-17,UK,Ukraine,3,3,0,0,0,0,0,0,0
2023-02-18,UK,Ukraine,4,2,0,0,2,0,2,2,0
2023-02-19,UK,Ukraine,4,2,0,0,2,1,1,2,0
2023-02-20,UK,Ukraine,2,2,0,0,0,0,0,0,0
2023-02-21,UK,Ukraine,5,5,0,0,0,0,0,0,0
2023-02-22,UK,Ukraine,4,4,0,0,0,0,0,0,0
2023-02-23,UK,Ukraine,4,4,0,0,0,0,0,0,0
2023-02-24,UK,Ukraine,4,4,0,0,0,0,0,0,0
2023-02-25,UK,Ukraine,4,4,0,0,0,0,0,0,0
2023-02-26,UK,Ukraine,4,4,0,0,0,0,0,0,0
2023-02-27,UK,Ukraine,2,2,0,0,0,0,0,0,0
2023-02-28,UK,Ukraine,4,4,0,0,0,0,0,0,0
2023-03-01,UK,Ukraine,2,2,0,0,0,0,0,0,0
2023-03-02,UK,Ukraine,4,4,0,0,0,0,0,0,0
2023-03-03,UK,Ukraine,7,7,0,0,0,0,0,0,0
2023-03-04,UK,Ukraine,4,4,0,0,0,0,0,0,0
2023-03-05,UK,Ukraine,4,4,0,0,0,0,0,0,0
2023-03-06,UK,Ukraine,2,2,0,0,0,0,0,0,0
2023-03-07,UK,Ukraine,2,2,0,0,0,0,0,0,0
2023-03-08,UK,Ukraine,6,6,0,0,0,0,0,0,0
2023-03-09,UK,Ukraine,5,5,0,0,0,0,0,0,0
2023-03-10,UK,Ukraine,4,4,0,0,0,0,0,0,0
2023-03-11,UK,Ukraine,2,2,0,0,0,0,0,0,0
2023-03-12,UK,Ukraine,3,3,0,0,0,0,0,0,0
2023-03-13,UK,Ukraine,3,3,0,0,0,0,0,0,0
2023-03-14,UK,Ukraine,4,4,0,0,0,0,0,0,0
2023-03-15,UK,Ukraine,1,1,0,0,0,0,0,0,0
2023-03-16,UK,Ukraine,2,2,0,0,0,0,0,0,0
2023-03-17,UK,Ukraine,3,1,0,0,2,1,1,2,0
2023-03-18,UK,Ukraine,2,2,0,0,0,0,0,0,0
2023-03-19,UK,Ukraine,4,4,0,0,0,0,0,0,0
2023-03-20,UK,Ukraine,2,2,0,0,0,0,0,0,0
2023-03-21,UK,Ukraine,1,1,0,0,0,0,0,0,0
2023-03-22,UK,Ukraine,5,3,0,0,2,1,1,2,0
2023-03-23,UK,Ukraine,1,1,0,0,0,0,0,0,0
2023-03-24,UK,Ukraine,4,3,0,0,1,0,1,1,0
2023-03-25,UK,Ukraine,3,3,0,0,0,0,0,0,0
2023-03-26,UK,Ukraine,4,4,0,0,0,0,0,0,0
2023-03-27,UK,Ukraine,5,3,0,0,2,0,2,2,0
2023-03-28,UK,Ukraine,0,-1,0,0,1,1,0,1,0
2023-03-29,UK,Ukraine,4,4,0,0,0,0,0,0,0
2023-03-30,UK,Ukraine,0,0,0,0,0,0,0,0,0
2023-03-31,UK,Ukraine,1,1,0,0,0,0,0,0,0
2023-04-01,UK,Ukraine,4,4,0,0,0,0,0,0,0
2023-04-02,UK,Ukraine,6,6,0,0,0,0,0,0,0
2023-04-03,UK,Ukraine,3,3,0,0,0,0,0,0,0
2023-04-04,UK,Ukraine,3,3,0,0,0,0,0,0,0
2023-04-05,UK,Ukraine,5,5,0,0,0,0,0,0,0
2023-04-06,UK,Ukraine,4,4,0,0,0,0,0,0,0
2023-04-07,UK,Ukraine,1,1,0,0,0,0,0,0,0
2023-04-08,UK,Ukraine,3,3,0,0,0,0,0,0,0
2023-04-09,UK,Ukraine,3,3,0,0,0,0,0,0,0
2023-04-10,UK,Ukraine,0,0,0,0,0,0,0,0,0
2023-04-11,UK,Ukraine,4,4,0,0,0,0,0,0,0
2023-04-12,UK,Ukraine,2,2,0,0,0,0,0,0,0
2023-04-13,UK,Ukraine,5,5,0,0,0,0,0,0,0
2023-04-14,UK,Ukraine,1,1,0,0,0,0,0,0,0
2023-04-15,UK,Ukraine,3,3,0,0,0,0,0,0,0
2023-04-16,UK,Ukraine,4,4,0,0,0,0,0,0,0
2023-04-17,UK,Ukraine,4,4,0,0,0,0,0,0,0
2023-04-18,UK,Ukraine,3,3,0,0,0,0,0,0,0
2023-04-19,UK,Ukraine,3,3,0,0,0,0,0,0,0
2023-04-20,UK,Ukraine,6,6,0,0,0,0,0,0,0
2023-04-21,UK,Ukraine,2,2,0,0,0,0,0,0,0
2023-04-22,UK,Ukraine,5,5,0,0,0,0,0,0,0
2023-04-23,UK,Ukraine,0,0,0,0,0,0,0,0,0
2023-04-24,UK,Ukraine,4,3,0,0,1,0,1,1,0
2023-04-25,UK,Ukraine,2,1,0,0,1,1,0,1,0
2023-04-26,UK,Ukraine,2,2,0,0,0,0,0,0,0
2023-04-27,UK,Ukraine,5,5,0,0,0,0,0,0,0
2023-04-28,UK,Ukraine,5,4,0,0,1,0,1,1,0
2023-04-29,UK,Ukraine,4,4,0,0,0,0,0,0,0
2023-04-30,UK,Ukraine,4,4,0,0,0,0,0,0,0
2023-05-01,UK,Ukraine,1,1,0,0,0,0,0,0,0
2023-05-02,UK,Ukraine,2,2,0,0,0,0,0,0,0
2023-05-03,UK,Ukraine,2,2,0,0,0,0,0,0,0
2023-05-04,UK,Ukraine,1,1,0,0,0,0,0,0,0
2023-05-05,UK,Ukraine,6,5,0,0,1,1,0,1,0
2023-05-06,UK,Ukraine,0,0,0,0,0,0,0,0,0
2023-05-07,UK,Ukraine,1,1,0,0,0,0,0,0,0
2023-05-08,UK,Ukraine,6,6,0,0,0,0,0,0,0
2023-05-09,UK,Ukraine,1,1,0,0,0,0,0,0,0
2023-05-10,UK,Ukraine,2,1,0,0,1,1,0,1,0
2023-05-11,UK,Ukraine,0,0,0,0,0,0,0,0,0
2023-05-12,UK,Ukraine,1,1,0,0,0,0,0,0,0
2023-05-13,UK,Ukraine,2,2,0,0,0,0,0,0,0
2023-05-14,UK,Ukraine,2,2,0,0,0,0,0,0,0
2023-05-15,UK,Ukraine,1,1,0,0,0,0,0,0,0
2023-05-16,UK,Ukraine,0,0,0,0,0,0,0,0,0
2023-05-17,UK,Ukraine,2,1,0,0,1,1,0,1,0
2023-05-18,UK,Ukraine,4,3,0,0,1,0,1,1,0
2023-05-19,UK,Ukraine,5,5,0,0,0,0,0,0,0
2023-05-20,UK,Ukraine,1,1,0,0,0,0,0,0,0
2023-05-21,UK,Ukraine,2,2,0,0,0,0,0,0,0
2023-05-22,UK,Ukraine,4,4,0,0,0,0,0,0,0
2023-05-23,UK,Ukraine,3,3,0,0,0,0,0,0,0
2023-05-24,UK,Ukraine,3,3,0,0,0,0,0,0,0
2023-05-25,UK,Ukraine,6,6,0,0,0,0,0,0,0
2023-05-26,UK,Ukraine,2,2,0,0,0,0,0,0,0
2023-05-27,UK,Ukraine,2,2,0,0,0,0,0,0,0
2023-05-28,UK,Ukraine,2,2,0,0,0,0,0,0,0
2023-05-29,UK,Ukraine,6,6,0,0,0,0,0,0,0
2023-05-30,UK,Ukraine,1,1,0,0,0,0,0,0,0
2023-05-31,UK,Ukraine,3,2,0,0,1,0,1,1,0
2023-06-01,UK,Ukraine,3,2,0,0,1,1,0,1,0
2023-06-02,UK,Ukraine,5,5,0,0,0,0,0,0,0
2023-06-03,UK,Ukraine,4,2,0,0,2,1,1,2,0
2023-06-04,UK,Ukraine,5,5,0,0,0,0,0,0,0
2023-06-05,UK,Ukraine,3,3,0,0,0,0,0,0,0
2023-06-06,UK,Ukraine,2,2,0,0,0,0,0,0,0
2023-06-07,UK,Ukraine,2,1,0,0,1,0,1,1,0
2023-06-08,UK,Ukraine,4,4,0,0,0,0,0,0,0
2023-06-09,UK,Ukraine,3,3,0,0,0,0,0,0,0
2023-06-10,UK,Ukraine,3,3,0,0,0,0,0,0,0
2023-06-11,UK,Ukraine,7,7,0,0,0,0,0,0,0
2023-06-12,UK,Ukraine,4,4,0,0,0,0,0,0,0
2023-06-13,UK,Ukraine,5,5,0,0,0,0,0,0,0
2023-06-14,UK,Ukraine,7,7,0,0,0,0,0,0,0
2023-06-15,UK,Ukraine,4,4,0,0,0,0,0,0,0
2023-06-16,UK,Ukraine,9,9,0,0,0,0,0,0,0
2023-06-17,UK,Ukraine,5,5,0,0,0,0,0,0,0
2023-06-18,UK,Ukraine,0,0,0,0,0,0,0,0,0
2023-06-19,UK,Ukraine,4,4,0,0,0,0,0,0,0
2023-06-20,UK,Ukraine,7,7,0,0,0,0,0,0,0
2023-06-21,UK,Ukraine,5,5,0,0,0,0,0,0,0
2023-06-22,UK,Ukraine,4,4,0,0,0,0,0,0,0
2023-06-23,UK,Ukraine,10,8,0,0,2,1,1,2,0
2023-06-24,UK,Ukraine,3,2,0,0,1,0,1,1,0
2023-06-25,UK,Ukraine,0,0,0,0,0,0,0,0,0
2023-06-26,UK,Ukraine,2,2,0,0,0,0,0,0,0
2023-06-27,UK,Ukraine,2,2,0,0,0,0,0,0,0
2023-06-28,UK,Ukraine,1,1,0,0,0,0,0,0,0
2023-06-29,UK,Ukraine,3,3,0,0,0,0,0,0,0
2023-06-30,UK,Ukraine,7,7,0,0,0,0,0,0,0
2023-07-01,UK,Ukraine,2,2,0,0,0,0,0,0,0
2023-07-02,UK,Ukraine,4,4,0,0,0,0,0,0,0
2023-07-03,UK,Ukraine,5,4,0,0,1,0,1,1,0
2023-07-04,UK,Ukraine,2,2,0,0,0,0,0,0,0
2023-07-05,UK,Ukraine,5,5,0,0,0,0,0,0,0
2023-07-06,UK,Ukraine,8,8,0,0,0,0,0,0,0
2023-07-07,UK,Ukraine,4,4,0,0,0,0,0,0,0
2023-07-08,UK,Ukraine,8,8,0,0,0,0,0,0,0
2023-07-09,UK,Ukraine,2,2,0,0,0,0,0,0,0
2023-07-10,UK,Ukraine,7,6,0,0,1,1,0,1,0
2023-07-11,UK,Ukraine,2,2,0,0,0,0,0,0,0
2023-07-12,UK,Ukraine,3,3,0,0,0,0,0,0,0
2023-07-13,UK,Ukraine,6,5,1,0,1,0,0,0,1
2023-07-14,UK,Ukraine,6,6,0,0,0,0,0,0,0
2023-07-15,UK,Ukraine,6,5,0,0,1,0,1,1,0
2023-07-16,UK,Ukraine,1,1,0,0,0,0,0,0,0
2023-07-17,UK,Ukraine,8,6,0,0,2,2,0,2,0
2023-07-18,UK,Ukraine,8,8,0,0,0,0,0,0,0
2023-07-19,UK,Ukraine,6,6,0,0,0,0,0,0,0
2023-07-20,UK,Ukraine,5,5,0,0,0,0,0,0,0
2023-07-21,UK,Ukraine,1,1,0,0,0,0,0,0,0
2023-07-22,UK,Ukraine,4,2,0,0,2,1,1,2,0
2023-07-23,UK,Ukraine,3,3,0,0,0,0,0,0,0
2023-07-24,UK,Ukraine,8,8,0,0,0,0,0,0,0
2023-07-25,UK,Ukraine,7,7,0,0,0,0,0,0,0
2023-07-26,UK,Ukraine,8,8,0,0,0,0,0,0,0
2023-07-27,UK,Ukraine,9,7,0,0,2,1,1,2,0
2023-07-28,UK,Ukraine,1,1,0,0,0,0,0,0,0
2023-07-29,UK,Ukraine,3,2,0,0,1,1,0,1,0
2023-07-30,UK,Ukraine,1,1,0,0,0,0,0,0,0
2023-07-31,UK,Ukraine,3,3,0,0,0,0,0,0,0
2023-08-01,UK,Ukraine,1,1,0,0,0,0,0,0,0
2023-08-02,UK,Ukraine,5,4,0,0,1,1,0,1,0
2023-08-03,UK,Ukraine,6,6,0,0,0,0,0,0,0
2023-08-04,UK,Ukraine,3,3,0,0,0,0,0,0,0
2023-08-05,UK,Ukraine,5,5,0,0,0,0,0,0,0
2023-08-06,UK,Ukraine,3,3,0,0,0,0,0,0,0
2023-08-07,UK,Ukraine,1,1,0,0,0,0,0,0,0
2023-08-08,UK,Ukraine,4,3,0,0,1,1,0,1,0
2023-08-09,UK,Ukraine,4,4,0,0,0,0,0,0,0
2023-08-10,UK,Ukraine,6,4,0,0,2,1,1,2,0
2023-08-11,UK,Ukraine,5,4,0,0,1,0,1,1,0
2023-08-12,UK,Ukraine,3,3,0,0,0,0,0,0,0
2023-08-13,UK,Ukraine,5,5,0,0,0,0,0,0,0
2023-08-14,UK,Ukraine,4,4,0,0,0,0,0,0,0
2023-08-15,UK,Ukraine,7,6,0,0,1,1,0,1,0
2023-08-16,UK,Ukraine,2,1,0,0,1,0,1,1,0
2023-08-17,UK,Ukraine,1,1,0,0,0,0,0,0,0
2023-08-18,UK,Ukraine,8,8,0,0,0,0,0,0,0
2023-08-19,UK,Ukraine,1,1,0,0,0,0,0,0,0
2023-08-20,UK,Ukraine,4,4,0,0,0,0,0,0,0
2023-08-21,UK,Ukraine,8,8,0,0,0,0,0,0,0
2023-08-22,UK,Ukraine,4,4,0,0,0,0,0,0,0
2023-08-23,UK,Ukraine,10,10,0,0,0,0,0,0,0
2023-08-24,UK,Ukraine,4,4,0,0,0,0,0,0,0
2023-08-25,UK,Ukraine,2,2,0,0,0,0,0,0,0
2023-08-26,UK,Ukraine,3,3,0,0,0,0,0,0,0
2023-08-27,UK,Ukraine,5,5,0,0,0,0,0,0,0
2023-08-28,UK,Ukraine,2,2,0,0,0,0,0,0,0
2023-08-29,UK,Ukraine,1,1,0,0,0,0,0,0,0
2023-08-30,UK,Ukraine,3,3,0,0,0,0,0,0,0
2023-08-31,UK,Ukraine,3,3,0,0,0,0,0,0,0
2023-09-01,UK,Ukraine,2,2,0,0,0,0,0,0,0
2023-09-02,UK,Ukraine,2,1,0,0,1,1,0,1,0
2023-09-03,UK,Ukraine,2,1,0,0,1,0,1,1,0
2023-09-04,UK,Ukraine,4,4,0,0,0,0,0,0,0
2023-09-05,UK,Ukraine,9,6,0,0,3,1,2,3,0
2023-09-06,UK,Ukraine,4,4,0,0,0,0,0,0,0
2023-09-07,UK,Ukraine,4,4,0,0,0,0,0,0,0
2023-09-08,UK,Ukraine,4,4,0,0,0,0,0,0,0
2023-09-09,UK,Ukraine,2,2,0,0,0,0,0,0,0
2023-09-10,UK,Ukraine,3,3,0,0,0,0,0,0,0
2023-09-11,UK,Ukraine,4,4,0,0,0,0,0,0,0
2023-09-12,UK,Ukraine,2,2,0,0,0,0,0,0,0
2023-09-13,UK,Ukraine,4,4,0,0,0,0,0,0,0
2023-09-14,UK,Ukraine,7,5,0,0,2,1,1,2,0
2023-09-15,UK,Ukraine,2,2,0,0,0,0,0,0,0
2023-09-16,UK,Ukraine,2,2,0,0,0,0,0,0,0
2023-09-17,UK,Ukraine,5,5,0,0,0,0,0,0,0
2023-09-18,UK,Ukraine,4,4,0,0,0,0,0,0,0
2023-09-19,UK,Ukraine,3,3,0,0,0,0,0,0,0
2023-09-20,UK,Ukraine,1,1,0,0,0,0,0,0,0
2023-09-21,UK,Ukraine,2,2,0,0,0,0,0,0,0
2023-09-22,UK,Ukraine,0,0,0,0,0,0,0,0,0
2023-09-23,UK,Ukraine,4,3,0,0,1,1,0,1,0
2023-09-24,UK,Ukraine,4,4,0,0,0,0,0,0,0
2023-09-25,UK,Ukraine,0,0,0,0,0,0,0,0,0
2023-09-26,UK,Ukraine,0,0,0,0,0,0,0,0,0
2023-09-27,UK,Ukraine,2,2,0,0,0,0,0,0,0
2023-09-28,UK,Ukraine,2,2,0,0,0,0,0,0,0
2023-09-29,UK,Ukraine,2,2,0,0,0,0,0,0,0
2023-09-30,UK,Ukraine,3,3,0,0,0,0,0,0,0
2023-10-01,UK,Ukraine,7,7,0,0,0,0,0,0,0
2023-10-02,UK,Ukraine,3,3,0,0,0,0,0,0,0
2023-01-01,EG,United Kingdom,4936,1201,392,2,3735,1674,1669,3343,390
2023-01-02,EG,United Kingdom,6018,1296,691,3,4722,1979,2052,4031,688
2023-01-03,EG,United Kingdom,5659,1205,715,7,4454,1860,1879,3739,708
2023-01-04,EG,United Kingdom,5667,1259,811,14,4408,1805,1792,3597,797
2023-01-05,EG,United Kingdom,5733,1249,816,15,4484,1839,1829,3668,801
2023-01-06,EG,United Kingdom,6008,1280,836,11,4728,1957,1935,3892,825
2023-01-07,EG,United Kingdom,5492,1313,477,4,4179,1853,1849,3702,473
2023-01-08,EG,United Kingdom,5743,1305,594,4,4438,1913,1931,3844,590
2023-01-09,EG,United Kingdom,5635,1185,820,12,4450,1799,1831,3630,808
2023-01-10,EG,United Kingdom,4854,1134,673,6,3720,1539,1508,3047,667
2023-01-11,EG,United Kingdom,4858,1088,721,14,3770,1511,1538,3049,707
2023-01-12,EG,United Kingdom,5226,1128,786,19,4098,1659,1653,3312,767
2023-01-13,EG,United Kingdom,5703,1181,822,13,4522,1838,1862,3700,809
2023-01-14,EG,United Kingdom,5057,1182,444,8,3875,1718,1713,3431,436
2023-01-15,EG,United Kingdom,5533,1266,571,2,4267,1840,1856,3696,569
2023-01-16,EG,United Kingdom,5513,1260,777,12,4253,1744,1732,3476,765
2023-01-17,EG,United Kingdom,4743,1110,700,17,3633,1468,1465,2933,683
2023-01-18,EG,United Kingdom,4772,1077,742,15,3695,1468,1485,2953,727
2023-01-19,EG,United Kingdom,5160,1116,790,14,4044,1647,1607,3254,776
2023-01-20,EG,United Kingdom,5888,1262,893,14,4626,1864,1869,3733,879
2023-01-21,EG,United Kingdom,5187,1290,489,3,3897,1723,1685,3408,486
2023-01-22,EG,United Kingdom,5474,1218,614,4,4256,1804,1838,3642,610
2023-01-23,EG,United Kingdom,5400,1190,802,16,4210,1696,1712,3408,786
2023-01-24,EG,United Kingdom,4784,1111,744,14,3673,1480,1449,2929,730
2023-01-25,EG,United Kingdom,4710,1105,709,20,3605,1443,1453,2896,689
2023-01-26,EG,United Kingdom,5322,1176,857,16,4146,1650,1639,3289,841
2023-01-27,EG,United Kingdom,5698,1200,854,21,4498,1817,1827,3644,833
2023-01-28,EG,United Kingdom,5073,1293,430,8,3780,1679,1671,3350,422
2023-01-29,EG,United Kingdom,5507,1265,549,8,4242,1829,1864,3693,541
2023-01-30,EG,United Kingdom,5416,1117,803,25,4299,1751,1745,3496,778
2023-01-31,EG,United Kingdom,4764,1056,698,19,3708,1513,1497,3010,679
2023-02-01,EG,United Kingdom,4854,1037,768,17,3817,1534,1515,3049,751
2023-02-02,EG,United Kingdom,5326,1172,828,21,4154,1659,1667,3326,807
2023-02-03,EG,United Kingdom,5871,1244,843,9,4627,1882,1902,3784,834
2023-02-04,EG,United Kingdom,5171,1242,462,8,3929,1743,1724,3467,454
2023-02-05,EG,United Kingdom,5666,1268,626,8,4398,1878,1894,3772,618
2023-02-06,EG,United Kingdom,5673,1208,822,18,4465,1824,1819,3643,804
2023-02-07,EG,United Kingdom,4772,1065,708,19,3707,1495,1504,2999,689
2023-02-08,EG,United Kingdom,4959,1101,723,20,3858,1565,1570,3135,703
2023-02-09,EG,United Kingdom,5645,1180,844,16,4465,1810,1811,3621,828
2023-02-10,EG,United Kingdom,6461,1341,891,18,5120,2110,2119,4229,873
2023-02-11,EG,United Kingdom,5812,1289,492,4,4523,2055,1976,4031,488
2023-02-12,EG,United Kingdom,5970,1369,599,4,4601,2011,1991,4002,595
2023-02-13,EG,United Kingdom,5881,1194,851,11,4687,1920,1916,3836,840
2023-02-14,EG,United Kingdom,5103,1117,758,19,3986,1613,1615,3228,739
2023-02-15,EG,United Kingdom,5295,1082,825,27,4213,1689,1699,3388,798
2023-02-16,EG,United Kingdom,5738,1217,836,19,4521,1845,1840,3685,817
2023-02-17,EG,United Kingdom,5854,1061,833,24,4793,1979,1981,3960,809
2023-02-18,EG,United Kingdom,5942,1304,500,4,4638,2037,2101,4138,496
2023-02-19,EG,United Kingdom,6285,1316,632,9,4969,2150,2187,4337,623
2023-02-20,EG,United Kingdom,6035,1271,833,9,4764,1975,1956,3931,824
2023-02-21,EG,United Kingdom,5304,1145,727,12,4159,1715,1717,3432,715
2023-02-22,EG,United Kingdom,5295,1141,710,13,4154,1727,1717,3444,697
2023-02-23,EG,United Kingdom,5741,1212,768,17,4529,1897,1864,3761,751
2023-02-24,EG,United Kingdom,6212,1264,895,13,4948,2041,2012,4053,882
2023-02-25,EG,United Kingdom,5563,1299,505,2,4264,1871,1888,3759,503
2023-02-26,EG,United Kingdom,6045,1342,637,4,4703,2019,2047,4066,633
2023-02-27,EG,United Kingdom,6064,1249,871,15,4815,1966,1978,3944,856
2023-02-28,EG,United Kingdom,5467,1194,824,17,4273,1725,1724,3449,807
2023-03-01,EG,United Kingdom,5549,1196,827,12,4353,1774,1752,3526,815
2023-03-02,EG,United Kingdom,5843,1255,843,17,4588,1883,1862,3745,826
2023-03-03,EG,United Kingdom,6249,1312,865,14,4937,2037,2035,4072,851
2023-03-04,EG,United Kingdom,5533,1271,500,5,4262,1886,1876,3762,495
2023-03-05,EG,United Kingdom,5910,1286,626,8,4624,1980,2018,3998,618
2023-03-06,EG,United Kingdom,6017,1269,820,17,4748,1962,1966,3928,803
2023-03-07,EG,United Kingdom,5263,1107,763,22,4156,1684,1709,3393,741
2023-03-08,EG,United Kingdom,5176,1174,717,16,4002,1646,1639,3285,701
2023-03-09,EG,United Kingdom,5805,1278,779,17,4527,1877,1871,3748,762
2023-03-10,EG,United Kingdom,6095,1332,793,13,4763,1990,1980,3970,780
2023-03-11,EG,United Kingdom,5655,1407,515,12,4248,1873,1860,3733,503
2023-03-12,EG,United Kingdom,6165,1422,668,8,4743,2025,2050,4075,660
2023-03-13,EG,United Kingdom,5805,1230,751,13,4575,1899,1925,3824,738
2023-03-14,EG,United Kingdom,5532,1153,841,12,4379,1777,1761,3538,829
2023-03-15,EG,United Kingdom,5661,1246,855,24,4415,1793,1767,3560,831
2023-03-16,EG,United Kingdom,5994,1322,853,17,4672,1915,1904,3819,836
2023-03-17,EG,United Kingdom,6350,1284,888,16,5066,2081,2097,4178,872
2023-03-18,EG,United Kingdom,5630,1323,503,2,4307,1918,1886,3804,501
2023-03-19,EG,United Kingdom,6132,1351,633,9,4781,2052,2096,4148,624
2023-03-20,EG,United Kingdom,6092,1324,803,19,4768,1987,1978,3965,784
2023-03-21,EG,United Kingdom,5498,1190,791,19,4308,1752,1765,3517,772
2023-03-22,EG,United Kingdom,5680,1329,802,30,4351,1775,1774,3549,772
2023-03-23,EG,United Kingdom,5979,1310,841,10,4669,1909,1919,3828,831
2023-03-24,EG,United Kingdom,6390,1396,841,13,4994,2079,2074,4153,828
2023-03-25,EG,United Kingdom,5568,1354,473,3,4214,1875,1866,3741,470
2023-03-26,EG,United Kingdom,6204,1419,633,3,4785,2059,2093,4152,630
2023-03-27,EG,United Kingdom,6216,1269,913,11,4947,2008,2026,4034,902
2023-03-28,EG,United Kingdom,6303,1467,827,22,4836,2017,1992,4009,805
2023-03-29,EG,United Kingdom,6487,1451,884,22,5036,2073,2079,4152,862
2023-03-30,EG,United Kingdom,6820,1473,922,22,5347,2219,2206,4425,900
2023-03-31,EG,United Kingdom,6847,1528,820,7,5319,2261,2238,4499,813
2023-04-01,EG,United Kingdom,6283,1465,578,6,4818,2128,2112,4240,572
2023-04-02,EG,United Kingdom,6635,1570,676,5,5065,2180,2209,4389,671
2023-04-03,EG,United Kingdom,6785,1503,925,14,5282,2184,2173,4357,911
2023-04-04,EG,United Kingdom,6666,1450,909,15,5216,2160,2147,4307,894
2023-04-05,EG,United Kingdom,6705,1484,911,14,5221,2147,2163,4310,897
2023-04-06,EG,United Kingdom,6961,1477,929,16,5484,2291,2264,4555,913
2023-04-07,EG,United Kingdom,6751,1474,842,10,5277,2215,2220,4435,832
2023-04-08,EG,United Kingdom,6084,1398,534,8,4686,2086,2066,4152,526
2023-04-09,EG,United Kingdom,6421,1453,649,8,4968,2148,2171,4319,641
2023-04-10,EG,United Kingdom,6580,1409,790,10,5171,2186,2195,4381,780
2023-04-11,EG,United Kingdom,6555,1393,857,13,5162,2141,2164,4305,844
2023-04-12,EG,United Kingdom,6551,1446,833,14,5105,2122,2150,4272,819
2023-04-13,EG,United Kingdom,6853,1433,944,16,5420,2247,2229,4476,928
2023-04-14,EG,United Kingdom,7032,1512,920,11,5520,2285,2315,4600,909
2023-04-15,EG,United Kingdom,6304,1448,584,13,4856,2129,2143,4272,571
2023-04-16,EG,United Kingdom,6689,1474,658,8,5215,2275,2282,4557,650
2023-04-17,EG,United Kingdom,6919,1480,947,18,5439,2234,2258,4492,929
2023-04-18,EG,United Kingdom,6706,1435,883,12,5271,2206,2182,4388,871
2023-04-19,EG,United Kingdom,6787,1476,882,15,5311,2223,2206,4429,867
2023-04-20,EG,United Kingdom,6958,1475,935,15,5483,2295,2253,4548,920
2023-04-21,EG,United Kingdom,7082,1526,952,14,5556,2297,2307,4604,938
2023-04-22,EG,United Kingdom,6156,1443,592,6,4713,2064,2057,4121,586
2023-04-23,EG,United Kingdom,6660,1555,700,4,5105,2180,2225,4405,696
2023-04-24,EG,United Kingdom,6949,1539,943,9,5410,2238,2229,4467,934
2023-04-25,EG,United Kingdom,6735,1502,903,14,5233,2166,2164,4330,889
2023-04-26,EG,United Kingdom,6744,1460,923,14,5284,2188,2173,4361,909
2023-04-27,EG,United Kingdom,7020,1510,892,18,5510,2306,2312,4618,874
2023-04-28,EG,United Kingdom,7187,1507,991,10,5680,2377,2312,4689,981
2023-04-29,EG,United Kingdom,6179,1403,580,8,4776,2107,2089,4196,572
2023-04-30,EG,United Kingdom,6588,1488,731,13,5100,2176,2193,4369,718
2023-05-01,EG,United Kingdom,6774,1433,820,7,5341,2246,2275,4521,813
2023-05-02,EG,United Kingdom,7043,1554,882,16,5489,2297,2310,4607,866
2023-05-03,EG,United Kingdom,7047,1546,924,19,5501,2275,2302,4577,905
2023-05-04,EG,United Kingdom,7385,1539,999,18,5846,2417,2430,4847,981
2023-05-05,EG,United Kingdom,7517,1597,973,14,5920,2473,2474,4947,959
2023-05-06,EG,United Kingdom,6477,1489,562,8,4988,2235,2191,4426,554
2023-05-07,EG,United Kingdom,6924,1578,696,9,5346,2324,2326,4650,687
2023-05-08,EG,United Kingdom,7140,1550,799,10,5590,2380,2411,4791,789
2023-05-09,EG,United Kingdom,6979,1495,822,15,5484,2345,2317,4662,807
2023-05-10,EG,United Kingdom,7053,1527,893,16,5526,2304,2329,4633,877
2023-05-11,EG,United Kingdom,7448,1579,975,16,5869,2462,2432,4894,959
2023-05-12,EG,United Kingdom,7599,1662,979,11,5937,2477,2481,4958,968
2023-05-13,EG,United Kingdom,6629,1517,605,10,5112,2258,2249,4507,595
2023-05-14,EG,United Kingdom,7111,1645,734,11,5466,2344,2388,4732,723
2023-05-15,EG,United Kingdom,7389,1591,966,15,5798,2410,2422,4832,951
2023-05-16,EG,United Kingdom,7250,1618,921,17,5632,2362,2349,4711,904
2023-05-17,EG,United Kingdom,7310,1670,927,25,5640,2339,2374,4713,902
2023-05-18,EG,United Kingdom,7495,1602,987,17,5893,2456,2450,4906,970
2023-05-19,EG,United Kingdom,7455,1648,1006,11,5807,2409,2392,4801,995
2023-05-20,EG,United Kingdom,6642,1524,603,11,5118,2278,2237,4515,592
2023-05-21,EG,United Kingdom,7208,1716,723,7,5492,2382,2387,4769,716
2023-05-22,EG,United Kingdom,7465,1629,969,17,5836,2404,2463,4867,952
2023-05-23,EG,United Kingdom,7371,1640,920,22,5731,2412,2399,4811,898
2023-05-24,EG,United Kingdom,7467,1658,931,27,5809,2436,2442,4878,904
2023-05-25,EG,United Kingdom,7737,1631,975,17,6106,2572,2559,5131,958
2023-05-26,EG,United Kingdom,8056,1741,980,11,6315,2679,2656,5335,969
2023-05-27,EG,United Kingdom,7168,1623,632,8,5545,2485,2428,4913,624
2023-05-28,EG,United Kingdom,7221,1628,715,10,5593,2431,2447,4878,705
2023-05-29,EG,United Kingdom,7540,1675,856,8,5865,2480,2529,5009,848
2023-05-30,EG,United Kingdom,7465,1621,890,15,5844,2471,2483,4954,875
2023-05-31,EG,United Kingdom,7588,1676,990,19,5912,2461,2461,4922,971
2023-06-01,EG,United Kingdom,7815,1687,990,14,6128,2580,2558,5138,976
2023-06-02,EG,United Kingdom,7865,1720,973,11,6145,2584,2588,5172,962
2023-06-03,EG,United Kingdom,7161,1691,605,10,5470,2419,2446,4865,595
2023-06-04,EG,United Kingdom,7707,1777,750,9,5930,2575,2605,5180,741
2023-06-05,EG,United Kingdom,7789,1691,975,10,6098,2562,2561,5123,965
2023-06-06,EG,United Kingdom,7568,1727,925,4,5841,2469,2447,4916,921
2023-06-07,EG,United Kingdom,7828,1771,951,12,6057,2549,2557,5106,939
2023-06-08,EG,United Kingdom,7955,1759,971,13,6196,2606,2619,5225,958
2023-06-09,EG,United Kingdom,8101,1796,970,11,6305,2672,2663,5335,959
2023-06-10,EG,United Kingdom,7193,1663,597,4,5530,2464,2469,4933,593
2023-06-11,EG,United Kingdom,7563,1764,741,12,5799,2513,2545,5058,729
2023-06-12,EG,United Kingdom,7695,1768,897,24,5927,2494,2536,5030,873
2023-06-13,EG,United Kingdom,7753,1774,905,22,5979,2545,2529,5074,883
2023-06-14,EG,United Kingdom,7841,1718,977,25,6123,2561,2585,5146,952
2023-06-15,EG,United Kingdom,8018,1754,997,24,6264,2654,2613,5267,973
2023-06-16,EG,United Kingdom,8164,1794,1001,19,6370,2683,2686,5369,982
2023-06-17,EG,United Kingdom,7236,1703,599,12,5533,2457,2477,4934,587
2023-06-18,EG,United Kingdom,7339,1717,661,7,5622,2503,2458,4961,654
2023-06-19,EG,United Kingdom,8051,1897,937,12,6154,2601,2616,5217,925
2023-06-20,EG,United Kingdom,7739,1823,881,23,5916,2514,2521,5035,858
2023-06-21,EG,United Kingdom,7924,1788,951,20,6136,2591,2594,5185,931
2023-06-22,EG,United Kingdom,8154,1871,1011,27,6283,2627,2645,5272,984
2023-06-23,EG,United Kingdom,8170,1786,993,9,6384,2685,2706,5391,984
2023-06-24,EG,United Kingdom,7249,1722,593,16,5527,2487,2447,4934,577
2023-06-25,EG,United Kingdom,7719,1764,739,17,5955,2606,2610,5216,722
2023-06-26,EG,United Kingdom,7987,1713,978,14,6274,2633,2663,5296,964
2023-06-27,EG,United Kingdom,7802,1726,908,23,6076,2589,2579,5168,885
2023-06-28,EG,United Kingdom,7895,1796,895,15,6099,2597,2607,5204,880
2023-06-29,EG,United Kingdom,8080,1784,978,16,6296,2672,2646,5318,962
2023-06-30,EG,United Kingdom,8163,1784,1003,6,6379,2694,2682,5376,997
2023-07-01,EG,United Kingdom,7445,1731,620,8,5714,2548,2546,5094,612
2023-07-02,EG,United Kingdom,7797,1779,714,3,6018,2655,2649,5304,711
2023-07-03,EG,United Kingdom,7952,1748,925,8,6204,2629,2650,5279,917
2023-07-04,EG,United Kingdom,7857,1777,914,8,6080,2588,2578,5166,906
2023-07-05,EG,United Kingdom,7741,1706,936,24,6035,2546,2553,5099,912
2023-07-06,EG,United Kingdom,8164,1757,976,15,6407,2714,2717,5431,961
2023-07-07,EG,United Kingdom,8343,1805,1001,18,6538,2770,2767,5537,983
2023-07-08,EG,United Kingdom,7323,1702,581,8,5621,2532,2508,5040,573
2023-07-09,EG,United Kingdom,7920,1868,727,7,6052,2655,2670,5325,720
2023-07-10,EG,United Kingdom,8152,1817,947,22,6335,2688,2700,5388,925
2023-07-11,EG,United Kingdom,7898,1764,935,20,6134,2600,2599,5199,915
2023-07-12,EG,United Kingdom,7911,1738,915,18,6173,2604,2654,5258,897
2023-07-13,EG,United Kingdom,8192,1813,975,25,6379,2689,2715,5404,950
2023-07-14,EG,United Kingdom,8106,1695,929,10,6411,2728,2754,5482,919
2023-07-15,EG,United Kingdom,7266,1671,593,5,5595,2518,2484,5002,588
2023-07-16,EG,United Kingdom,7892,1802,727,8,6090,2677,2686,5363,719
2023-07-17,EG,United Kingdom,8219,1820,973,20,6399,2750,2676,5426,953
2023-07-18,EG,United Kingdom,7934,1801,925,18,6133,2603,2605,5208,907
2023-07-19,EG,United Kingdom,7967,1811,922,17,6156,2625,2609,5234,905
2023-07-20,EG,United Kingdom,8147,1821,959,21,6326,2679,2688,5367,938
2023-07-21,EG,United Kingdom,8235,1798,997,14,6437,2727,2713,5440,983
2023-07-22,EG,United Kingdom,7360,1688,623,10,5672,2544,2505,5049,613
2023-07-23,EG,United Kingdom,7867,1858,734,8,6009,2610,2665,5275,726
2023-07-24,EG,United Kingdom,7909,1732,960,11,6177,2605,2612,5217,949
2023-07-25,EG,United Kingdom,7791,1757,899,27,6034,2574,2561,5135,872
2023-07-26,EG,United Kingdom,7902,1764,911,20,6138,2615,2612,5227,891
2023-07-27,EG,United Kingdom,8102,1812,949,16,6290,2674,2667,5341,933
2023-07-28,EG,United Kingdom,8224,1834,1012,20,6390,2690,2688,5378,992
2023-07-29,EG,United Kingdom,7425,1737,635,8,5688,2539,2514,5053,627
2023-07-30,EG,United Kingdom,7822,1825,720,1,5997,2627,2650,5277,719
2023-07-31,EG,United Kingdom,7926,1748,927,9,6178,2623,2628,5251,918
2023-08-01,EG,United Kingdom,7771,1731,885,15,6040,2579,2576,5155,870
2023-08-02,EG,United Kingdom,7698,1719,864,9,5979,2564,2551,5115,855
2023-08-03,EG,United Kingdom,8025,1771,966,14,6254,2635,2653,5288,952
2023-08-04,EG,United Kingdom,8107,1760,996,23,6347,2675,2676,5351,973
2023-08-05,EG,United Kingdom,7333,1682,586,8,5651,2545,2520,5065,578
2023-08-06,EG,United Kingdom,7698,1720,761,14,5978,2594,2623,5217,747
2023-08-07,EG,United Kingdom,7909,1757,931,15,6152,2612,2609,5221,916
2023-08-08,EG,United Kingdom,7683,1715,873,21,5968,2546,2549,5095,852
2023-08-09,EG,United Kingdom,7853,1794,944,23,6059,2560,2555,5115,921
2023-08-10,EG,United Kingdom,7988,1791,958,18,6197,2612,2627,5239,940
2023-08-11,EG,United Kingdom,8186,1853,973,10,6333,2691,2669,5360,963
2023-08-12,EG,United Kingdom,7344,1703,624,5,5641,2507,2510,5017,619
2023-08-13,EG,United Kingdom,7751,1815,754,5,5936,2588,2594,5182,749
2023-08-14,EG,United Kingdom,7862,1775,923,10,6087,2582,2582,5164,913
2023-08-15,EG,United Kingdom,7804,1829,871,20,5975,2553,2551,5104,851
2023-08-16,EG,United Kingdom,7719,1751,895,24,5968,2534,2539,5073,871
2023-08-17,EG,United Kingdom,7906,1743,944,21,6163,2614,2605,5219,923
2023-08-18,EG,United Kingdom,7947,1771,925,18,6176,2630,2621,5251,907
2023-08-19,EG,United Kingdom,7355,1776,595,15,5579,2505,2479,4984,580
2023-08-20,EG,United Kingdom,7833,1855,739,6,5978,2621,2618,5239,733
2023-08-21,EG,United Kingdom,7901,1741,940,17,6160,2594,2626,5220,923
2023-08-22,EG,United Kingdom,7750,1721,917,26,6029,2563,2549,5112,891
2023-08-23,EG,United Kingdom,7909,1729,935,22,6180,2613,2632,5245,913
2023-08-24,EG,United Kingdom,7882,1822,963,15,6060,2548,2549,5097,948
2023-08-25,EG,United Kingdom,8152,1806,974,14,6346,2698,2674,5372,960
2023-08-26,EG,United Kingdom,7367,1731,614,3,5636,2512,2510,5022,611
2023-08-27,EG,United Kingdom,7675,1802,713,3,5873,2577,2583,5160,710
2023-08-28,EG,United Kingdom,6001,1636,629,10,4365,1906,1830,3736,619
2023-08-29,EG,United Kingdom,7961,1642,891,7,6319,2649,2779,5428,884
2023-08-30,EG,United Kingdom,8060,1696,919,18,6364,2703,2742,5445,901
2023-08-31,EG,United Kingdom,8165,1677,946,16,6488,2784,2758,5542,930
2023-09-01,EG,United Kingdom,8193,1723,972,9,6470,2741,2757,5498,963
2023-09-02,EG,United Kingdom,7445,1770,627,11,5675,2532,2516,5048,616
2023-09-03,EG,United Kingdom,8001,1853,785,16,6148,2676,2687,5363,769
2023-09-04,EG,United Kingdom,8154,1837,937,12,6317,2691,2689,5380,925
2023-09-05,EG,United Kingdom,7862,1748,915,20,6114,2603,2596,5199,895
2023-09-06,EG,United Kingdom,7837,1743,912,18,6094,2586,2596,5182,894
2023-09-07,EG,United Kingdom,8115,1738,977,26,6377,2720,2680,5400,951
2023-09-08,EG,United Kingdom,8170,1768,988,22,6402,2712,2702,5414,966
2023-09-09,EG,United Kingdom,7304,1718,625,12,5586,2494,2467,4961,613
2023-09-10,EG,United Kingdom,7821,1768,751,6,6053,2632,2670,5302,745
2023-09-11,EG,United Kingdom,8010,1728,951,20,6282,2632,2699,5331,931
2023-09-12,EG,United Kingdom,7853,1761,910,14,6092,2599,2583,5182,896
2023-09-13,EG,United Kingdom,7901,1736,914,13,6165,2626,2625,5251,901
2023-09-14,EG,United Kingdom,8026,1721,1000,16,6305,2665,2640,5305,984
2023-09-15,EG,United Kingdom,8129,1713,1013,20,6416,2707,2696,5403,993
2023-09-16,EG,United Kingdom,7287,1681,626,11,5606,2507,2473,4980,615
2023-09-17,EG,United Kingdom,7616,1761,732,10,5855,2557,2566,5123,722
2023-09-18,EG,United Kingdom,7949,1741,918,14,6208,2626,2664,5290,904
2023-09-19,EG,United Kingdom,7735,1709,900,12,6026,2552,2574,5126,888
2023-09-20,EG,United Kingdom,7757,1711,860,16,6046,2596,2590,5186,844
2023-09-21,EG,United Kingdom,8097,1781,973,21,6316,2672,2671,5343,952
2023-09-22,EG,United Kingdom,8116,1747,1002,13,6369,2687,2680,5367,989
2023-09-23,EG,United Kingdom,7195,1664,639,11,5531,2451,2441,4892,628
2023-09-24,EG,United Kingdom,7675,1757,734,9,5918,2589,2595,5184,725
2023-09-25,EG,United Kingdom,7782,1716,940,11,6066,2563,2563,5126,929
2023-09-26,EG,United Kingdom,7197,1201,914,20,5996,2540,2542,5082,894
2023-09-27,EG,United Kingdom,7613,1650,878,18,5963,2556,2529,5085,860
2023-09-28,EG,United Kingdom,7940,1698,939,21,6242,2659,2644,5303,918
2023-09-29,EG,United Kingdom,7958,1639,983,17,6319,2656,2680,5336,966
2023-09-30,EG,United Kingdom,7113,1676,601,8,5437,2428,2408,4836,593
2023-10-01,EG,United Kingdom,7556,1760,710,8,5796,2520,2566,5086,702
2023-10-02,EG,United Kingdom,7736,1725,935,19,6011,2515,2561,5076,916
