entry_date,country_icao_code,country_name,flt_daio,flt_o,flt_i,flt_c,flt_dai,flt_d,flt_a,flt_da,flt_i_excl_c
2024-01-01,LA,Albania,584,436,0,0,148,73,75,148,0
2024-01-02,LA,Albania,629,454,0,0,175,88,87,175,0
2024-01-03,LA,Albania,666,493,0,0,173,86,87,173,0
2024-01-04,LA,Albania,25,-147,0,0,172,87,85,172,0
2024-01-05,LA,Albania,710,535,0,0,175,88,87,175,0
2024-01-06,LA,Albania,791,631,0,0,160,79,81,160,0
2024-01-07,LA,Albania,732,567,0,0,165,84,81,165,0
2024-01-08,LA,Albania,602,441,0,0,161,79,82,161,0
2024-01-09,LA,Albania,531,359,0,0,172,87,85,172,0
2024-01-10,LA,Albania,543,378,0,0,165,82,83,165,0
2024-01-11,LA,Albania,537,374,1,1,163,81,81,162,0
2024-01-12,LA,Albania,580,432,0,0,148,75,73,148,0
2024-01-13,LA,Albania,667,505,0,0,162,81,81,162,0
2024-01-14,LA,Albania,650,500,0,0,150,76,74,150,0
2024-01-15,LA,Albania,537,392,0,0,145,72,73,145,0
2024-01-01,UD,Armenia,156,54,0,0,102,52,50,102,0
2024-01-02,UD,Armenia,178,77,0,0,101,48,53,101,0
2024-01-03,UD,Armenia,174,63,0,0,111,55,56,111,0
2024-01-04,UD,Armenia,11,-100,0,0,111,56,55,111,0
2024-01-05,UD,Armenia,188,78,0,0,110,55,55,110,0
2024-01-06,UD,Armenia,209,80,0,0,129,63,66,129,0
2024-01-07,UD,Armenia,196,83,0,0,113,58,55,113,0
2024-01-08,UD,Armenia,200,75,0,0,125,63,62,125,0
2024-01-09,UD,Armenia,192,87,0,0,105,52,53,105,0
2024-01-10,UD,Armenia,187,77,0,0,110,54,56,110,0
2024-01-11,UD,Armenia,185,83,1,1,102,51,50,101,0
2024-01-12,UD,Armenia,177,79,0,0,98,48,50,98,0
2024-01-13,UD,Armenia,176,66,0,0,110,56,54,110,0
2024-01-14,UD,Armenia,170,67,0,0,103,51,52,103,0
2024-01-15,UD,Armenia,144,62,0,0,82,40,42,82,0
2024-01-01,LO,Austria,2922,2310,12,0,612,301,299,600,12
2024-01-02,LO,Austria,3119,2405,19,2,714,353,342,695,17
2024-01-03,LO,Austria,3145,2424,19,0,721,354,348,702,19
2024-01-04,LO,Austria,131,-580,13,2,711,348,350,698,11
2024-01-05,LO,Austria,3540,2690,39,0,850,410,401,811,39
2024-01-06,LO,Austria,3486,2693,18,1,793,389,386,775,17
2024-01-07,LO,Austria,3448,2712,13,0,736,363,360,723,13
2024-01-08,LO,Austria,3213,2509,21,1,704,336,347,683,20
2024-01-09,LO,Austria,2765,2165,29,1,600,283,288,571,28
2024-01-10,LO,Austria,2833,2149,39,3,684,326,319,645,36
2024-01-11,LO,Austria,2914,2239,44,2,675,310,321,631,42
2024-01-12,LO,Austria,3372,2613,21,1,759,366,372,738,20
2024-01-13,LO,Austria,3220,2485,18,1,735,360,357,717,17
2024-01-14,LO,Austria,3346,2608,31,1,738,359,348,707,30
2024-01-15,LO,Austria,3130,2406,24,1,724,351,349,700,23
2024-01-01,EB,Belgium and Luxembourg,2575,1811,1,1,764,386,377,763,0
2024-01-02,EB,Belgium and Luxembourg,2819,1947,5,2,872,429,438,867,3
2024-01-03,EB,Belgium and Luxembourg,2822,1910,5,3,912,451,456,907,2
2024-01-04,EB,Belgium and Luxembourg,128,-822,12,7,950,477,461,938,5
2024-01-05,EB,Belgium and Luxembourg,2988,2024,7,3,964,484,473,957,4
2024-01-06,EB,Belgium and Luxembourg,2944,2126,3,0,818,404,411,815,3
2024-01-07,EB,Belgium and Luxembourg,3020,2101,5,1,919,455,459,914,4
2024-01-08,EB,Belgium and Luxembourg,2728,1833,6,2,895,432,457,889,4
2024-01-09,EB,Belgium and Luxembourg,2472,1639,14,9,833,409,410,819,5
2024-01-10,EB,Belgium and Luxembourg,2456,1598,24,15,858,420,414,834,9
2024-01-11,EB,Belgium and Luxembourg,2679,1810,15,10,869,429,425,854,5
2024-01-12,EB,Belgium and Luxembourg,2952,2035,7,3,917,467,443,910,4
2024-01-13,EB,Belgium and Luxembourg,2706,2066,7,1,640,307,326,633,6
2024-01-14,EB,Belgium and Luxembourg,2954,2117,5,0,837,417,415,832,5
2024-01-15,EB,Belgium and Luxembourg,2625,1770,15,4,855,401,439,840,11
2024-01-01,LQ,Bosnia-Herzegovina,961,924,0,0,37,17,20,37,0
2024-01-02,LQ,Bosnia-Herzegovina,1071,1028,0,0,43,22,21,43,0
2024-01-03,LQ,Bosnia-Herzegovina,1034,990,0,0,44,22,22,44,0
2024-01-04,LQ,Bosnia-Herzegovina,39,-10,0,0,49,23,26,49,0
2024-01-05,LQ,Bosnia-Herzegovina,1086,1032,0,0,54,28,26,54,0
2024-01-06,LQ,Bosnia-Herzegovina,1202,1172,0,0,30,15,15,30,0
2024-01-07,LQ,Bosnia-Herzegovina,1162,1124,0,0,38,19,19,38,0
2024-01-08,LQ,Bosnia-Herzegovina,1015,961,0,0,54,27,27,54,0
2024-01-09,LQ,Bosnia-Herzegovina,893,847,0,0,46,23,23,46,0
2024-01-10,LQ,Bosnia-Herzegovina,882,843,1,1,39,20,18,38,0
2024-01-11,LQ,Bosnia-Herzegovina,896,853,1,1,43,20,22,42,0
2024-01-12,LQ,Bosnia-Herzegovina,1013,960,0,0,53,27,26,53,0
2024-01-13,LQ,Bosnia-Herzegovina,1051,1020,1,1,31,15,15,30,0
2024-01-14,LQ,Bosnia-Herzegovina,1061,1025,0,0,36,18,18,36,0
2024-01-15,LQ,Bosnia-Herzegovina,919,878,0,0,41,20,21,41,0
2024-01-01,LB,Bulgaria,2007,1864,4,0,143,70,69,139,4
2024-01-02,LB,Bulgaria,2302,2034,8,1,268,123,137,260,7
2024-01-03,LB,Bulgaria,2326,2103,9,2,223,104,110,214,7
2024-01-04,LB,Bulgaria,246,55,8,2,191,94,89,183,6
2024-01-05,LB,Bulgaria,2387,2172,7,0,215,106,102,208,7
2024-01-06,LB,Bulgaria,2497,2280,2,0,217,107,108,215,2
2024-01-07,LB,Bulgaria,2458,2265,6,0,193,93,94,187,6
2024-01-08,LB,Bulgaria,2227,2043,8,0,184,85,91,176,8
2024-01-09,LB,Bulgaria,2162,1995,11,0,167,81,75,156,11
2024-01-10,LB,Bulgaria,2204,2042,8,0,162,74,80,154,8
2024-01-11,LB,Bulgaria,2207,2036,7,0,171,83,81,164,7
2024-01-12,LB,Bulgaria,2250,2059,7,1,191,91,93,184,6
2024-01-13,LB,Bulgaria,2279,2086,4,0,193,95,94,189,4
2024-01-14,LB,Bulgaria,2268,2086,4,0,182,86,92,178,4
2024-01-15,LB,Bulgaria,2069,1900,12,1,169,80,77,157,11
2024-01-01,LD,Croatia,1519,1389,25,0,130,54,51,105,25
2024-01-02,LD,Croatia,1721,1566,26,1,155,66,63,129,25
2024-01-03,LD,Croatia,1643,1506,19,0,137,59,59,118,19
2024-01-04,LD,Croatia,61,-92,23,0,153,66,64,130,23
2024-01-05,LD,Croatia,1768,1600,26,0,168,69,73,142,26
2024-01-06,LD,Croatia,1869,1727,14,0,142,66,62,128,14
2024-01-07,LD,Croatia,1871,1730,17,0,141,62,62,124,17
2024-01-08,LD,Croatia,1608,1452,24,0,156,64,68,132,24
2024-01-09,LD,Croatia,1391,1262,26,0,129,52,51,103,26
2024-01-10,LD,Croatia,1408,1292,18,1,116,49,49,98,17
2024-01-11,LD,Croatia,1413,1285,21,0,128,52,55,107,21
2024-01-12,LD,Croatia,1591,1433,25,0,158,67,66,133,25
2024-01-13,LD,Croatia,1638,1513,15,0,125,55,55,110,15
2024-01-14,LD,Croatia,1704,1572,17,1,132,58,57,115,16
2024-01-15,LD,Croatia,1481,1332,27,0,149,61,61,122,27
2024-01-01,LC,Cyprus,705,543,5,5,162,80,77,157,0
2024-01-02,LC,Cyprus,738,578,7,7,160,76,77,153,0
2024-01-03,LC,Cyprus,718,533,8,8,185,85,92,177,0
2024-01-04,LC,Cyprus,52,-130,3,3,182,91,88,179,0
2024-01-05,LC,Cyprus,780,592,6,6,188,92,90,182,0
2024-01-06,LC,Cyprus,790,603,1,1,187,89,97,186,0
2024-01-07,LC,Cyprus,866,673,5,5,193,90,98,188,0
2024-01-08,LC,Cyprus,749,561,6,6,188,93,89,182,0
2024-01-09,LC,Cyprus,694,560,6,6,134,62,66,128,0
2024-01-10,LC,Cyprus,702,534,7,7,168,80,81,161,0
2024-01-11,LC,Cyprus,815,650,7,7,165,78,80,158,0
2024-01-12,LC,Cyprus,679,495,4,3,184,94,86,180,1
2024-01-13,LC,Cyprus,667,512,2,2,155,75,78,153,0
2024-01-14,LC,Cyprus,741,554,7,7,187,91,89,180,0
2024-01-15,LC,Cyprus,686,506,10,10,180,86,84,170,0
2024-01-01,LK,Czech Republic,1530,1248,0,0,282,137,145,282,0
2024-01-02,LK,Czech Republic,1629,1322,2,0,307,156,149,305,2
2024-01-03,LK,Czech Republic,1754,1423,7,3,331,160,164,324,4
2024-01-04,LK,Czech Republic,94,-232,4,0,326,159,163,322,4
2024-01-05,LK,Czech Republic,1919,1547,18,3,372,180,174,354,15
2024-01-06,LK,Czech Republic,1742,1501,6,0,241,110,125,235,6
2024-01-07,LK,Czech Republic,1820,1491,5,2,329,160,164,324,3
2024-01-08,LK,Czech Republic,1811,1484,13,3,327,155,159,314,10
2024-01-09,LK,Czech Republic,1448,1213,12,9,235,111,112,223,3
2024-01-10,LK,Czech Republic,1618,1337,19,7,281,131,131,262,12
2024-01-11,LK,Czech Republic,1586,1273,17,6,313,153,143,296,11
2024-01-12,LK,Czech Republic,1727,1398,14,4,329,159,156,315,10
2024-01-13,LK,Czech Republic,1494,1286,3,1,208,104,101,205,2
2024-01-14,LK,Czech Republic,1636,1338,10,3,298,137,151,288,7
2024-01-15,LK,Czech Republic,1659,1354,7,2,305,147,151,298,5
2024-01-01,EK,Denmark,1283,704,54,0,579,265,260,525,54
2024-01-02,EK,Denmark,1313,670,89,3,643,276,278,554,86
2024-01-03,EK,Denmark,1313,690,48,0,623,289,286,575,48
2024-01-04,EK,Denmark,47,-578,62,3,625,282,281,563,59
2024-01-05,EK,Denmark,1414,704,66,9,710,321,323,644,57
2024-01-06,EK,Denmark,1246,703,36,1,543,253,254,507,35
2024-01-07,EK,Denmark,1415,766,46,0,649,304,299,603,46
2024-01-08,EK,Denmark,1372,643,83,12,729,324,322,646,71
2024-01-09,EK,Denmark,1085,526,63,6,559,250,246,496,57
2024-01-10,EK,Denmark,1165,553,66,4,612,273,273,546,62
2024-01-11,EK,Denmark,1260,609,96,10,651,276,279,555,86
2024-01-12,EK,Denmark,1412,680,105,6,732,311,316,627,99
2024-01-13,EK,Denmark,1142,637,40,2,505,230,235,465,38
2024-01-14,EK,Denmark,1337,705,58,5,632,285,289,574,53
2024-01-15,EK,Denmark,1284,606,74,8,678,311,293,604,66
2024-01-01,EE,Estonia,345,253,9,1,92,41,42,83,8
2024-01-02,EE,Estonia,363,275,10,2,88,40,38,78,8
2024-01-03,EE,Estonia,379,283,11,3,96,40,45,85,8
2024-01-04,EE,Estonia,19,-72,9,1,91,39,43,82,8
2024-01-05,EE,Estonia,410,316,12,4,94,42,40,82,8
2024-01-06,EE,Estonia,386,312,5,1,74,34,35,69,4
2024-01-07,EE,Estonia,405,308,5,1,97,48,44,92,4
2024-01-08,EE,Estonia,408,300,8,0,108,51,49,100,8
2024-01-09,EE,Estonia,347,261,10,2,86,38,38,76,8
2024-01-10,EE,Estonia,342,251,9,1,91,40,42,82,8
2024-01-11,EE,Estonia,351,265,9,1,86,41,36,77,8
2024-01-12,EE,Estonia,352,259,6,2,93,41,46,87,4
2024-01-13,EE,Estonia,359,286,6,2,73,33,34,67,4
2024-01-14,EE,Estonia,356,267,5,1,89,43,41,84,4
2024-01-15,EE,Estonia,344,248,8,2,96,45,43,88,6
2024-01-01,EF,Finland,527,149,80,0,378,147,151,298,80
2024-01-02,EF,Finland,661,175,97,2,486,200,189,389,95
2024-01-03,EF,Finland,638,191,86,0,447,179,182,361,86
2024-01-04,EF,Finland,33,-404,93,1,437,172,172,344,92
2024-01-05,EF,Finland,642,193,107,2,449,172,170,342,105
2024-01-06,EF,Finland,621,169,78,0,452,187,187,374,78
2024-01-07,EF,Finland,693,193,86,0,500,201,213,414,86
2024-01-08,EF,Finland,641,165,124,3,476,178,174,352,121
2024-01-09,EF,Finland,594,141,116,2,453,172,165,337,114
2024-01-10,EF,Finland,603,153,115,0,450,165,170,335,115
2024-01-11,EF,Finland,605,141,123,2,464,171,170,341,121
2024-01-12,EF,Finland,585,147,105,0,438,168,165,333,105
2024-01-13,EF,Finland,534,108,68,1,426,180,178,358,67
2024-01-14,EF,Finland,599,151,82,0,448,180,186,366,82
2024-01-15,EF,Finland,594,140,116,1,454,165,173,338,115
2024-01-01,LF,France,7333,4123,460,1,3210,1382,1368,2750,459
2024-01-02,LF,France,7895,4410,610,6,3485,1425,1450,2875,604
2024-01-03,LF,France,7680,4223,618,28,3457,1415,1424,2839,590
2024-01-04,LF,France,230,-3336,721,24,3566,1425,1420,2845,697
2024-01-05,LF,France,8410,4583,778,11,3827,1519,1530,3049,767
2024-01-06,LF,France,8126,4761,441,8,3365,1472,1452,2924,433
2024-01-07,LF,France,8382,4760,583,24,3622,1523,1516,3039,559
2024-01-08,LF,France,7675,4115,793,28,3560,1372,1395,2767,765
2024-01-09,LF,France,6052,3334,694,24,2718,1009,1015,2024,670
2024-01-10,LF,France,6118,3314,715,26,2804,1046,1043,2089,689
2024-01-11,LF,France,6452,3491,792,31,2961,1067,1102,2169,761
2024-01-12,LF,France,7504,4160,842,26,3344,1267,1235,2502,816
2024-01-13,LF,France,6832,4141,394,17,2691,1148,1149,2297,377
2024-01-14,LF,France,7303,4345,486,7,2958,1233,1239,2472,479
2024-01-15,LF,France,6862,3779,784,31,3083,1140,1159,2299,753
2024-01-01,UG,Georgia,518,395,0,0,123,58,65,123,0
2024-01-02,UG,Georgia,614,462,0,0,152,76,76,152,0
2024-01-03,UG,Georgia,590,453,2,0,137,68,67,135,2
2024-01-04,UG,Georgia,94,-46,0,0,140,69,71,140,0
2024-01-05,UG,Georgia,641,487,3,0,154,76,75,151,3
2024-01-06,UG,Georgia,616,476,0,0,140,71,69,140,0
2024-01-07,UG,Georgia,628,476,2,0,152,74,76,150,2
2024-01-08,UG,Georgia,602,461,0,0,141,73,68,141,0
2024-01-09,UG,Georgia,609,463,0,0,146,72,74,146,0
2024-01-10,UG,Georgia,588,452,3,0,136,66,67,133,3
2024-01-11,UG,Georgia,599,458,3,0,141,70,68,138,3
2024-01-12,UG,Georgia,627,484,0,0,143,69,74,143,0
2024-01-13,UG,Georgia,604,473,1,0,131,66,64,130,1
2024-01-14,UG,Georgia,621,469,0,0,152,77,75,152,0
2024-01-15,UG,Georgia,563,433,2,0,130,66,62,128,2
2024-01-01,ED,Germany,5950,3008,227,3,2942,1384,1331,2715,224
2024-01-02,ED,Germany,6684,3097,354,11,3587,1631,1602,3233,343
2024-01-03,ED,Germany,6843,3132,360,22,3711,1679,1672,3351,338
2024-01-04,ED,Germany,279,-3486,369,17,3765,1693,1703,3396,352
2024-01-05,ED,Germany,7406,3332,424,25,4074,1814,1836,3650,399
2024-01-06,ED,Germany,6900,3391,266,4,3509,1632,1611,3243,262
2024-01-07,ED,Germany,7149,3354,319,1,3795,1721,1755,3476,318
2024-01-08,ED,Germany,6997,3097,496,17,3900,1692,1712,3404,479
2024-01-09,ED,Germany,6081,2539,546,22,3542,1494,1502,2996,524
2024-01-10,ED,Germany,6300,2633,594,34,3667,1540,1533,3073,560
2024-01-11,ED,Germany,6486,2761,573,19,3725,1576,1576,3152,554
2024-01-12,ED,Germany,6991,3129,458,7,3862,1706,1698,3404,451
2024-01-13,ED,Germany,6142,3055,291,5,3087,1406,1390,2796,286
2024-01-14,ED,Germany,6691,3190,353,7,3501,1557,1591,3148,346
2024-01-15,ED,Germany,6544,2962,452,11,3582,1527,1603,3130,441
2024-01-01,LG,Greece,1580,995,210,0,585,187,188,375,210
2024-01-02,LG,Greece,1757,1033,270,9,724,229,225,454,261
2024-01-03,LG,Greece,1757,1050,255,19,707,225,227,452,236
2024-01-04,LG,Greece,85,-595,279,17,680,205,196,401,262
2024-01-05,LG,Greece,1912,1164,297,21,748,225,226,451,276
2024-01-06,LG,Greece,1963,1289,258,4,674,204,212,416,254
2024-01-07,LG,Greece,1932,1216,256,5,716,233,227,460,251
2024-01-08,LG,Greece,1713,1002,297,9,711,210,204,414,288
2024-01-09,LG,Greece,1524,960,249,24,564,156,159,315,225
2024-01-10,LG,Greece,1504,918,251,22,586,168,167,335,229
2024-01-11,LG,Greece,1644,1028,294,27,616,163,159,322,267
2024-01-12,LG,Greece,1614,937,283,16,677,195,199,394,267
2024-01-13,LG,Greece,1609,1086,230,6,523,146,147,293,224
2024-01-14,LG,Greece,1694,1092,243,10,602,180,179,359,233
2024-01-15,LG,Greece,1490,871,258,7,619,181,180,361,251
2024-01-01,LH,Hungary,2200,1898,2,0,302,150,150,300,2
2024-01-02,LH,Hungary,2294,1991,0,0,303,151,152,303,0
2024-01-03,LH,Hungary,2407,2072,1,1,335,167,167,334,0
2024-01-04,LH,Hungary,214,-92,1,0,306,157,148,305,1
2024-01-05,LH,Hungary,2562,2215,5,2,347,169,173,342,3
2024-01-06,LH,Hungary,2499,2239,0,0,260,131,129,260,0
2024-01-07,LH,Hungary,2580,2272,0,0,308,151,157,308,0
2024-01-08,LH,Hungary,2446,2115,2,0,331,165,164,329,2
2024-01-09,LH,Hungary,2198,1952,1,1,246,127,118,245,0
2024-01-10,LH,Hungary,2294,2014,1,0,280,137,142,279,1
2024-01-11,LH,Hungary,2321,2041,3,1,280,138,139,277,2
2024-01-12,LH,Hungary,2420,2095,3,3,325,159,163,322,0
2024-01-13,LH,Hungary,2237,1993,1,1,244,121,122,243,0
2024-01-14,LH,Hungary,2339,2043,0,0,296,147,149,296,0
2024-01-15,LH,Hungary,2270,1936,6,1,334,166,162,328,5
2024-01-01,EI,Ireland,1317,585,9,0,732,360,363,723,9
2024-01-02,EI,Ireland,1310,592,18,4,718,350,350,700,14
2024-01-03,EI,Ireland,1427,695,17,4,732,355,360,715,13
2024-01-04,EI,Ireland,138,-623,18,4,761,371,372,743,14
2024-01-05,EI,Ireland,1595,749,22,6,846,412,412,824,16
2024-01-06,EI,Ireland,1456,748,14,2,708,346,348,694,12
2024-01-07,EI,Ireland,1592,781,11,1,811,398,402,800,10
2024-01-08,EI,Ireland,1471,721,17,3,750,372,361,733,14
2024-01-09,EI,Ireland,1261,738,19,2,523,252,252,504,17
2024-01-10,EI,Ireland,1198,655,17,3,543,263,263,526,14
2024-01-11,EI,Ireland,1343,738,21,5,605,292,292,584,16
2024-01-12,EI,Ireland,1443,690,26,14,753,361,366,727,12
2024-01-13,EI,Ireland,1287,670,11,3,617,304,302,606,8
2024-01-14,EI,Ireland,1289,591,9,1,698,340,349,689,8
2024-01-15,EI,Ireland,1394,702,18,5,692,342,332,674,13
2024-01-01,LL,Israel,188,3,23,4,185,82,80,162,19
2024-01-02,LL,Israel,186,6,27,2,180,77,76,153,25
2024-01-03,LL,Israel,179,10,19,1,169,76,74,150,18
2024-01-04,LL,Israel,15,-192,33,1,207,87,87,174,32
2024-01-05,LL,Israel,145,18,21,2,127,51,55,106,19
2024-01-06,LL,Israel,102,8,17,2,94,37,40,77,15
2024-01-07,LL,Israel,212,0,29,6,212,93,90,183,23
2024-01-08,LL,Israel,210,8,22,3,202,91,89,180,19
2024-01-09,LL,Israel,188,23,19,1,165,75,71,146,18
2024-01-10,LL,Israel,193,2,25,3,191,81,85,166,22
2024-01-11,LL,Israel,241,2,34,4,239,100,105,205,30
2024-01-12,LL,Israel,151,19,14,1,132,57,61,118,13
2024-01-13,LL,Israel,109,-3,21,2,112,44,47,91,19
2024-01-14,LL,Israel,222,-6,25,4,228,105,98,203,21
2024-01-15,LL,Israel,197,9,16,1,188,86,86,172,15
2024-01-01,LI,Italy,4331,1335,664,3,2996,1171,1161,2332,661
2024-01-02,LI,Italy,4525,1480,713,11,3045,1164,1168,2332,702
2024-01-03,LI,Italy,4530,1457,755,29,3073,1156,1162,2318,726
2024-01-04,LI,Italy,110,-3005,776,25,3115,1167,1172,2339,751
2024-01-05,LI,Italy,4863,1584,750,19,3279,1260,1269,2529,731
2024-01-06,LI,Italy,4633,1643,672,5,2990,1159,1159,2318,667
2024-01-07,LI,Italy,4907,1669,728,10,3238,1250,1260,2510,718
2024-01-08,LI,Italy,4554,1425,769,25,3129,1187,1173,2360,744
2024-01-09,LI,Italy,3624,1165,625,22,2459,916,918,1834,603
2024-01-10,LI,Italy,3687,1204,670,27,2483,898,915,1813,643
2024-01-11,LI,Italy,3791,1235,659,21,2556,944,953,1897,638
2024-01-12,LI,Italy,4432,1363,753,19,3069,1145,1171,2316,734
2024-01-13,LI,Italy,4004,1388,604,15,2616,1016,996,2012,589
2024-01-14,LI,Italy,4277,1464,620,9,2813,1091,1102,2193,611
2024-01-15,LI,Italy,4191,1262,714,26,2929,1110,1105,2215,688
2024-01-01,EV,Latvia,466,312,0,0,154,78,76,154,0
2024-01-02,EV,Latvia,484,343,2,2,141,70,69,139,0
2024-01-03,EV,Latvia,477,335,3,3,142,70,69,139,0
2024-01-04,EV,Latvia,26,-146,1,1,172,86,85,171,0
2024-01-05,EV,Latvia,548,377,0,0,171,86,85,171,0
2024-01-06,EV,Latvia,506,363,1,1,143,71,71,142,0
2024-01-07,EV,Latvia,555,384,0,0,171,82,89,171,0
2024-01-08,EV,Latvia,558,376,1,1,182,91,90,181,0
2024-01-09,EV,Latvia,423,322,1,1,101,49,51,100,0
2024-01-10,EV,Latvia,422,319,4,4,103,49,50,99,0
2024-01-11,EV,Latvia,450,322,2,2,128,65,61,126,0
2024-01-12,EV,Latvia,475,316,0,0,159,81,78,159,0
2024-01-13,EV,Latvia,448,322,0,0,126,62,64,126,0
2024-01-14,EV,Latvia,487,336,0,0,151,74,77,151,0
2024-01-15,EV,Latvia,485,316,0,0,169,84,85,169,0
2024-01-01,EY,Lithuania,419,309,1,1,110,51,58,109,0
2024-01-02,EY,Lithuania,473,334,7,6,139,64,68,132,1
2024-01-03,EY,Lithuania,473,328,5,4,145,73,67,140,1
2024-01-04,EY,Lithuania,23,-113,3,3,136,65,68,133,0
2024-01-05,EY,Lithuania,512,364,7,6,148,71,70,141,1
2024-01-06,EY,Lithuania,493,353,3,3,140,68,69,137,0
2024-01-07,EY,Lithuania,524,385,5,3,139,67,67,134,2
2024-01-08,EY,Lithuania,507,367,8,7,140,66,66,132,1
2024-01-09,EY,Lithuania,414,300,9,8,114,53,52,105,1
2024-01-10,EY,Lithuania,401,282,0,0,119,61,58,119,0
2024-01-11,EY,Lithuania,426,299,8,8,127,57,62,119,0
2024-01-12,EY,Lithuania,439,299,2,2,140,71,67,138,0
2024-01-13,EY,Lithuania,403,291,2,1,112,55,55,110,1
2024-01-14,EY,Lithuania,446,320,1,1,126,62,63,125,0
2024-01-15,EY,Lithuania,448,316,1,0,132,65,66,131,1
2024-01-01,LM,Malta,352,196,0,0,156,79,77,156,0
2024-01-02,LM,Malta,316,174,3,3,142,69,70,139,0
2024-01-03,LM,Malta,342,198,2,2,144,71,71,142,0
2024-01-04,LM,Malta,16,-125,1,1,141,67,73,140,0
2024-01-05,LM,Malta,366,188,2,2,178,89,87,176,0
2024-01-06,LM,Malta,381,213,0,0,168,85,83,168,0
2024-01-07,LM,Malta,376,235,0,0,141,70,71,141,0
2024-01-08,LM,Malta,394,228,0,0,166,83,83,166,0
2024-01-09,LM,Malta,302,214,0,0,88,42,46,88,0
2024-01-10,LM,Malta,293,200,2,2,93,46,45,91,0
2024-01-11,LM,Malta,310,200,4,4,110,53,53,106,0
2024-01-12,LM,Malta,337,176,1,1,161,83,77,160,0
2024-01-13,LM,Malta,347,194,0,0,153,74,79,153,0
2024-01-14,LM,Malta,318,176,0,0,142,70,72,142,0
2024-01-15,LM,Malta,341,189,0,0,152,76,76,152,0
2024-01-01,LU,Moldova,29,-1,0,0,30,13,17,30,0
2024-01-02,LU,Moldova,62,1,0,0,61,32,29,61,0
2024-01-03,LU,Moldova,60,-1,0,0,61,30,31,61,0
2024-01-04,LU,Moldova,3,-61,0,0,64,31,33,64,0
2024-01-05,LU,Moldova,68,2,0,0,66,32,34,66,0
2024-01-06,LU,Moldova,62,1,0,0,61,32,29,61,0
2024-01-07,LU,Moldova,68,-2,0,0,70,35,35,70,0
2024-01-08,LU,Moldova,37,4,0,0,33,16,17,33,0
2024-01-09,LU,Moldova,65,-1,0,0,66,34,32,66,0
2024-01-10,LU,Moldova,62,-1,0,0,63,31,32,63,0
2024-01-11,LU,Moldova,60,-1,0,0,61,31,30,61,0
2024-01-12,LU,Moldova,65,1,0,0,64,32,32,64,0
2024-01-13,LU,Moldova,54,1,0,0,53,28,25,53,0
2024-01-14,LU,Moldova,63,0,0,0,63,31,32,63,0
2024-01-15,LU,Moldova,58,1,1,1,57,27,29,56,0
2024-01-01,GM,Morocco,1436,791,55,0,645,292,298,590,55
2024-01-02,GM,Morocco,1570,899,71,2,671,302,298,600,69
2024-01-03,GM,Morocco,1539,886,78,6,653,294,281,575,72
2024-01-04,GM,Morocco,53,-567,61,1,620,280,279,559,60
2024-01-05,GM,Morocco,1615,921,68,0,694,315,311,626,68
2024-01-06,GM,Morocco,1849,1138,55,2,711,328,328,656,53
2024-01-07,GM,Morocco,1657,1002,69,0,655,290,296,586,69
2024-01-08,GM,Morocco,1488,818,73,2,670,299,298,597,71
2024-01-09,GM,Morocco,1229,749,63,2,480,207,210,417,61
2024-01-10,GM,Morocco,1220,733,68,2,487,213,206,419,66
2024-01-11,GM,Morocco,1283,796,60,0,487,214,213,427,60
2024-01-12,GM,Morocco,1427,818,76,2,609,265,268,533,74
2024-01-13,GM,Morocco,1661,1049,49,1,612,282,281,563,48
2024-01-14,GM,Morocco,1506,927,60,0,579,262,257,519,60
2024-01-15,GM,Morocco,1295,720,65,5,575,256,254,510,60
2024-01-01,EH,Netherlands,2834,1442,10,1,1392,694,688,1382,9
2024-01-02,EH,Netherlands,2939,1571,19,2,1368,667,682,1349,17
2024-01-03,EH,Netherlands,3119,1660,43,10,1459,711,705,1416,33
2024-01-04,EH,Netherlands,152,-1358,48,10,1510,736,726,1462,38
2024-01-05,EH,Netherlands,3194,1669,40,12,1525,738,747,1485,28
2024-01-06,EH,Netherlands,3089,1719,7,1,1370,669,694,1363,6
2024-01-07,EH,Netherlands,3191,1691,15,1,1500,752,733,1485,14
2024-01-08,EH,Netherlands,3066,1629,50,12,1437,692,695,1387,38
2024-01-09,EH,Netherlands,2675,1331,62,14,1344,637,645,1282,48
2024-01-10,EH,Netherlands,2754,1383,62,12,1371,655,654,1309,50
2024-01-11,EH,Netherlands,2911,1459,55,17,1452,710,687,1397,38
2024-01-12,EH,Netherlands,3184,1709,56,18,1475,696,723,1419,38
2024-01-13,EH,Netherlands,2809,1564,16,4,1245,618,611,1229,12
2024-01-14,EH,Netherlands,3063,1683,17,2,1380,682,681,1363,15
2024-01-15,EH,Netherlands,2740,1498,31,5,1242,596,615,1211,26
2024-01-01,LW,North Macedonia,443,385,0,0,58,28,30,58,0
2024-01-02,LW,North Macedonia,473,406,0,0,67,36,31,67,0
2024-01-03,LW,North Macedonia,474,416,0,0,58,29,29,58,0
2024-01-04,LW,North Macedonia,24,-44,0,0,68,31,37,68,0
2024-01-05,LW,North Macedonia,492,441,0,0,51,29,22,51,0
2024-01-06,LW,North Macedonia,569,496,0,0,73,32,41,73,0
2024-01-07,LW,North Macedonia,533,460,0,0,73,36,37,73,0
2024-01-08,LW,North Macedonia,441,376,0,0,65,33,32,65,0
2024-01-09,LW,North Macedonia,362,292,0,0,70,35,35,70,0
2024-01-10,LW,North Macedonia,354,292,0,0,62,31,31,62,0
2024-01-11,LW,North Macedonia,397,333,0,0,64,32,32,64,0
2024-01-12,LW,North Macedonia,452,384,0,0,68,34,34,68,0
2024-01-13,LW,North Macedonia,446,378,0,0,68,34,34,68,0
2024-01-14,LW,North Macedonia,477,411,0,0,66,33,33,66,0
2024-01-15,LW,North Macedonia,420,353,0,0,67,33,34,67,0
2024-01-01,EN,Norway,1184,265,501,1,919,207,211,418,500
2024-01-02,EN,Norway,1402,237,750,2,1165,211,204,415,748
2024-01-03,EN,Norway,1407,218,738,5,1189,222,229,451,733
2024-01-04,EN,Norway,47,-1226,775,2,1273,248,250,498,773
2024-01-05,EN,Norway,1415,198,713,6,1217,250,254,504,707
2024-01-06,EN,Norway,887,222,247,4,665,215,203,418,243
2024-01-07,EN,Norway,1240,230,515,2,1010,240,255,495,513
2024-01-08,EN,Norway,1380,145,772,11,1235,238,225,463,761
2024-01-09,EN,Norway,1317,143,800,8,1174,185,189,374,792
2024-01-10,EN,Norway,1395,165,792,13,1230,218,220,438,779
2024-01-11,EN,Norway,1436,180,809,21,1256,224,223,447,788
2024-01-12,EN,Norway,1448,184,784,18,1264,240,240,480,766
2024-01-13,EN,Norway,753,200,209,6,553,175,169,344,203
2024-01-14,EN,Norway,1208,224,534,4,984,219,231,450,530
2024-01-15,EN,Norway,1308,185,731,8,1123,199,193,392,723
2024-01-01,EP,Poland,1570,682,62,0,888,416,410,826,62
2024-01-02,EP,Poland,1647,676,76,3,971,444,451,895,73
2024-01-03,EP,Poland,1649,650,92,8,999,454,453,907,84
2024-01-04,EP,Poland,66,-948,93,10,1014,469,452,921,83
2024-01-05,EP,Poland,1839,713,129,34,1126,488,509,997,95
2024-01-06,EP,Poland,1725,752,61,2,973,453,459,912,59
2024-01-07,EP,Poland,1701,717,79,6,984,454,451,905,73
2024-01-08,EP,Poland,1752,668,117,15,1084,479,488,967,102
2024-01-09,EP,Poland,1407,560,110,16,847,364,373,737,94
2024-01-10,EP,Poland,1405,568,89,10,837,376,372,748,79
2024-01-11,EP,Poland,1483,567,89,3,916,416,411,827,86
2024-01-12,EP,Poland,1710,667,107,11,1043,461,475,936,96
2024-01-13,EP,Poland,1601,681,59,2,920,437,424,861,57
2024-01-14,EP,Poland,1625,664,80,2,961,438,443,881,78
2024-01-15,EP,Poland,1634,628,105,9,1006,452,449,901,96
2024-01-01,LP,Portugal,2050,988,148,0,1062,451,463,914,148
2024-01-02,LP,Portugal,2213,1078,192,0,1135,476,467,943,192
2024-01-03,LP,Portugal,2049,1014,176,1,1035,440,419,859,175
2024-01-04,LP,Portugal,105,-981,153,1,1086,460,473,933,152
2024-01-05,LP,Portugal,2299,1192,150,1,1107,480,477,957,149
2024-01-06,LP,Portugal,2530,1398,139,0,1132,503,490,993,139
2024-01-07,LP,Portugal,2331,1235,136,3,1096,479,481,960,133
2024-01-08,LP,Portugal,2067,1033,147,0,1034,435,452,887,147
2024-01-09,LP,Portugal,1850,1035,135,1,815,343,337,680,134
2024-01-10,LP,Portugal,1692,922,131,2,770,326,313,639,129
2024-01-11,LP,Portugal,1824,983,126,2,841,352,363,715,124
2024-01-12,LP,Portugal,1980,999,158,3,981,413,410,823,155
2024-01-13,LP,Portugal,2055,1159,132,4,896,380,384,764,128
2024-01-14,LP,Portugal,2006,1007,131,0,999,441,427,868,131
2024-01-15,LP,Portugal,1836,891,144,1,945,393,408,801,143
2024-01-01,LR,Romania,1675,1297,13,4,378,180,185,365,9
2024-01-02,LR,Romania,1794,1361,30,4,433,201,202,403,26
2024-01-03,LR,Romania,1919,1411,50,9,508,226,232,458,41
2024-01-04,LR,Romania,207,-296,50,7,503,226,227,453,43
2024-01-05,LR,Romania,2011,1498,52,5,513,228,233,461,47
2024-01-06,LR,Romania,1970,1538,26,4,432,204,202,406,22
2024-01-07,LR,Romania,2031,1541,35,4,490,224,231,455,31
2024-01-08,LR,Romania,1917,1414,48,0,503,226,229,455,48
2024-01-09,LR,Romania,1838,1392,55,8,446,199,192,391,47
2024-01-10,LR,Romania,1889,1406,57,9,483,209,217,426,48
2024-01-11,LR,Romania,1879,1424,65,6,455,198,192,390,59
2024-01-12,LR,Romania,1940,1436,69,8,504,218,217,435,61
2024-01-13,LR,Romania,1853,1451,30,7,402,190,182,372,23
2024-01-14,LR,Romania,1882,1437,33,5,445,204,208,412,28
2024-01-15,LR,Romania,1850,1343,60,11,507,221,226,447,49
2024-01-01,LY,Serbia & Montenegro,1715,1437,17,0,278,130,131,261,17
2024-01-02,LY,Serbia & Montenegro,1913,1662,19,0,251,112,120,232,19
2024-01-03,LY,Serbia & Montenegro,1886,1627,22,0,259,122,115,237,22
2024-01-04,LY,Serbia & Montenegro,73,-172,20,0,245,114,111,225,20
2024-01-05,LY,Serbia & Montenegro,2013,1711,16,0,302,139,147,286,16
2024-01-06,LY,Serbia & Montenegro,2147,1894,20,0,253,119,114,233,20
2024-01-07,LY,Serbia & Montenegro,2088,1832,19,0,256,118,119,237,19
2024-01-08,LY,Serbia & Montenegro,1795,1515,18,3,280,130,132,262,15
2024-01-09,LY,Serbia & Montenegro,1606,1354,18,0,252,117,117,234,18
2024-01-10,LY,Serbia & Montenegro,1635,1403,20,0,232,109,103,212,20
2024-01-11,LY,Serbia & Montenegro,1647,1413,17,0,234,107,110,217,17
2024-01-12,LY,Serbia & Montenegro,1794,1505,16,0,289,136,137,273,16
2024-01-13,LY,Serbia & Montenegro,1825,1587,21,1,238,109,108,217,20
2024-01-14,LY,Serbia & Montenegro,1862,1618,18,0,244,112,114,226,18
2024-01-15,LY,Serbia & Montenegro,1641,1365,15,1,276,129,132,261,14
2024-01-01,LZ,Slovakia,1056,1016,0,0,40,19,21,40,0
2024-01-02,LZ,Slovakia,1134,1076,4,0,58,29,25,54,4
2024-01-03,LZ,Slovakia,1169,1120,3,0,49,24,22,46,3
2024-01-04,LZ,Slovakia,100,41,7,2,59,25,27,52,5
2024-01-05,LZ,Slovakia,1283,1218,5,2,65,29,31,60,3
2024-01-06,LZ,Slovakia,1249,1207,1,0,42,22,19,41,1
2024-01-07,LZ,Slovakia,1280,1219,1,0,61,28,32,60,1
2024-01-08,LZ,Slovakia,1187,1132,1,1,55,27,27,54,0
2024-01-09,LZ,Slovakia,998,967,3,2,31,15,13,28,1
2024-01-10,LZ,Slovakia,1077,1033,4,1,44,19,21,40,3
2024-01-11,LZ,Slovakia,1097,1040,7,1,57,25,25,50,6
2024-01-12,LZ,Slovakia,1153,1090,6,1,63,29,28,57,5
2024-01-13,LZ,Slovakia,1152,1108,3,0,44,22,19,41,3
2024-01-14,LZ,Slovakia,1159,1115,1,0,44,22,21,43,1
2024-01-15,LZ,Slovakia,1139,1081,2,1,58,27,29,56,1
2024-01-01,LJ,Slovenia,937,907,0,0,30,15,15,30,0
2024-01-02,LJ,Slovenia,963,920,1,1,43,21,21,42,0
2024-01-03,LJ,Slovenia,994,936,1,1,58,27,30,57,0
2024-01-04,LJ,Slovenia,25,-36,9,1,61,25,27,52,8
2024-01-05,LJ,Slovenia,1090,1034,0,0,56,28,28,56,0
2024-01-06,LJ,Slovenia,1125,1088,0,0,37,20,17,37,0
2024-01-07,LJ,Slovenia,1119,1077,0,0,42,20,22,42,0
2024-01-08,LJ,Slovenia,948,901,1,1,47,23,23,46,0
2024-01-09,LJ,Slovenia,804,758,1,1,46,23,22,45,0
2024-01-10,LJ,Slovenia,818,771,3,1,47,22,22,44,2
2024-01-11,LJ,Slovenia,827,764,3,0,63,30,30,60,3
2024-01-12,LJ,Slovenia,958,911,0,0,47,22,25,47,0
2024-01-13,LJ,Slovenia,1025,986,1,0,39,18,20,38,1
2024-01-14,LJ,Slovenia,1060,1013,1,1,47,22,24,46,0
2024-01-15,LJ,Slovenia,884,836,2,2,48,24,22,46,0
2024-01-01,LE,Spain,4951,1114,973,1,3837,1439,1425,2864,972
2024-01-02,LE,Spain,5197,1082,1056,14,4115,1551,1508,3059,1042
2024-01-03,LE,Spain,4981,987,1033,12,3994,1486,1475,2961,1021
2024-01-04,LE,Spain,108,-4025,1070,15,4133,1523,1540,3063,1055
2024-01-05,LE,Spain,5256,1162,1006,6,4094,1545,1543,3088,1000
2024-01-06,LE,Spain,5328,1238,898,7,4090,1605,1587,3192,891
2024-01-07,LE,Spain,5384,1101,1063,4,4283,1613,1607,3220,1059
2024-01-08,LE,Spain,4972,1087,1056,24,3885,1422,1407,2829,1032
2024-01-09,LE,Spain,4440,1103,1015,26,3337,1163,1159,2322,989
2024-01-10,LE,Spain,4263,1049,991,30,3214,1107,1116,2223,961
2024-01-11,LE,Spain,4555,1086,1066,31,3469,1200,1203,2403,1035
2024-01-12,LE,Spain,5334,1286,1231,35,4048,1411,1406,2817,1196
2024-01-13,LE,Spain,4940,1232,931,24,3708,1387,1390,2777,907
2024-01-14,LE,Spain,5279,1306,1081,19,3973,1451,1441,2892,1062
2024-01-15,LE,Spain,4906,1188,1108,24,3718,1305,1305,2610,1084
2024-01-01,ES,Sweden,1285,761,90,2,524,214,220,434,88
2024-01-02,ES,Sweden,1463,787,206,3,676,234,236,470,203
2024-01-03,ES,Sweden,1488,812,195,5,676,236,245,481,190
2024-01-04,ES,Sweden,54,-699,234,5,753,258,261,519,229
2024-01-05,ES,Sweden,1551,795,197,13,756,281,278,559,184
2024-01-06,ES,Sweden,1275,761,70,5,514,221,223,444,65
2024-01-07,ES,Sweden,1642,901,212,5,741,262,267,529,207
2024-01-08,ES,Sweden,1583,760,244,21,823,295,284,579,223
2024-01-09,ES,Sweden,1325,631,242,15,694,225,227,452,227
2024-01-10,ES,Sweden,1396,704,255,13,692,218,219,437,242
2024-01-11,ES,Sweden,1422,697,248,14,725,237,240,477,234
2024-01-12,ES,Sweden,1631,840,236,9,791,281,274,555,227
2024-01-13,ES,Sweden,1179,731,71,2,448,190,187,377,69
2024-01-14,ES,Sweden,1553,869,193,5,684,242,249,491,188
2024-01-15,ES,Sweden,1545,767,254,5,778,265,259,524,249
2024-01-01,LS,Switzerland,2512,1418,24,0,1094,538,532,1070,24
2024-01-02,LS,Switzerland,2699,1481,47,2,1218,581,590,1171,45
2024-01-03,LS,Switzerland,2639,1488,49,4,1151,549,553,1102,45
2024-01-04,LS,Switzerland,75,-1133,45,5,1208,584,579,1163,40
2024-01-05,LS,Switzerland,2840,1557,37,1,1283,628,618,1246,36
2024-01-06,LS,Switzerland,2853,1517,34,1,1336,647,655,1302,33
2024-01-07,LS,Switzerland,2987,1602,35,0,1385,678,672,1350,35
2024-01-08,LS,Switzerland,2609,1436,46,1,1173,564,563,1127,45
2024-01-09,LS,Switzerland,2104,1146,30,0,958,466,462,928,30
2024-01-10,LS,Switzerland,2194,1190,50,0,1004,482,472,954,50
2024-01-11,LS,Switzerland,2257,1205,54,4,1052,490,508,998,50
2024-01-12,LS,Switzerland,2562,1313,61,2,1249,592,596,1188,59
2024-01-13,LS,Switzerland,2352,1228,34,2,1124,543,547,1090,32
2024-01-14,LS,Switzerland,2639,1315,39,2,1324,640,645,1285,37
2024-01-15,LS,Switzerland,2402,1129,60,1,1273,587,626,1213,59
2024-01-01,LT,Türkiye,3619,1274,750,0,2345,799,796,1595,750
2024-01-02,LT,Türkiye,3863,1363,730,4,2500,889,881,1770,726
2024-01-03,LT,Türkiye,3876,1403,754,4,2473,856,863,1719,750
2024-01-04,LT,Türkiye,339,-2078,714,4,2417,860,843,1703,710
2024-01-05,LT,Türkiye,4104,1462,794,4,2642,936,912,1848,790
2024-01-06,LT,Türkiye,4133,1469,748,7,2664,948,968,1916,741
2024-01-07,LT,Türkiye,4148,1486,762,4,2662,948,952,1900,758
2024-01-08,LT,Türkiye,3807,1344,757,4,2463,847,859,1706,753
2024-01-09,LT,Türkiye,3674,1352,693,4,2322,809,820,1629,689
2024-01-10,LT,Türkiye,3720,1381,717,7,2339,814,808,1622,710
2024-01-11,LT,Türkiye,3769,1414,737,9,2355,808,810,1618,728
2024-01-12,LT,Türkiye,3830,1425,756,3,2405,833,816,1649,753
2024-01-13,LT,Türkiye,3860,1414,743,2,2446,850,853,1703,741
2024-01-14,LT,Türkiye,3918,1463,764,1,2455,850,841,1691,763
2024-01-15,LT,Türkiye,3613,1306,759,3,2307,764,784,1548,756
2024-01-01,UK,Ukraine,1,1,0,0,0,0,0,0,0
2024-01-02,UK,Ukraine,4,4,0,0,0,0,0,0,0
2024-01-03,UK,Ukraine,4,4,0,0,0,0,0,0,0
2024-01-04,UK,Ukraine,0,-1,0,0,1,0,1,1,0
2024-01-05,UK,Ukraine,3,3,0,0,0,0,0,0,0
2024-01-06,UK,Ukraine,6,6,0,0,0,0,0,0,0
2024-01-07,UK,Ukraine,1,1,0,0,0,0,0,0,0
2024-01-08,UK,Ukraine,3,3,0,0,0,0,0,0,0
2024-01-09,UK,Ukraine,3,3,0,0,0,0,0,0,0
2024-01-10,UK,Ukraine,3,3,0,0,0,0,0,0,0
2024-01-11,UK,Ukraine,0,0,0,0,0,0,0,0,0
2024-01-12,UK,Ukraine,5,5,0,0,0,0,0,0,0
2024-01-13,UK,Ukraine,4,3,0,0,1,0,1,1,0
2024-01-14,UK,Ukraine,3,3,0,0,0,0,0,0,0
2024-01-15,UK,Ukraine,2,2,0,0,0,0,0,0,0
2024-01-01,EG,United Kingdom,5460,1228,441,0,4232,1894,1897,3791,441
2024-01-02,EG,United Kingdom,6005,1312,662,6,4693,1993,2038,4031,656
2024-01-03,EG,United Kingdom,6066,1365,782,11,4701,1943,1976,3919,771
2024-01-04,EG,United Kingdom,322,-4599,784,15,4921,2062,2075,4137,769
2024-01-05,EG,United Kingdom,6586,1446,822,9,5140,2162,2156,4318,813
2024-01-06,EG,United Kingdom,6073,1428,502,7,4645,2065,2078,4143,495
2024-01-07,EG,United Kingdom,6322,1409,591,3,4913,2155,2167,4322,588
2024-01-08,EG,United Kingdom,6021,1357,742,17,4664,1957,1965,3922,725
2024-01-09,EG,United Kingdom,4989,1204,723,12,3785,1534,1528,3062,711
2024-01-10,EG,United Kingdom,4973,1176,713,13,3797,1536,1548,3084,700
2024-01-11,EG,United Kingdom,5463,1268,789,16,4195,1720,1686,3406,773
2024-01-12,EG,United Kingdom,6107,1294,869,14,4813,1959,1985,3944,855
2024-01-13,EG,United Kingdom,5421,1306,481,7,4115,1819,1815,3634,474
2024-01-14,EG,United Kingdom,5859,1288,620,6,4571,1971,1980,3951,614
2024-01-15,EG,United Kingdom,5639,1208,713,12,4431,1876,1842,3718,701
