entry_date,country_icao_code,country_name,flt_daio,flt_o,flt_i,flt_c,flt_dai,flt_d,flt_a,flt_da,flt_i_excl_c
2024-01-01,LA,Albania,584,436,0,0,148,73,75,148,0
2024-01-02,LA,Albania,629,454,0,0,175,88,87,175,0
2024-01-03,LA,Albania,666,493,0,0,173,86,87,173,0
2024-01-04,LA,Albania,664,492,0,0,172,87,85,172,0
2024-01-05,LA,Albania,710,535,0,0,175,88,87,175,0
2024-01-06,LA,Albania,791,631,0,0,160,79,81,160,0
2024-01-07,LA,Albania,732,567,0,0,165,84,81,165,0
2024-01-08,LA,Albania,602,441,0,0,161,79,82,161,0
2024-01-09,LA,Albania,531,359,0,0,172,87,85,172,0
2024-01-10,LA,Albania,543,378,0,0,165,82,83,165,0
2024-01-11,LA,Albania,537,374,1,1,163,81,81,162,0
2024-01-12,LA,Albania,580,432,0,0,148,75,73,148,0
2024-01-13,LA,Albania,667,505,0,0,162,81,81,162,0
2024-01-14,LA,Albania,650,500,0,0,150,76,74,150,0
2024-01-15,LA,Albania,537,392,0,0,145,72,73,145,0
2024-01-16,LA,Albania,515,364,0,0,151,75,76,151,0
2024-01-17,LA,Albania,528,385,0,0,143,72,71,143,0
2024-01-18,LA,Albania,491,333,0,0,158,79,79,158,0
2024-01-19,LA,Albania,568,429,0,0,139,70,69,139,0
2024-01-20,LA,Albania,582,434,0,0,148,72,76,148,0
2024-01-21,LA,Albania,602,460,0,0,142,72,70,142,0
2024-01-22,LA,Albania,516,374,0,0,142,71,71,142,0
2024-01-23,LA,Albania,442,315,0,0,127,64,63,127,0
2024-01-24,LA,Albania,494,359,0,0,135,68,67,135,0
2024-01-25,LA,Albania,486,335,0,0,151,75,76,151,0
2024-01-26,LA,Albania,591,445,0,0,146,75,71,146,0
2024-01-27,LA,Albania,614,477,0,0,137,68,69,137,0
2024-01-28,LA,Albania,556,422,1,1,134,65,68,133,0
2024-01-29,LA,Albania,470,331,0,0,139,71,68,139,0
2024-01-30,LA,Albania,481,327,0,0,154,76,78,154,0
2024-01-31,LA,Albania,535,401,0,0,134,66,68,134,0
2024-02-01,LA,Albania,508,359,0,0,149,75,74,149,0
2024-02-02,LA,Albania,543,401,0,0,142,72,70,142,0
2024-02-03,LA,Albania,622,478,0,0,144,71,73,144,0
2024-02-04,LA,Albania,619,485,0,0,134,68,66,134,0
2024-02-05,LA,Albania,553,413,0,0,140,68,72,140,0
2024-02-06,LA,Albania,525,374,0,0,151,77,74,151,0
2024-02-07,LA,Albania,560,426,0,0,134,68,66,134,0
2024-02-08,LA,Albania,554,401,0,0,153,75,78,153,0
2024-02-09,LA,Albania,610,472,0,0,138,70,68,138,0
2024-02-10,LA,Albania,680,537,0,0,143,73,70,143,0
2024-02-11,LA,Albania,636,501,0,0,135,68,67,135,0
2024-02-12,LA,Albania,528,385,0,0,143,70,73,143,0
2024-02-13,LA,Albania,503,354,0,0,149,73,76,149,0
2024-02-14,LA,Albania,528,391,0,0,137,69,68,137,0
2024-02-15,LA,Albania,546,388,0,0,158,80,78,158,0
2024-02-16,LA,Albania,573,435,0,0,138,70,68,138,0
2024-02-17,LA,Albania,646,505,0,0,141,70,71,141,0
2024-02-18,LA,Albania,654,517,0,0,137,68,69,137,0
2024-02-19,LA,Albania,534,402,0,0,132,66,66,132,0
2024-02-20,LA,Albania,473,330,0,0,143,71,72,143,0
2024-02-21,LA,Albania,526,399,0,0,127,64,63,127,0
2024-02-22,LA,Albania,551,402,0,0,149,74,75,149,0
2024-02-23,LA,Albania,595,460,0,0,135,68,67,135,0
2024-02-24,LA,Albania,679,541,0,0,138,69,69,138,0
2024-02-25,LA,Albania,635,505,0,0,130,65,65,130,0
2024-02-26,LA,Albania,551,417,0,0,134,67,67,134,0
2024-02-27,LA,Albania,519,371,0,0,148,74,74,148,0
2024-02-28,LA,Albania,556,414,0,0,142,70,72,142,0
2024-02-29,LA,Albania,589,432,0,0,157,79,78,157,0
2024-03-01,LA,Albania,601,460,0,0,141,72,69,141,0
2024-03-02,LA,Albania,650,507,0,0,143,71,72,143,0
2024-03-03,LA,Albania,637,495,0,0,142,70,72,142,0
2024-03-04,LA,Albania,576,439,0,0,137,69,68,137,0
2024-03-05,LA,Albania,534,377,0,0,157,79,78,157,0
2024-03-06,LA,Albania,573,435,0,0,138,69,69,138,0
2024-03-07,LA,Albania,537,387,0,0,150,75,75,150,0
2024-03-08,LA,Albania,609,468,0,0,141,72,69,141,0
2024-03-09,LA,Albania,694,549,0,0,145,71,74,145,0
2024-03-10,LA,Albania,701,558,0,0,143,70,73,143,0
2024-03-11,LA,Albania,568,427,0,0,141,71,70,141,0
2024-03-12,LA,Albania,518,369,0,0,149,75,74,149,0
2024-03-13,LA,Albania,569,428,0,0,141,71,70,141,0
2024-03-14,LA,Albania,597,450,0,0,147,74,73,147,0
2024-03-15,LA,Albania,706,549,0,0,157,79,78,157,0
2024-03-16,LA,Albania,702,560,0,0,142,71,71,142,0
2024-03-17,LA,Albania,652,513,0,0,139,69,70,139,0
2024-03-18,LA,Albania,591,452,0,0,139,69,70,139,0
2024-03-19,LA,Albania,627,485,0,0,142,71,71,142,0
2024-03-20,LA,Albania,607,474,0,0,133,67,66,133,0
2024-03-21,LA,Albania,625,475,0,0,150,74,76,150,0
2024-03-22,LA,Albania,703,565,0,0,138,69,69,138,0
2024-03-23,LA,Albania,776,631,0,0,145,72,73,145,0
2024-03-24,LA,Albania,824,689,0,0,135,71,64,135,0
2024-03-25,LA,Albania,658,525,0,0,133,64,69,133,0
2024-03-26,LA,Albania,611,474,0,0,137,70,67,137,0
2024-03-27,LA,Albania,685,535,0,0,150,75,75,150,0
2024-03-28,LA,Albania,661,492,0,0,169,83,86,169,0
2024-03-29,LA,Albania,742,586,0,0,156,78,78,156,0
2024-03-30,LA,Albania,773,621,0,0,152,75,77,152,0
2024-03-31,LA,Albania,919,735,0,0,184,92,92,184,0
2024-04-01,LA,Albania,764,576,0,0,188,96,92,188,0
2024-04-02,LA,Albania,742,564,0,0,178,87,91,178,0
2024-04-03,LA,Albania,796,608,0,0,188,92,96,188,0
2024-04-04,LA,Albania,713,542,0,0,171,88,83,171,0
2024-04-05,LA,Albania,883,694,0,0,189,94,95,189,0
2024-04-06,LA,Albania,1065,886,0,0,179,90,89,179,0
2024-04-07,LA,Albania,1007,831,0,0,176,88,88,176,0
2024-04-08,LA,Albania,824,647,0,0,177,87,90,177,0
2024-04-09,LA,Albania,853,671,0,0,182,91,91,182,0
2024-04-10,LA,Albania,834,673,0,0,161,81,80,161,0
2024-04-11,LA,Albania,864,689,0,0,175,88,87,175,0
2024-04-12,LA,Albania,948,755,0,0,193,96,97,193,0
2024-04-13,LA,Albania,1104,920,0,0,184,93,91,184,0
2024-04-14,LA,Albania,1168,977,0,0,191,95,96,191,0
2024-04-15,LA,Albania,953,756,0,0,197,99,98,197,0
2024-04-16,LA,Albania,888,698,0,0,190,95,95,190,0
2024-04-17,LA,Albania,891,704,0,0,187,95,92,187,0
2024-04-18,LA,Albania,860,678,0,0,182,90,92,182,0
2024-04-19,LA,Albania,982,784,0,0,198,99,99,198,0
2024-04-20,LA,Albania,1117,936,0,0,181,90,91,181,0
2024-04-21,LA,Albania,1008,815,1,1,193,95,97,192,0
2024-04-22,LA,Albania,882,686,0,0,196,99,97,196,0
2024-04-23,LA,Albania,806,625,0,0,181,91,90,181,0
2024-04-24,LA,Albania,851,656,0,0,195,97,98,195,0
2024-04-25,LA,Albania,784,610,0,0,174,86,88,174,0
2024-04-26,LA,Albania,932,730,0,0,202,101,101,202,0
2024-04-27,LA,Albania,1121,933,0,0,188,95,93,188,0
2024-04-28,LA,Albania,1062,871,0,0,191,94,97,191,0
2024-04-29,LA,Albania,876,676,0,0,200,101,99,200,0
2024-04-30,LA,Albania,916,730,0,0,186,92,94,186,0
2024-05-01,LA,Albania,972,767,0,0,205,102,103,205,0
2024-05-02,LA,Albania,954,773,0,0,181,93,88,181,0
2024-05-03,LA,Albania,1041,835,0,0,206,101,105,206,0
2024-05-04,LA,Albania,1140,949,0,0,191,96,95,191,0
2024-05-05,LA,Albania,1158,963,0,0,195,97,98,195,0
2024-05-06,LA,Albania,1107,902,0,0,205,101,104,205,0
2024-05-07,LA,Albania,1084,893,0,0,191,97,94,191,0
2024-05-08,LA,Albania,1116,906,0,0,210,104,106,210,0
2024-05-09,LA,Albania,1055,866,0,0,189,95,94,189,0
2024-05-10,LA,Albania,1086,880,0,0,206,103,103,206,0
2024-05-11,LA,Albania,1195,1000,0,0,195,98,97,195,0
2024-05-12,LA,Albania,1178,981,0,0,197,100,97,197,0
2024-05-13,LA,Albania,1055,851,0,0,204,101,103,204,0
2024-05-14,LA,Albania,987,803,0,0,184,92,92,184,0
2024-05-15,LA,Albania,1009,803,0,0,206,102,104,206,0
2024-05-16,LA,Albania,981,796,0,0,185,94,91,185,0
2024-05-17,LA,Albania,1143,928,0,0,215,106,109,215,0
2024-05-18,LA,Albania,1281,1087,0,0,194,98,96,194,0
2024-05-19,LA,Albania,1306,1104,0,0,202,100,102,202,0
2024-05-20,LA,Albania,1151,942,0,0,209,105,104,209,0
2024-05-21,LA,Albania,1105,911,0,0,194,95,99,194,0
2024-05-22,LA,Albania,1055,850,0,0,205,104,101,205,0
2024-05-23,LA,Albania,1125,940,0,0,185,92,93,185,0
2024-05-24,LA,Albania,1195,983,0,0,212,106,106,212,0
2024-05-25,LA,Albania,1279,1084,0,0,195,98,97,195,0
2024-05-26,LA,Albania,1238,1034,0,0,204,103,101,204,0
2024-05-27,LA,Albania,1131,939,0,0,192,98,94,192,0
2024-05-28,LA,Albania,1037,847,0,0,190,93,97,190,0
2024-05-29,LA,Albania,1072,870,0,0,202,100,102,202,0
2024-05-30,LA,Albania,1098,891,0,0,207,105,102,207,0
2024-05-31,LA,Albania,1218,990,0,0,228,111,117,228,0
2024-06-01,LA,Albania,1393,1185,0,0,208,106,102,208,0
2024-06-02,LA,Albania,1289,1081,0,0,208,104,104,208,0
2024-06-03,LA,Albania,1204,960,0,0,244,119,125,244,0
2024-06-04,LA,Albania,1205,994,0,0,211,106,105,211,0
2024-06-05,LA,Albania,1200,987,0,0,213,107,106,213,0
2024-06-06,LA,Albania,1147,940,0,0,207,101,106,207,0
2024-06-07,LA,Albania,1250,1007,0,0,243,126,117,243,0
2024-06-08,LA,Albania,1372,1161,0,0,211,103,108,211,0
2024-06-09,LA,Albania,1363,1138,0,0,225,113,112,225,0
2024-06-10,LA,Albania,1306,1055,1,1,251,123,127,250,0
2024-06-11,LA,Albania,1208,1000,0,0,208,105,103,208,0
2024-06-12,LA,Albania,1209,982,0,0,227,114,113,227,0
2024-06-13,LA,Albania,1202,983,0,0,219,109,110,219,0
2024-06-14,LA,Albania,1356,1099,0,0,257,128,129,257,0
2024-06-15,LA,Albania,1441,1222,0,0,219,112,107,219,0
2024-06-16,LA,Albania,1365,1129,0,0,236,117,119,236,0
2024-06-17,LA,Albania,1253,1006,0,0,247,120,127,247,0
2024-06-18,LA,Albania,1230,1013,0,0,217,111,106,217,0
2024-06-19,LA,Albania,1181,946,0,0,235,121,114,235,0
2024-06-20,LA,Albania,1236,999,0,0,237,115,122,237,0
2024-06-21,LA,Albania,1352,1107,0,0,245,125,120,245,0
2024-06-22,LA,Albania,1571,1358,0,0,213,106,107,213,0
2024-06-23,LA,Albania,1600,1370,0,0,230,116,114,230,0
2024-06-24,LA,Albania,1462,1209,0,0,253,125,128,253,0
2024-06-25,LA,Albania,1287,1057,0,0,230,114,116,230,0
2024-06-26,LA,Albania,1602,1373,0,0,229,118,111,229,0
2024-06-27,LA,Albania,1431,1205,0,0,226,110,116,226,0
2024-06-28,LA,Albania,1458,1209,0,0,249,126,123,249,0
2024-06-29,LA,Albania,1500,1280,0,0,220,107,113,220,0
2024-06-30,LA,Albania,1504,1275,0,0,229,116,113,229,0
2024-07-01,LA,Albania,1371,1124,0,0,247,124,123,247,0
2024-07-02,LA,Albania,1556,1332,0,0,224,112,112,224,0
2024-07-03,LA,Albania,1389,1155,0,0,234,117,117,234,0
2024-07-04,LA,Albania,1282,1050,0,0,232,114,118,232,0
2024-07-05,LA,Albania,1529,1276,0,0,253,128,125,253,0
2024-07-06,LA,Albania,1598,1372,0,0,226,113,113,226,0
2024-07-07,LA,Albania,1521,1291,0,0,230,116,114,230,0
2024-07-08,LA,Albania,1419,1165,0,0,254,124,130,254,0
2024-07-09,LA,Albania,1362,1141,0,0,221,110,111,221,0
2024-07-10,LA,Albania,1451,1217,0,0,234,119,115,234,0
2024-07-11,LA,Albania,1393,1162,0,0,231,115,116,231,0
2024-07-12,LA,Albania,1528,1278,0,0,250,125,125,250,0
2024-07-13,LA,Albania,1552,1310,0,0,242,122,120,242,0
2024-07-14,LA,Albania,1655,1415,0,0,240,122,118,240,0
2024-07-15,LA,Albania,1455,1202,0,0,253,124,129,253,0
2024-07-16,LA,Albania,1493,1262,0,0,231,116,115,231,0
2024-07-17,LA,Albania,1479,1253,0,0,226,115,111,226,0
2024-07-18,LA,Albania,1372,1124,0,0,248,122,126,248,0
2024-07-19,LA,Albania,1337,1119,0,0,218,110,108,218,0
2024-07-20,LA,Albania,1629,1418,0,0,211,109,102,211,0
2024-07-21,LA,Albania,1662,1433,0,0,229,113,116,229,0
2024-07-22,LA,Albania,1431,1197,0,0,234,118,116,234,0
2024-07-23,LA,Albania,1435,1217,0,0,218,107,111,218,0
2024-07-24,LA,Albania,1462,1225,0,0,237,120,117,237,0
2024-07-25,LA,Albania,1414,1168,1,1,246,120,125,245,0
2024-07-26,LA,Albania,1473,1225,0,0,248,126,122,248,0
2024-07-27,LA,Albania,1624,1392,0,0,232,115,117,232,0
2024-07-28,LA,Albania,1557,1320,0,0,237,119,118,237,0
2024-07-29,LA,Albania,1442,1180,0,0,262,131,131,262,0
2024-07-30,LA,Albania,1396,1169,0,0,227,113,114,227,0
2024-01-01,UD,Armenia,156,54,0,0,102,52,50,102,0
2024-01-02,UD,Armenia,178,77,0,0,101,48,53,101,0
2024-01-03,UD,Armenia,174,63,0,0,111,55,56,111,0
2024-01-04,UD,Armenia,181,70,0,0,111,56,55,111,0
2024-01-05,UD,Armenia,188,78,0,0,110,55,55,110,0
2024-01-06,UD,Armenia,209,80,0,0,129,63,66,129,0
2024-01-07,UD,Armenia,196,83,0,0,113,58,55,113,0
2024-01-08,UD,Armenia,200,75,0,0,125,63,62,125,0
2024-01-09,UD,Armenia,192,87,0,0,105,52,53,105,0
2024-01-10,UD,Armenia,187,77,0,0,110,54,56,110,0
2024-01-11,UD,Armenia,185,83,1,1,102,51,50,101,0
2024-01-12,UD,Armenia,177,79,0,0,98,48,50,98,0
2024-01-13,UD,Armenia,176,66,0,0,110,56,54,110,0
2024-01-14,UD,Armenia,170,67,0,0,103,51,52,103,0
2024-01-15,UD,Armenia,144,62,0,0,82,40,42,82,0
2024-01-16,UD,Armenia,153,68,0,0,85,41,44,85,0
2024-01-17,UD,Armenia,151,69,0,0,82,40,42,82,0
2024-01-18,UD,Armenia,153,64,0,0,89,48,41,89,0
2024-01-19,UD,Armenia,160,78,0,0,82,41,41,82,0
2024-01-20,UD,Armenia,152,58,0,0,94,47,47,94,0
2024-01-21,UD,Armenia,163,70,0,0,93,46,47,93,0
2024-01-22,UD,Armenia,142,67,0,0,75,38,37,75,0
2024-01-23,UD,Armenia,139,69,0,0,70,34,36,70,0
2024-01-24,UD,Armenia,145,63,0,0,82,40,42,82,0
2024-01-25,UD,Armenia,159,76,0,0,83,43,40,83,0
2024-01-26,UD,Armenia,167,74,0,0,93,47,46,93,0
2024-01-27,UD,Armenia,161,67,0,0,94,48,46,94,0
2024-01-28,UD,Armenia,167,69,0,0,98,48,50,98,0
2024-01-29,UD,Armenia,142,67,0,0,75,37,38,75,0
2024-01-30,UD,Armenia,144,75,0,0,69,34,35,69,0
2024-01-31,UD,Armenia,160,74,0,0,86,42,44,86,0
2024-02-01,UD,Armenia,155,75,0,0,80,42,38,80,0
2024-02-02,UD,Armenia,160,78,0,0,82,41,41,82,0
2024-02-03,UD,Armenia,170,81,0,0,89,47,42,89,0
2024-02-04,UD,Armenia,168,76,0,0,92,44,48,92,0
2024-02-05,UD,Armenia,152,72,1,1,80,40,39,79,0
2024-02-06,UD,Armenia,150,81,2,2,69,32,35,67,0
2024-02-07,UD,Armenia,163,82,0,0,81,42,39,81,0
2024-02-08,UD,Armenia,166,100,0,0,66,33,33,66,0
2024-02-09,UD,Armenia,186,98,0,0,88,42,46,88,0
2024-02-10,UD,Armenia,184,95,0,0,89,48,41,89,0
2024-02-11,UD,Armenia,174,79,0,0,95,45,50,95,0
2024-02-12,UD,Armenia,154,77,0,0,77,39,38,77,0
2024-02-13,UD,Armenia,136,71,0,0,65,31,34,65,0
2024-02-14,UD,Armenia,154,75,0,0,79,41,38,79,0
2024-02-15,UD,Armenia,147,76,0,0,71,36,35,71,0
2024-02-16,UD,Armenia,163,76,0,0,87,44,43,87,0
2024-02-17,UD,Armenia,181,90,0,0,91,46,45,91,0
2024-02-18,UD,Armenia,174,82,0,0,92,44,48,92,0
2024-02-19,UD,Armenia,150,69,0,0,81,44,37,81,0
2024-02-20,UD,Armenia,136,71,0,0,65,30,35,65,0
2024-02-21,UD,Armenia,146,68,0,0,78,39,39,78,0
2024-02-22,UD,Armenia,162,79,0,0,83,40,43,83,0
2024-02-23,UD,Armenia,178,84,0,0,94,48,46,94,0
2024-02-24,UD,Armenia,173,79,0,0,94,47,47,94,0
2024-02-25,UD,Armenia,168,76,0,0,92,46,46,92,0
2024-02-26,UD,Armenia,155,76,0,0,79,41,38,79,0
2024-02-27,UD,Armenia,145,82,0,0,63,31,32,63,0
2024-02-28,UD,Armenia,155,80,0,0,75,36,39,75,0
2024-02-29,UD,Armenia,171,94,0,0,77,39,38,77,0
2024-03-01,UD,Armenia,169,90,0,0,79,40,39,79,0
2024-03-02,UD,Armenia,192,90,0,0,102,51,51,102,0
2024-03-03,UD,Armenia,164,80,0,0,84,41,43,84,0
2024-03-04,UD,Armenia,171,87,0,0,84,43,41,84,0
2024-03-05,UD,Armenia,163,89,0,0,74,37,37,74,0
2024-03-06,UD,Armenia,165,82,0,0,83,40,43,83,0
2024-03-07,UD,Armenia,170,84,0,0,86,45,41,86,0
2024-03-08,UD,Armenia,186,102,0,0,84,40,44,84,0
2024-03-09,UD,Armenia,179,85,0,0,94,49,45,94,0
2024-03-10,UD,Armenia,185,87,0,0,98,47,51,98,0
2024-03-11,UD,Armenia,152,70,0,0,82,41,41,82,0
2024-03-12,UD,Armenia,149,83,0,0,66,32,34,66,0
2024-03-13,UD,Armenia,172,77,1,1,95,48,46,94,0
2024-03-14,UD,Armenia,176,96,0,0,80,41,39,80,0
2024-03-15,UD,Armenia,204,118,0,0,86,42,44,86,0
2024-03-16,UD,Armenia,204,105,0,0,99,50,49,99,0
2024-03-17,UD,Armenia,179,86,0,0,93,46,47,93,0
2024-03-18,UD,Armenia,178,92,0,0,86,44,42,86,0
2024-03-19,UD,Armenia,168,97,0,0,71,34,37,71,0
2024-03-20,UD,Armenia,175,83,0,0,92,45,47,92,0
2024-03-21,UD,Armenia,164,83,0,0,81,42,39,81,0
2024-03-22,UD,Armenia,190,99,0,0,91,47,44,91,0
2024-03-23,UD,Armenia,201,94,1,0,107,53,53,106,1
2024-03-24,UD,Armenia,198,104,2,2,94,43,49,92,0
2024-03-25,UD,Armenia,186,96,0,0,90,48,42,90,0
2024-03-26,UD,Armenia,164,96,0,0,68,31,37,68,0
2024-03-27,UD,Armenia,186,83,0,0,103,51,52,103,0
2024-03-28,UD,Armenia,173,84,0,0,89,47,42,89,0
2024-03-29,UD,Armenia,179,95,0,0,84,41,43,84,0
2024-03-30,UD,Armenia,199,96,0,0,103,51,52,103,0
2024-03-31,UD,Armenia,183,72,0,0,111,57,54,111,0
2024-04-01,UD,Armenia,168,79,0,0,89,46,43,89,0
2024-04-02,UD,Armenia,171,79,0,0,92,45,47,92,0
2024-04-03,UD,Armenia,175,77,0,0,98,48,50,98,0
2024-04-04,UD,Armenia,192,84,0,0,108,54,54,108,0
2024-04-05,UD,Armenia,198,97,0,0,101,49,52,101,0
2024-04-06,UD,Armenia,199,96,0,0,103,54,49,103,0
2024-04-07,UD,Armenia,198,92,0,0,106,53,53,106,0
2024-04-08,UD,Armenia,179,92,0,0,87,44,43,87,0
2024-04-09,UD,Armenia,210,118,0,0,92,44,48,92,0
2024-04-10,UD,Armenia,198,98,2,1,100,47,51,98,1
2024-04-11,UD,Armenia,204,106,0,0,98,50,48,98,0
2024-04-12,UD,Armenia,192,95,0,0,97,49,48,97,0
2024-04-13,UD,Armenia,225,116,0,0,109,55,54,109,0
2024-04-14,UD,Armenia,229,125,0,0,104,53,51,104,0
2024-04-15,UD,Armenia,200,115,0,0,85,43,42,85,0
2024-04-16,UD,Armenia,196,107,0,0,89,43,46,89,0
2024-04-17,UD,Armenia,168,83,0,0,85,43,42,85,0
2024-04-18,UD,Armenia,207,112,0,0,95,48,47,95,0
2024-04-19,UD,Armenia,229,131,0,0,98,47,51,98,0
2024-04-20,UD,Armenia,219,112,0,0,107,56,51,107,0
2024-04-21,UD,Armenia,221,120,0,0,101,51,50,101,0
2024-04-22,UD,Armenia,212,126,0,0,86,42,44,86,0
2024-04-23,UD,Armenia,191,106,0,0,85,41,44,85,0
2024-04-24,UD,Armenia,185,99,0,0,86,44,42,86,0
2024-04-25,UD,Armenia,191,95,0,0,96,49,47,96,0
2024-04-26,UD,Armenia,217,124,0,0,93,46,47,93,0
2024-04-27,UD,Armenia,230,127,0,0,103,52,51,103,0
2024-04-28,UD,Armenia,220,109,0,0,111,56,55,111,0
2024-04-29,UD,Armenia,199,111,0,0,88,43,45,88,0
2024-04-30,UD,Armenia,231,123,0,0,108,56,52,108,0
2024-05-01,UD,Armenia,213,112,0,0,101,49,52,101,0
2024-05-02,UD,Armenia,244,129,0,0,115,57,58,115,0
2024-05-03,UD,Armenia,233,131,0,0,102,51,51,102,0
2024-05-04,UD,Armenia,238,120,0,0,118,59,59,118,0
2024-05-05,UD,Armenia,212,94,1,1,118,59,58,117,0
2024-05-06,UD,Armenia,204,110,0,0,94,47,47,94,0
2024-05-07,UD,Armenia,223,123,0,0,100,50,50,100,0
2024-05-08,UD,Armenia,211,117,0,0,94,47,47,94,0
2024-05-09,UD,Armenia,248,132,0,0,116,57,59,116,0
2024-05-10,UD,Armenia,254,153,0,0,101,52,49,101,0
2024-05-11,UD,Armenia,262,143,0,0,119,58,61,119,0
2024-05-12,UD,Armenia,262,135,0,0,127,65,62,127,0
2024-05-13,UD,Armenia,236,138,0,0,98,49,49,98,0
2024-05-14,UD,Armenia,216,117,0,0,99,47,52,99,0
2024-05-15,UD,Armenia,209,108,0,0,101,49,52,101,0
2024-05-16,UD,Armenia,239,126,0,0,113,58,55,113,0
2024-05-17,UD,Armenia,226,131,0,0,95,49,46,95,0
2024-05-18,UD,Armenia,231,119,0,0,112,56,56,112,0
2024-05-19,UD,Armenia,227,110,0,0,117,59,58,117,0
2024-05-20,UD,Armenia,218,123,0,0,95,49,46,95,0
2024-05-21,UD,Armenia,232,137,0,0,95,45,50,95,0
2024-05-22,UD,Armenia,231,128,0,0,103,53,50,103,0
2024-05-23,UD,Armenia,250,134,0,0,116,58,58,116,0
2024-05-24,UD,Armenia,241,147,0,0,94,47,47,94,0
2024-05-25,UD,Armenia,263,146,0,0,117,56,61,117,0
2024-05-26,UD,Armenia,247,126,0,0,121,59,62,121,0
2024-05-27,UD,Armenia,250,150,0,0,100,55,45,100,0
2024-05-28,UD,Armenia,281,191,0,0,90,44,46,90,0
2024-05-29,UD,Armenia,274,170,0,0,104,52,52,104,0
2024-05-30,UD,Armenia,363,247,0,0,116,58,58,116,0
2024-05-31,UD,Armenia,301,192,0,0,109,55,54,109,0
2024-06-01,UD,Armenia,320,190,0,0,130,65,65,130,0
2024-06-02,UD,Armenia,310,187,0,0,123,63,60,123,0
2024-06-03,UD,Armenia,284,181,0,0,103,51,52,103,0
2024-06-04,UD,Armenia,276,167,0,0,109,53,56,109,0
2024-06-05,UD,Armenia,269,155,1,1,114,56,57,113,0
2024-06-06,UD,Armenia,306,183,0,0,123,63,60,123,0
2024-06-07,UD,Armenia,298,188,0,0,110,53,57,110,0
2024-06-08,UD,Armenia,337,208,0,0,129,66,63,129,0
2024-06-09,UD,Armenia,393,270,0,0,123,62,61,123,0
2024-06-10,UD,Armenia,312,196,0,0,116,59,57,116,0
2024-06-11,UD,Armenia,320,213,0,0,107,53,54,107,0
2024-06-12,UD,Armenia,339,216,0,0,123,61,62,123,0
2024-06-13,UD,Armenia,313,193,0,0,120,62,58,120,0
2024-06-14,UD,Armenia,334,219,0,0,115,54,61,115,0
2024-06-15,UD,Armenia,336,201,0,0,135,69,66,135,0
2024-06-16,UD,Armenia,304,175,0,0,129,64,65,129,0
2024-06-17,UD,Armenia,308,204,0,0,104,51,53,104,0
2024-06-18,UD,Armenia,373,273,0,0,100,51,49,100,0
2024-06-19,UD,Armenia,337,205,0,0,132,63,69,132,0
2024-06-20,UD,Armenia,447,316,0,0,131,68,63,131,0
2024-06-21,UD,Armenia,337,219,1,1,118,57,60,117,0
2024-06-22,UD,Armenia,331,197,0,0,134,68,66,134,0
2024-06-23,UD,Armenia,317,178,0,0,139,68,71,139,0
2024-06-24,UD,Armenia,317,199,0,0,118,62,56,118,0
2024-06-25,UD,Armenia,318,208,0,0,110,54,56,110,0
2024-06-26,UD,Armenia,342,215,0,0,127,64,63,127,0
2024-06-27,UD,Armenia,323,199,0,0,124,62,62,124,0
2024-06-28,UD,Armenia,305,193,0,0,112,55,57,112,0
2024-06-29,UD,Armenia,329,188,0,0,141,71,70,141,0
2024-06-30,UD,Armenia,292,165,0,0,127,65,62,127,0
2024-07-01,UD,Armenia,315,196,0,0,119,60,59,119,0
2024-07-02,UD,Armenia,306,186,0,0,120,57,63,120,0
2024-07-03,UD,Armenia,318,184,0,0,134,65,69,134,0
2024-07-04,UD,Armenia,327,187,0,0,140,73,67,140,0
2024-07-05,UD,Armenia,316,194,0,0,122,60,62,122,0
2024-07-06,UD,Armenia,408,267,0,0,141,70,71,141,0
2024-07-07,UD,Armenia,340,204,0,0,136,68,68,136,0
2024-07-08,UD,Armenia,287,173,0,0,114,58,56,114,0
2024-07-09,UD,Armenia,295,177,0,0,118,58,60,118,0
2024-07-10,UD,Armenia,331,187,0,0,144,72,72,144,0
2024-07-11,UD,Armenia,354,215,0,0,139,71,68,139,0
2024-07-12,UD,Armenia,313,201,0,0,112,55,57,112,0
2024-07-13,UD,Armenia,320,176,0,0,144,72,72,144,0
2024-07-14,UD,Armenia,320,181,0,0,139,71,68,139,0
2024-07-15,UD,Armenia,299,180,0,0,119,61,58,119,0
2024-07-16,UD,Armenia,311,186,0,0,125,60,65,125,0
2024-07-17,UD,Armenia,320,174,0,0,146,73,73,146,0
2024-07-18,UD,Armenia,332,201,0,0,131,66,65,131,0
2024-07-19,UD,Armenia,317,202,0,0,115,60,55,115,0
2024-07-20,UD,Armenia,306,178,0,0,128,62,66,128,0
2024-07-21,UD,Armenia,367,229,0,0,138,69,69,138,0
2024-07-22,UD,Armenia,328,216,0,0,112,56,56,112,0
2024-07-23,UD,Armenia,355,225,0,0,130,65,65,130,0
2024-07-24,UD,Armenia,376,237,1,1,139,66,72,138,0
2024-07-25,UD,Armenia,387,239,0,0,148,75,73,148,0
2024-07-26,UD,Armenia,395,273,0,0,122,63,59,122,0
2024-07-27,UD,Armenia,342,200,0,0,142,70,72,142,0
2024-07-28,UD,Armenia,338,202,0,0,136,70,66,136,0
2024-07-29,UD,Armenia,326,204,0,0,122,62,60,122,0
2024-07-30,UD,Armenia,345,216,0,0,129,62,67,129,0
2024-01-01,LO,Austria,2922,2310,12,0,612,301,299,600,12
2024-01-02,LO,Austria,3119,2405,19,2,714,353,342,695,17
2024-01-03,LO,Austria,3145,2424,19,0,721,354,348,702,19
2024-01-04,LO,Austria,3200,2489,13,2,711,348,350,698,11
2024-01-05,LO,Austria,3540,2690,39,0,850,410,401,811,39
2024-01-06,LO,Austria,3486,2693,18,1,793,389,386,775,17
2024-01-07,LO,Austria,3448,2712,13,0,736,363,360,723,13
2024-01-08,LO,Austria,3213,2509,21,1,704,336,347,683,20
2024-01-09,LO,Austria,2765,2165,29,1,600,283,288,571,28
2024-01-10,LO,Austria,2833,2149,39,3,684,326,319,645,36
2024-01-11,LO,Austria,2914,2239,44,2,675,310,321,631,42
2024-01-12,LO,Austria,3372,2613,21,1,759,366,372,738,20
2024-01-13,LO,Austria,3220,2485,18,1,735,360,357,717,17
2024-01-14,LO,Austria,3346,2608,31,1,738,359,348,707,30
2024-01-15,LO,Austria,3130,2406,24,1,724,351,349,700,23
2024-01-16,LO,Austria,2608,2022,20,2,586,276,290,566,18
2024-01-17,LO,Austria,2563,1910,27,1,653,317,309,626,26
2024-01-18,LO,Austria,2891,2221,25,3,670,318,327,645,22
2024-01-19,LO,Austria,3274,2464,20,0,810,397,393,790,20
2024-01-20,LO,Austria,3153,2380,25,1,773,373,375,748,24
2024-01-21,LO,Austria,3157,2392,23,0,765,379,363,742,23
2024-01-22,LO,Austria,2990,2240,48,1,750,351,351,702,47
2024-01-23,LO,Austria,2464,1874,24,1,590,281,285,566,23
2024-01-24,LO,Austria,2610,1948,26,1,662,317,319,636,25
2024-01-25,LO,Austria,2743,2044,23,0,699,333,343,676,23
2024-01-26,LO,Austria,3192,2394,24,2,798,391,383,774,22
2024-01-27,LO,Austria,3045,2221,24,3,824,384,416,800,21
2024-01-28,LO,Austria,3139,2372,16,0,767,380,371,751,16
2024-01-29,LO,Austria,2940,2193,37,1,747,361,349,710,36
2024-01-30,LO,Austria,2519,1932,34,1,587,274,279,553,33
2024-01-31,LO,Austria,2743,2060,24,2,683,328,331,659,22
2024-02-01,LO,Austria,2736,2080,29,5,656,316,311,627,24
2024-02-02,LO,Austria,3121,2322,30,0,799,385,384,769,30
2024-02-03,LO,Austria,3051,2229,28,0,822,390,404,794,28
2024-02-04,LO,Austria,3110,2372,16,1,738,372,350,722,15
2024-02-05,LO,Austria,2901,2194,19,0,707,347,341,688,19
2024-02-06,LO,Austria,2539,1983,26,0,556,264,266,530,26
2024-02-07,LO,Austria,2573,1892,29,2,681,330,322,652,27
2024-02-08,LO,Austria,2912,2197,21,1,715,337,357,694,20
2024-02-09,LO,Austria,3368,2493,37,1,875,423,415,838,36
2024-02-10,LO,Austria,3352,2438,31,2,914,431,452,883,29
2024-02-11,LO,Austria,3242,2464,19,1,778,386,373,759,18
2024-02-12,LO,Austria,3054,2325,26,0,729,351,352,703,26
2024-02-13,LO,Austria,2634,2022,13,0,612,304,295,599,13
2024-02-14,LO,Austria,2954,2256,18,0,698,340,340,680,18
2024-02-15,LO,Austria,3094,2342,42,2,752,349,361,710,40
2024-02-16,LO,Austria,3419,2529,54,3,890,420,416,836,51
2024-02-17,LO,Austria,3446,2510,22,2,936,456,458,914,20
2024-02-18,LO,Austria,3491,2655,25,0,836,408,403,811,25
2024-02-19,LO,Austria,3143,2372,24,0,771,374,373,747,24
2024-02-20,LO,Austria,2556,1953,18,1,603,294,291,585,17
2024-02-21,LO,Austria,2980,2226,42,0,754,355,357,712,42
2024-02-22,LO,Austria,3086,2360,35,2,726,346,345,691,33
2024-02-23,LO,Austria,3389,2560,21,0,829,403,405,808,21
2024-02-24,LO,Austria,3442,2524,30,0,918,442,446,888,30
2024-02-25,LO,Austria,3395,2567,24,1,828,409,395,804,23
2024-02-26,LO,Austria,3219,2441,33,3,778,372,373,745,30
2024-02-27,LO,Austria,2817,2162,35,4,655,314,306,620,31
2024-02-28,LO,Austria,2998,2218,40,5,780,374,366,740,35
2024-02-29,LO,Austria,3179,2406,34,5,773,359,380,739,29
2024-03-01,LO,Austria,3358,2631,30,5,727,347,350,697,25
2024-03-02,LO,Austria,3325,2447,21,3,878,431,426,857,18
2024-03-03,LO,Austria,3374,2570,17,0,804,392,395,787,17
2024-03-04,LO,Austria,3250,2421,34,3,829,401,394,795,31
2024-03-05,LO,Austria,2864,2168,31,2,696,334,331,665,29
2024-03-06,LO,Austria,2990,2212,29,2,778,380,369,749,27
2024-03-07,LO,Austria,2790,2023,30,1,767,369,368,737,29
2024-03-08,LO,Austria,3121,2353,21,1,768,369,378,747,20
2024-03-09,LO,Austria,3289,2432,18,0,857,413,426,839,18
2024-03-10,LO,Austria,3448,2641,22,2,807,393,392,785,20
2024-03-11,LO,Austria,3266,2444,29,1,822,399,394,793,28
2024-03-12,LO,Austria,2789,2100,24,1,689,333,332,665,23
2024-03-13,LO,Austria,2956,2168,31,2,788,379,378,757,29
2024-03-14,LO,Austria,3072,2376,26,1,696,331,339,670,25
2024-03-15,LO,Austria,3559,2672,43,1,887,423,421,844,42
2024-03-16,LO,Austria,3413,2562,21,1,851,414,416,830,20
2024-03-17,LO,Austria,3600,2722,25,0,878,429,424,853,25
2024-03-18,LO,Austria,3302,2470,29,0,832,401,402,803,29
2024-03-19,LO,Austria,2948,2246,32,1,702,337,333,670,31
2024-03-20,LO,Austria,3142,2333,47,2,809,382,380,762,45
2024-03-21,LO,Austria,3217,2382,47,2,835,391,397,788,45
2024-03-22,LO,Austria,3616,2663,37,0,953,457,459,916,37
2024-03-23,LO,Austria,3537,2661,18,0,876,426,432,858,18
2024-03-24,LO,Austria,3429,2628,12,0,801,396,393,789,12
2024-03-25,LO,Austria,3315,2505,24,1,810,397,389,786,23
2024-03-26,LO,Austria,3203,2471,28,1,732,350,354,704,27
2024-03-27,LO,Austria,3357,2548,25,2,809,391,393,784,23
2024-03-28,LO,Austria,3289,2689,19,2,600,285,296,581,17
2024-03-29,LO,Austria,3511,2771,36,6,740,364,340,704,30
2024-03-30,LO,Austria,3520,2696,12,1,824,407,405,812,11
2024-03-31,LO,Austria,3789,3031,6,0,758,378,374,752,6
2024-04-01,LO,Austria,3782,2985,17,1,797,389,391,780,16
2024-04-02,LO,Austria,3648,2814,30,1,834,406,398,804,29
2024-04-03,LO,Austria,3784,2934,37,3,850,401,412,813,34
2024-04-04,LO,Austria,3850,3108,27,1,742,359,356,715,26
2024-04-05,LO,Austria,4119,3227,53,4,892,420,419,839,49
2024-04-06,LO,Austria,3947,3128,19,0,819,403,397,800,19
2024-04-07,LO,Austria,3994,3157,23,1,837,406,408,814,22
2024-04-08,LO,Austria,3789,2948,34,2,841,405,402,807,32
2024-04-09,LO,Austria,3730,2901,27,1,829,404,398,802,26
2024-04-10,LO,Austria,3968,3093,32,3,875,419,424,843,29
2024-04-11,LO,Austria,3968,3059,47,1,909,442,420,862,46
2024-04-12,LO,Austria,4184,3266,44,0,918,428,446,874,44
2024-04-13,LO,Austria,3854,3069,32,1,785,373,380,753,31
2024-04-14,LO,Austria,3859,3034,32,4,825,398,395,793,28
2024-04-15,LO,Austria,3845,3018,36,5,827,395,396,791,31
2024-04-16,LO,Austria,3784,2920,40,4,864,416,408,824,36
2024-04-17,LO,Austria,3782,2909,28,5,873,421,424,845,23
2024-04-18,LO,Austria,3872,3021,29,1,851,410,412,822,28
2024-04-19,LO,Austria,4165,3266,35,1,899,434,430,864,34
2024-04-20,LO,Austria,3945,3218,12,0,727,352,363,715,12
2024-04-21,LO,Austria,4073,3255,16,0,818,398,404,802,16
2024-04-22,LO,Austria,3898,3049,37,2,849,408,404,812,35
2024-04-23,LO,Austria,3804,2981,23,1,823,400,400,800,22
2024-04-24,LO,Austria,3966,3105,20,2,861,423,418,841,18
2024-04-25,LO,Austria,4169,3297,44,2,872,405,423,828,42
2024-04-26,LO,Austria,4330,3356,55,3,974,459,460,919,52
2024-04-27,LO,Austria,4171,3364,30,2,807,385,392,777,28
2024-04-28,LO,Austria,4223,3383,32,0,840,408,400,808,32
2024-04-29,LO,Austria,4139,3228,35,1,911,444,432,876,34
2024-04-30,LO,Austria,4140,3258,29,2,882,421,432,853,27
2024-05-01,LO,Austria,4294,3429,26,1,865,420,419,839,25
2024-05-02,LO,Austria,4182,3289,30,1,893,432,431,863,29
2024-05-03,LO,Austria,4501,3583,28,0,918,446,444,890,28
2024-05-04,LO,Austria,4450,3635,35,1,815,392,388,780,34
2024-05-05,LO,Austria,4563,3672,35,1,891,423,433,856,34
2024-05-06,LO,Austria,4231,3344,34,0,887,431,422,853,34
2024-05-07,LO,Austria,4258,3394,37,1,864,413,414,827,36
2024-05-08,LO,Austria,4506,3562,33,1,944,454,457,911,32
2024-05-09,LO,Austria,4532,3618,29,2,914,451,434,885,27
2024-05-10,LO,Austria,4580,3697,30,1,883,428,425,853,29
2024-05-11,LO,Austria,4514,3715,10,0,799,393,396,789,10
2024-05-12,LO,Austria,4704,3795,21,0,909,432,456,888,21
2024-05-13,LO,Austria,4400,3460,36,1,940,448,456,904,35
2024-05-14,LO,Austria,4445,3530,48,6,915,437,430,867,42
2024-05-15,LO,Austria,4445,3503,40,2,942,454,448,902,38
2024-05-16,LO,Austria,4517,3554,47,7,963,454,462,916,40
2024-05-17,LO,Austria,4866,3877,37,4,989,489,463,952,33
2024-05-18,LO,Austria,4730,3892,27,0,838,398,413,811,27
2024-05-19,LO,Austria,4711,3844,18,0,867,426,423,849,18
2024-05-20,LO,Austria,4661,3701,28,1,960,453,479,932,27
2024-05-21,LO,Austria,4409,3478,36,4,931,453,442,895,32
2024-05-22,LO,Austria,4558,3583,49,3,975,463,463,926,46
2024-05-23,LO,Austria,4712,3747,42,5,965,464,459,923,37
2024-05-24,LO,Austria,4838,3870,36,3,968,466,466,932,33
2024-05-25,LO,Austria,4762,3925,31,2,837,400,406,806,29
2024-05-26,LO,Austria,4946,4015,37,2,931,439,455,894,35
2024-05-27,LO,Austria,4681,3727,35,1,954,466,453,919,34
2024-05-28,LO,Austria,4562,3659,26,3,903,434,443,877,23
2024-05-29,LO,Austria,4817,3790,46,2,1027,494,487,981,44
2024-05-30,LO,Austria,4734,3805,22,1,929,459,448,907,21
2024-05-31,LO,Austria,4826,3886,30,3,940,459,451,910,27
2024-06-01,LO,Austria,5070,4177,16,2,893,434,443,877,14
2024-06-02,LO,Austria,5171,4159,24,4,1012,482,506,988,20
2024-06-03,LO,Austria,4737,3809,21,2,928,452,455,907,19
2024-06-04,LO,Austria,4636,3695,29,1,941,448,464,912,28
2024-06-05,LO,Austria,4779,3812,25,0,967,478,464,942,25
2024-06-06,LO,Austria,4973,3976,38,6,997,476,483,959,32
2024-06-07,LO,Austria,4954,3951,29,4,1003,491,483,974,25
2024-06-08,LO,Austria,4718,3834,20,4,884,432,432,864,16
2024-06-09,LO,Austria,4911,3986,23,0,925,455,447,902,23
2024-06-10,LO,Austria,4773,3836,27,2,937,449,461,910,25
2024-06-11,LO,Austria,4706,3755,33,1,951,460,458,918,32
2024-06-12,LO,Austria,4742,3769,35,2,973,469,469,938,33
2024-06-13,LO,Austria,4856,3856,36,5,1000,481,483,964,31
2024-06-14,LO,Austria,5155,4070,40,2,1085,525,520,1045,38
2024-06-15,LO,Austria,5229,4298,18,0,931,459,454,913,18
2024-06-16,LO,Austria,5120,4175,25,0,945,466,454,920,25
2024-06-17,LO,Austria,4831,3863,31,1,968,473,464,937,30
2024-06-18,LO,Austria,4705,3717,38,2,988,463,487,950,36
2024-06-19,LO,Austria,4901,3903,40,3,998,481,477,958,37
2024-06-20,LO,Austria,4903,3873,50,3,1030,490,490,980,47
2024-06-21,LO,Austria,4933,3909,41,2,1024,499,484,983,39
2024-06-22,LO,Austria,5090,4172,31,2,918,442,445,887,29
2024-06-23,LO,Austria,5107,4163,23,1,944,458,463,921,22
2024-06-24,LO,Austria,4945,3949,37,3,996,474,485,959,34
2024-06-25,LO,Austria,4928,3908,37,5,1020,499,484,983,32
2024-06-26,LO,Austria,4830,3848,35,4,982,469,478,947,31
2024-06-27,LO,Austria,4899,3911,36,2,988,472,480,952,34
2024-06-28,LO,Austria,5176,4095,33,1,1081,522,526,1048,32
2024-06-29,LO,Austria,5303,4339,30,2,964,461,473,934,28
2024-06-30,LO,Austria,5401,4330,46,3,1071,512,513,1025,43
2024-07-01,LO,Austria,4886,3880,27,1,1006,495,484,979,26
2024-07-02,LO,Austria,5002,3999,35,0,1003,494,474,968,35
2024-07-03,LO,Austria,5281,4251,42,0,1030,490,498,988,42
2024-07-04,LO,Austria,5132,4144,40,5,988,471,477,948,35
2024-07-05,LO,Austria,5154,4125,30,0,1029,500,499,999,30
2024-07-06,LO,Austria,5244,4313,14,0,931,455,462,917,14
2024-07-07,LO,Austria,5260,4314,19,0,946,459,468,927,19
2024-07-08,LO,Austria,5163,4213,26,1,950,470,454,924,25
2024-07-09,LO,Austria,5172,4199,43,2,973,467,463,930,41
2024-07-10,LO,Austria,4886,3909,32,2,977,473,472,945,30
2024-07-11,LO,Austria,5108,4146,32,1,962,467,463,930,31
2024-07-12,LO,Austria,4953,4003,41,3,950,458,451,909,38
2024-07-13,LO,Austria,5190,4243,23,2,947,459,465,924,21
2024-07-14,LO,Austria,5378,4412,31,1,966,470,465,935,30
2024-07-15,LO,Austria,5208,4210,40,3,998,470,488,958,37
2024-07-16,LO,Austria,5211,4239,40,1,972,469,463,932,39
2024-07-17,LO,Austria,5040,4033,36,4,1007,486,485,971,32
2024-07-18,LO,Austria,5253,4257,37,4,996,486,473,959,33
2024-07-19,LO,Austria,4631,3680,36,1,951,457,458,915,35
2024-07-20,LO,Austria,5079,4143,23,2,936,452,461,913,21
2024-07-21,LO,Austria,4999,4042,26,1,957,460,471,931,25
2024-07-22,LO,Austria,5115,4156,25,2,959,475,459,934,23
2024-07-23,LO,Austria,5058,4098,41,1,960,453,466,919,40
2024-07-24,LO,Austria,5153,4153,37,2,1000,486,477,963,35
2024-07-25,LO,Austria,5067,4068,34,2,999,482,483,965,32
2024-07-26,LO,Austria,5392,4357,31,5,1035,502,502,1004,26
2024-07-27,LO,Austria,5380,4422,25,0,958,463,470,933,25
2024-07-28,LO,Austria,5216,4262,25,1,954,461,468,929,24
2024-07-29,LO,Austria,5173,4200,35,1,973,471,467,938,34
2024-07-30,LO,Austria,5035,4095,33,4,940,449,458,907,29
2024-01-01,EB,Belgium and Luxembourg,2575,1811,1,1,764,386,377,763,0
2024-01-02,EB,Belgium and Luxembourg,2819,1947,5,2,872,429,438,867,3
2024-01-03,EB,Belgium and Luxembourg,2822,1910,5,3,912,451,456,907,2
2024-01-04,EB,Belgium and Luxembourg,2890,1940,12,7,950,477,461,938,5
2024-01-05,EB,Belgium and Luxembourg,2988,2024,7,3,964,484,473,957,4
2024-01-06,EB,Belgium and Luxembourg,2944,2126,3,0,818,404,411,815,3
2024-01-07,EB,Belgium and Luxembourg,3020,2101,5,1,919,455,459,914,4
2024-01-08,EB,Belgium and Luxembourg,2728,1833,6,2,895,432,457,889,4
2024-01-09,EB,Belgium and Luxembourg,2472,1639,14,9,833,409,410,819,5
2024-01-10,EB,Belgium and Luxembourg,2456,1598,24,15,858,420,414,834,9
2024-01-11,EB,Belgium and Luxembourg,2679,1810,15,10,869,429,425,854,5
2024-01-12,EB,Belgium and Luxembourg,2952,2035,7,3,917,467,443,910,4
2024-01-13,EB,Belgium and Luxembourg,2706,2066,7,1,640,307,326,633,6
2024-01-14,EB,Belgium and Luxembourg,2954,2117,5,0,837,417,415,832,5
2024-01-15,EB,Belgium and Luxembourg,2625,1770,15,4,855,401,439,840,11
2024-01-16,EB,Belgium and Luxembourg,2353,1512,23,8,841,404,414,818,15
2024-01-17,EB,Belgium and Luxembourg,2209,1484,10,4,725,355,360,715,6
2024-01-18,EB,Belgium and Luxembourg,2555,1646,11,4,909,468,430,898,7
2024-01-19,EB,Belgium and Luxembourg,2773,1826,13,9,947,478,456,934,4
2024-01-20,EB,Belgium and Luxembourg,2517,1826,8,2,691,332,351,683,6
2024-01-21,EB,Belgium and Luxembourg,2726,1870,8,0,856,418,430,848,8
2024-01-22,EB,Belgium and Luxembourg,2524,1663,6,2,861,426,429,855,4
2024-01-23,EB,Belgium and Luxembourg,2361,1499,14,8,862,421,427,848,6
2024-01-24,EB,Belgium and Luxembourg,2423,1566,15,8,857,428,414,842,7
2024-01-25,EB,Belgium and Luxembourg,2551,1639,11,6,912,455,446,901,5
2024-01-26,EB,Belgium and Luxembourg,2818,1893,9,5,925,470,446,916,4
2024-01-27,EB,Belgium and Luxembourg,2710,1984,10,4,726,353,363,716,6
2024-01-28,EB,Belgium and Luxembourg,2923,2035,16,4,888,431,441,872,12
2024-01-29,EB,Belgium and Luxembourg,2758,1850,18,10,908,431,459,890,8
2024-01-30,EB,Belgium and Luxembourg,2406,1568,9,6,838,417,412,829,3
2024-01-31,EB,Belgium and Luxembourg,2616,1696,22,7,920,438,460,898,15
2024-02-01,EB,Belgium and Luxembourg,2622,1675,26,11,947,471,450,921,15
2024-02-02,EB,Belgium and Luxembourg,2840,1907,18,10,933,474,441,915,8
2024-02-03,EB,Belgium and Luxembourg,2723,1977,13,5,746,364,369,733,8
2024-02-04,EB,Belgium and Luxembourg,2941,2089,5,3,852,421,426,847,2
2024-02-05,EB,Belgium and Luxembourg,2722,1831,13,5,891,428,450,878,8
2024-02-06,EB,Belgium and Luxembourg,2440,1557,16,10,883,431,436,867,6
2024-02-07,EB,Belgium and Luxembourg,2491,1612,11,6,879,436,432,868,5
2024-02-08,EB,Belgium and Luxembourg,2856,1908,9,0,948,464,475,939,9
2024-02-09,EB,Belgium and Luxembourg,3087,2050,17,7,1037,523,497,1020,10
2024-02-10,EB,Belgium and Luxembourg,3018,2176,15,7,842,414,413,827,8
2024-02-11,EB,Belgium and Luxembourg,2959,2057,4,1,902,452,446,898,3
2024-02-12,EB,Belgium and Luxembourg,2752,1819,14,9,933,449,470,919,5
2024-02-13,EB,Belgium and Luxembourg,2494,1626,14,6,868,421,433,854,8
2024-02-14,EB,Belgium and Luxembourg,2715,1812,14,6,903,447,442,889,8
2024-02-15,EB,Belgium and Luxembourg,2940,1955,24,13,985,488,473,961,11
2024-02-16,EB,Belgium and Luxembourg,3098,2114,17,12,984,492,475,967,5
2024-02-17,EB,Belgium and Luxembourg,2964,2164,12,5,800,386,402,788,7
2024-02-18,EB,Belgium and Luxembourg,3176,2216,9,2,960,470,481,951,7
2024-02-19,EB,Belgium and Luxembourg,2803,1863,17,9,940,453,470,923,8
2024-02-20,EB,Belgium and Luxembourg,2567,1704,12,5,863,427,424,851,7
2024-02-21,EB,Belgium and Luxembourg,2729,1857,7,3,872,438,427,865,4
2024-02-22,EB,Belgium and Luxembourg,2952,1996,12,6,956,471,473,944,6
2024-02-23,EB,Belgium and Luxembourg,3045,2048,13,6,997,501,483,984,7
2024-02-24,EB,Belgium and Luxembourg,2798,2025,8,3,773,379,386,765,5
2024-02-25,EB,Belgium and Luxembourg,3048,2124,15,4,924,457,452,909,11
2024-02-26,EB,Belgium and Luxembourg,2899,1951,6,2,948,455,487,942,4
2024-02-27,EB,Belgium and Luxembourg,2658,1766,15,8,892,440,437,877,7
2024-02-28,EB,Belgium and Luxembourg,2800,1880,25,11,920,444,451,895,14
2024-02-29,EB,Belgium and Luxembourg,2903,1969,16,8,934,456,462,918,8
2024-03-01,EB,Belgium and Luxembourg,3064,2076,11,5,988,512,465,977,6
2024-03-02,EB,Belgium and Luxembourg,2830,2048,2,0,782,385,395,780,2
2024-03-03,EB,Belgium and Luxembourg,3066,2154,3,1,912,450,459,909,2
2024-03-04,EB,Belgium and Luxembourg,2910,1937,12,7,973,471,490,961,5
2024-03-05,EB,Belgium and Luxembourg,2706,1784,6,4,922,457,459,916,2
2024-03-06,EB,Belgium and Luxembourg,2822,1867,13,8,955,480,462,942,5
2024-03-07,EB,Belgium and Luxembourg,2871,1892,14,4,979,483,482,965,10
2024-03-08,EB,Belgium and Luxembourg,3013,2025,8,5,988,502,478,980,3
2024-03-09,EB,Belgium and Luxembourg,2847,2036,10,3,811,390,411,801,7
2024-03-10,EB,Belgium and Luxembourg,3126,2200,9,1,926,461,456,917,8
2024-03-11,EB,Belgium and Luxembourg,2988,2004,12,8,984,470,502,972,4
2024-03-12,EB,Belgium and Luxembourg,2722,1780,11,5,942,469,462,931,6
2024-03-13,EB,Belgium and Luxembourg,2797,1878,10,6,919,461,448,909,4
2024-03-14,EB,Belgium and Luxembourg,3008,1955,23,15,1053,516,514,1030,8
2024-03-15,EB,Belgium and Luxembourg,3117,2063,18,8,1054,524,512,1036,10
2024-03-16,EB,Belgium and Luxembourg,2854,2088,10,4,766,372,384,756,6
2024-03-17,EB,Belgium and Luxembourg,3099,2167,9,0,932,458,465,923,9
2024-03-18,EB,Belgium and Luxembourg,3020,2012,17,7,1008,487,504,991,10
2024-03-19,EB,Belgium and Luxembourg,2759,1789,19,8,970,480,471,951,11
2024-03-20,EB,Belgium and Luxembourg,2965,1922,22,13,1043,512,509,1021,9
2024-03-21,EB,Belgium and Luxembourg,3087,2030,19,13,1057,512,526,1038,6
2024-03-22,EB,Belgium and Luxembourg,3249,2167,22,12,1082,551,509,1060,10
2024-03-23,EB,Belgium and Luxembourg,2870,2091,7,3,779,386,386,772,4
2024-03-24,EB,Belgium and Luxembourg,3001,2094,11,6,907,435,461,896,5
2024-03-25,EB,Belgium and Luxembourg,3023,2024,25,15,999,475,499,974,10
2024-03-26,EB,Belgium and Luxembourg,2926,1951,17,10,975,484,474,958,7
2024-03-27,EB,Belgium and Luxembourg,3085,2081,13,7,1004,500,491,991,6
2024-03-28,EB,Belgium and Luxembourg,3134,2100,16,6,1034,511,507,1018,10
2024-03-29,EB,Belgium and Luxembourg,3178,2093,30,17,1085,536,519,1055,13
2024-03-30,EB,Belgium and Luxembourg,3004,2139,9,4,865,424,432,856,5
2024-03-31,EB,Belgium and Luxembourg,3202,2243,5,4,959,476,478,954,1
2024-04-01,EB,Belgium and Luxembourg,3263,2264,10,3,999,485,504,989,7
2024-04-02,EB,Belgium and Luxembourg,3042,2017,10,2,1025,508,507,1015,8
2024-04-03,EB,Belgium and Luxembourg,3297,2212,17,9,1085,537,531,1068,8
2024-04-04,EB,Belgium and Luxembourg,3274,2184,2,1,1090,543,545,1088,1
2024-04-05,EB,Belgium and Luxembourg,3385,2297,9,8,1088,555,524,1079,1
2024-04-06,EB,Belgium and Luxembourg,3133,2228,13,7,905,449,443,892,6
2024-04-07,EB,Belgium and Luxembourg,3347,2302,10,1,1045,512,523,1035,9
2024-04-08,EB,Belgium and Luxembourg,3336,2237,14,5,1099,528,557,1085,9
2024-04-09,EB,Belgium and Luxembourg,3196,2152,5,2,1044,517,522,1039,3
2024-04-10,EB,Belgium and Luxembourg,3405,2300,20,11,1105,549,536,1085,9
2024-04-11,EB,Belgium and Luxembourg,3418,2257,20,10,1161,561,580,1141,10
2024-04-12,EB,Belgium and Luxembourg,3482,2304,28,14,1178,583,567,1150,14
2024-04-13,EB,Belgium and Luxembourg,3188,2254,6,4,934,465,463,928,2
2024-04-14,EB,Belgium and Luxembourg,3375,2317,9,2,1058,520,529,1049,7
2024-04-15,EB,Belgium and Luxembourg,3221,2156,9,4,1065,510,546,1056,5
2024-04-16,EB,Belgium and Luxembourg,3179,2137,3,2,1042,522,517,1039,1
2024-04-17,EB,Belgium and Luxembourg,3277,2148,14,10,1129,558,557,1115,4
2024-04-18,EB,Belgium and Luxembourg,3456,2275,28,18,1181,586,567,1153,10
2024-04-19,EB,Belgium and Luxembourg,3419,2300,14,7,1119,565,540,1105,7
2024-04-20,EB,Belgium and Luxembourg,3227,2258,10,4,969,479,480,959,6
2024-04-21,EB,Belgium and Luxembourg,3323,2262,9,5,1061,520,532,1052,4
2024-04-22,EB,Belgium and Luxembourg,3311,2148,27,14,1163,562,574,1136,13
2024-04-23,EB,Belgium and Luxembourg,3182,2066,13,10,1116,548,555,1103,3
2024-04-24,EB,Belgium and Luxembourg,3389,2258,12,3,1131,561,558,1119,9
2024-04-25,EB,Belgium and Luxembourg,3276,2141,20,7,1135,556,559,1115,13
2024-04-26,EB,Belgium and Luxembourg,3512,2333,21,14,1179,594,564,1158,7
2024-04-27,EB,Belgium and Luxembourg,3156,2217,9,4,939,462,468,930,5
2024-04-28,EB,Belgium and Luxembourg,3366,2302,2,0,1064,523,539,1062,2
2024-04-29,EB,Belgium and Luxembourg,3285,2160,19,6,1125,545,561,1106,13
2024-04-30,EB,Belgium and Luxembourg,3300,2187,24,11,1113,549,540,1089,13
2024-05-01,EB,Belgium and Luxembourg,3538,2430,11,4,1108,545,552,1097,7
2024-05-02,EB,Belgium and Luxembourg,3313,2181,22,12,1132,558,552,1110,10
2024-05-03,EB,Belgium and Luxembourg,3526,2397,18,10,1129,561,550,1111,8
2024-05-04,EB,Belgium and Luxembourg,3337,2371,11,6,966,480,475,955,5
2024-05-05,EB,Belgium and Luxembourg,3516,2440,5,3,1076,530,541,1071,2
2024-05-06,EB,Belgium and Luxembourg,3452,2282,26,17,1170,559,585,1144,9
2024-05-07,EB,Belgium and Luxembourg,3386,2243,26,16,1143,558,559,1117,10
2024-05-08,EB,Belgium and Luxembourg,3594,2388,25,16,1206,607,574,1181,9
2024-05-09,EB,Belgium and Luxembourg,3503,2367,16,4,1136,568,552,1120,12
2024-05-10,EB,Belgium and Luxembourg,3562,2439,14,5,1123,558,551,1109,9
2024-05-11,EB,Belgium and Luxembourg,3345,2345,12,4,1000,485,503,988,8
2024-05-12,EB,Belgium and Luxembourg,3609,2449,14,3,1160,564,582,1146,11
2024-05-13,EB,Belgium and Luxembourg,3593,2392,22,7,1201,576,603,1179,15
2024-05-14,EB,Belgium and Luxembourg,3511,2356,20,10,1155,569,566,1135,10
2024-05-15,EB,Belgium and Luxembourg,3706,2496,15,9,1210,605,590,1195,6
2024-05-16,EB,Belgium and Luxembourg,3727,2488,15,5,1239,617,607,1224,10
2024-05-17,EB,Belgium and Luxembourg,3679,2488,11,6,1191,602,578,1180,5
2024-05-18,EB,Belgium and Luxembourg,3329,2342,13,7,987,488,486,974,6
2024-05-19,EB,Belgium and Luxembourg,3500,2425,11,4,1075,532,532,1064,7
2024-05-20,EB,Belgium and Luxembourg,3501,2368,10,4,1133,539,584,1123,6
2024-05-21,EB,Belgium and Luxembourg,3546,2351,24,16,1195,586,585,1171,8
2024-05-22,EB,Belgium and Luxembourg,3595,2437,19,8,1158,575,564,1139,11
2024-05-23,EB,Belgium and Luxembourg,3742,2516,21,10,1226,610,595,1205,11
2024-05-24,EB,Belgium and Luxembourg,3695,2504,19,7,1191,603,569,1172,12
2024-05-25,EB,Belgium and Luxembourg,3522,2494,10,4,1028,503,515,1018,6
2024-05-26,EB,Belgium and Luxembourg,3656,2537,9,0,1119,553,557,1110,9
2024-05-27,EB,Belgium and Luxembourg,3545,2360,22,12,1185,567,596,1163,10
2024-05-28,EB,Belgium and Luxembourg,3552,2381,22,11,1171,576,573,1149,11
2024-05-29,EB,Belgium and Luxembourg,3669,2513,18,15,1156,573,565,1138,3
2024-05-30,EB,Belgium and Luxembourg,3604,2425,14,10,1179,583,582,1165,4
2024-05-31,EB,Belgium and Luxembourg,3702,2511,18,12,1191,603,570,1173,6
2024-06-01,EB,Belgium and Luxembourg,3503,2539,22,20,964,466,476,942,2
2024-06-02,EB,Belgium and Luxembourg,3797,2685,13,6,1112,541,558,1099,7
2024-06-03,EB,Belgium and Luxembourg,3555,2396,19,17,1159,555,585,1140,2
2024-06-04,EB,Belgium and Luxembourg,3569,2424,18,10,1145,570,557,1127,8
2024-06-05,EB,Belgium and Luxembourg,3699,2512,14,3,1187,590,583,1173,11
2024-06-06,EB,Belgium and Luxembourg,3728,2517,17,9,1211,606,588,1194,8
2024-06-07,EB,Belgium and Luxembourg,3745,2552,20,15,1193,594,579,1173,5
2024-06-08,EB,Belgium and Luxembourg,3487,2517,11,7,970,478,481,959,4
2024-06-09,EB,Belgium and Luxembourg,3699,2598,11,1,1101,539,551,1090,10
2024-06-10,EB,Belgium and Luxembourg,3586,2399,10,4,1187,578,599,1177,6
2024-06-11,EB,Belgium and Luxembourg,3513,2368,21,11,1145,567,557,1124,10
2024-06-12,EB,Belgium and Luxembourg,3652,2430,17,7,1222,589,616,1205,10
2024-06-13,EB,Belgium and Luxembourg,3763,2518,23,10,1245,617,605,1222,13
2024-06-14,EB,Belgium and Luxembourg,3814,2610,20,10,1204,612,572,1184,10
2024-06-15,EB,Belgium and Luxembourg,3526,2534,5,3,992,493,494,987,2
2024-06-16,EB,Belgium and Luxembourg,3737,2617,6,2,1120,545,569,1114,4
2024-06-17,EB,Belgium and Luxembourg,3690,2456,19,7,1234,602,613,1215,12
2024-06-18,EB,Belgium and Luxembourg,3582,2391,15,9,1191,591,585,1176,6
2024-06-19,EB,Belgium and Luxembourg,3695,2441,22,12,1254,621,611,1232,10
2024-06-20,EB,Belgium and Luxembourg,3705,2497,14,7,1208,593,601,1194,7
2024-06-21,EB,Belgium and Luxembourg,3775,2590,8,4,1185,607,570,1177,4
2024-06-22,EB,Belgium and Luxembourg,3498,2499,7,4,999,488,504,992,3
2024-06-23,EB,Belgium and Luxembourg,3734,2575,14,6,1159,573,572,1145,8
2024-06-24,EB,Belgium and Luxembourg,3657,2444,18,14,1213,586,609,1195,4
2024-06-25,EB,Belgium and Luxembourg,3655,2512,18,7,1143,568,557,1125,11
2024-06-26,EB,Belgium and Luxembourg,3716,2488,33,13,1228,586,609,1195,20
2024-06-27,EB,Belgium and Luxembourg,3637,2410,24,12,1227,594,609,1203,12
2024-06-28,EB,Belgium and Luxembourg,3673,2441,19,8,1232,627,586,1213,11
2024-06-29,EB,Belgium and Luxembourg,3406,2375,8,2,1031,517,506,1023,6
2024-06-30,EB,Belgium and Luxembourg,3783,2619,7,0,1164,575,582,1157,7
2024-07-01,EB,Belgium and Luxembourg,3714,2468,21,7,1246,603,622,1225,14
2024-07-02,EB,Belgium and Luxembourg,3710,2507,13,6,1203,595,595,1190,7
2024-07-03,EB,Belgium and Luxembourg,3762,2557,19,10,1205,595,591,1186,9
2024-07-04,EB,Belgium and Luxembourg,3770,2550,11,6,1220,607,602,1209,5
2024-07-05,EB,Belgium and Luxembourg,3839,2628,9,4,1211,610,592,1202,5
2024-07-06,EB,Belgium and Luxembourg,3572,2533,8,2,1039,520,511,1031,6
2024-07-07,EB,Belgium and Luxembourg,3726,2591,5,3,1135,561,569,1130,2
2024-07-08,EB,Belgium and Luxembourg,3775,2595,15,9,1180,570,595,1165,6
2024-07-09,EB,Belgium and Luxembourg,3563,2385,20,4,1178,577,581,1158,16
2024-07-10,EB,Belgium and Luxembourg,3771,2543,11,5,1228,612,605,1217,6
2024-07-11,EB,Belgium and Luxembourg,3888,2654,6,2,1234,619,609,1228,4
2024-07-12,EB,Belgium and Luxembourg,3922,2704,17,4,1218,600,601,1201,13
2024-07-13,EB,Belgium and Luxembourg,3617,2535,8,2,1082,540,534,1074,6
2024-07-14,EB,Belgium and Luxembourg,3762,2616,6,1,1146,578,562,1140,5
2024-07-15,EB,Belgium and Luxembourg,3685,2493,21,14,1192,563,608,1171,7
2024-07-16,EB,Belgium and Luxembourg,3692,2503,12,10,1189,603,574,1177,2
2024-07-17,EB,Belgium and Luxembourg,3722,2501,19,10,1221,601,601,1202,9
2024-07-18,EB,Belgium and Luxembourg,3791,2558,12,7,1233,606,615,1221,5
2024-07-19,EB,Belgium and Luxembourg,3604,2388,10,6,1216,606,600,1206,4
2024-07-20,EB,Belgium and Luxembourg,3600,2520,13,3,1080,532,535,1067,10
2024-07-21,EB,Belgium and Luxembourg,3803,2644,9,4,1159,577,573,1150,5
2024-07-22,EB,Belgium and Luxembourg,3843,2600,15,7,1243,605,623,1228,8
2024-07-23,EB,Belgium and Luxembourg,3626,2446,16,11,1180,588,576,1164,5
2024-07-24,EB,Belgium and Luxembourg,3800,2539,25,9,1261,611,625,1236,16
2024-07-25,EB,Belgium and Luxembourg,3808,2539,15,7,1269,619,635,1254,8
2024-07-26,EB,Belgium and Luxembourg,3757,2504,17,7,1253,633,603,1236,10
2024-07-27,EB,Belgium and Luxembourg,3616,2573,7,4,1043,509,527,1036,3
2024-07-28,EB,Belgium and Luxembourg,3848,2600,10,1,1248,625,613,1238,9
2024-07-29,EB,Belgium and Luxembourg,3762,2506,19,12,1256,613,624,1237,7
2024-07-30,EB,Belgium and Luxembourg,3592,2385,25,16,1207,593,589,1182,9
2024-01-01,LQ,Bosnia-Herzegovina,961,924,0,0,37,17,20,37,0
2024-01-02,LQ,Bosnia-Herzegovina,1071,1028,0,0,43,22,21,43,0
2024-01-03,LQ,Bosnia-Herzegovina,1034,990,0,0,44,22,22,44,0
2024-01-04,LQ,Bosnia-Herzegovina,1014,965,0,0,49,23,26,49,0
2024-01-05,LQ,Bosnia-Herzegovina,1086,1032,0,0,54,28,26,54,0
2024-01-06,LQ,Bosnia-Herzegovina,1202,1172,0,0,30,15,15,30,0
2024-01-07,LQ,Bosnia-Herzegovina,1162,1124,0,0,38,19,19,38,0
2024-01-08,LQ,Bosnia-Herzegovina,1015,961,0,0,54,27,27,54,0
2024-01-09,LQ,Bosnia-Herzegovina,893,847,0,0,46,23,23,46,0
2024-01-10,LQ,Bosnia-Herzegovina,882,843,1,1,39,20,18,38,0
2024-01-11,LQ,Bosnia-Herzegovina,896,853,1,1,43,20,22,42,0
2024-01-12,LQ,Bosnia-Herzegovina,1013,960,0,0,53,27,26,53,0
2024-01-13,LQ,Bosnia-Herzegovina,1051,1020,1,1,31,15,15,30,0
2024-01-14,LQ,Bosnia-Herzegovina,1061,1025,0,0,36,18,18,36,0
2024-01-15,LQ,Bosnia-Herzegovina,919,878,0,0,41,20,21,41,0
2024-01-16,LQ,Bosnia-Herzegovina,834,793,0,0,41,21,20,41,0
2024-01-17,LQ,Bosnia-Herzegovina,847,807,2,0,40,19,19,38,2
2024-01-18,LQ,Bosnia-Herzegovina,849,814,0,0,35,17,18,35,0
2024-01-19,LQ,Bosnia-Herzegovina,933,882,0,0,51,26,25,51,0
2024-01-20,LQ,Bosnia-Herzegovina,958,928,0,0,30,15,15,30,0
2024-01-21,LQ,Bosnia-Herzegovina,1010,972,0,0,38,18,20,38,0
2024-01-22,LQ,Bosnia-Herzegovina,877,836,0,0,41,20,21,41,0
2024-01-23,LQ,Bosnia-Herzegovina,767,728,0,0,39,20,19,39,0
2024-01-24,LQ,Bosnia-Herzegovina,882,840,0,0,42,22,20,42,0
2024-01-25,LQ,Bosnia-Herzegovina,831,797,0,0,34,17,17,34,0
2024-01-26,LQ,Bosnia-Herzegovina,956,899,1,0,57,29,27,56,1
2024-01-27,LQ,Bosnia-Herzegovina,941,902,3,0,39,18,18,36,3
2024-01-28,LQ,Bosnia-Herzegovina,977,939,1,0,38,17,20,37,1
2024-01-29,LQ,Bosnia-Herzegovina,890,840,1,1,50,25,24,49,0
2024-01-30,LQ,Bosnia-Herzegovina,778,741,0,0,37,18,19,37,0
2024-01-31,LQ,Bosnia-Herzegovina,886,845,0,0,41,22,19,41,0
2024-02-01,LQ,Bosnia-Herzegovina,860,822,0,0,38,17,21,38,0
2024-02-02,LQ,Bosnia-Herzegovina,1000,947,0,0,53,28,25,53,0
2024-02-03,LQ,Bosnia-Herzegovina,999,969,0,0,30,15,15,30,0
2024-02-04,LQ,Bosnia-Herzegovina,1014,977,0,0,37,18,19,37,0
2024-02-05,LQ,Bosnia-Herzegovina,893,852,2,0,41,20,19,39,2
2024-02-06,LQ,Bosnia-Herzegovina,778,740,0,0,38,18,20,38,0
2024-02-07,LQ,Bosnia-Herzegovina,802,761,1,1,41,22,18,40,0
2024-02-08,LQ,Bosnia-Herzegovina,895,859,2,0,36,15,19,34,2
2024-02-09,LQ,Bosnia-Herzegovina,987,929,2,0,58,29,27,56,2
2024-02-10,LQ,Bosnia-Herzegovina,1063,1031,0,0,32,16,16,32,0
2024-02-11,LQ,Bosnia-Herzegovina,1007,968,0,0,39,19,20,39,0
2024-02-12,LQ,Bosnia-Herzegovina,903,860,0,0,43,22,21,43,0
2024-02-13,LQ,Bosnia-Herzegovina,821,778,0,0,43,21,22,43,0
2024-02-14,LQ,Bosnia-Herzegovina,885,840,0,0,45,24,21,45,0
2024-02-15,LQ,Bosnia-Herzegovina,932,893,0,0,39,18,21,39,0
2024-02-16,LQ,Bosnia-Herzegovina,1004,947,1,0,57,29,27,56,1
2024-02-17,LQ,Bosnia-Herzegovina,1063,1031,0,0,32,16,16,32,0
2024-02-18,LQ,Bosnia-Herzegovina,1049,1010,0,0,39,19,20,39,0
2024-02-19,LQ,Bosnia-Herzegovina,944,903,0,0,41,21,20,41,0
2024-02-20,LQ,Bosnia-Herzegovina,819,784,0,0,35,17,18,35,0
2024-02-21,LQ,Bosnia-Herzegovina,926,885,0,0,41,22,19,41,0
2024-02-22,LQ,Bosnia-Herzegovina,919,884,2,0,35,14,19,33,2
2024-02-23,LQ,Bosnia-Herzegovina,993,946,0,0,47,26,21,47,0
2024-02-24,LQ,Bosnia-Herzegovina,997,966,0,0,31,15,16,31,0
2024-02-25,LQ,Bosnia-Herzegovina,1046,1011,0,0,35,17,18,35,0
2024-02-26,LQ,Bosnia-Herzegovina,918,876,0,0,42,21,21,42,0
2024-02-27,LQ,Bosnia-Herzegovina,872,828,1,0,44,21,22,43,1
2024-02-28,LQ,Bosnia-Herzegovina,896,858,0,0,38,21,17,38,0
2024-02-29,LQ,Bosnia-Herzegovina,947,908,0,0,39,17,22,39,0
2024-03-01,LQ,Bosnia-Herzegovina,975,922,2,1,53,27,24,51,1
2024-03-02,LQ,Bosnia-Herzegovina,1068,1036,0,0,32,16,16,32,0
2024-03-03,LQ,Bosnia-Herzegovina,1102,1065,0,0,37,18,19,37,0
2024-03-04,LQ,Bosnia-Herzegovina,965,921,0,0,44,21,23,44,0
2024-03-05,LQ,Bosnia-Herzegovina,863,822,0,0,41,22,19,41,0
2024-03-06,LQ,Bosnia-Herzegovina,912,873,2,0,39,19,18,37,2
2024-03-07,LQ,Bosnia-Herzegovina,876,835,0,0,41,19,22,41,0
2024-03-08,LQ,Bosnia-Herzegovina,980,933,0,0,47,24,23,47,0
2024-03-09,LQ,Bosnia-Herzegovina,1055,1027,1,1,28,14,13,27,0
2024-03-10,LQ,Bosnia-Herzegovina,1095,1063,0,0,32,16,16,32,0
2024-03-11,LQ,Bosnia-Herzegovina,931,894,0,0,37,17,20,37,0
2024-03-12,LQ,Bosnia-Herzegovina,822,782,1,1,40,20,19,39,0
2024-03-13,LQ,Bosnia-Herzegovina,929,889,1,0,40,21,18,39,1
2024-03-14,LQ,Bosnia-Herzegovina,948,912,0,0,36,16,20,36,0
2024-03-15,LQ,Bosnia-Herzegovina,1064,1018,0,0,46,24,22,46,0
2024-03-16,LQ,Bosnia-Herzegovina,1074,1044,0,0,30,15,15,30,0
2024-03-17,LQ,Bosnia-Herzegovina,1085,1049,0,0,36,18,18,36,0
2024-03-18,LQ,Bosnia-Herzegovina,954,908,1,1,46,22,23,45,0
2024-03-19,LQ,Bosnia-Herzegovina,976,928,4,0,48,22,22,44,4
2024-03-20,LQ,Bosnia-Herzegovina,986,946,1,1,40,20,19,39,0
2024-03-21,LQ,Bosnia-Herzegovina,930,886,0,0,44,21,23,44,0
2024-03-22,LQ,Bosnia-Herzegovina,1135,1081,2,0,54,27,25,52,2
2024-03-23,LQ,Bosnia-Herzegovina,1140,1109,1,1,31,14,16,30,0
2024-03-24,LQ,Bosnia-Herzegovina,1086,1046,0,0,40,20,20,40,0
2024-03-25,LQ,Bosnia-Herzegovina,1072,1024,0,0,48,24,24,48,0
2024-03-26,LQ,Bosnia-Herzegovina,973,933,0,0,40,20,20,40,0
2024-03-27,LQ,Bosnia-Herzegovina,1043,1005,0,0,38,20,18,38,0
2024-03-28,LQ,Bosnia-Herzegovina,1028,994,0,0,34,17,17,34,0
2024-03-29,LQ,Bosnia-Herzegovina,1188,1139,1,1,49,24,24,48,0
2024-03-30,LQ,Bosnia-Herzegovina,1159,1133,0,0,26,13,13,26,0
2024-03-31,LQ,Bosnia-Herzegovina,1348,1318,0,0,30,15,15,30,0
2024-04-01,LQ,Bosnia-Herzegovina,1261,1204,2,0,57,27,28,55,2
2024-04-02,LQ,Bosnia-Herzegovina,1162,1118,0,0,44,20,24,44,0
2024-04-03,LQ,Bosnia-Herzegovina,1210,1157,0,0,53,28,25,53,0
2024-04-04,LQ,Bosnia-Herzegovina,1228,1179,1,0,49,23,25,48,1
2024-04-05,LQ,Bosnia-Herzegovina,1412,1338,0,0,74,38,36,74,0
2024-04-06,LQ,Bosnia-Herzegovina,1460,1418,0,0,42,20,22,42,0
2024-04-07,LQ,Bosnia-Herzegovina,1479,1426,0,0,53,27,26,53,0
2024-04-08,LQ,Bosnia-Herzegovina,1361,1293,0,0,68,34,34,68,0
2024-04-09,LQ,Bosnia-Herzegovina,1283,1237,0,0,46,23,23,46,0
2024-04-10,LQ,Bosnia-Herzegovina,1301,1249,1,1,52,26,25,51,0
2024-04-11,LQ,Bosnia-Herzegovina,1269,1211,0,0,58,28,30,58,0
2024-04-12,LQ,Bosnia-Herzegovina,1447,1377,0,0,70,35,35,70,0
2024-04-13,LQ,Bosnia-Herzegovina,1577,1531,1,1,46,22,23,45,0
2024-04-14,LQ,Bosnia-Herzegovina,1489,1439,0,0,50,26,24,50,0
2024-04-15,LQ,Bosnia-Herzegovina,1381,1311,4,1,70,32,34,66,3
2024-04-16,LQ,Bosnia-Herzegovina,1251,1204,1,0,47,23,23,46,1
2024-04-17,LQ,Bosnia-Herzegovina,1278,1218,2,1,60,29,29,58,1
2024-04-18,LQ,Bosnia-Herzegovina,1302,1240,2,1,62,29,31,60,1
2024-04-19,LQ,Bosnia-Herzegovina,1456,1386,1,1,70,36,33,69,0
2024-04-20,LQ,Bosnia-Herzegovina,1516,1473,0,0,43,21,22,43,0
2024-04-21,LQ,Bosnia-Herzegovina,1470,1423,0,0,47,24,23,47,0
2024-04-22,LQ,Bosnia-Herzegovina,1386,1309,0,0,77,38,39,77,0
2024-04-23,LQ,Bosnia-Herzegovina,1331,1285,0,0,46,23,23,46,0
2024-04-24,LQ,Bosnia-Herzegovina,1346,1292,1,1,54,27,26,53,0
2024-04-25,LQ,Bosnia-Herzegovina,1364,1302,0,0,62,30,32,62,0
2024-04-26,LQ,Bosnia-Herzegovina,1488,1416,1,1,72,37,34,71,0
2024-04-27,LQ,Bosnia-Herzegovina,1581,1529,0,0,52,25,27,52,0
2024-04-28,LQ,Bosnia-Herzegovina,1484,1435,0,0,49,25,24,49,0
2024-04-29,LQ,Bosnia-Herzegovina,1457,1385,1,0,72,35,36,71,1
2024-04-30,LQ,Bosnia-Herzegovina,1468,1421,0,0,47,23,24,47,0
2024-05-01,LQ,Bosnia-Herzegovina,1511,1453,0,0,58,30,28,58,0
2024-05-02,LQ,Bosnia-Herzegovina,1396,1338,0,0,58,28,30,58,0
2024-05-03,LQ,Bosnia-Herzegovina,1579,1504,0,0,75,38,37,75,0
2024-05-04,LQ,Bosnia-Herzegovina,1674,1622,0,0,52,26,26,52,0
2024-05-05,LQ,Bosnia-Herzegovina,1698,1643,0,0,55,28,27,55,0
2024-05-06,LQ,Bosnia-Herzegovina,1548,1475,0,0,73,36,37,73,0
2024-05-07,LQ,Bosnia-Herzegovina,1539,1483,1,0,56,27,28,55,1
2024-05-08,LQ,Bosnia-Herzegovina,1567,1503,0,0,64,32,32,64,0
2024-05-09,LQ,Bosnia-Herzegovina,1530,1466,0,0,64,31,33,64,0
2024-05-10,LQ,Bosnia-Herzegovina,1609,1528,1,1,81,42,38,80,0
2024-05-11,LQ,Bosnia-Herzegovina,1748,1704,1,0,44,22,21,43,1
2024-05-12,LQ,Bosnia-Herzegovina,1683,1632,0,0,51,25,26,51,0
2024-05-13,LQ,Bosnia-Herzegovina,1589,1516,2,0,73,34,37,71,2
2024-05-14,LQ,Bosnia-Herzegovina,1542,1480,2,0,62,30,30,60,2
2024-05-15,LQ,Bosnia-Herzegovina,1529,1465,1,1,64,32,31,63,0
2024-05-16,LQ,Bosnia-Herzegovina,1517,1450,1,0,67,32,34,66,1
2024-05-17,LQ,Bosnia-Herzegovina,1705,1625,0,0,80,42,38,80,0
2024-05-18,LQ,Bosnia-Herzegovina,1808,1763,0,0,45,22,23,45,0
2024-05-19,LQ,Bosnia-Herzegovina,1706,1651,0,0,55,28,27,55,0
2024-05-20,LQ,Bosnia-Herzegovina,1669,1593,2,0,76,37,37,74,2
2024-05-21,LQ,Bosnia-Herzegovina,1528,1480,0,0,48,23,25,48,0
2024-05-22,LQ,Bosnia-Herzegovina,1594,1537,1,1,57,29,27,56,0
2024-05-23,LQ,Bosnia-Herzegovina,1652,1590,2,2,62,29,31,60,0
2024-05-24,LQ,Bosnia-Herzegovina,1759,1684,1,1,75,38,36,74,0
2024-05-25,LQ,Bosnia-Herzegovina,1768,1719,0,0,49,24,25,49,0
2024-05-26,LQ,Bosnia-Herzegovina,1748,1692,0,0,56,29,27,56,0
2024-05-27,LQ,Bosnia-Herzegovina,1674,1599,0,0,75,38,37,75,0
2024-05-28,LQ,Bosnia-Herzegovina,1560,1505,0,0,55,27,28,55,0
2024-05-29,LQ,Bosnia-Herzegovina,1635,1577,0,0,58,29,29,58,0
2024-05-30,LQ,Bosnia-Herzegovina,1562,1500,0,0,62,30,32,62,0
2024-05-31,LQ,Bosnia-Herzegovina,1694,1611,0,0,83,43,40,83,0
2024-06-01,LQ,Bosnia-Herzegovina,1884,1828,0,0,56,26,30,56,0
2024-06-02,LQ,Bosnia-Herzegovina,1804,1740,0,0,64,33,31,64,0
2024-06-03,LQ,Bosnia-Herzegovina,1550,1473,2,0,77,38,37,75,2
2024-06-04,LQ,Bosnia-Herzegovina,1687,1624,0,0,63,31,32,63,0
2024-06-05,LQ,Bosnia-Herzegovina,1674,1607,0,0,67,33,34,67,0
2024-06-06,LQ,Bosnia-Herzegovina,1662,1587,0,0,75,37,38,75,0
2024-06-07,LQ,Bosnia-Herzegovina,1756,1664,0,0,92,47,45,92,0
2024-06-08,LQ,Bosnia-Herzegovina,1801,1737,2,2,64,31,31,62,0
2024-06-09,LQ,Bosnia-Herzegovina,1807,1733,2,0,74,36,36,72,2
2024-06-10,LQ,Bosnia-Herzegovina,1735,1641,0,0,94,46,48,94,0
2024-06-11,LQ,Bosnia-Herzegovina,1571,1495,0,0,76,39,37,76,0
2024-06-12,LQ,Bosnia-Herzegovina,1603,1539,0,0,64,32,32,64,0
2024-06-13,LQ,Bosnia-Herzegovina,1590,1519,0,0,71,35,36,71,0
2024-06-14,LQ,Bosnia-Herzegovina,1762,1670,0,0,92,47,45,92,0
2024-06-15,LQ,Bosnia-Herzegovina,1963,1892,0,0,71,35,36,71,0
2024-06-16,LQ,Bosnia-Herzegovina,1849,1782,0,0,67,33,34,67,0
2024-06-17,LQ,Bosnia-Herzegovina,1786,1698,1,0,88,43,44,87,1
2024-06-18,LQ,Bosnia-Herzegovina,1815,1728,1,1,87,44,42,86,0
2024-06-19,LQ,Bosnia-Herzegovina,1811,1736,0,0,75,38,37,75,0
2024-06-20,LQ,Bosnia-Herzegovina,1766,1680,0,0,86,42,44,86,0
2024-06-21,LQ,Bosnia-Herzegovina,1872,1778,1,1,94,48,45,93,0
2024-06-22,LQ,Bosnia-Herzegovina,1914,1835,1,1,79,37,41,78,0
2024-06-23,LQ,Bosnia-Herzegovina,1939,1867,0,0,72,37,35,72,0
2024-06-24,LQ,Bosnia-Herzegovina,1810,1709,0,0,101,50,51,101,0
2024-06-25,LQ,Bosnia-Herzegovina,1717,1626,1,1,91,45,45,90,0
2024-06-26,LQ,Bosnia-Herzegovina,1586,1512,0,0,74,37,37,74,0
2024-06-27,LQ,Bosnia-Herzegovina,1636,1554,1,1,82,40,41,81,0
2024-06-28,LQ,Bosnia-Herzegovina,1984,1888,1,1,96,49,46,95,0
2024-06-29,LQ,Bosnia-Herzegovina,2131,2056,0,0,75,37,38,75,0
2024-06-30,LQ,Bosnia-Herzegovina,1993,1919,1,1,74,37,36,73,0
2024-07-01,LQ,Bosnia-Herzegovina,1920,1821,3,1,99,47,49,96,2
2024-07-02,LQ,Bosnia-Herzegovina,1845,1755,0,0,90,46,44,90,0
2024-07-03,LQ,Bosnia-Herzegovina,2019,1939,0,0,80,40,40,80,0
2024-07-04,LQ,Bosnia-Herzegovina,1945,1860,0,0,85,41,44,85,0
2024-07-05,LQ,Bosnia-Herzegovina,2042,1941,1,0,101,50,50,100,1
2024-07-06,LQ,Bosnia-Herzegovina,2075,2000,1,1,75,37,37,74,0
2024-07-07,LQ,Bosnia-Herzegovina,1968,1895,1,1,73,36,36,72,0
2024-07-08,LQ,Bosnia-Herzegovina,1959,1857,2,2,102,49,51,100,0
2024-07-09,LQ,Bosnia-Herzegovina,1945,1842,2,2,103,51,50,101,0
2024-07-10,LQ,Bosnia-Herzegovina,1969,1891,2,2,78,38,38,76,0
2024-07-11,LQ,Bosnia-Herzegovina,1968,1875,3,1,93,45,45,90,2
2024-07-12,LQ,Bosnia-Herzegovina,2055,1949,2,0,106,54,50,104,2
2024-07-13,LQ,Bosnia-Herzegovina,2134,2055,0,0,79,39,40,79,0
2024-07-14,LQ,Bosnia-Herzegovina,2023,1945,0,0,78,39,39,78,0
2024-07-15,LQ,Bosnia-Herzegovina,2027,1930,0,0,97,48,49,97,0
2024-07-16,LQ,Bosnia-Herzegovina,1953,1860,0,0,93,47,46,93,0
2024-07-17,LQ,Bosnia-Herzegovina,1817,1745,0,0,72,36,36,72,0
2024-07-18,LQ,Bosnia-Herzegovina,1840,1756,0,0,84,40,44,84,0
2024-07-19,LQ,Bosnia-Herzegovina,1745,1654,1,1,91,47,43,90,0
2024-07-20,LQ,Bosnia-Herzegovina,2026,1947,0,0,79,39,40,79,0
2024-07-21,LQ,Bosnia-Herzegovina,1971,1899,0,0,72,36,36,72,0
2024-07-22,LQ,Bosnia-Herzegovina,1787,1677,1,1,110,54,55,109,0
2024-07-23,LQ,Bosnia-Herzegovina,1975,1881,0,0,94,48,46,94,0
2024-07-24,LQ,Bosnia-Herzegovina,1864,1778,0,0,86,44,42,86,0
2024-07-25,LQ,Bosnia-Herzegovina,1876,1787,1,1,89,42,46,88,0
2024-07-26,LQ,Bosnia-Herzegovina,1996,1889,1,1,107,54,52,106,0
2024-07-27,LQ,Bosnia-Herzegovina,2142,2062,1,1,80,39,40,79,0
2024-07-28,LQ,Bosnia-Herzegovina,1989,1913,0,0,76,38,38,76,0
2024-07-29,LQ,Bosnia-Herzegovina,1963,1861,2,0,102,50,50,100,2
2024-07-30,LQ,Bosnia-Herzegovina,1995,1894,2,1,101,49,50,99,1
2024-01-01,LB,Bulgaria,2007,1864,4,0,143,70,69,139,4
2024-01-02,LB,Bulgaria,2302,2034,8,1,268,123,137,260,7
2024-01-03,LB,Bulgaria,2326,2103,9,2,223,104,110,214,7
2024-01-04,LB,Bulgaria,2351,2160,8,2,191,94,89,183,6
2024-01-05,LB,Bulgaria,2387,2172,7,0,215,106,102,208,7
2024-01-06,LB,Bulgaria,2497,2280,2,0,217,107,108,215,2
2024-01-07,LB,Bulgaria,2458,2265,6,0,193,93,94,187,6
2024-01-08,LB,Bulgaria,2227,2043,8,0,184,85,91,176,8
2024-01-09,LB,Bulgaria,2162,1995,11,0,167,81,75,156,11
2024-01-10,LB,Bulgaria,2204,2042,8,0,162,74,80,154,8
2024-01-11,LB,Bulgaria,2207,2036,7,0,171,83,81,164,7
2024-01-12,LB,Bulgaria,2250,2059,7,1,191,91,93,184,6
2024-01-13,LB,Bulgaria,2279,2086,4,0,193,95,94,189,4
2024-01-14,LB,Bulgaria,2268,2086,4,0,182,86,92,178,4
2024-01-15,LB,Bulgaria,2069,1900,12,1,169,80,77,157,11
2024-01-16,LB,Bulgaria,1973,1823,8,2,150,71,71,142,6
2024-01-17,LB,Bulgaria,1986,1821,13,2,165,78,74,152,11
2024-01-18,LB,Bulgaria,2171,2016,9,0,155,70,76,146,9
2024-01-19,LB,Bulgaria,2252,2070,8,2,182,89,85,174,6
2024-01-20,LB,Bulgaria,2304,2119,2,0,185,89,94,183,2
2024-01-21,LB,Bulgaria,2283,2103,6,1,180,89,85,174,5
2024-01-22,LB,Bulgaria,2082,1912,14,4,170,77,79,156,10
2024-01-23,LB,Bulgaria,2013,1849,12,3,164,77,75,152,9
2024-01-24,LB,Bulgaria,2068,1895,11,2,173,81,81,162,9
2024-01-25,LB,Bulgaria,2147,1991,9,3,156,74,73,147,6
2024-01-26,LB,Bulgaria,2137,1943,7,0,194,95,92,187,7
2024-01-27,LB,Bulgaria,2244,2043,3,0,201,100,98,198,3
2024-01-28,LB,Bulgaria,2273,2090,5,0,183,88,90,178,5
2024-01-29,LB,Bulgaria,1993,1836,8,2,157,73,76,149,6
2024-01-30,LB,Bulgaria,2001,1843,10,0,158,74,74,148,10
2024-01-31,LB,Bulgaria,2000,1838,12,2,162,76,74,150,10
2024-02-01,LB,Bulgaria,1987,1825,9,1,162,78,75,153,8
2024-02-02,LB,Bulgaria,2225,2039,6,0,186,90,90,180,6
2024-02-03,LB,Bulgaria,2272,2079,2,0,193,99,92,191,2
2024-02-04,LB,Bulgaria,2286,2104,5,0,182,86,91,177,5
2024-02-05,LB,Bulgaria,2036,1868,8,2,168,81,79,160,6
2024-02-06,LB,Bulgaria,1965,1807,12,2,158,71,75,146,10
2024-02-07,LB,Bulgaria,2014,1854,20,4,160,70,70,140,16
2024-02-08,LB,Bulgaria,2159,1990,12,0,169,78,79,157,12
2024-02-09,LB,Bulgaria,2200,2002,15,5,198,91,92,183,10
2024-02-10,LB,Bulgaria,2296,2100,3,1,196,97,96,193,2
2024-02-11,LB,Bulgaria,2322,2140,4,0,182,90,88,178,4
2024-02-12,LB,Bulgaria,2060,1909,7,0,151,70,74,144,7
2024-02-13,LB,Bulgaria,2039,1876,12,4,163,77,74,151,8
2024-02-14,LB,Bulgaria,2067,1899,12,4,168,79,77,156,8
2024-02-15,LB,Bulgaria,2167,2000,12,2,167,78,77,155,10
2024-02-16,LB,Bulgaria,2208,2031,6,0,177,83,88,171,6
2024-02-17,LB,Bulgaria,2296,2104,4,1,192,95,93,188,3
2024-02-18,LB,Bulgaria,2348,2163,6,0,185,88,91,179,6
2024-02-19,LB,Bulgaria,2067,1900,10,2,167,80,77,157,8
2024-02-20,LB,Bulgaria,2094,1950,8,0,144,68,68,136,8
2024-02-21,LB,Bulgaria,2098,1931,13,5,167,76,78,154,8
2024-02-22,LB,Bulgaria,2218,2049,10,0,169,78,81,159,10
2024-02-23,LB,Bulgaria,2267,2087,7,0,180,87,86,173,7
2024-02-24,LB,Bulgaria,2391,2199,4,0,192,94,94,188,4
2024-02-25,LB,Bulgaria,2440,2255,5,0,185,90,90,180,5
2024-02-26,LB,Bulgaria,2070,1909,10,0,161,74,77,151,10
2024-02-27,LB,Bulgaria,2154,1975,18,4,179,82,79,161,14
2024-02-28,LB,Bulgaria,2155,1978,10,2,177,81,86,167,8
2024-02-29,LB,Bulgaria,2312,2125,14,2,187,90,83,173,12
2024-03-01,LB,Bulgaria,2337,2136,6,0,201,99,96,195,6
2024-03-02,LB,Bulgaria,2423,2218,3,0,205,103,99,202,3
2024-03-03,LB,Bulgaria,2440,2249,5,0,191,94,92,186,5
2024-03-04,LB,Bulgaria,2160,1979,7,0,181,85,89,174,7
2024-03-05,LB,Bulgaria,2149,1974,14,6,175,78,83,161,8
2024-03-06,LB,Bulgaria,2217,2035,6,0,182,91,85,176,6
2024-03-07,LB,Bulgaria,2237,2080,8,0,157,76,73,149,8
2024-03-08,LB,Bulgaria,2311,2135,6,0,176,86,84,170,6
2024-03-09,LB,Bulgaria,2393,2191,3,0,202,96,103,199,3
2024-03-10,LB,Bulgaria,2413,2217,5,0,196,94,97,191,5
2024-03-11,LB,Bulgaria,2219,2046,10,1,173,81,82,163,9
2024-03-12,LB,Bulgaria,2177,2007,10,2,170,83,77,160,8
2024-03-13,LB,Bulgaria,2185,1993,19,4,192,87,86,173,15
2024-03-14,LB,Bulgaria,2198,2028,11,0,170,76,83,159,11
2024-03-15,LB,Bulgaria,2324,2122,13,3,202,99,90,189,10
2024-03-16,LB,Bulgaria,2483,2280,5,2,203,100,98,198,3
2024-03-17,LB,Bulgaria,2488,2299,4,0,189,91,94,185,4
2024-03-18,LB,Bulgaria,2201,2035,9,1,166,78,79,157,8
2024-03-19,LB,Bulgaria,2087,1919,12,1,168,79,77,156,11
2024-03-20,LB,Bulgaria,2252,2051,15,1,201,93,93,186,14
2024-03-21,LB,Bulgaria,2275,2088,13,3,187,91,83,174,10
2024-03-22,LB,Bulgaria,2413,2209,6,0,204,99,99,198,6
2024-03-23,LB,Bulgaria,2533,2339,2,0,194,94,98,192,2
2024-03-24,LB,Bulgaria,2488,2289,4,0,199,95,100,195,4
2024-03-25,LB,Bulgaria,2277,2110,6,0,167,82,79,161,6
2024-03-26,LB,Bulgaria,2351,2168,10,0,183,83,90,173,10
2024-03-27,LB,Bulgaria,2401,2216,9,2,185,90,86,176,7
2024-03-28,LB,Bulgaria,2533,2343,6,0,190,94,90,184,6
2024-03-29,LB,Bulgaria,2540,2340,7,1,200,93,100,193,6
2024-03-30,LB,Bulgaria,2647,2439,2,0,208,105,101,206,2
2024-03-31,LB,Bulgaria,2704,2489,4,0,215,107,104,211,4
2024-04-01,LB,Bulgaria,2453,2250,15,1,203,95,93,188,14
2024-04-02,LB,Bulgaria,2520,2311,8,0,209,98,103,201,8
2024-04-03,LB,Bulgaria,2452,2258,12,0,194,92,90,182,12
2024-04-04,LB,Bulgaria,2625,2422,14,1,203,94,95,189,13
2024-04-05,LB,Bulgaria,2636,2426,8,0,210,101,101,202,8
2024-04-06,LB,Bulgaria,2742,2540,4,0,202,102,96,198,4
2024-04-07,LB,Bulgaria,2652,2440,4,0,212,98,110,208,4
2024-04-08,LB,Bulgaria,2404,2211,9,1,193,93,91,184,8
2024-04-09,LB,Bulgaria,2373,2144,15,3,229,104,110,214,12
2024-04-10,LB,Bulgaria,2400,2202,13,3,198,96,89,185,10
2024-04-11,LB,Bulgaria,2563,2341,10,0,222,107,105,212,10
2024-04-12,LB,Bulgaria,2516,2320,6,0,196,94,96,190,6
2024-04-13,LB,Bulgaria,2633,2449,5,1,184,87,92,179,4
2024-04-14,LB,Bulgaria,2295,2082,7,0,213,104,102,206,7
2024-04-15,LB,Bulgaria,2281,2092,7,1,189,94,88,182,6
2024-04-16,LB,Bulgaria,2374,2153,12,4,221,106,103,209,8
2024-04-17,LB,Bulgaria,2324,2124,9,0,200,97,94,191,9
2024-04-18,LB,Bulgaria,2507,2299,9,0,208,98,101,199,9
2024-04-19,LB,Bulgaria,2478,2280,8,0,198,94,96,190,8
2024-04-20,LB,Bulgaria,2640,2448,4,0,192,95,93,188,4
2024-04-21,LB,Bulgaria,2710,2495,6,0,215,103,106,209,6
2024-04-22,LB,Bulgaria,2431,2225,15,1,206,98,93,191,14
2024-04-23,LB,Bulgaria,2366,2177,7,1,189,90,92,182,6
2024-04-24,LB,Bulgaria,2599,2391,12,0,208,99,97,196,12
2024-04-25,LB,Bulgaria,2684,2477,8,0,207,98,101,199,8
2024-04-26,LB,Bulgaria,2838,2627,6,0,211,103,102,205,6
2024-04-27,LB,Bulgaria,3074,2862,5,1,212,108,99,207,4
2024-04-28,LB,Bulgaria,2963,2749,4,0,214,102,108,210,4
2024-04-29,LB,Bulgaria,2568,2371,12,2,197,92,93,185,10
2024-04-30,LB,Bulgaria,2709,2470,12,2,239,116,111,227,10
2024-05-01,LB,Bulgaria,2760,2561,8,0,199,98,93,191,8
2024-05-02,LB,Bulgaria,2753,2546,8,2,207,101,98,199,6
2024-05-03,LB,Bulgaria,2907,2686,6,0,221,105,110,215,6
2024-05-04,LB,Bulgaria,3077,2869,4,0,208,103,101,204,4
2024-05-05,LB,Bulgaria,3082,2871,4,0,211,102,105,207,4
2024-05-06,LB,Bulgaria,2693,2482,8,1,211,102,101,203,7
2024-05-07,LB,Bulgaria,2809,2579,7,0,230,111,112,223,7
2024-05-08,LB,Bulgaria,2888,2683,8,1,205,96,101,197,7
2024-05-09,LB,Bulgaria,2921,2698,7,1,223,108,108,216,6
2024-05-10,LB,Bulgaria,2931,2710,10,1,221,106,105,211,9
2024-05-11,LB,Bulgaria,3301,3094,7,1,207,102,98,200,6
2024-05-12,LB,Bulgaria,3134,2912,6,0,222,106,110,216,6
2024-05-13,LB,Bulgaria,2779,2556,7,1,223,109,107,216,6
2024-05-14,LB,Bulgaria,2900,2659,12,1,241,114,115,229,11
2024-05-15,LB,Bulgaria,2924,2704,22,2,220,99,99,198,20
2024-05-16,LB,Bulgaria,2927,2703,18,1,224,102,104,206,17
2024-05-17,LB,Bulgaria,3132,2893,8,0,239,116,115,231,8
2024-05-18,LB,Bulgaria,3394,3181,6,2,213,105,102,207,4
2024-05-19,LB,Bulgaria,3278,3053,5,0,225,107,113,220,5
2024-05-20,LB,Bulgaria,2857,2637,7,1,220,109,104,213,6
2024-05-21,LB,Bulgaria,2909,2665,16,3,244,115,113,228,13
2024-05-22,LB,Bulgaria,2874,2656,17,2,218,101,100,201,15
2024-05-23,LB,Bulgaria,3005,2755,6,0,250,124,120,244,6
2024-05-24,LB,Bulgaria,3048,2804,9,0,244,117,118,235,9
2024-05-25,LB,Bulgaria,3426,3198,8,0,228,111,109,220,8
2024-05-26,LB,Bulgaria,3343,3089,9,0,254,117,128,245,9
2024-05-27,LB,Bulgaria,3047,2781,11,1,266,129,126,255,10
2024-05-28,LB,Bulgaria,3048,2769,16,4,279,132,131,263,12
2024-05-29,LB,Bulgaria,3155,2915,11,0,240,117,112,229,11
2024-05-30,LB,Bulgaria,3198,2962,11,0,236,110,115,225,11
2024-05-31,LB,Bulgaria,3245,2963,9,0,282,138,135,273,9
2024-06-01,LB,Bulgaria,3653,3411,4,0,242,123,115,238,4
2024-06-02,LB,Bulgaria,3560,3314,4,0,246,120,122,242,4
2024-06-03,LB,Bulgaria,3155,2896,9,0,259,125,125,250,9
2024-06-04,LB,Bulgaria,3240,2933,11,1,307,145,151,296,10
2024-06-05,LB,Bulgaria,3240,2983,13,2,257,124,120,244,11
2024-06-06,LB,Bulgaria,3265,2995,18,1,270,126,126,252,17
2024-06-07,LB,Bulgaria,3351,3010,7,0,341,165,169,334,7
2024-06-08,LB,Bulgaria,3582,3323,5,1,259,131,123,254,4
2024-06-09,LB,Bulgaria,3500,3224,12,0,276,131,133,264,12
2024-06-10,LB,Bulgaria,3245,2968,22,1,277,129,126,255,21
2024-06-11,LB,Bulgaria,3282,2958,17,6,324,149,158,307,11
2024-06-12,LB,Bulgaria,3319,3051,19,7,268,126,123,249,12
2024-06-13,LB,Bulgaria,3304,3017,12,0,287,134,141,275,12
2024-06-14,LB,Bulgaria,3401,3039,13,2,362,175,174,349,11
2024-06-15,LB,Bulgaria,3786,3513,9,0,273,134,130,264,9
2024-06-16,LB,Bulgaria,3646,3353,6,0,293,143,144,287,6
2024-06-17,LB,Bulgaria,3314,3021,12,0,293,144,137,281,12
2024-06-18,LB,Bulgaria,3326,2953,18,1,373,175,180,355,17
2024-06-19,LB,Bulgaria,3563,3280,16,0,283,137,130,267,16
2024-06-20,LB,Bulgaria,3388,3098,11,0,290,137,142,279,11
2024-06-21,LB,Bulgaria,3505,3092,12,0,413,199,202,401,12
2024-06-22,LB,Bulgaria,3658,3389,6,0,269,134,129,263,6
2024-06-23,LB,Bulgaria,3662,3334,7,0,328,158,163,321,7
2024-06-24,LB,Bulgaria,3512,3181,12,0,331,161,158,319,12
2024-06-25,LB,Bulgaria,3504,3108,11,0,396,192,193,385,11
2024-06-26,LB,Bulgaria,3298,3003,15,2,295,140,140,280,13
2024-06-27,LB,Bulgaria,3310,2974,15,1,336,159,162,321,14
2024-06-28,LB,Bulgaria,3537,3109,10,1,428,207,211,418,9
2024-06-29,LB,Bulgaria,3743,3438,15,6,305,147,143,290,9
2024-06-30,LB,Bulgaria,3719,3390,12,3,329,159,158,317,9
2024-07-01,LB,Bulgaria,3539,3186,13,0,353,170,170,340,13
2024-07-02,LB,Bulgaria,3519,3092,15,1,427,205,207,412,14
2024-07-03,LB,Bulgaria,3651,3347,10,0,304,144,150,294,10
2024-07-04,LB,Bulgaria,3552,3215,16,1,337,164,157,321,15
2024-07-05,LB,Bulgaria,3710,3258,14,3,452,221,217,438,11
2024-07-06,LB,Bulgaria,3878,3569,12,0,309,145,152,297,12
2024-07-07,LB,Bulgaria,3855,3526,10,0,329,160,159,319,10
2024-07-08,LB,Bulgaria,3589,3238,14,0,351,172,165,337,14
2024-07-09,LB,Bulgaria,3642,3205,12,1,437,214,211,425,11
2024-07-10,LB,Bulgaria,3607,3303,17,0,304,140,147,287,17
2024-07-11,LB,Bulgaria,3645,3277,15,0,368,179,174,353,15
2024-07-12,LB,Bulgaria,3671,3244,11,1,427,204,212,416,10
2024-07-13,LB,Bulgaria,3862,3570,8,1,292,145,139,284,7
2024-07-14,LB,Bulgaria,3752,3425,13,2,327,155,159,314,11
2024-07-15,LB,Bulgaria,3619,3259,11,0,360,173,176,349,11
2024-07-16,LB,Bulgaria,3601,3178,23,2,423,200,200,400,21
2024-07-17,LB,Bulgaria,3603,3291,17,0,312,146,149,295,17
2024-07-18,LB,Bulgaria,3634,3295,16,1,339,162,161,323,15
2024-07-19,LB,Bulgaria,3496,3071,12,1,425,204,209,413,11
2024-07-20,LB,Bulgaria,3723,3424,10,1,299,149,140,289,9
2024-07-21,LB,Bulgaria,3630,3299,18,5,331,154,159,313,13
2024-07-22,LB,Bulgaria,3601,3239,15,3,362,175,172,347,12
2024-07-23,LB,Bulgaria,3639,3220,12,0,419,201,206,407,12
2024-07-24,LB,Bulgaria,3698,3391,17,0,307,141,149,290,17
2024-07-25,LB,Bulgaria,3687,3324,12,3,363,177,174,351,9
2024-07-26,LB,Bulgaria,3780,3340,11,1,440,216,213,429,10
2024-07-27,LB,Bulgaria,3879,3572,12,2,307,154,141,295,10
2024-07-28,LB,Bulgaria,3829,3504,11,0,325,155,159,314,11
2024-07-29,LB,Bulgaria,3654,3308,16,0,346,165,165,330,16
2024-07-30,LB,Bulgaria,3659,3247,14,1,412,196,202,398,13
2024-01-01,LD,Croatia,1519,1389,25,0,130,54,51,105,25
2024-01-02,LD,Croatia,1721,1566,26,1,155,66,63,129,25
2024-01-03,LD,Croatia,1643,1506,19,0,137,59,59,118,19
2024-01-04,LD,Croatia,1639,1486,23,0,153,66,64,130,23
2024-01-05,LD,Croatia,1768,1600,26,0,168,69,73,142,26
2024-01-06,LD,Croatia,1869,1727,14,0,142,66,62,128,14
2024-01-07,LD,Croatia,1871,1730,17,0,141,62,62,124,17
2024-01-08,LD,Croatia,1608,1452,24,0,156,64,68,132,24
2024-01-09,LD,Croatia,1391,1262,26,0,129,52,51,103,26
2024-01-10,LD,Croatia,1408,1292,18,1,116,49,49,98,17
2024-01-11,LD,Croatia,1413,1285,21,0,128,52,55,107,21
2024-01-12,LD,Croatia,1591,1433,25,0,158,67,66,133,25
2024-01-13,LD,Croatia,1638,1513,15,0,125,55,55,110,15
2024-01-14,LD,Croatia,1704,1572,17,1,132,58,57,115,16
2024-01-15,LD,Croatia,1481,1332,27,0,149,61,61,122,27
2024-01-16,LD,Croatia,1275,1159,23,2,116,47,46,93,21
2024-01-17,LD,Croatia,1285,1170,18,0,115,49,48,97,18
2024-01-18,LD,Croatia,1355,1232,21,0,123,50,52,102,21
2024-01-19,LD,Croatia,1511,1364,25,0,147,59,63,122,25
2024-01-20,LD,Croatia,1552,1429,14,1,123,55,54,109,13
2024-01-21,LD,Croatia,1619,1482,20,1,137,60,57,117,19
2024-01-22,LD,Croatia,1425,1263,29,1,162,66,67,133,28
2024-01-23,LD,Croatia,1257,1127,24,2,130,50,56,106,22
2024-01-24,LD,Croatia,1341,1218,18,0,123,53,52,105,18
2024-01-25,LD,Croatia,1320,1198,24,1,122,50,48,98,23
2024-01-26,LD,Croatia,1543,1387,25,0,156,65,66,131,25
2024-01-27,LD,Croatia,1511,1387,18,0,124,53,53,106,18
2024-01-28,LD,Croatia,1600,1454,22,0,146,64,60,124,22
2024-01-29,LD,Croatia,1428,1259,31,1,169,65,73,138,30
2024-01-30,LD,Croatia,1246,1110,30,1,136,52,54,106,29
2024-01-31,LD,Croatia,1409,1274,20,0,135,60,55,115,20
2024-02-01,LD,Croatia,1360,1224,21,1,136,59,56,115,20
2024-02-02,LD,Croatia,1562,1405,31,3,157,62,64,126,28
2024-02-03,LD,Croatia,1560,1443,13,0,117,54,50,104,13
2024-02-04,LD,Croatia,1607,1474,17,0,133,57,59,116,17
2024-02-05,LD,Croatia,1492,1335,26,0,157,63,68,131,26
2024-02-06,LD,Croatia,1285,1159,23,1,126,53,50,103,22
2024-02-07,LD,Croatia,1304,1189,21,1,115,48,46,94,20
2024-02-08,LD,Croatia,1418,1289,20,0,129,55,54,109,20
2024-02-09,LD,Croatia,1593,1429,28,0,164,69,67,136,28
2024-02-10,LD,Croatia,1813,1690,15,0,123,55,53,108,15
2024-02-11,LD,Croatia,1670,1533,17,0,137,59,61,120,17
2024-02-12,LD,Croatia,1465,1326,24,0,139,57,58,115,24
2024-02-13,LD,Croatia,1323,1205,24,2,118,46,48,94,22
2024-02-14,LD,Croatia,1435,1303,18,3,132,56,58,114,15
2024-02-15,LD,Croatia,1503,1368,22,0,135,58,55,113,22
2024-02-16,LD,Croatia,1607,1442,24,0,165,71,70,141,24
2024-02-17,LD,Croatia,1636,1506,16,0,130,57,57,114,16
2024-02-18,LD,Croatia,1719,1581,16,0,138,64,58,122,16
2024-02-19,LD,Croatia,1520,1360,28,1,160,63,69,132,27
2024-02-20,LD,Croatia,1338,1218,22,0,120,51,47,98,22
2024-02-21,LD,Croatia,1447,1317,18,0,130,53,59,112,18
2024-02-22,LD,Croatia,1410,1283,20,0,127,57,50,107,20
2024-02-23,LD,Croatia,1591,1432,26,1,159,68,65,133,25
2024-02-24,LD,Croatia,1599,1455,14,0,144,63,67,130,14
2024-02-25,LD,Croatia,1690,1543,17,0,147,65,65,130,17
2024-02-26,LD,Croatia,1444,1281,26,0,163,65,72,137,26
2024-02-27,LD,Croatia,1387,1254,28,0,133,55,50,105,28
2024-02-28,LD,Croatia,1416,1277,18,0,139,58,63,121,18
2024-02-29,LD,Croatia,1508,1372,24,1,136,57,55,112,23
2024-03-01,LD,Croatia,1615,1445,26,0,170,73,71,144,26
2024-03-02,LD,Croatia,1692,1548,14,0,144,62,68,130,14
2024-03-03,LD,Croatia,1705,1551,17,0,154,69,68,137,17
2024-03-04,LD,Croatia,1555,1380,28,1,175,73,74,147,27
2024-03-05,LD,Croatia,1380,1242,22,0,138,61,55,116,22
2024-03-06,LD,Croatia,1455,1320,17,0,135,57,61,118,17
2024-03-07,LD,Croatia,1415,1287,24,1,128,53,51,104,23
2024-03-08,LD,Croatia,1603,1439,33,0,164,64,67,131,33
2024-03-09,LD,Croatia,1678,1543,13,0,135,62,60,122,13
2024-03-10,LD,Croatia,1740,1592,18,0,148,64,66,130,18
2024-03-11,LD,Croatia,1557,1385,24,0,172,72,76,148,24
2024-03-12,LD,Croatia,1345,1209,22,0,136,61,53,114,22
2024-03-13,LD,Croatia,1477,1337,17,1,140,60,63,123,16
2024-03-14,LD,Croatia,1510,1354,22,0,156,67,67,134,22
2024-03-15,LD,Croatia,1715,1535,25,0,180,77,78,155,25
2024-03-16,LD,Croatia,1689,1547,15,0,142,62,65,127,15
2024-03-17,LD,Croatia,1805,1643,18,0,162,74,70,144,18
2024-03-18,LD,Croatia,1566,1392,26,0,174,76,72,148,26
2024-03-19,LD,Croatia,1544,1397,26,1,147,61,60,121,25
2024-03-20,LD,Croatia,1556,1407,18,0,149,64,67,131,18
2024-03-21,LD,Croatia,1523,1360,24,2,163,73,66,139,22
2024-03-22,LD,Croatia,1823,1638,26,0,185,79,80,159,26
2024-03-23,LD,Croatia,1845,1684,13,0,161,73,75,148,13
2024-03-24,LD,Croatia,1868,1719,15,0,149,67,67,134,15
2024-03-25,LD,Croatia,1713,1539,26,0,174,72,76,148,26
2024-03-26,LD,Croatia,1617,1467,22,0,150,67,61,128,22
2024-03-27,LD,Croatia,1676,1514,19,0,162,70,73,143,19
2024-03-28,LD,Croatia,1744,1560,24,0,184,78,82,160,24
2024-03-29,LD,Croatia,1915,1712,30,0,203,82,91,173,30
2024-03-30,LD,Croatia,1866,1702,15,0,164,72,77,149,15
2024-03-31,LD,Croatia,2255,2006,27,0,249,111,111,222,27
2024-04-01,LD,Croatia,2114,1858,30,0,256,112,114,226,30
2024-04-02,LD,Croatia,2025,1745,29,0,280,126,125,251,29
2024-04-03,LD,Croatia,2049,1767,20,0,282,130,132,262,20
2024-04-04,LD,Croatia,2118,1825,31,3,293,131,131,262,28
2024-04-05,LD,Croatia,2311,2012,34,1,299,131,134,265,33
2024-04-06,LD,Croatia,2508,2211,23,0,297,139,135,274,23
2024-04-07,LD,Croatia,2490,2183,33,1,307,138,136,274,32
2024-04-08,LD,Croatia,2202,1910,31,0,292,125,136,261,31
2024-04-09,LD,Croatia,2114,1843,28,1,271,122,121,243,27
2024-04-10,LD,Croatia,2156,1881,22,1,275,129,124,253,21
2024-04-11,LD,Croatia,2155,1853,28,0,302,136,138,274,28
2024-04-12,LD,Croatia,2347,2053,36,0,294,127,131,258,36
2024-04-13,LD,Croatia,2612,2299,24,0,313,143,146,289,24
2024-04-14,LD,Croatia,2556,2245,29,0,311,145,137,282,29
2024-04-15,LD,Croatia,2294,2004,29,0,290,131,130,261,29
2024-04-16,LD,Croatia,2158,1867,28,2,291,132,131,263,26
2024-04-17,LD,Croatia,2167,1881,18,1,286,134,134,268,17
2024-04-18,LD,Croatia,2288,1981,26,4,307,139,142,281,22
2024-04-19,LD,Croatia,2523,2216,32,2,307,140,135,275,30
2024-04-20,LD,Croatia,2671,2341,25,2,330,152,153,305,23
2024-04-21,LD,Croatia,2600,2254,40,2,346,156,150,306,38
2024-04-22,LD,Croatia,2345,2032,29,0,313,141,143,284,29
2024-04-23,LD,Croatia,2286,1976,30,1,310,140,140,280,29
2024-04-24,LD,Croatia,2322,2030,21,2,292,133,138,271,19
2024-04-25,LD,Croatia,2336,2024,31,0,312,139,142,281,31
2024-04-26,LD,Croatia,2533,2198,35,0,335,148,152,300,35
2024-04-27,LD,Croatia,2769,2395,25,0,374,178,171,349,25
2024-04-28,LD,Croatia,2595,2235,36,0,360,160,164,324,36
2024-04-29,LD,Croatia,2449,2127,34,0,322,141,147,288,34
2024-04-30,LD,Croatia,2458,2134,34,1,324,147,143,290,33
2024-05-01,LD,Croatia,2542,2207,19,1,335,160,156,316,18
2024-05-02,LD,Croatia,2508,2156,27,0,352,159,166,325,27
2024-05-03,LD,Croatia,2766,2423,36,1,343,152,155,307,35
2024-05-04,LD,Croatia,2998,2545,24,0,453,215,214,429,24
2024-05-05,LD,Croatia,2963,2543,39,0,420,194,187,381,39
2024-05-06,LD,Croatia,2690,2345,33,0,345,154,158,312,33
2024-05-07,LD,Croatia,2677,2297,34,1,380,173,173,346,33
2024-05-08,LD,Croatia,2715,2332,17,0,383,179,187,366,17
2024-05-09,LD,Croatia,2753,2342,27,0,411,192,192,384,27
2024-05-10,LD,Croatia,2807,2424,38,0,383,169,176,345,38
2024-05-11,LD,Croatia,3101,2603,31,0,498,236,231,467,31
2024-05-12,LD,Croatia,3108,2632,33,0,476,234,209,443,33
2024-05-13,LD,Croatia,2709,2352,32,1,357,163,162,325,31
2024-05-14,LD,Croatia,2639,2245,30,0,394,183,181,364,30
2024-05-15,LD,Croatia,2575,2235,22,1,340,157,161,318,21
2024-05-16,LD,Croatia,2709,2283,30,0,426,194,202,396,30
2024-05-17,LD,Croatia,2977,2566,36,1,411,183,192,375,35
2024-05-18,LD,Croatia,3224,2720,25,0,504,239,240,479,25
2024-05-19,LD,Croatia,3110,2638,36,0,472,218,218,436,36
2024-05-20,LD,Croatia,2893,2485,31,1,408,195,182,377,30
2024-05-21,LD,Croatia,2638,2224,30,0,414,194,190,384,30
2024-05-22,LD,Croatia,2766,2368,21,1,398,192,185,377,20
2024-05-23,LD,Croatia,2955,2512,31,0,443,202,210,412,31
2024-05-24,LD,Croatia,3068,2632,39,0,436,196,201,397,39
2024-05-25,LD,Croatia,3266,2721,28,0,545,262,255,517,28
2024-05-26,LD,Croatia,3157,2658,34,0,499,236,229,465,34
2024-05-27,LD,Croatia,2956,2570,30,0,386,179,177,356,30
2024-05-28,LD,Croatia,2775,2336,30,1,439,207,202,409,29
2024-05-29,LD,Croatia,2854,2453,22,1,401,186,193,379,21
2024-05-30,LD,Croatia,2947,2511,27,2,436,201,208,409,25
2024-05-31,LD,Croatia,2997,2604,26,0,393,181,186,367,26
2024-06-01,LD,Croatia,3474,2884,26,1,590,283,281,564,25
2024-06-02,LD,Croatia,3332,2789,40,1,543,262,241,503,39
2024-06-03,LD,Croatia,2707,2298,30,0,409,189,190,379,30
2024-06-04,LD,Croatia,3013,2555,36,0,458,208,214,422,36
2024-06-05,LD,Croatia,2983,2502,26,3,481,227,228,455,23
2024-06-06,LD,Croatia,2999,2524,34,2,475,219,222,441,32
2024-06-07,LD,Croatia,3142,2678,42,1,464,207,215,422,41
2024-06-08,LD,Croatia,3329,2708,30,0,621,294,297,591,30
2024-06-09,LD,Croatia,3430,2867,39,0,563,268,256,524,39
2024-06-10,LD,Croatia,3124,2669,39,0,455,204,212,416,39
2024-06-11,LD,Croatia,2956,2447,36,0,509,242,231,473,36
2024-06-12,LD,Croatia,2856,2394,23,1,462,223,216,439,22
2024-06-13,LD,Croatia,2931,2439,35,0,492,217,240,457,35
2024-06-14,LD,Croatia,3145,2643,44,0,502,221,237,458,44
2024-06-15,LD,Croatia,3606,2951,27,0,655,310,318,628,27
2024-06-16,LD,Croatia,3442,2860,35,0,582,287,260,547,35
2024-06-17,LD,Croatia,3045,2563,45,2,482,219,218,437,43
2024-06-18,LD,Croatia,3101,2604,36,0,497,232,229,461,36
2024-06-19,LD,Croatia,3098,2593,26,0,505,237,242,479,26
2024-06-20,LD,Croatia,3154,2638,42,0,516,236,238,474,42
2024-06-21,LD,Croatia,3322,2799,37,0,523,232,254,486,37
2024-06-22,LD,Croatia,3825,3176,34,1,649,308,307,615,33
2024-06-23,LD,Croatia,3724,3131,40,0,593,289,264,553,40
2024-06-24,LD,Croatia,3324,2796,34,0,528,249,245,494,34
2024-06-25,LD,Croatia,3190,2636,39,1,554,255,260,515,38
2024-06-26,LD,Croatia,3078,2545,20,0,533,256,257,513,20
2024-06-27,LD,Croatia,3280,2717,40,0,563,265,258,523,40
2024-06-28,LD,Croatia,3603,3036,35,0,567,263,269,532,35
2024-06-29,LD,Croatia,3813,3106,29,0,707,338,340,678,29
2024-06-30,LD,Croatia,3822,3193,37,0,629,306,286,592,37
2024-07-01,LD,Croatia,3217,2640,37,1,577,269,271,540,36
2024-07-02,LD,Croatia,3405,2857,33,0,548,260,255,515,33
2024-07-03,LD,Croatia,3615,3040,21,0,575,276,278,554,21
2024-07-04,LD,Croatia,3529,2936,38,0,593,275,280,555,38
2024-07-05,LD,Croatia,3675,3065,39,0,610,281,290,571,39
2024-07-06,LD,Croatia,3896,3163,26,0,733,356,351,707,26
2024-07-07,LD,Croatia,3808,3166,34,0,642,308,300,608,34
2024-07-08,LD,Croatia,3553,2963,37,2,590,269,284,553,35
2024-07-09,LD,Croatia,3527,2939,31,0,588,283,274,557,31
2024-07-10,LD,Croatia,3577,3006,18,0,571,275,278,553,18
2024-07-11,LD,Croatia,3536,2952,35,1,584,266,283,549,34
2024-07-12,LD,Croatia,3601,3015,39,0,586,269,278,547,39
2024-07-13,LD,Croatia,3868,3129,27,0,739,360,352,712,27
2024-07-14,LD,Croatia,3956,3293,34,0,663,328,301,629,34
2024-07-15,LD,Croatia,3586,2996,36,0,590,277,277,554,36
2024-07-16,LD,Croatia,3552,2963,32,0,589,281,276,557,32
2024-07-17,LD,Croatia,3375,2789,23,0,586,281,282,563,23
2024-07-18,LD,Croatia,3499,2897,36,0,602,281,285,566,36
2024-07-19,LD,Croatia,3256,2666,36,0,590,274,280,554,36
2024-07-20,LD,Croatia,3703,2989,35,0,714,341,338,679,35
2024-07-21,LD,Croatia,3893,3256,41,0,637,300,296,596,41
2024-07-22,LD,Croatia,3401,2811,36,2,590,281,273,554,34
2024-07-23,LD,Croatia,3603,2992,42,0,611,288,281,569,42
2024-07-24,LD,Croatia,3521,2952,19,1,569,270,280,550,18
2024-07-25,LD,Croatia,3499,2890,36,0,609,285,288,573,36
2024-07-26,LD,Croatia,3599,2960,36,0,639,295,308,603,36
2024-07-27,LD,Croatia,4029,3264,28,0,765,369,368,737,28
2024-07-28,LD,Croatia,3881,3202,38,2,679,332,309,641,36
2024-07-29,LD,Croatia,3621,3006,37,1,615,291,287,578,36
2024-07-30,LD,Croatia,3526,2917,32,0,609,293,284,577,32
2024-01-01,LC,Cyprus,705,543,5,5,162,80,77,157,0
2024-01-02,LC,Cyprus,738,578,7,7,160,76,77,153,0
2024-01-03,LC,Cyprus,718,533,8,8,185,85,92,177,0
2024-01-04,LC,Cyprus,824,642,3,3,182,91,88,179,0
2024-01-05,LC,Cyprus,780,592,6,6,188,92,90,182,0
2024-01-06,LC,Cyprus,790,603,1,1,187,89,97,186,0
2024-01-07,LC,Cyprus,866,673,5,5,193,90,98,188,0
2024-01-08,LC,Cyprus,749,561,6,6,188,93,89,182,0
2024-01-09,LC,Cyprus,694,560,6,6,134,62,66,128,0
2024-01-10,LC,Cyprus,702,534,7,7,168,80,81,161,0
2024-01-11,LC,Cyprus,815,650,7,7,165,78,80,158,0
2024-01-12,LC,Cyprus,679,495,4,3,184,94,86,180,1
2024-01-13,LC,Cyprus,667,512,2,2,155,75,78,153,0
2024-01-14,LC,Cyprus,741,554,7,7,187,91,89,180,0
2024-01-15,LC,Cyprus,686,506,10,10,180,86,84,170,0
2024-01-16,LC,Cyprus,612,495,9,9,117,55,53,108,0
2024-01-17,LC,Cyprus,700,537,8,8,163,76,79,155,0
2024-01-18,LC,Cyprus,737,585,9,9,152,71,72,143,0
2024-01-19,LC,Cyprus,748,566,7,7,182,90,85,175,0
2024-01-20,LC,Cyprus,721,575,2,2,146,68,76,144,0
2024-01-21,LC,Cyprus,818,622,8,8,196,92,96,188,0
2024-01-22,LC,Cyprus,712,536,5,5,176,89,82,171,0
2024-01-23,LC,Cyprus,623,513,4,4,110,51,55,106,0
2024-01-24,LC,Cyprus,694,532,7,7,162,81,74,155,0
2024-01-25,LC,Cyprus,782,635,6,6,147,71,70,141,0
2024-01-26,LC,Cyprus,687,520,4,4,167,84,79,163,0
2024-01-27,LC,Cyprus,722,587,0,0,135,66,69,135,0
2024-01-28,LC,Cyprus,788,620,4,4,168,82,82,164,0
2024-01-29,LC,Cyprus,700,539,4,4,161,78,79,157,0
2024-01-30,LC,Cyprus,691,570,6,5,121,58,57,115,1
2024-01-31,LC,Cyprus,736,590,4,2,146,71,71,142,2
2024-02-01,LC,Cyprus,809,662,6,6,147,69,72,141,0
2024-02-02,LC,Cyprus,763,580,5,5,183,90,88,178,0
2024-02-03,LC,Cyprus,708,560,5,4,148,69,74,143,1
2024-02-04,LC,Cyprus,798,616,2,1,182,94,86,180,1
2024-02-05,LC,Cyprus,719,527,3,3,192,95,94,189,0
2024-02-06,LC,Cyprus,618,493,6,5,125,60,59,119,1
2024-02-07,LC,Cyprus,659,498,4,4,161,79,78,157,0
2024-02-08,LC,Cyprus,777,610,6,4,167,78,83,161,2
2024-02-09,LC,Cyprus,693,513,6,6,180,90,84,174,0
2024-02-10,LC,Cyprus,680,522,4,4,158,77,77,154,0
2024-02-11,LC,Cyprus,756,584,5,5,172,86,81,167,0
2024-02-12,LC,Cyprus,645,477,3,3,168,80,85,165,0
2024-02-13,LC,Cyprus,666,547,7,5,119,58,54,112,2
2024-02-14,LC,Cyprus,704,562,2,2,142,70,70,140,0
2024-02-15,LC,Cyprus,809,652,3,3,157,77,77,154,0
2024-02-16,LC,Cyprus,744,560,5,5,184,90,89,179,0
2024-02-17,LC,Cyprus,784,615,1,1,169,83,85,168,0
2024-02-18,LC,Cyprus,875,699,4,4,176,84,88,172,0
2024-02-19,LC,Cyprus,742,538,9,8,204,99,96,195,1
2024-02-20,LC,Cyprus,696,566,9,9,130,61,60,121,0
2024-02-21,LC,Cyprus,742,580,7,7,162,76,79,155,0
2024-02-22,LC,Cyprus,797,635,5,5,162,75,82,157,0
2024-02-23,LC,Cyprus,757,563,4,4,194,98,92,190,0
2024-02-24,LC,Cyprus,737,566,4,4,171,84,83,167,0
2024-02-25,LC,Cyprus,854,680,2,2,174,85,87,172,0
2024-02-26,LC,Cyprus,787,604,9,9,183,88,86,174,0
2024-02-27,LC,Cyprus,736,617,8,7,119,57,54,111,1
2024-02-28,LC,Cyprus,719,555,8,8,164,79,77,156,0
2024-02-29,LC,Cyprus,838,668,11,11,170,83,76,159,0
2024-03-01,LC,Cyprus,802,610,6,6,192,90,96,186,0
2024-03-02,LC,Cyprus,861,685,2,2,176,88,86,174,0
2024-03-03,LC,Cyprus,942,756,6,6,186,88,92,180,0
2024-03-04,LC,Cyprus,789,593,9,9,196,91,96,187,0
2024-03-05,LC,Cyprus,756,606,10,8,150,70,70,140,2
2024-03-06,LC,Cyprus,843,641,8,8,202,101,93,194,0
2024-03-07,LC,Cyprus,879,708,10,9,171,78,83,161,1
2024-03-08,LC,Cyprus,819,630,7,6,189,93,89,182,1
2024-03-09,LC,Cyprus,790,611,2,2,179,88,89,177,0
2024-03-10,LC,Cyprus,972,766,7,7,206,101,98,199,0
2024-03-11,LC,Cyprus,762,562,8,7,200,95,97,192,1
2024-03-12,LC,Cyprus,671,523,8,8,148,70,70,140,0
2024-03-13,LC,Cyprus,761,558,12,10,203,95,96,191,2
2024-03-14,LC,Cyprus,849,678,8,8,171,80,83,163,0
2024-03-15,LC,Cyprus,815,621,8,8,194,95,91,186,0
2024-03-16,LC,Cyprus,791,601,3,3,190,95,92,187,0
2024-03-17,LC,Cyprus,893,703,6,6,190,90,94,184,0
2024-03-18,LC,Cyprus,783,598,4,4,185,91,90,181,0
2024-03-19,LC,Cyprus,843,709,9,9,134,66,59,125,0
2024-03-20,LC,Cyprus,835,630,6,6,205,100,99,199,0
2024-03-21,LC,Cyprus,837,680,7,7,157,74,76,150,0
2024-03-22,LC,Cyprus,850,627,10,9,223,108,105,213,1
2024-03-23,LC,Cyprus,822,638,1,1,184,94,89,183,0
2024-03-24,LC,Cyprus,950,762,6,6,188,92,90,182,0
2024-03-25,LC,Cyprus,864,635,9,9,229,108,112,220,0
2024-03-26,LC,Cyprus,778,613,8,7,165,77,80,157,1
2024-03-27,LC,Cyprus,848,636,6,6,212,104,102,206,0
2024-03-28,LC,Cyprus,904,719,9,9,185,83,93,176,0
2024-03-29,LC,Cyprus,859,629,8,8,230,108,114,222,0
2024-03-30,LC,Cyprus,871,663,1,1,208,109,98,207,0
2024-03-31,LC,Cyprus,965,721,5,5,244,119,120,239,0
2024-04-01,LC,Cyprus,931,696,8,8,235,115,112,227,0
2024-04-02,LC,Cyprus,915,692,9,9,223,108,106,214,0
2024-04-03,LC,Cyprus,942,672,8,8,270,130,132,262,0
2024-04-04,LC,Cyprus,951,721,7,7,230,111,112,223,0
2024-04-05,LC,Cyprus,879,636,9,9,243,115,119,234,0
2024-04-06,LC,Cyprus,979,714,1,0,265,135,129,264,1
2024-04-07,LC,Cyprus,1121,868,4,4,253,126,123,249,0
2024-04-08,LC,Cyprus,959,706,5,4,253,128,120,248,1
2024-04-09,LC,Cyprus,994,765,6,6,229,107,116,223,0
2024-04-10,LC,Cyprus,1103,819,5,5,284,138,141,279,0
2024-04-11,LC,Cyprus,1064,826,5,4,238,119,114,233,1
2024-04-12,LC,Cyprus,990,742,3,3,248,126,119,245,0
2024-04-13,LC,Cyprus,1012,749,7,7,263,122,134,256,0
2024-04-14,LC,Cyprus,1314,1030,9,9,284,141,134,275,0
2024-04-15,LC,Cyprus,1159,879,11,11,280,138,131,269,0
2024-04-16,LC,Cyprus,1100,843,11,11,257,124,122,246,0
2024-04-17,LC,Cyprus,1056,764,7,7,292,140,145,285,0
2024-04-18,LC,Cyprus,1165,893,9,8,272,135,128,263,1
2024-04-19,LC,Cyprus,1222,955,8,8,267,125,134,259,0
2024-04-20,LC,Cyprus,1314,1034,6,6,280,137,137,274,0
2024-04-21,LC,Cyprus,1309,1019,6,5,290,142,142,284,1
2024-04-22,LC,Cyprus,1014,740,9,9,274,133,132,265,0
2024-04-23,LC,Cyprus,1021,775,4,4,246,116,126,242,0
2024-04-24,LC,Cyprus,1104,801,8,8,303,151,144,295,0
2024-04-25,LC,Cyprus,1114,838,10,8,276,136,130,266,2
2024-04-26,LC,Cyprus,1037,741,8,8,296,144,144,288,0
2024-04-27,LC,Cyprus,1082,776,3,3,306,153,150,303,0
2024-04-28,LC,Cyprus,1077,789,7,6,288,139,142,281,1
2024-04-29,LC,Cyprus,972,681,7,7,291,142,142,284,0
2024-04-30,LC,Cyprus,1191,924,5,5,267,135,127,262,0
2024-05-01,LC,Cyprus,1185,862,9,9,323,158,156,314,0
2024-05-02,LC,Cyprus,1164,899,11,8,265,123,131,254,3
2024-05-03,LC,Cyprus,1074,807,8,8,267,131,128,259,0
2024-05-04,LC,Cyprus,1101,804,0,0,297,152,145,297,0
2024-05-05,LC,Cyprus,1142,849,8,7,293,141,144,285,1
2024-05-06,LC,Cyprus,1037,761,9,9,276,133,134,267,0
2024-05-07,LC,Cyprus,1008,759,9,9,249,121,119,240,0
2024-05-08,LC,Cyprus,1043,732,6,6,311,153,152,305,0
2024-05-09,LC,Cyprus,1086,818,10,9,268,128,130,258,1
2024-05-10,LC,Cyprus,980,717,6,4,263,127,130,257,2
2024-05-11,LC,Cyprus,1010,718,4,4,292,147,141,288,0
2024-05-12,LC,Cyprus,1134,831,4,3,303,149,150,299,1
2024-05-13,LC,Cyprus,1015,727,7,6,288,141,140,281,1
2024-05-14,LC,Cyprus,1011,761,9,9,250,122,119,241,0
2024-05-15,LC,Cyprus,1045,728,11,8,317,151,155,306,3
2024-05-16,LC,Cyprus,1050,801,8,7,249,117,124,241,1
2024-05-17,LC,Cyprus,936,661,8,7,275,132,135,267,1
2024-05-18,LC,Cyprus,968,677,2,2,291,146,143,289,0
2024-05-19,LC,Cyprus,1084,778,8,7,306,147,151,298,1
2024-05-20,LC,Cyprus,981,692,7,7,289,139,143,282,0
2024-05-21,LC,Cyprus,995,749,5,5,246,124,117,241,0
2024-05-22,LC,Cyprus,1041,730,7,7,311,153,151,304,0
2024-05-23,LC,Cyprus,1147,866,9,8,281,134,138,272,1
2024-05-24,LC,Cyprus,1000,732,7,7,268,128,133,261,0
2024-05-25,LC,Cyprus,1001,718,2,1,283,142,139,281,1
2024-05-26,LC,Cyprus,1106,784,7,6,322,155,160,315,1
2024-05-27,LC,Cyprus,956,669,9,7,287,142,136,278,2
2024-05-28,LC,Cyprus,975,700,9,7,275,135,131,266,2
2024-05-29,LC,Cyprus,1030,715,3,3,315,154,158,312,0
2024-05-30,LC,Cyprus,1058,774,9,5,284,138,137,275,4
2024-05-31,LC,Cyprus,968,676,7,7,292,144,141,285,0
2024-06-01,LC,Cyprus,979,678,3,3,301,153,145,298,0
2024-06-02,LC,Cyprus,1112,787,7,6,325,156,162,318,1
2024-06-03,LC,Cyprus,1048,732,9,7,316,153,154,307,2
2024-06-04,LC,Cyprus,1041,764,11,11,277,132,134,266,0
2024-06-05,LC,Cyprus,1076,753,7,7,323,157,159,316,0
2024-06-06,LC,Cyprus,1113,809,9,8,304,147,148,295,1
2024-06-07,LC,Cyprus,986,706,4,4,280,139,137,276,0
2024-06-08,LC,Cyprus,1045,739,1,1,306,151,154,305,0
2024-06-09,LC,Cyprus,1162,836,7,6,326,161,158,319,1
2024-06-10,LC,Cyprus,1147,838,8,8,309,148,153,301,0
2024-06-11,LC,Cyprus,1041,759,13,9,282,132,137,269,4
2024-06-12,LC,Cyprus,990,655,9,9,335,168,158,326,0
2024-06-13,LC,Cyprus,1174,882,9,8,292,142,141,283,1
2024-06-14,LC,Cyprus,1122,824,8,8,298,143,147,290,0
2024-06-15,LC,Cyprus,1097,778,1,0,319,162,156,318,1
2024-06-16,LC,Cyprus,1196,854,8,7,342,167,167,334,1
2024-06-17,LC,Cyprus,1091,759,9,9,332,158,165,323,0
2024-06-18,LC,Cyprus,1092,784,8,8,308,148,152,300,0
2024-06-19,LC,Cyprus,1188,836,9,8,352,172,171,343,1
2024-06-20,LC,Cyprus,1260,936,10,9,324,158,156,314,1
2024-06-21,LC,Cyprus,1089,784,7,7,305,147,151,298,0
2024-06-22,LC,Cyprus,1102,783,1,1,319,159,159,318,0
2024-06-23,LC,Cyprus,1293,939,7,6,354,170,177,347,1
2024-06-24,LC,Cyprus,1222,878,8,7,344,172,164,336,1
2024-06-25,LC,Cyprus,1188,898,8,8,290,141,141,282,0
2024-06-26,LC,Cyprus,1240,882,8,7,358,177,173,350,1
2024-06-27,LC,Cyprus,1300,991,10,9,309,149,150,299,1
2024-06-28,LC,Cyprus,1170,848,11,10,322,154,157,311,1
2024-06-29,LC,Cyprus,1158,820,1,1,338,172,165,337,0
2024-06-30,LC,Cyprus,1346,986,7,6,360,175,178,353,1
2024-07-01,LC,Cyprus,1230,898,6,6,332,167,159,326,0
2024-07-02,LC,Cyprus,1269,972,8,8,297,146,143,289,0
2024-07-03,LC,Cyprus,1321,966,9,9,355,172,174,346,0
2024-07-04,LC,Cyprus,1330,1009,6,5,321,154,161,315,1
2024-07-05,LC,Cyprus,1110,796,4,4,314,158,152,310,0
2024-07-06,LC,Cyprus,1128,801,2,2,327,165,160,325,0
2024-07-07,LC,Cyprus,1260,915,5,4,345,170,170,340,1
2024-07-08,LC,Cyprus,1177,859,10,9,318,152,156,308,1
2024-07-09,LC,Cyprus,1218,928,6,4,290,142,142,284,2
2024-07-10,LC,Cyprus,1243,905,8,8,338,168,162,330,0
2024-07-11,LC,Cyprus,1311,990,9,8,321,151,161,312,1
2024-07-12,LC,Cyprus,1148,830,7,7,318,154,157,311,0
2024-07-13,LC,Cyprus,1143,796,0,0,347,174,173,347,0
2024-07-14,LC,Cyprus,1295,940,9,8,355,175,171,346,1
2024-07-15,LC,Cyprus,1199,853,5,5,346,174,167,341,0
2024-07-16,LC,Cyprus,1226,932,8,8,294,141,145,286,0
2024-07-17,LC,Cyprus,1238,861,8,8,377,184,185,369,0
2024-07-18,LC,Cyprus,1305,982,3,2,323,158,162,320,1
2024-07-19,LC,Cyprus,1153,828,5,5,325,160,160,320,0
2024-07-20,LC,Cyprus,1154,821,1,1,333,169,163,332,0
2024-07-21,LC,Cyprus,1307,943,10,6,364,174,180,354,4
2024-07-22,LC,Cyprus,1233,895,7,7,338,164,167,331,0
2024-07-23,LC,Cyprus,1217,909,6,6,308,151,151,302,0
2024-07-24,LC,Cyprus,1270,892,6,6,378,186,186,372,0
2024-07-25,LC,Cyprus,1327,993,7,6,334,163,164,327,1
2024-07-26,LC,Cyprus,1134,802,7,7,332,163,162,325,0
2024-07-27,LC,Cyprus,1117,771,4,2,346,173,169,342,2
2024-07-28,LC,Cyprus,1309,940,7,6,369,184,178,362,1
2024-07-29,LC,Cyprus,1185,835,6,6,350,170,174,344,0
2024-07-30,LC,Cyprus,1192,882,6,6,310,154,150,304,0
2024-01-01,LK,Czech Republic,1530,1248,0,0,282,137,145,282,0
2024-01-02,LK,Czech Republic,1629,1322,2,0,307,156,149,305,2
2024-01-03,LK,Czech Republic,1754,1423,7,3,331,160,164,324,4
2024-01-04,LK,Czech Republic,1778,1452,4,0,326,159,163,322,4
2024-01-05,LK,Czech Republic,1919,1547,18,3,372,180,174,354,15
2024-01-06,LK,Czech Republic,1742,1501,6,0,241,110,125,235,6
2024-01-07,LK,Czech Republic,1820,1491,5,2,329,160,164,324,3
2024-01-08,LK,Czech Republic,1811,1484,13,3,327,155,159,314,10
2024-01-09,LK,Czech Republic,1448,1213,12,9,235,111,112,223,3
2024-01-10,LK,Czech Republic,1618,1337,19,7,281,131,131,262,12
2024-01-11,LK,Czech Republic,1586,1273,17,6,313,153,143,296,11
2024-01-12,LK,Czech Republic,1727,1398,14,4,329,159,156,315,10
2024-01-13,LK,Czech Republic,1494,1286,3,1,208,104,101,205,2
2024-01-14,LK,Czech Republic,1636,1338,10,3,298,137,151,288,7
2024-01-15,LK,Czech Republic,1659,1354,7,2,305,147,151,298,5
2024-01-16,LK,Czech Republic,1355,1123,11,5,232,114,107,221,6
2024-01-17,LK,Czech Republic,1339,1102,7,4,237,115,115,230,3
2024-01-18,LK,Czech Republic,1492,1230,3,0,262,129,130,259,3
2024-01-19,LK,Czech Republic,1724,1394,17,8,330,156,157,313,9
2024-01-20,LK,Czech Republic,1563,1353,12,6,210,104,94,198,6
2024-01-21,LK,Czech Republic,1579,1277,11,8,302,141,150,291,3
2024-01-22,LK,Czech Republic,1639,1318,9,4,321,152,160,312,5
2024-01-23,LK,Czech Republic,1343,1119,5,2,224,111,108,219,3
2024-01-24,LK,Czech Republic,1428,1168,5,1,260,129,126,255,4
2024-01-25,LK,Czech Republic,1502,1215,4,2,287,144,139,283,2
2024-01-26,LK,Czech Republic,1692,1358,11,4,334,160,163,323,7
2024-01-27,LK,Czech Republic,1533,1313,8,5,220,105,107,212,3
2024-01-28,LK,Czech Republic,1605,1292,16,9,313,141,156,297,7
2024-01-29,LK,Czech Republic,1542,1243,7,3,299,146,146,292,4
2024-01-30,LK,Czech Republic,1401,1128,14,7,273,129,130,259,7
2024-01-31,LK,Czech Republic,1445,1184,9,2,261,124,128,252,7
2024-02-01,LK,Czech Republic,1411,1108,10,2,303,154,139,293,8
2024-02-02,LK,Czech Republic,1723,1379,12,4,344,171,161,332,8
2024-02-03,LK,Czech Republic,1558,1317,8,1,241,115,118,233,7
2024-02-04,LK,Czech Republic,1605,1306,1,0,299,144,154,298,1
2024-02-05,LK,Czech Republic,1618,1299,13,4,319,154,152,306,9
2024-02-06,LK,Czech Republic,1384,1127,8,3,257,124,125,249,5
2024-02-07,LK,Czech Republic,1404,1160,5,2,244,120,119,239,3
2024-02-08,LK,Czech Republic,1585,1277,7,4,308,149,152,301,3
2024-02-09,LK,Czech Republic,1829,1440,15,7,389,195,179,374,8
2024-02-10,LK,Czech Republic,1619,1364,12,6,255,121,122,243,6
2024-02-11,LK,Czech Republic,1610,1307,2,0,303,140,161,301,2
2024-02-12,LK,Czech Republic,1659,1340,17,12,319,151,151,302,5
2024-02-13,LK,Czech Republic,1441,1155,16,8,286,138,132,270,8
2024-02-14,LK,Czech Republic,1531,1222,17,6,309,152,140,292,11
2024-02-15,LK,Czech Republic,1636,1301,14,7,335,161,160,321,7
2024-02-16,LK,Czech Republic,1843,1444,22,12,399,194,183,377,10
2024-02-17,LK,Czech Republic,1665,1403,6,4,262,131,125,256,2
2024-02-18,LK,Czech Republic,1734,1402,13,9,332,152,167,319,4
2024-02-19,LK,Czech Republic,1732,1406,8,5,326,159,159,318,3
2024-02-20,LK,Czech Republic,1369,1124,12,8,245,112,121,233,4
2024-02-21,LK,Czech Republic,1601,1284,23,15,317,153,141,294,8
2024-02-22,LK,Czech Republic,1670,1342,9,1,328,157,162,319,8
2024-02-23,LK,Czech Republic,1893,1498,17,8,395,192,186,378,9
2024-02-24,LK,Czech Republic,1676,1405,11,9,271,129,131,260,2
2024-02-25,LK,Czech Republic,1747,1398,4,2,349,166,179,345,2
2024-02-26,LK,Czech Republic,1760,1386,19,6,374,178,177,355,13
2024-02-27,LK,Czech Republic,1518,1198,26,7,320,149,145,294,19
2024-02-28,LK,Czech Republic,1627,1268,20,9,359,168,171,339,11
2024-02-29,LK,Czech Republic,1721,1323,18,2,398,196,184,380,16
2024-03-01,LK,Czech Republic,1914,1488,14,4,426,210,202,412,10
2024-03-02,LK,Czech Republic,1717,1458,10,6,259,126,123,249,4
2024-03-03,LK,Czech Republic,1776,1427,22,11,349,153,174,327,11
2024-03-04,LK,Czech Republic,1803,1427,19,9,376,178,179,357,10
2024-03-05,LK,Czech Republic,1554,1232,23,10,322,153,146,299,13
2024-03-06,LK,Czech Republic,1595,1280,10,5,315,150,155,305,5
2024-03-07,LK,Czech Republic,1630,1251,12,5,379,191,176,367,7
2024-03-08,LK,Czech Republic,1804,1389,20,11,415,203,192,395,9
2024-03-09,LK,Czech Republic,1753,1459,13,9,294,136,145,281,4
2024-03-10,LK,Czech Republic,1821,1464,14,5,357,164,179,343,9
2024-03-11,LK,Czech Republic,1753,1393,14,7,360,171,175,346,7
2024-03-12,LK,Czech Republic,1478,1186,16,11,292,136,140,276,5
2024-03-13,LK,Czech Republic,1565,1243,14,6,322,158,150,308,8
2024-03-14,LK,Czech Republic,1653,1281,16,7,372,186,170,356,9
2024-03-15,LK,Czech Republic,1973,1540,21,10,433,200,212,412,11
2024-03-16,LK,Czech Republic,1782,1509,9,1,273,140,124,264,8
2024-03-17,LK,Czech Republic,1858,1489,11,6,369,171,187,358,5
2024-03-18,LK,Czech Republic,1873,1480,16,9,393,193,184,377,7
2024-03-19,LK,Czech Republic,1568,1256,19,7,312,146,147,293,12
2024-03-20,LK,Czech Republic,1771,1436,11,6,335,164,160,324,5
2024-03-21,LK,Czech Republic,1756,1383,20,7,373,176,177,353,13
2024-03-22,LK,Czech Republic,2051,1602,30,10,449,210,209,419,20
2024-03-23,LK,Czech Republic,1845,1547,17,8,298,142,139,281,9
2024-03-24,LK,Czech Republic,1833,1511,7,3,322,152,163,315,4
2024-03-25,LK,Czech Republic,1880,1490,10,4,390,193,187,380,6
2024-03-26,LK,Czech Republic,1690,1348,30,14,342,146,166,312,16
2024-03-27,LK,Czech Republic,1883,1504,14,9,379,189,176,365,5
2024-03-28,LK,Czech Republic,1928,1499,26,9,429,212,191,403,17
2024-03-29,LK,Czech Republic,1984,1576,14,7,408,196,198,394,7
2024-03-30,LK,Czech Republic,1775,1488,7,3,287,144,136,280,4
2024-03-31,LK,Czech Republic,1909,1563,6,3,346,162,178,340,3
2024-04-01,LK,Czech Republic,2005,1592,9,1,413,198,206,404,8
2024-04-02,LK,Czech Republic,1958,1615,14,4,343,164,165,329,10
2024-04-03,LK,Czech Republic,2069,1692,15,4,377,183,179,362,11
2024-04-04,LK,Czech Republic,2036,1632,22,8,404,194,188,382,14
2024-04-05,LK,Czech Republic,2135,1725,20,12,410,200,190,390,8
2024-04-06,LK,Czech Republic,1936,1616,9,5,320,159,152,311,4
2024-04-07,LK,Czech Republic,1995,1619,10,4,376,171,195,366,6
2024-04-08,LK,Czech Republic,2058,1626,21,12,432,207,204,411,9
2024-04-09,LK,Czech Republic,1958,1599,17,8,359,173,169,342,9
2024-04-10,LK,Czech Republic,2022,1643,10,4,379,183,186,369,6
2024-04-11,LK,Czech Republic,1998,1577,24,8,421,197,200,397,16
2024-04-12,LK,Czech Republic,2110,1669,22,10,441,213,206,419,12
2024-04-13,LK,Czech Republic,1861,1554,18,10,307,144,145,289,8
2024-04-14,LK,Czech Republic,1962,1579,10,4,383,183,190,373,6
2024-04-15,LK,Czech Republic,2031,1612,13,6,419,203,203,406,7
2024-04-16,LK,Czech Republic,2012,1650,9,4,362,182,171,353,5
2024-04-17,LK,Czech Republic,2032,1629,19,8,403,196,188,384,11
2024-04-18,LK,Czech Republic,2100,1671,23,8,429,200,206,406,15
2024-04-19,LK,Czech Republic,2184,1740,21,4,444,208,215,423,17
2024-04-20,LK,Czech Republic,1934,1625,4,0,309,154,151,305,4
2024-04-21,LK,Czech Republic,2144,1724,14,6,420,193,213,406,8
2024-04-22,LK,Czech Republic,2088,1672,16,5,416,200,200,400,11
2024-04-23,LK,Czech Republic,1988,1639,16,6,349,170,163,333,10
2024-04-24,LK,Czech Republic,2059,1678,19,10,381,183,179,362,9
2024-04-25,LK,Czech Republic,2139,1704,26,9,435,210,199,409,17
2024-04-26,LK,Czech Republic,2298,1829,30,13,469,214,225,439,17
2024-04-27,LK,Czech Republic,2079,1748,8,7,331,163,160,323,1
2024-04-28,LK,Czech Republic,2207,1793,13,7,414,195,206,401,6
2024-04-29,LK,Czech Republic,2160,1710,28,14,450,213,209,422,14
2024-04-30,LK,Czech Republic,2109,1716,19,10,393,185,189,374,9
2024-05-01,LK,Czech Republic,2164,1777,19,7,387,187,181,368,12
2024-05-02,LK,Czech Republic,2244,1813,27,15,431,204,200,404,12
2024-05-03,LK,Czech Republic,2305,1877,23,5,428,208,197,405,18
2024-05-04,LK,Czech Republic,2091,1761,5,0,330,163,162,325,5
2024-05-05,LK,Czech Republic,2343,1905,7,1,438,209,222,431,6
2024-05-06,LK,Czech Republic,2170,1751,7,3,419,204,208,412,4
2024-05-07,LK,Czech Republic,2179,1784,9,5,395,198,188,386,4
2024-05-08,LK,Czech Republic,2240,1835,9,0,405,199,197,396,9
2024-05-09,LK,Czech Republic,2293,1831,11,9,462,215,236,451,2
2024-05-10,LK,Czech Republic,2328,1873,19,12,455,224,212,436,7
2024-05-11,LK,Czech Republic,2166,1819,15,9,347,169,163,332,6
2024-05-12,LK,Czech Republic,2422,1937,19,4,485,229,237,466,15
2024-05-13,LK,Czech Republic,2360,1909,23,12,451,216,212,428,11
2024-05-14,LK,Czech Republic,2243,1829,28,7,414,194,192,386,21
2024-05-15,LK,Czech Republic,2361,1900,17,13,461,218,226,444,4
2024-05-16,LK,Czech Republic,2450,1934,29,11,516,245,242,487,18
2024-05-17,LK,Czech Republic,2378,1928,20,6,450,220,210,430,14
2024-05-18,LK,Czech Republic,2323,1941,14,0,382,183,185,368,14
2024-05-19,LK,Czech Republic,2416,1970,11,1,446,210,225,435,10
2024-05-20,LK,Czech Republic,2287,1861,21,9,426,209,196,405,12
2024-05-21,LK,Czech Republic,2274,1863,20,5,411,196,195,391,15
2024-05-22,LK,Czech Republic,2313,1894,13,7,419,200,206,406,6
2024-05-23,LK,Czech Republic,2456,1980,29,7,476,225,222,447,22
2024-05-24,LK,Czech Republic,2417,1955,11,5,462,233,218,451,6
2024-05-25,LK,Czech Republic,2316,1927,11,4,389,191,187,378,7
2024-05-26,LK,Czech Republic,2511,2000,16,4,511,236,259,495,12
2024-05-27,LK,Czech Republic,2456,1980,16,7,476,237,223,460,9
2024-05-28,LK,Czech Republic,2264,1852,10,4,412,204,198,402,6
2024-05-29,LK,Czech Republic,2423,1960,19,11,463,217,227,444,8
2024-05-30,LK,Czech Republic,2494,1970,18,3,524,251,255,506,15
2024-05-31,LK,Czech Republic,2519,1994,12,2,525,267,246,513,10
2024-06-01,LK,Czech Republic,2443,1997,6,2,446,220,220,440,4
2024-06-02,LK,Czech Republic,2621,2112,8,2,509,238,263,501,6
2024-06-03,LK,Czech Republic,2536,2014,13,5,522,259,250,509,8
2024-06-04,LK,Czech Republic,2317,1841,18,10,476,229,229,458,8
2024-06-05,LK,Czech Republic,2528,1980,31,11,548,263,254,517,20
2024-06-06,LK,Czech Republic,2508,1943,17,7,565,284,264,548,10
2024-06-07,LK,Czech Republic,2591,2034,16,12,557,273,268,541,4
2024-06-08,LK,Czech Republic,2531,2060,12,0,471,228,231,459,12
2024-06-09,LK,Czech Republic,2627,2103,12,3,524,245,267,512,9
2024-06-10,LK,Czech Republic,2526,1967,16,9,559,280,263,543,7
2024-06-11,LK,Czech Republic,2400,1887,13,7,513,244,256,500,6
2024-06-12,LK,Czech Republic,2488,1952,19,7,536,257,260,517,12
2024-06-13,LK,Czech Republic,2681,2074,33,9,607,293,281,574,24
2024-06-14,LK,Czech Republic,2637,2045,23,10,592,290,279,569,13
2024-06-15,LK,Czech Republic,2547,2068,6,2,479,236,237,473,4
2024-06-16,LK,Czech Republic,2636,2073,20,6,563,254,289,543,14
2024-06-17,LK,Czech Republic,2633,2081,16,5,552,271,265,536,11
2024-06-18,LK,Czech Republic,2433,1865,27,10,568,275,266,541,17
2024-06-19,LK,Czech Republic,2583,1993,26,5,590,278,286,564,21
2024-06-20,LK,Czech Republic,2750,2142,21,6,608,294,293,587,15
2024-06-21,LK,Czech Republic,2700,2132,16,6,568,282,270,552,10
2024-06-22,LK,Czech Republic,2676,2177,9,2,499,245,245,490,7
2024-06-23,LK,Czech Republic,2670,2102,17,5,568,267,284,551,12
2024-06-24,LK,Czech Republic,2656,2067,32,10,589,282,275,557,22
2024-06-25,LK,Czech Republic,2584,2003,25,11,581,278,278,556,14
2024-06-26,LK,Czech Republic,2608,2023,19,9,585,283,283,566,10
2024-06-27,LK,Czech Republic,2709,2091,32,10,618,284,302,586,22
2024-06-28,LK,Czech Republic,2817,2197,29,8,620,306,285,591,21
2024-06-29,LK,Czech Republic,2668,2151,19,0,517,257,241,498,19
2024-06-30,LK,Czech Republic,2769,2230,12,0,539,255,272,527,12
2024-07-01,LK,Czech Republic,2746,2175,23,9,571,273,275,548,14
2024-07-02,LK,Czech Republic,2460,1949,18,9,511,241,252,493,9
2024-07-03,LK,Czech Republic,2696,2133,21,6,563,270,272,542,15
2024-07-04,LK,Czech Republic,2619,2028,35,12,591,282,274,556,23
2024-07-05,LK,Czech Republic,2556,2023,14,3,533,265,254,519,11
2024-07-06,LK,Czech Republic,2526,2033,11,2,493,240,242,482,9
2024-07-07,LK,Czech Republic,2658,2094,17,5,564,267,280,547,12
2024-07-08,LK,Czech Republic,2575,2023,25,9,552,264,263,527,16
2024-07-09,LK,Czech Republic,2426,1903,24,10,523,249,250,499,14
2024-07-10,LK,Czech Republic,2688,2133,24,6,555,264,267,531,18
2024-07-11,LK,Czech Republic,2728,2173,26,6,555,268,261,529,20
2024-07-12,LK,Czech Republic,2703,2170,22,6,533,260,251,511,16
2024-07-13,LK,Czech Republic,2634,2133,10,6,501,251,240,491,4
2024-07-14,LK,Czech Republic,2734,2163,16,4,571,266,289,555,12
2024-07-15,LK,Czech Republic,2697,2143,23,13,554,264,267,531,10
2024-07-16,LK,Czech Republic,2624,2087,22,11,537,258,257,515,11
2024-07-17,LK,Czech Republic,2668,2106,31,15,562,265,266,531,16
2024-07-18,LK,Czech Republic,2658,2101,28,7,557,271,258,529,21
2024-07-19,LK,Czech Republic,2536,2001,28,8,535,255,252,507,20
2024-07-20,LK,Czech Republic,2562,2093,9,1,469,228,232,460,8
2024-07-21,LK,Czech Republic,2661,2106,19,3,555,257,279,536,16
2024-07-22,LK,Czech Republic,2678,2150,12,2,528,254,262,516,10
2024-07-23,LK,Czech Republic,2590,2075,16,11,515,257,242,499,5
2024-07-24,LK,Czech Republic,2634,2070,25,12,564,266,273,539,13
2024-07-25,LK,Czech Republic,2709,2141,30,17,568,274,264,538,13
2024-07-26,LK,Czech Republic,2698,2143,15,6,555,270,270,540,9
2024-07-27,LK,Czech Republic,2494,2009,13,4,485,234,238,472,9
2024-07-28,LK,Czech Republic,2622,2087,18,2,535,254,263,517,16
2024-07-29,LK,Czech Republic,2637,2082,29,17,555,261,265,526,12
2024-07-30,LK,Czech Republic,2430,1913,18,9,517,250,249,499,9
2024-01-01,EK,Denmark,1283,704,54,0,579,265,260,525,54
2024-01-02,EK,Denmark,1313,670,89,3,643,276,278,554,86
2024-01-03,EK,Denmark,1313,690,48,0,623,289,286,575,48
2024-01-04,EK,Denmark,1343,718,62,3,625,282,281,563,59
2024-01-05,EK,Denmark,1414,704,66,9,710,321,323,644,57
2024-01-06,EK,Denmark,1246,703,36,1,543,253,254,507,35
2024-01-07,EK,Denmark,1415,766,46,0,649,304,299,603,46
2024-01-08,EK,Denmark,1372,643,83,12,729,324,322,646,71
2024-01-09,EK,Denmark,1085,526,63,6,559,250,246,496,57
2024-01-10,EK,Denmark,1165,553,66,4,612,273,273,546,62
2024-01-11,EK,Denmark,1260,609,96,10,651,276,279,555,86
2024-01-12,EK,Denmark,1412,680,105,6,732,311,316,627,99
2024-01-13,EK,Denmark,1142,637,40,2,505,230,235,465,38
2024-01-14,EK,Denmark,1337,705,58,5,632,285,289,574,53
2024-01-15,EK,Denmark,1284,606,74,8,678,311,293,604,66
2024-01-16,EK,Denmark,1074,525,74,14,549,233,242,475,60
2024-01-17,EK,Denmark,1069,497,75,7,572,247,250,497,68
2024-01-18,EK,Denmark,1245,613,101,18,632,263,268,531,83
2024-01-19,EK,Denmark,1440,692,92,7,748,328,328,656,85
2024-01-20,EK,Denmark,1169,647,35,1,522,240,247,487,34
2024-01-21,EK,Denmark,1321,693,57,5,628,287,284,571,52
2024-01-22,EK,Denmark,1357,646,92,5,711,314,305,619,87
2024-01-23,EK,Denmark,1160,559,87,11,601,255,259,514,76
2024-01-24,EK,Denmark,1204,595,78,6,609,265,266,531,72
2024-01-25,EK,Denmark,1332,633,118,18,699,293,288,581,100
2024-01-26,EK,Denmark,1444,703,92,1,741,318,331,649,91
2024-01-27,EK,Denmark,1152,622,33,6,530,248,249,497,27
2024-01-28,EK,Denmark,1378,737,60,3,641,288,293,581,57
2024-01-29,EK,Denmark,1432,669,107,16,763,335,321,656,91
2024-01-30,EK,Denmark,1186,549,105,11,637,265,267,532,94
2024-01-31,EK,Denmark,1286,599,121,13,687,286,280,566,108
2024-02-01,EK,Denmark,1240,562,104,8,678,286,288,574,96
2024-02-02,EK,Denmark,1464,680,101,8,784,338,345,683,93
2024-02-03,EK,Denmark,1216,658,34,3,558,258,266,524,31
2024-02-04,EK,Denmark,1397,735,53,0,662,307,302,609,53
2024-02-05,EK,Denmark,1466,708,105,11,758,330,323,653,94
2024-02-06,EK,Denmark,1219,578,100,8,641,267,274,541,92
2024-02-07,EK,Denmark,1204,557,86,8,647,281,280,561,78
2024-02-08,EK,Denmark,1351,629,93,18,722,314,315,629,75
2024-02-09,EK,Denmark,1516,711,89,8,805,355,361,716,81
2024-02-10,EK,Denmark,1297,689,29,1,608,293,286,579,28
2024-02-11,EK,Denmark,1441,751,52,2,690,321,317,638,50
2024-02-12,EK,Denmark,1479,713,95,5,766,340,331,671,90
2024-02-13,EK,Denmark,1246,585,104,15,661,273,284,557,89
2024-02-14,EK,Denmark,1317,628,84,16,689,302,303,605,68
2024-02-15,EK,Denmark,1338,644,60,5,694,317,317,634,55
2024-02-16,EK,Denmark,1594,735,115,20,859,370,374,744,95
2024-02-17,EK,Denmark,1377,715,60,10,662,292,310,602,50
2024-02-18,EK,Denmark,1527,801,66,5,726,334,326,660,61
2024-02-19,EK,Denmark,1513,715,94,2,798,354,350,704,92
2024-02-20,EK,Denmark,1275,579,122,27,696,287,287,574,95
2024-02-21,EK,Denmark,1406,667,118,20,739,311,310,621,98
2024-02-22,EK,Denmark,1489,730,99,10,759,328,332,660,89
2024-02-23,EK,Denmark,1599,799,74,1,800,362,364,726,73
2024-02-24,EK,Denmark,1412,786,47,17,626,290,289,579,30
2024-02-25,EK,Denmark,1535,805,65,6,730,330,335,665,59
2024-02-26,EK,Denmark,1522,695,105,20,827,364,358,722,85
2024-02-27,EK,Denmark,1337,648,94,12,689,297,298,595,82
2024-02-28,EK,Denmark,1408,673,112,12,735,312,311,623,100
2024-02-29,EK,Denmark,1465,691,121,26,774,327,326,653,95
2024-03-01,EK,Denmark,1647,760,125,13,887,383,379,762,112
2024-03-02,EK,Denmark,1349,737,33,1,612,286,293,579,32
2024-03-03,EK,Denmark,1513,794,58,5,719,329,332,661,53
2024-03-04,EK,Denmark,1559,737,105,22,822,362,355,717,83
2024-03-05,EK,Denmark,1345,624,103,12,721,307,311,618,91
2024-03-06,EK,Denmark,1382,668,87,4,714,314,313,627,83
2024-03-07,EK,Denmark,1459,657,114,12,802,342,346,688,102
2024-03-08,EK,Denmark,1588,734,107,7,854,375,372,747,100
2024-03-09,EK,Denmark,1321,719,30,4,602,286,286,572,26
2024-03-10,EK,Denmark,1474,762,49,3,712,329,334,663,46
2024-03-11,EK,Denmark,1593,752,103,8,841,373,365,738,95
2024-03-12,EK,Denmark,1368,661,99,16,707,303,305,608,83
2024-03-13,EK,Denmark,1415,672,102,19,743,319,322,641,83
2024-03-14,EK,Denmark,1541,699,147,22,842,346,349,695,125
2024-03-15,EK,Denmark,1640,752,125,13,888,381,382,763,112
2024-03-16,EK,Denmark,1230,632,36,6,598,280,282,562,30
2024-03-17,EK,Denmark,1512,770,64,7,742,339,339,678,57
2024-03-18,EK,Denmark,1626,781,104,19,845,372,369,741,85
2024-03-19,EK,Denmark,1434,678,114,13,756,315,327,642,101
2024-03-20,EK,Denmark,1495,709,121,12,786,333,332,665,109
2024-03-21,EK,Denmark,1561,714,126,20,847,360,361,721,106
2024-03-22,EK,Denmark,1727,787,137,22,940,401,402,803,115
2024-03-23,EK,Denmark,1364,713,32,5,651,308,311,619,27
2024-03-24,EK,Denmark,1495,760,55,1,735,341,339,680,54
2024-03-25,EK,Denmark,1519,714,87,13,805,369,349,718,74
2024-03-26,EK,Denmark,1326,621,80,11,705,309,316,625,69
2024-03-27,EK,Denmark,1486,700,103,18,786,342,341,683,85
2024-03-28,EK,Denmark,1546,774,84,8,772,344,344,688,76
2024-03-29,EK,Denmark,1425,728,63,6,697,316,318,634,57
2024-03-30,EK,Denmark,1286,681,36,5,605,282,287,569,31
2024-03-31,EK,Denmark,1548,750,48,3,798,374,376,750,45
2024-04-01,EK,Denmark,1599,737,81,6,862,389,392,781,75
2024-04-02,EK,Denmark,1645,773,105,9,872,386,381,767,96
2024-04-03,EK,Denmark,1680,770,104,13,910,401,405,806,91
2024-04-04,EK,Denmark,1681,766,117,6,915,397,401,798,111
2024-04-05,EK,Denmark,1744,767,112,18,977,435,430,865,94
2024-04-06,EK,Denmark,1392,709,49,9,683,319,315,634,40
2024-04-07,EK,Denmark,1661,775,76,7,886,404,406,810,69
2024-04-08,EK,Denmark,1751,763,117,18,988,439,432,871,99
2024-04-09,EK,Denmark,1679,761,131,24,918,391,396,787,107
2024-04-10,EK,Denmark,1720,770,120,18,950,412,418,830,102
2024-04-11,EK,Denmark,1734,750,127,17,984,433,424,857,110
2024-04-12,EK,Denmark,1768,761,118,9,1007,446,443,889,109
2024-04-13,EK,Denmark,1376,691,46,9,685,314,325,639,37
2024-04-14,EK,Denmark,1609,735,62,2,874,402,410,812,60
2024-04-15,EK,Denmark,1708,720,129,25,988,438,421,859,104
2024-04-16,EK,Denmark,1643,744,105,13,899,391,403,794,92
2024-04-17,EK,Denmark,1728,775,116,18,953,420,417,837,98
2024-04-18,EK,Denmark,1740,783,105,15,957,428,424,852,90
2024-04-19,EK,Denmark,1702,729,100,5,973,435,438,873,95
2024-04-20,EK,Denmark,1314,651,41,5,663,308,314,622,36
2024-04-21,EK,Denmark,1618,730,60,0,888,415,413,828,60
2024-04-22,EK,Denmark,1694,738,113,20,956,420,423,843,93
2024-04-23,EK,Denmark,1640,713,114,9,927,407,406,813,105
2024-04-24,EK,Denmark,1703,759,113,18,944,417,414,831,95
2024-04-25,EK,Denmark,1680,737,124,22,943,409,410,819,102
2024-04-26,EK,Denmark,1780,790,102,13,990,440,448,888,89
2024-04-27,EK,Denmark,1427,730,34,3,697,332,331,663,31
2024-04-28,EK,Denmark,1656,784,64,7,872,405,403,808,57
2024-04-29,EK,Denmark,1764,786,123,19,978,430,425,855,104
2024-04-30,EK,Denmark,1656,751,112,19,905,395,398,793,93
2024-05-01,EK,Denmark,1622,733,105,29,889,391,393,784,76
2024-05-02,EK,Denmark,1713,733,128,26,980,426,426,852,102
2024-05-03,EK,Denmark,1715,712,109,21,1003,447,447,894,88
2024-05-04,EK,Denmark,1422,677,42,7,745,349,354,703,35
2024-05-05,EK,Denmark,1696,796,69,6,900,414,417,831,63
2024-05-06,EK,Denmark,1765,764,108,14,1001,448,445,893,94
2024-05-07,EK,Denmark,1744,779,129,22,965,416,420,836,107
2024-05-08,EK,Denmark,1804,778,125,20,1026,447,454,901,105
2024-05-09,EK,Denmark,1628,751,71,5,877,408,398,806,66
2024-05-10,EK,Denmark,1585,723,72,6,862,398,392,790,66
2024-05-11,EK,Denmark,1433,703,28,2,730,349,353,702,26
2024-05-12,EK,Denmark,1759,790,67,3,969,439,463,902,64
2024-05-13,EK,Denmark,1845,800,110,9,1045,478,457,935,101
2024-05-14,EK,Denmark,1718,762,106,14,956,420,430,850,92
2024-05-15,EK,Denmark,1763,767,98,9,996,455,443,898,89
2024-05-16,EK,Denmark,1805,817,105,10,988,438,445,883,95
2024-05-17,EK,Denmark,1808,797,91,4,1011,466,454,920,87
2024-05-18,EK,Denmark,1501,739,32,2,762,360,370,730,30
2024-05-19,EK,Denmark,1628,744,54,4,884,413,417,830,50
2024-05-20,EK,Denmark,1750,826,63,7,924,433,428,861,56
2024-05-21,EK,Denmark,1730,797,109,12,933,407,417,824,97
2024-05-22,EK,Denmark,1806,795,111,10,1011,446,454,900,101
2024-05-23,EK,Denmark,1773,780,105,13,993,448,440,888,92
2024-05-24,EK,Denmark,1815,767,108,14,1048,475,465,940,94
2024-05-25,EK,Denmark,1483,732,33,2,751,359,359,718,31
2024-05-26,EK,Denmark,1772,839,57,1,933,432,444,876,56
2024-05-27,EK,Denmark,1841,807,115,10,1034,462,457,919,105
2024-05-28,EK,Denmark,1806,842,121,9,964,423,420,843,112
2024-05-29,EK,Denmark,1834,807,133,18,1027,449,445,894,115
2024-05-30,EK,Denmark,1809,793,117,15,1016,437,462,899,102
2024-05-31,EK,Denmark,1883,814,121,13,1069,480,468,948,108
2024-06-01,EK,Denmark,1555,765,44,0,790,370,376,746,44
2024-06-02,EK,Denmark,1787,821,66,2,966,447,453,900,64
2024-06-03,EK,Denmark,1845,778,134,26,1067,473,460,933,108
2024-06-04,EK,Denmark,1757,762,125,14,995,436,434,870,111
2024-06-05,EK,Denmark,1817,849,101,11,968,427,440,867,90
2024-06-06,EK,Denmark,1857,821,118,13,1036,457,461,918,105
2024-06-07,EK,Denmark,1838,796,101,10,1042,469,472,941,91
2024-06-08,EK,Denmark,1540,748,42,5,792,376,374,750,37
2024-06-09,EK,Denmark,1826,864,67,4,962,449,446,895,63
2024-06-10,EK,Denmark,1861,812,112,12,1049,476,461,937,100
2024-06-11,EK,Denmark,1776,812,117,20,964,419,428,847,97
2024-06-12,EK,Denmark,1935,866,149,16,1069,460,460,920,133
2024-06-13,EK,Denmark,1938,838,157,21,1100,470,473,943,136
2024-06-14,EK,Denmark,1935,846,140,8,1089,475,474,949,132
2024-06-15,EK,Denmark,1642,801,92,6,841,373,376,749,86
2024-06-16,EK,Denmark,1935,912,85,5,1023,461,477,938,80
2024-06-17,EK,Denmark,1940,873,114,8,1067,481,472,953,106
2024-06-18,EK,Denmark,1790,813,116,13,977,432,429,861,103
2024-06-19,EK,Denmark,1880,816,125,20,1064,474,465,939,105
2024-06-20,EK,Denmark,1937,870,116,17,1067,477,474,951,99
2024-06-21,EK,Denmark,1905,869,112,17,1036,462,462,924,95
2024-06-22,EK,Denmark,1629,805,44,1,824,386,394,780,43
2024-06-23,EK,Denmark,1833,860,62,2,973,450,461,911,60
2024-06-24,EK,Denmark,1949,887,89,10,1062,487,486,973,79
2024-06-25,EK,Denmark,1879,852,104,15,1027,461,462,923,89
2024-06-26,EK,Denmark,1924,896,104,18,1028,459,465,924,86
2024-06-27,EK,Denmark,1926,908,107,22,1018,458,453,911,85
2024-06-28,EK,Denmark,1957,915,94,17,1042,473,475,948,77
2024-06-29,EK,Denmark,1694,830,39,4,864,419,406,825,35
2024-06-30,EK,Denmark,1860,892,60,2,968,449,459,908,58
2024-07-01,EK,Denmark,1949,930,96,19,1019,459,464,923,77
2024-07-02,EK,Denmark,1836,890,90,15,946,426,430,856,75
2024-07-03,EK,Denmark,1993,1004,94,15,989,448,447,895,79
2024-07-04,EK,Denmark,2000,985,87,11,1015,467,461,928,76
2024-07-05,EK,Denmark,1909,881,79,13,1028,471,478,949,66
2024-07-06,EK,Denmark,1708,837,57,8,871,410,404,814,49
2024-07-07,EK,Denmark,1856,916,57,6,940,438,445,883,51
2024-07-08,EK,Denmark,1913,890,85,17,1023,469,469,938,68
2024-07-09,EK,Denmark,1793,854,86,13,939,428,425,853,73
2024-07-10,EK,Denmark,1892,916,88,9,976,442,446,888,79
2024-07-11,EK,Denmark,1946,939,88,12,1007,461,458,919,76
2024-07-12,EK,Denmark,1850,862,77,13,988,455,456,911,64
2024-07-13,EK,Denmark,1739,868,53,4,871,412,406,818,49
2024-07-14,EK,Denmark,1886,934,54,1,952,442,456,898,53
2024-07-15,EK,Denmark,1910,901,75,4,1009,469,465,934,71
2024-07-16,EK,Denmark,1798,864,96,19,934,417,421,838,77
2024-07-17,EK,Denmark,1936,938,95,11,998,448,455,903,84
2024-07-18,EK,Denmark,1926,906,82,12,1020,476,462,938,70
2024-07-19,EK,Denmark,1785,815,74,9,970,449,447,896,65
2024-07-20,EK,Denmark,1745,869,57,5,876,415,404,819,52
2024-07-21,EK,Denmark,1924,967,62,5,957,443,452,895,57
2024-07-22,EK,Denmark,1956,928,76,15,1028,479,473,952,61
2024-07-23,EK,Denmark,1794,866,98,14,928,416,414,830,84
2024-07-24,EK,Denmark,1873,897,87,16,976,441,448,889,71
2024-07-25,EK,Denmark,1882,886,84,13,996,452,460,912,71
2024-07-26,EK,Denmark,1850,862,81,11,988,459,448,907,70
2024-07-27,EK,Denmark,1705,836,61,8,869,407,401,808,53
2024-07-28,EK,Denmark,1801,875,51,6,926,431,444,875,45
2024-07-29,EK,Denmark,1928,896,86,15,1032,470,476,946,71
2024-07-30,EK,Denmark,1793,853,89,10,940,423,428,851,79
2024-01-01,EE,Estonia,345,253,9,1,92,41,42,83,8
2024-01-02,EE,Estonia,363,275,10,2,88,40,38,78,8
2024-01-03,EE,Estonia,379,283,11,3,96,40,45,85,8
2024-01-04,EE,Estonia,375,284,9,1,91,39,43,82,8
2024-01-05,EE,Estonia,410,316,12,4,94,42,40,82,8
2024-01-06,EE,Estonia,386,312,5,1,74,34,35,69,4
2024-01-07,EE,Estonia,405,308,5,1,97,48,44,92,4
2024-01-08,EE,Estonia,408,300,8,0,108,51,49,100,8
2024-01-09,EE,Estonia,347,261,10,2,86,38,38,76,8
2024-01-10,EE,Estonia,342,251,9,1,91,40,42,82,8
2024-01-11,EE,Estonia,351,265,9,1,86,41,36,77,8
2024-01-12,EE,Estonia,352,259,6,2,93,41,46,87,4
2024-01-13,EE,Estonia,359,286,6,2,73,33,34,67,4
2024-01-14,EE,Estonia,356,267,5,1,89,43,41,84,4
2024-01-15,EE,Estonia,344,248,8,2,96,45,43,88,6
2024-01-16,EE,Estonia,285,208,10,2,77,34,33,67,8
2024-01-17,EE,Estonia,311,231,11,3,80,34,35,69,8
2024-01-18,EE,Estonia,326,242,7,0,84,37,40,77,7
2024-01-19,EE,Estonia,355,258,7,1,97,44,46,90,6
2024-01-20,EE,Estonia,333,261,5,1,72,34,33,67,4
2024-01-21,EE,Estonia,370,279,5,1,91,43,43,86,4
2024-01-22,EE,Estonia,340,261,5,1,79,39,35,74,4
2024-01-23,EE,Estonia,315,230,9,1,85,36,40,76,8
2024-01-24,EE,Estonia,328,240,10,2,88,38,40,78,8
2024-01-25,EE,Estonia,358,268,10,2,90,39,41,80,8
2024-01-26,EE,Estonia,382,286,9,1,96,44,43,87,8
2024-01-27,EE,Estonia,342,275,6,2,67,32,29,61,4
2024-01-28,EE,Estonia,353,267,5,1,86,39,42,81,4
2024-01-29,EE,Estonia,372,273,11,3,99,46,42,88,8
2024-01-30,EE,Estonia,302,228,10,2,74,32,32,64,8
2024-01-31,EE,Estonia,325,243,9,1,82,37,36,73,8
2024-02-01,EE,Estonia,270,193,10,2,77,31,36,67,8
2024-02-02,EE,Estonia,286,198,15,5,88,37,36,73,10
2024-02-03,EE,Estonia,338,268,7,3,70,32,31,63,4
2024-02-04,EE,Estonia,357,269,6,2,88,41,41,82,4
2024-02-05,EE,Estonia,338,242,9,1,96,44,43,87,8
2024-02-06,EE,Estonia,307,228,9,1,79,34,36,70,8
2024-02-07,EE,Estonia,306,227,16,1,79,32,31,63,15
2024-02-08,EE,Estonia,355,263,10,1,92,42,40,82,9
2024-02-09,EE,Estonia,357,259,10,2,98,43,45,88,8
2024-02-10,EE,Estonia,324,252,11,7,72,31,30,61,4
2024-02-11,EE,Estonia,363,263,10,5,100,41,49,90,5
2024-02-12,EE,Estonia,353,255,6,2,98,49,43,92,4
2024-02-13,EE,Estonia,285,213,6,2,72,33,33,66,4
2024-02-14,EE,Estonia,318,237,9,1,81,36,36,72,8
2024-02-15,EE,Estonia,353,261,4,0,92,44,44,88,4
2024-02-16,EE,Estonia,382,292,4,0,90,42,44,86,4
2024-02-17,EE,Estonia,329,268,6,2,61,29,26,55,4
2024-02-18,EE,Estonia,370,272,9,4,98,42,47,89,5
2024-02-19,EE,Estonia,374,269,14,6,105,48,43,91,8
2024-02-20,EE,Estonia,296,215,13,5,81,33,35,68,8
2024-02-21,EE,Estonia,354,262,9,0,92,40,43,83,9
2024-02-22,EE,Estonia,388,282,7,0,106,49,50,99,7
2024-02-23,EE,Estonia,399,296,9,1,103,48,46,94,8
2024-02-24,EE,Estonia,333,262,4,0,71,33,34,67,4
2024-02-25,EE,Estonia,378,281,8,4,97,45,44,89,4
2024-02-26,EE,Estonia,382,280,8,0,102,48,46,94,8
2024-02-27,EE,Estonia,311,234,4,0,77,38,35,73,4
2024-02-28,EE,Estonia,349,259,6,0,90,42,42,84,6
2024-02-29,EE,Estonia,390,283,10,1,107,46,51,97,9
2024-03-01,EE,Estonia,395,291,9,1,104,49,46,95,8
2024-03-02,EE,Estonia,341,268,6,2,73,34,33,67,4
2024-03-03,EE,Estonia,391,292,6,2,99,47,46,93,4
2024-03-04,EE,Estonia,386,270,11,3,116,52,53,105,8
2024-03-05,EE,Estonia,329,237,12,3,92,40,40,80,9
2024-03-06,EE,Estonia,367,268,11,3,99,44,44,88,8
2024-03-07,EE,Estonia,385,282,12,3,103,45,46,91,9
2024-03-08,EE,Estonia,373,280,8,0,93,42,43,85,8
2024-03-09,EE,Estonia,360,288,7,3,72,33,32,65,4
2024-03-10,EE,Estonia,391,300,9,5,91,41,41,82,4
2024-03-11,EE,Estonia,380,269,8,0,111,52,51,103,8
2024-03-12,EE,Estonia,314,228,11,3,86,37,38,75,8
2024-03-13,EE,Estonia,344,244,11,3,100,45,44,89,8
2024-03-14,EE,Estonia,388,277,11,1,111,50,50,100,10
2024-03-15,EE,Estonia,387,288,11,3,99,44,44,88,8
2024-03-16,EE,Estonia,346,268,9,5,78,34,35,69,4
2024-03-17,EE,Estonia,374,279,4,0,95,46,45,91,4
2024-03-18,EE,Estonia,371,267,8,0,104,50,46,96,8
2024-03-19,EE,Estonia,322,236,8,0,86,39,39,78,8
2024-03-20,EE,Estonia,360,264,8,0,96,44,44,88,8
2024-03-21,EE,Estonia,385,280,8,0,105,47,50,97,8
2024-03-22,EE,Estonia,412,298,10,1,114,50,54,104,9
2024-03-23,EE,Estonia,345,269,4,0,76,36,36,72,4
2024-03-24,EE,Estonia,376,282,7,3,94,44,43,87,4
2024-03-25,EE,Estonia,379,271,8,0,108,52,48,100,8
2024-03-26,EE,Estonia,340,257,8,0,83,38,37,75,8
2024-03-27,EE,Estonia,372,276,11,3,96,43,42,85,8
2024-03-28,EE,Estonia,390,278,14,6,112,48,50,98,8
2024-03-29,EE,Estonia,400,300,12,4,100,43,45,88,8
2024-03-30,EE,Estonia,354,283,4,0,71,33,34,67,4
2024-03-31,EE,Estonia,432,326,6,2,106,51,49,100,4
2024-04-01,EE,Estonia,422,305,10,2,117,53,54,107,8
2024-04-02,EE,Estonia,384,284,8,2,100,48,44,92,6
2024-04-03,EE,Estonia,411,304,7,1,107,49,51,100,6
2024-04-04,EE,Estonia,440,315,9,0,125,58,58,116,9
2024-04-05,EE,Estonia,430,318,7,0,112,54,51,105,7
2024-04-06,EE,Estonia,397,314,2,0,83,38,43,81,2
2024-04-07,EE,Estonia,456,335,5,1,121,56,60,116,4
2024-04-08,EE,Estonia,467,336,12,4,131,61,58,119,8
2024-04-09,EE,Estonia,431,318,11,3,113,52,50,102,8
2024-04-10,EE,Estonia,448,318,11,3,130,58,61,119,8
2024-04-11,EE,Estonia,445,319,9,1,126,59,58,117,8
2024-04-12,EE,Estonia,468,342,9,1,126,57,60,117,8
2024-04-13,EE,Estonia,421,317,8,4,104,48,48,96,4
2024-04-14,EE,Estonia,446,321,6,0,125,61,58,119,6
2024-04-15,EE,Estonia,454,326,8,0,128,60,60,120,8
2024-04-16,EE,Estonia,429,321,9,1,108,49,50,99,8
2024-04-17,EE,Estonia,451,331,8,0,120,55,57,112,8
2024-04-18,EE,Estonia,454,324,8,0,130,63,59,122,8
2024-04-19,EE,Estonia,457,334,9,1,123,55,59,114,8
2024-04-20,EE,Estonia,421,326,4,0,95,46,45,91,4
2024-04-21,EE,Estonia,489,360,7,3,129,62,60,122,4
2024-04-22,EE,Estonia,474,340,8,0,134,62,64,126,8
2024-04-23,EE,Estonia,414,306,9,1,108,50,49,99,8
2024-04-24,EE,Estonia,491,364,12,4,127,58,57,115,8
2024-04-25,EE,Estonia,444,320,8,0,124,59,57,116,8
2024-04-26,EE,Estonia,499,370,9,1,129,60,60,120,8
2024-04-27,EE,Estonia,447,350,9,5,97,42,46,88,4
2024-04-28,EE,Estonia,538,406,11,5,132,61,60,121,6
2024-04-29,EE,Estonia,520,388,11,3,132,62,59,121,8
2024-04-30,EE,Estonia,449,345,11,3,104,45,48,93,8
2024-05-01,EE,Estonia,515,394,10,2,121,56,55,111,8
2024-05-02,EE,Estonia,519,385,10,2,134,63,61,124,8
2024-05-03,EE,Estonia,512,388,9,1,124,56,59,115,8
2024-05-04,EE,Estonia,485,380,7,1,105,49,49,98,6
2024-05-05,EE,Estonia,535,406,6,2,129,62,61,123,4
2024-05-06,EE,Estonia,520,392,8,0,128,61,59,120,8
2024-05-07,EE,Estonia,481,364,9,1,117,54,54,108,8
2024-05-08,EE,Estonia,539,391,10,2,148,66,72,138,8
2024-05-09,EE,Estonia,538,406,8,0,132,63,61,124,8
2024-05-10,EE,Estonia,513,382,14,5,131,57,60,117,9
2024-05-11,EE,Estonia,504,386,9,4,118,56,53,109,5
2024-05-12,EE,Estonia,539,414,6,1,125,60,59,119,5
2024-05-13,EE,Estonia,536,402,10,2,134,63,61,124,8
2024-05-14,EE,Estonia,500,382,9,1,118,55,54,109,8
2024-05-15,EE,Estonia,513,387,9,1,126,59,58,117,8
2024-05-16,EE,Estonia,543,401,9,1,142,65,68,133,8
2024-05-17,EE,Estonia,543,407,13,2,136,62,61,123,11
2024-05-18,EE,Estonia,501,393,7,1,108,51,50,101,6
2024-05-19,EE,Estonia,540,410,7,2,130,63,60,123,5
2024-05-20,EE,Estonia,549,402,17,6,147,64,66,130,11
2024-05-21,EE,Estonia,486,363,14,4,123,53,56,109,10
2024-05-22,EE,Estonia,509,376,13,3,133,61,59,120,10
2024-05-23,EE,Estonia,530,390,13,4,140,68,59,127,9
2024-05-24,EE,Estonia,511,386,12,2,125,56,57,113,10
2024-05-25,EE,Estonia,498,386,5,1,112,51,56,107,4
2024-05-26,EE,Estonia,523,401,4,0,122,60,58,118,4
2024-05-27,EE,Estonia,537,411,8,0,126,59,59,118,8
2024-05-28,EE,Estonia,491,368,14,2,123,57,52,109,12
2024-05-29,EE,Estonia,528,401,8,0,127,57,62,119,8
2024-05-30,EE,Estonia,544,410,10,1,134,63,61,124,9
2024-05-31,EE,Estonia,516,392,10,0,124,57,57,114,10
2024-06-01,EE,Estonia,514,412,4,0,102,47,51,98,4
2024-06-02,EE,Estonia,568,435,8,0,133,65,60,125,8
2024-06-03,EE,Estonia,560,425,8,0,135,63,64,127,8
2024-06-04,EE,Estonia,513,402,9,1,111,51,51,102,8
2024-06-05,EE,Estonia,543,410,9,1,133,63,61,124,8
2024-06-06,EE,Estonia,547,414,12,3,133,60,61,121,9
2024-06-07,EE,Estonia,531,401,11,2,130,61,58,119,9
2024-06-08,EE,Estonia,499,402,4,0,97,47,46,93,4
2024-06-09,EE,Estonia,566,443,5,0,123,57,61,118,5
2024-06-10,EE,Estonia,547,414,9,1,133,62,62,124,8
2024-06-11,EE,Estonia,515,395,8,0,120,56,56,112,8
2024-06-12,EE,Estonia,537,407,8,0,130,60,62,122,8
2024-06-13,EE,Estonia,550,411,10,1,139,66,63,129,9
2024-06-14,EE,Estonia,536,414,9,1,122,54,59,113,8
2024-06-15,EE,Estonia,513,400,6,0,113,55,52,107,6
2024-06-16,EE,Estonia,541,414,4,0,127,63,60,123,4
2024-06-17,EE,Estonia,531,404,9,1,127,58,60,118,8
2024-06-18,EE,Estonia,495,380,9,1,115,52,54,106,8
2024-06-19,EE,Estonia,550,410,12,4,140,62,66,128,8
2024-06-20,EE,Estonia,566,423,9,0,143,71,63,134,9
2024-06-21,EE,Estonia,526,405,10,1,121,57,54,111,9
2024-06-22,EE,Estonia,483,383,8,3,100,44,48,92,5
2024-06-23,EE,Estonia,548,421,6,1,127,61,60,121,5
2024-06-24,EE,Estonia,540,408,10,0,132,63,59,122,10
2024-06-25,EE,Estonia,506,389,14,3,117,51,52,103,11
2024-06-26,EE,Estonia,529,404,11,0,125,56,58,114,11
2024-06-27,EE,Estonia,544,409,9,0,135,62,64,126,9
2024-06-28,EE,Estonia,523,402,8,0,121,59,54,113,8
2024-06-29,EE,Estonia,494,393,5,1,101,47,49,96,4
2024-06-30,EE,Estonia,543,431,5,1,112,53,54,107,4
2024-07-01,EE,Estonia,555,427,12,2,128,57,59,116,10
2024-07-02,EE,Estonia,506,396,12,4,110,49,49,98,8
2024-07-03,EE,Estonia,553,422,13,5,131,59,59,118,8
2024-07-04,EE,Estonia,549,413,21,5,136,58,57,115,16
2024-07-05,EE,Estonia,544,422,13,5,122,54,55,109,8
2024-07-06,EE,Estonia,540,426,12,7,114,51,51,102,5
2024-07-07,EE,Estonia,550,431,7,3,119,58,54,112,4
2024-07-08,EE,Estonia,544,412,16,7,132,57,59,116,9
2024-07-09,EE,Estonia,533,416,12,2,117,51,54,105,10
2024-07-10,EE,Estonia,558,425,10,2,133,63,60,123,8
2024-07-11,EE,Estonia,542,415,13,5,127,60,54,114,8
2024-07-12,EE,Estonia,554,427,12,4,127,59,56,115,8
2024-07-13,EE,Estonia,523,423,5,1,100,46,49,95,4
2024-07-14,EE,Estonia,547,434,5,0,113,55,53,108,5
2024-07-15,EE,Estonia,554,418,13,5,136,60,63,123,8
2024-07-16,EE,Estonia,530,412,11,2,118,53,54,107,9
2024-07-17,EE,Estonia,537,414,9,0,123,56,58,114,9
2024-07-18,EE,Estonia,537,415,10,2,122,57,55,112,8
2024-07-19,EE,Estonia,551,435,13,5,116,50,53,103,8
2024-07-20,EE,Estonia,532,429,6,2,103,51,46,97,4
2024-07-21,EE,Estonia,562,445,5,1,117,54,58,112,4
2024-07-22,EE,Estonia,570,433,10,2,137,64,63,127,8
2024-07-23,EE,Estonia,532,427,12,3,105,47,46,93,9
2024-07-24,EE,Estonia,571,436,15,5,135,60,60,120,10
2024-07-25,EE,Estonia,558,424,13,3,134,59,62,121,10
2024-07-26,EE,Estonia,550,435,11,1,115,54,50,104,10
2024-07-27,EE,Estonia,510,414,4,0,96,45,47,92,4
2024-07-28,EE,Estonia,553,441,5,1,112,54,53,107,4
2024-07-29,EE,Estonia,553,424,8,0,129,60,61,121,8
2024-07-30,EE,Estonia,521,405,12,1,116,53,51,104,11
2024-01-01,EF,Finland,527,149,80,0,378,147,151,298,80
2024-01-02,EF,Finland,661,175,97,2,486,200,189,389,95
2024-01-03,EF,Finland,638,191,86,0,447,179,182,361,86
2024-01-04,EF,Finland,624,187,93,1,437,172,172,344,92
2024-01-05,EF,Finland,642,193,107,2,449,172,170,342,105
2024-01-06,EF,Finland,621,169,78,0,452,187,187,374,78
2024-01-07,EF,Finland,693,193,86,0,500,201,213,414,86
2024-01-08,EF,Finland,641,165,124,3,476,178,174,352,121
2024-01-09,EF,Finland,594,141,116,2,453,172,165,337,114
2024-01-10,EF,Finland,603,153,115,0,450,165,170,335,115
2024-01-11,EF,Finland,605,141,123,2,464,171,170,341,121
2024-01-12,EF,Finland,585,147,105,0,438,168,165,333,105
2024-01-13,EF,Finland,534,108,68,1,426,180,178,358,67
2024-01-14,EF,Finland,599,151,82,0,448,180,186,366,82
2024-01-15,EF,Finland,594,140,116,1,454,165,173,338,115
2024-01-16,EF,Finland,543,125,99,2,418,166,153,319,97
2024-01-17,EF,Finland,580,143,107,2,437,164,166,330,105
2024-01-18,EF,Finland,591,130,125,0,461,166,170,336,125
2024-01-19,EF,Finland,603,150,118,0,453,168,167,335,118
2024-01-20,EF,Finland,573,128,81,1,445,184,180,364,80
2024-01-21,EF,Finland,618,164,86,0,454,179,189,368,86
2024-01-22,EF,Finland,558,129,118,2,429,152,159,311,116
2024-01-23,EF,Finland,590,139,108,3,451,178,165,343,105
2024-01-24,EF,Finland,597,138,114,1,459,175,170,345,113
2024-01-25,EF,Finland,632,155,135,1,477,171,171,342,134
2024-01-26,EF,Finland,634,156,131,2,478,170,177,347,129
2024-01-27,EF,Finland,570,123,80,0,447,186,181,367,80
2024-01-28,EF,Finland,594,142,89,0,452,178,185,363,89
2024-01-29,EF,Finland,582,140,105,1,442,171,166,337,104
2024-01-30,EF,Finland,552,121,115,1,431,157,159,316,114
2024-01-31,EF,Finland,628,146,117,2,482,187,178,365,115
2024-02-01,EF,Finland,320,135,32,0,185,69,84,153,32
2024-02-02,EF,Finland,325,138,30,0,187,82,75,157,30
2024-02-03,EF,Finland,552,109,78,1,443,183,182,365,77
2024-02-04,EF,Finland,627,153,88,1,474,192,194,386,87
2024-02-05,EF,Finland,638,151,139,1,487,176,172,348,138
2024-02-06,EF,Finland,578,131,121,0,447,164,162,326,121
2024-02-07,EF,Finland,606,159,112,1,447,166,169,335,111
2024-02-08,EF,Finland,624,140,124,4,484,182,178,360,120
2024-02-09,EF,Finland,612,144,116,0,468,171,181,352,116
2024-02-10,EF,Finland,558,106,84,0,452,188,180,368,84
2024-02-11,EF,Finland,625,143,90,1,482,194,198,392,89
2024-02-12,EF,Finland,620,130,134,0,490,177,179,356,134
2024-02-13,EF,Finland,594,135,123,2,459,170,166,336,121
2024-02-14,EF,Finland,609,145,116,1,464,172,176,348,115
2024-02-15,EF,Finland,670,157,133,0,513,188,192,380,133
2024-02-16,EF,Finland,609,145,117,2,464,171,176,347,115
2024-02-17,EF,Finland,586,106,93,1,480,196,191,387,92
2024-02-18,EF,Finland,673,150,97,0,523,216,210,426,97
2024-02-19,EF,Finland,623,142,120,0,481,180,181,361,120
2024-02-20,EF,Finland,584,137,108,1,447,174,165,339,107
2024-02-21,EF,Finland,610,137,107,1,473,181,185,366,106
2024-02-22,EF,Finland,632,158,113,0,474,183,178,361,113
2024-02-23,EF,Finland,652,156,119,0,496,187,190,377,119
2024-02-24,EF,Finland,573,113,96,0,460,184,180,364,96
2024-02-25,EF,Finland,652,154,98,0,498,197,203,400,98
2024-02-26,EF,Finland,623,145,118,0,478,178,182,360,118
2024-02-27,EF,Finland,597,128,112,1,469,180,177,357,111
2024-02-28,EF,Finland,624,138,114,1,486,185,187,372,113
2024-02-29,EF,Finland,629,146,111,2,483,190,182,372,109
2024-03-01,EF,Finland,618,149,117,0,469,173,179,352,117
2024-03-02,EF,Finland,566,106,87,1,460,186,187,373,86
2024-03-03,EF,Finland,616,158,81,0,458,187,190,377,81
2024-03-04,EF,Finland,629,154,109,0,475,185,181,366,109
2024-03-05,EF,Finland,599,131,104,1,468,182,182,364,103
2024-03-06,EF,Finland,632,149,110,2,483,185,188,373,108
2024-03-07,EF,Finland,671,162,132,2,509,190,187,377,130
2024-03-08,EF,Finland,639,161,123,0,478,175,180,355,123
2024-03-09,EF,Finland,559,111,89,0,448,182,177,359,89
2024-03-10,EF,Finland,649,179,98,0,470,185,187,372,98
2024-03-11,EF,Finland,639,151,125,1,488,183,180,363,124
2024-03-12,EF,Finland,596,136,115,3,460,176,169,345,112
2024-03-13,EF,Finland,613,143,109,0,470,178,183,361,109
2024-03-14,EF,Finland,662,159,123,0,503,191,189,380,123
2024-03-15,EF,Finland,629,162,119,1,467,175,173,348,118
2024-03-16,EF,Finland,530,111,77,0,419,175,167,342,77
2024-03-17,EF,Finland,624,167,86,0,457,180,191,371,86
2024-03-18,EF,Finland,624,148,123,0,476,175,178,353,123
2024-03-19,EF,Finland,603,142,115,2,461,176,170,346,113
2024-03-20,EF,Finland,647,161,115,2,486,183,188,371,113
2024-03-21,EF,Finland,683,185,131,1,498,187,180,367,130
2024-03-22,EF,Finland,633,152,124,0,481,176,181,357,124
2024-03-23,EF,Finland,539,131,84,0,408,164,160,324,84
2024-03-24,EF,Finland,621,169,91,0,452,178,183,361,91
2024-03-25,EF,Finland,669,175,132,1,494,182,180,362,131
2024-03-26,EF,Finland,623,157,120,1,466,173,173,346,119
2024-03-27,EF,Finland,624,146,109,2,478,181,188,369,107
2024-03-28,EF,Finland,646,154,126,0,492,188,178,366,126
2024-03-29,EF,Finland,556,136,76,0,420,172,172,344,76
2024-03-30,EF,Finland,485,107,68,0,378,155,155,310,68
2024-03-31,EF,Finland,602,169,69,0,433,184,180,364,69
2024-04-01,EF,Finland,588,144,85,1,444,176,183,359,84
2024-04-02,EF,Finland,628,150,96,1,478,193,189,382,95
2024-04-03,EF,Finland,641,160,103,0,481,188,190,378,103
2024-04-04,EF,Finland,664,146,125,0,518,198,195,393,125
2024-04-05,EF,Finland,616,158,104,1,458,176,178,354,103
2024-04-06,EF,Finland,546,133,74,0,413,169,170,339,74
2024-04-07,EF,Finland,626,170,79,0,456,187,190,377,79
2024-04-08,EF,Finland,664,172,99,0,492,194,199,393,99
2024-04-09,EF,Finland,680,164,111,1,516,203,202,405,110
2024-04-10,EF,Finland,656,167,99,0,489,197,193,390,99
2024-04-11,EF,Finland,677,166,113,0,511,198,200,398,113
2024-04-12,EF,Finland,658,175,93,0,483,194,196,390,93
2024-04-13,EF,Finland,548,157,64,0,391,168,159,327,64
2024-04-14,EF,Finland,630,203,70,0,427,176,181,357,70
2024-04-15,EF,Finland,665,182,98,1,483,195,190,385,97
2024-04-16,EF,Finland,640,165,90,2,475,190,195,385,88
2024-04-17,EF,Finland,663,181,97,0,482,194,191,385,97
2024-04-18,EF,Finland,683,178,107,1,505,197,201,398,106
2024-04-19,EF,Finland,674,180,105,0,494,195,194,389,105
2024-04-20,EF,Finland,545,153,57,0,392,170,165,335,57
2024-04-21,EF,Finland,644,196,64,2,448,191,193,384,62
2024-04-22,EF,Finland,668,174,98,0,494,197,199,396,98
2024-04-23,EF,Finland,610,193,79,2,417,168,170,338,77
2024-04-24,EF,Finland,701,192,97,1,509,207,205,412,96
2024-04-25,EF,Finland,677,172,106,2,505,200,199,399,104
2024-04-26,EF,Finland,675,191,93,1,484,196,195,391,92
2024-04-27,EF,Finland,579,166,81,2,413,167,165,332,79
2024-04-28,EF,Finland,658,207,58,1,451,193,200,393,57
2024-04-29,EF,Finland,681,189,91,0,492,200,201,401,91
2024-04-30,EF,Finland,655,192,94,4,463,184,185,369,90
2024-05-01,EF,Finland,630,190,57,5,440,189,194,383,52
2024-05-02,EF,Finland,738,212,112,3,526,209,205,414,109
2024-05-03,EF,Finland,694,197,100,0,497,200,197,397,100
2024-05-04,EF,Finland,584,169,60,0,415,180,175,355,60
2024-05-05,EF,Finland,670,204,61,2,466,196,209,405,59
2024-05-06,EF,Finland,721,212,98,2,509,205,206,411,96
2024-05-07,EF,Finland,707,191,93,2,516,213,210,423,91
2024-05-08,EF,Finland,741,202,117,4,539,212,210,422,113
2024-05-09,EF,Finland,670,207,61,2,463,201,201,402,59
2024-05-10,EF,Finland,663,180,84,1,483,199,200,399,83
2024-05-11,EF,Finland,600,185,48,0,415,185,182,367,48
2024-05-12,EF,Finland,682,220,62,1,462,197,203,400,61
2024-05-13,EF,Finland,740,199,99,0,541,221,221,442,99
2024-05-14,EF,Finland,714,180,93,0,534,222,219,441,93
2024-05-15,EF,Finland,719,207,83,1,512,214,215,429,82
2024-05-16,EF,Finland,738,215,96,1,523,217,210,427,95
2024-05-17,EF,Finland,721,198,104,3,523,205,214,419,101
2024-05-18,EF,Finland,621,181,60,5,440,193,187,380,55
2024-05-19,EF,Finland,667,200,60,0,467,198,209,407,60
2024-05-20,EF,Finland,716,202,90,2,514,214,210,424,88
2024-05-21,EF,Finland,703,185,91,0,518,215,212,427,91
2024-05-22,EF,Finland,708,193,99,0,515,207,209,416,99
2024-05-23,EF,Finland,761,212,122,3,549,213,214,427,119
2024-05-24,EF,Finland,713,198,94,1,515,211,210,421,93
2024-05-25,EF,Finland,596,172,58,1,424,186,180,366,57
2024-05-26,EF,Finland,654,197,61,1,457,195,201,396,60
2024-05-27,EF,Finland,711,194,102,1,517,206,209,415,101
2024-05-28,EF,Finland,676,171,88,1,505,209,208,417,87
2024-05-29,EF,Finland,717,197,98,5,520,211,211,422,93
2024-05-30,EF,Finland,760,213,100,3,547,222,225,447,97
2024-05-31,EF,Finland,713,189,106,1,524,209,209,418,105
2024-06-01,EF,Finland,610,191,51,0,419,186,182,368,51
2024-06-02,EF,Finland,692,208,62,0,484,211,211,422,62
2024-06-03,EF,Finland,745,202,93,3,543,223,227,450,90
2024-06-04,EF,Finland,731,188,93,2,543,228,222,450,91
2024-06-05,EF,Finland,732,194,109,2,538,214,215,429,107
2024-06-06,EF,Finland,750,214,95,0,536,219,222,441,95
2024-06-07,EF,Finland,714,199,106,0,515,204,205,409,106
2024-06-08,EF,Finland,632,193,59,0,439,192,188,380,59
2024-06-09,EF,Finland,697,220,59,0,477,207,211,418,59
2024-06-10,EF,Finland,740,209,93,0,531,219,219,438,93
2024-06-11,EF,Finland,734,201,99,0,533,218,216,434,99
2024-06-12,EF,Finland,744,213,88,1,531,221,222,443,87
2024-06-13,EF,Finland,786,234,94,1,552,228,230,458,93
2024-06-14,EF,Finland,749,210,88,2,539,218,233,451,86
2024-06-15,EF,Finland,641,189,63,4,452,200,189,389,59
2024-06-16,EF,Finland,704,212,69,2,492,211,212,423,67
2024-06-17,EF,Finland,750,205,96,4,545,223,226,449,92
2024-06-18,EF,Finland,738,193,103,1,545,222,220,442,102
2024-06-19,EF,Finland,741,213,92,0,528,223,213,436,92
2024-06-20,EF,Finland,744,214,78,1,530,225,227,452,77
2024-06-21,EF,Finland,609,158,49,2,451,196,206,402,47
2024-06-22,EF,Finland,560,154,43,3,406,183,180,363,40
2024-06-23,EF,Finland,667,199,51,1,468,209,208,417,50
2024-06-24,EF,Finland,709,201,71,0,508,217,220,437,71
2024-06-25,EF,Finland,691,177,77,1,514,220,217,437,76
2024-06-26,EF,Finland,703,210,72,0,493,216,205,421,72
2024-06-27,EF,Finland,702,214,76,1,488,205,207,412,75
2024-06-28,EF,Finland,657,169,68,2,488,209,211,420,66
2024-06-29,EF,Finland,616,192,40,1,424,196,188,384,39
2024-06-30,EF,Finland,666,226,48,1,440,194,198,392,47
2024-07-01,EF,Finland,689,200,73,2,489,206,210,416,71
2024-07-02,EF,Finland,681,206,60,1,475,210,205,415,59
2024-07-03,EF,Finland,699,225,60,0,474,205,209,414,60
2024-07-04,EF,Finland,715,229,67,1,486,210,209,419,66
2024-07-05,EF,Finland,695,210,68,1,485,209,208,417,67
2024-07-06,EF,Finland,634,207,49,1,427,190,188,378,48
2024-07-07,EF,Finland,672,216,55,1,456,200,201,401,54
2024-07-08,EF,Finland,671,201,53,0,470,209,208,417,53
2024-07-09,EF,Finland,672,197,52,0,475,211,212,423,52
2024-07-10,EF,Finland,701,220,60,4,481,207,214,421,56
2024-07-11,EF,Finland,695,215,57,1,480,212,211,423,56
2024-07-12,EF,Finland,661,192,54,0,469,207,208,415,54
2024-07-13,EF,Finland,628,197,51,0,431,193,187,380,51
2024-07-14,EF,Finland,684,230,57,3,454,199,198,397,54
2024-07-15,EF,Finland,696,206,65,4,490,211,214,425,61
2024-07-16,EF,Finland,693,209,55,1,484,214,215,429,54
2024-07-17,EF,Finland,683,209,54,1,474,211,209,420,53
2024-07-18,EF,Finland,697,228,58,1,469,208,203,411,57
2024-07-19,EF,Finland,679,214,53,0,465,204,208,412,53
2024-07-20,EF,Finland,633,207,47,0,426,194,185,379,47
2024-07-21,EF,Finland,698,235,57,0,463,200,206,406,57
2024-07-22,EF,Finland,704,216,63,1,488,209,216,425,62
2024-07-23,EF,Finland,692,213,55,2,479,212,212,424,53
2024-07-24,EF,Finland,693,216,59,1,477,208,210,418,58
2024-07-25,EF,Finland,711,234,58,4,477,214,205,419,54
2024-07-26,EF,Finland,678,206,61,1,472,203,208,411,60
2024-07-27,EF,Finland,636,211,46,1,425,191,188,379,45
2024-07-28,EF,Finland,682,222,57,0,460,197,206,403,57
2024-07-29,EF,Finland,693,205,76,3,488,208,204,412,73
2024-07-30,EF,Finland,692,212,61,2,480,208,211,419,59
2024-01-01,LF,France,7333,4123,460,1,3210,1382,1368,2750,459
2024-01-02,LF,France,7895,4410,610,6,3485,1425,1450,2875,604
2024-01-03,LF,France,7680,4223,618,28,3457,1415,1424,2839,590
2024-01-04,LF,France,7960,4394,721,24,3566,1425,1420,2845,697
2024-01-05,LF,France,8410,4583,778,11,3827,1519,1530,3049,767
2024-01-06,LF,France,8126,4761,441,8,3365,1472,1452,2924,433
2024-01-07,LF,France,8382,4760,583,24,3622,1523,1516,3039,559
2024-01-08,LF,France,7675,4115,793,28,3560,1372,1395,2767,765
2024-01-09,LF,France,6050,3332,694,24,2718,1009,1015,2024,670
2024-01-10,LF,France,6118,3314,715,26,2804,1046,1043,2089,689
2024-01-11,LF,France,6452,3491,792,31,2961,1067,1102,2169,761
2024-01-12,LF,France,7503,4159,842,26,3344,1267,1235,2502,816
2024-01-13,LF,France,6832,4141,394,17,2691,1148,1149,2297,377
2024-01-14,LF,France,7304,4346,486,7,2958,1233,1239,2472,479
2024-01-15,LF,France,6862,3780,784,31,3082,1140,1158,2298,753
2024-01-16,LF,France,5831,3036,823,39,2795,989,983,1972,784
2024-01-17,LF,France,5569,2946,702,33,2623,960,961,1921,669
2024-01-18,LF,France,6298,3413,803,31,2885,1046,1036,2082,772
2024-01-19,LF,France,7479,4129,861,32,3350,1239,1250,2489,829
2024-01-20,LF,France,6698,4064,408,8,2634,1122,1104,2226,400
2024-01-21,LF,France,7020,4080,481,9,2940,1216,1243,2459,472
2024-01-22,LF,France,6943,3804,836,35,3139,1152,1151,2303,801
2024-01-23,LF,France,5753,2997,827,48,2756,957,972,1929,779
2024-01-24,LF,France,6114,3162,927,45,2952,1018,1007,2025,882
2024-01-25,LF,France,6558,3504,864,44,3054,1102,1088,2190,820
2024-01-26,LF,France,7400,4087,878,29,3313,1219,1216,2435,849
2024-01-27,LF,France,6799,4117,440,20,2682,1127,1115,2242,420
2024-01-28,LF,France,7272,4297,518,18,2975,1235,1222,2457,500
2024-01-29,LF,France,6931,3748,870,33,3183,1149,1164,2313,837
2024-01-30,LF,France,5900,3025,894,51,2875,988,993,1981,843
2024-01-31,LF,France,6231,3269,897,51,2962,1020,1045,2065,846
2024-02-01,LF,France,6711,3590,919,52,3121,1105,1097,2202,867
2024-02-02,LF,France,7581,4208,884,37,3373,1232,1257,2489,847
2024-02-03,LF,France,7058,4292,423,16,2766,1179,1164,2343,407
2024-02-04,LF,France,7488,4456,509,12,3032,1278,1245,2523,497
2024-02-05,LF,France,7245,3944,882,36,3301,1197,1222,2419,846
2024-02-06,LF,France,6082,3200,858,41,2882,1003,1021,2024,817
2024-02-07,LF,France,6090,3154,841,39,2936,1047,1048,2095,802
2024-02-08,LF,France,7126,3859,897,37,3267,1180,1190,2370,860
2024-02-09,LF,France,8138,4471,904,41,3667,1388,1375,2763,863
2024-02-10,LF,France,7832,4791,425,16,3041,1311,1305,2616,409
2024-02-11,LF,France,7851,4605,500,13,3246,1363,1383,2746,487
2024-02-12,LF,France,7523,4093,890,35,3430,1267,1273,2540,855
2024-02-13,LF,France,6436,3406,877,41,3030,1069,1084,2153,836
2024-02-14,LF,France,6746,3584,884,30,3162,1137,1141,2278,854
2024-02-15,LF,France,7744,4039,980,42,3705,1376,1349,2725,938
2024-02-16,LF,France,8566,4556,984,49,4010,1497,1529,3026,935
2024-02-17,LF,France,8159,4746,513,12,3413,1463,1437,2900,501
2024-02-18,LF,France,8543,4937,584,4,3606,1531,1491,3022,580
2024-02-19,LF,France,7950,4192,903,45,3758,1422,1433,2855,858
2024-02-20,LF,France,6724,3480,883,42,3244,1188,1173,2361,841
2024-02-21,LF,France,7029,3625,890,62,3404,1248,1266,2514,828
2024-02-22,LF,France,7337,3900,798,34,3437,1313,1326,2639,764
2024-02-23,LF,France,8276,4380,886,26,3896,1491,1519,3010,860
2024-02-24,LF,France,7946,4594,529,13,3352,1426,1397,2823,516
2024-02-25,LF,France,8269,4654,590,7,3615,1523,1502,3025,583
2024-02-26,LF,France,7889,4126,819,24,3763,1471,1473,2944,795
2024-02-27,LF,France,6813,3511,864,43,3302,1223,1215,2438,821
2024-02-28,LF,France,7058,3593,903,39,3465,1264,1298,2562,864
2024-02-29,LF,France,7659,4005,926,26,3654,1376,1352,2728,900
2024-03-01,LF,France,8380,4506,867,35,3874,1481,1526,3007,832
2024-03-02,LF,France,7878,4565,469,6,3313,1440,1404,2844,463
2024-03-03,LF,France,8224,4682,585,10,3542,1474,1483,2957,575
2024-03-04,LF,France,8092,4257,898,47,3835,1462,1475,2937,851
2024-03-05,LF,France,6991,3619,874,42,3372,1255,1243,2498,832
2024-03-06,LF,France,7271,3726,952,51,3545,1302,1291,2593,901
2024-03-07,LF,France,7859,4075,1095,82,3784,1343,1346,2689,1013
2024-03-08,LF,France,8466,4498,973,41,3968,1480,1515,2995,932
2024-03-09,LF,France,7881,4623,437,7,3258,1428,1393,2821,430
2024-03-10,LF,France,8297,4707,596,6,3590,1494,1500,2994,590
2024-03-11,LF,France,8356,4386,942,55,3970,1502,1526,3028,887
2024-03-12,LF,France,7161,3616,1097,68,3545,1217,1231,2448,1029
2024-03-13,LF,France,7201,3751,985,56,3450,1225,1240,2465,929
2024-03-14,LF,France,8043,4095,1199,52,3948,1381,1368,2749,1147
2024-03-15,LF,France,8671,4637,977,29,4034,1552,1505,3057,948
2024-03-16,LF,France,7974,4744,525,26,3230,1338,1367,2705,499
2024-03-17,LF,France,8440,4833,645,5,3607,1496,1466,2962,640
2024-03-18,LF,France,8303,4418,1031,56,3885,1425,1429,2854,975
2024-03-19,LF,France,7292,3782,1045,58,3510,1231,1234,2465,987
2024-03-20,LF,France,7381,3771,1025,43,3610,1287,1298,2585,982
2024-03-21,LF,France,7956,4178,1071,48,3778,1358,1349,2707,1023
2024-03-22,LF,France,9075,4871,1151,34,4204,1517,1536,3053,1117
2024-03-23,LF,France,8087,4849,472,10,3238,1389,1377,2766,462
2024-03-24,LF,France,8343,4845,574,7,3498,1467,1457,2924,567
2024-03-25,LF,France,8556,4609,1067,40,3947,1434,1446,2880,1027
2024-03-26,LF,France,7583,4195,856,32,3388,1260,1272,2532,824
2024-03-27,LF,France,7932,4321,961,38,3611,1343,1307,2650,923
2024-03-28,LF,France,8606,4745,998,31,3861,1410,1453,2863,967
2024-03-29,LF,France,8918,4895,1005,30,4023,1492,1526,3018,975
2024-03-30,LF,France,8194,4984,473,14,3210,1386,1351,2737,459
2024-03-31,LF,France,8873,5352,544,7,3521,1491,1486,2977,537
2024-04-01,LF,France,9224,5451,637,13,3773,1569,1567,3136,624
2024-04-02,LF,France,9100,5136,963,26,3964,1505,1496,3001,937
2024-04-03,LF,France,9037,5038,1018,35,3999,1484,1497,2981,983
2024-04-04,LF,France,9527,5288,989,34,4239,1625,1625,3250,955
2024-04-05,LF,France,9826,5361,1110,26,4465,1659,1696,3355,1084
2024-04-06,LF,France,9479,5761,519,12,3718,1623,1576,3199,507
2024-04-07,LF,France,9815,5760,678,20,4055,1708,1669,3377,658
2024-04-08,LF,France,9558,5261,998,33,4297,1635,1664,3299,965
2024-04-09,LF,France,9086,5075,892,28,4011,1566,1553,3119,864
2024-04-10,LF,France,9277,5081,982,33,4196,1591,1623,3214,949
2024-04-11,LF,France,9901,5313,1072,45,4588,1758,1758,3516,1027
2024-04-12,LF,France,10030,5452,1059,33,4578,1738,1781,3519,1026
2024-04-13,LF,France,9607,5741,569,12,3866,1652,1645,3297,557
2024-04-14,LF,France,9791,5711,670,7,4080,1742,1668,3410,663
2024-04-15,LF,France,9623,5299,928,22,4324,1701,1695,3396,906
2024-04-16,LF,France,9155,5093,888,63,4062,1591,1583,3174,825
2024-04-17,LF,France,9258,5137,924,54,4121,1599,1598,3197,870
2024-04-18,LF,France,9880,5413,918,36,4467,1763,1786,3549,882
2024-04-19,LF,France,10122,5499,1029,29,4623,1783,1811,3594,1000
2024-04-20,LF,France,9519,5642,600,19,3877,1643,1634,3277,581
2024-04-21,LF,France,9737,5575,726,12,4162,1721,1715,3436,714
2024-04-22,LF,France,9707,5316,951,31,4391,1715,1725,3440,920
2024-04-23,LF,France,9352,5155,944,43,4197,1623,1630,3253,901
2024-04-24,LF,France,9526,5220,967,52,4306,1688,1651,3339,915
2024-04-25,LF,France,7389,4963,460,29,2426,969,997,1966,431
2024-04-26,LF,France,9998,5338,1038,47,4660,1800,1822,3622,991
2024-04-27,LF,France,9423,5619,555,12,3804,1627,1622,3249,543
2024-04-28,LF,France,9643,5548,700,16,4095,1714,1681,3395,684
2024-04-29,LF,France,9861,5317,1072,56,4544,1717,1755,3472,1016
2024-04-30,LF,France,9469,5191,964,58,4278,1664,1650,3314,906
2024-05-01,LF,France,9337,5513,603,24,3824,1603,1618,3221,579
2024-05-02,LF,France,9953,5529,975,37,4424,1714,1735,3449,938
2024-05-03,LF,France,10343,5764,1023,44,4579,1778,1778,3556,979
2024-05-04,LF,France,9928,6027,591,12,3901,1664,1646,3310,579
2024-05-05,LF,France,10055,5846,697,11,4209,1768,1744,3512,686
2024-05-06,LF,France,10152,5593,1024,56,4559,1769,1766,3535,968
2024-05-07,LF,France,9887,5458,995,71,4429,1705,1729,3434,924
2024-05-08,LF,France,9885,5606,771,30,4279,1754,1754,3508,741
2024-05-09,LF,France,10043,5864,674,36,4179,1722,1783,3505,638
2024-05-10,LF,France,10155,5778,834,26,4377,1747,1796,3543,808
2024-05-11,LF,France,10080,6087,597,17,3993,1699,1697,3396,580
2024-05-12,LF,France,10739,6070,850,12,4669,1904,1915,3819,838
2024-05-13,LF,France,10536,5695,1122,27,4841,1879,1840,3719,1095
2024-05-14,LF,France,9836,5461,1002,35,4375,1695,1678,3373,967
2024-05-15,LF,France,9908,5429,1060,39,4479,1706,1713,3419,1021
2024-05-16,LF,France,10415,5682,1081,49,4733,1816,1836,3652,1032
2024-05-17,LF,France,10775,5793,1228,50,4982,1870,1884,3754,1178
2024-05-18,LF,France,10078,6038,636,22,4040,1708,1696,3404,614
2024-05-19,LF,France,10162,6020,698,10,4142,1730,1714,3444,688
2024-05-20,LF,France,10326,5803,906,22,4523,1810,1807,3617,884
2024-05-21,LF,France,10013,5505,1029,37,4508,1738,1741,3479,992
2024-05-22,LF,France,10352,5685,1102,40,4667,1781,1784,3565,1062
2024-05-23,LF,France,10967,5905,1161,71,5062,1914,1987,3901,1090
2024-05-24,LF,France,11218,6086,1206,63,5132,1933,1993,3926,1143
2024-05-25,LF,France,10336,6400,634,25,3936,1640,1662,3302,609
2024-05-26,LF,France,10468,6221,716,8,4247,1802,1729,3531,708
2024-05-27,LF,France,11004,5923,1155,23,5081,1992,1934,3926,1132
2024-05-28,LF,France,10457,5789,1125,36,4668,1774,1769,3543,1089
2024-05-29,LF,France,10440,5814,1115,53,4626,1742,1769,3511,1062
2024-05-30,LF,France,10857,5955,1149,54,4902,1863,1890,3753,1095
2024-05-31,LF,France,11100,6087,1187,52,5013,1904,1922,3826,1135
2024-06-01,LF,France,10709,6519,617,13,4190,1798,1775,3573,604
2024-06-02,LF,France,11225,6628,804,16,4597,1902,1891,3793,788
2024-06-03,LF,France,10949,6034,1168,45,4915,1855,1892,3747,1123
2024-06-04,LF,France,10562,5956,1048,39,4606,1778,1780,3558,1009
2024-06-05,LF,France,10748,5952,1173,52,4796,1777,1846,3623,1121
2024-06-06,LF,France,10876,5975,1159,44,4901,1846,1896,3742,1115
2024-06-07,LF,France,11327,6142,1217,40,5185,1982,1986,3968,1177
2024-06-08,LF,France,10515,6375,632,12,4140,1748,1760,3508,620
2024-06-09,LF,France,10817,6250,731,8,4567,1957,1879,3836,723
2024-06-10,LF,France,11144,6016,1210,32,5128,1972,1946,3918,1178
2024-06-11,LF,France,10519,5913,1079,26,4606,1761,1766,3527,1053
2024-06-12,LF,France,10907,6024,1126,43,4883,1895,1862,3757,1083
2024-06-13,LF,France,11217,6194,1128,35,5023,1928,1967,3895,1093
2024-06-14,LF,France,11507,6252,1242,34,5255,1997,2016,4013,1208
2024-06-15,LF,France,10631,6409,612,7,4222,1805,1805,3610,605
2024-06-16,LF,France,11131,6407,809,7,4724,1991,1924,3915,802
2024-06-17,LF,France,11026,6049,1118,19,4977,1910,1949,3859,1099
2024-06-18,LF,France,10645,5927,1047,29,4718,1840,1831,3671,1018
2024-06-19,LF,France,10929,6038,1119,26,4891,1885,1887,3772,1093
2024-06-20,LF,France,11189,6071,1104,42,5118,2006,2008,4014,1062
2024-06-21,LF,France,11603,6402,1153,43,5201,2012,2036,4048,1110
2024-06-22,LF,France,10890,6644,634,12,4246,1812,1800,3612,622
2024-06-23,LF,France,11208,6536,781,10,4672,1954,1937,3891,771
2024-06-24,LF,France,11249,6195,1130,35,5054,1945,1979,3924,1095
2024-06-25,LF,France,10845,6048,1071,25,4797,1861,1865,3726,1046
2024-06-26,LF,France,11136,6203,1134,34,4933,1905,1894,3799,1100
2024-06-27,LF,France,11590,6461,1169,50,5129,1971,1989,3960,1119
2024-06-28,LF,France,11763,6515,1193,39,5248,2033,2022,4055,1154
2024-06-29,LF,France,10662,6371,662,9,4291,1815,1814,3629,653
2024-06-30,LF,France,11440,6814,734,6,4626,1966,1926,3892,728
2024-07-01,LF,France,11616,6475,1152,44,5141,1990,1999,3989,1108
2024-07-02,LF,France,11320,6445,1117,49,4875,1879,1879,3758,1068
2024-07-03,LF,France,11267,6326,1125,43,4941,1907,1909,3816,1082
2024-07-04,LF,France,11480,6320,1167,48,5160,1991,2002,3993,1119
2024-07-05,LF,France,11810,6549,1182,39,5261,2023,2056,4079,1143
2024-07-06,LF,France,11259,6737,697,10,4522,1926,1899,3825,687
2024-07-07,LF,France,11503,6753,754,11,4750,2009,1987,3996,743
2024-07-08,LF,France,11424,6388,1078,41,5036,1974,1984,3958,1037
2024-07-09,LF,France,11045,6242,997,51,4803,1904,1902,3806,946
2024-07-10,LF,France,11436,6488,1092,39,4948,1941,1915,3856,1053
2024-07-11,LF,France,11553,6472,1093,35,5081,1976,2012,3988,1058
2024-07-12,LF,France,11476,6488,992,42,4988,1989,2007,3996,950
2024-07-13,LF,France,11435,6786,766,14,4649,1948,1935,3883,752
2024-07-14,LF,France,11349,6700,727,16,4649,1962,1960,3922,711
2024-07-15,LF,France,11416,6274,1058,35,5142,2039,2045,4084,1023
2024-07-16,LF,France,11217,6296,1041,42,4921,1930,1950,3880,999
2024-07-17,LF,France,11484,6509,1060,43,4975,1962,1953,3915,1017
2024-07-18,LF,France,11541,6460,1048,69,5081,2018,2015,4033,979
2024-07-19,LF,France,10968,6034,1045,50,4934,1929,1960,3889,995
2024-07-20,LF,France,11297,6730,729,17,4567,1942,1896,3838,712
2024-07-21,LF,France,11252,6739,671,8,4513,1926,1916,3842,663
2024-07-22,LF,France,11488,6444,999,28,5044,2008,2037,4045,971
2024-07-23,LF,France,11130,6309,937,45,4821,1939,1945,3884,892
2024-07-24,LF,France,11386,6392,1018,51,4994,1965,2011,3976,967
2024-07-25,LF,France,11594,6381,988,32,5213,2075,2150,4225,956
2024-07-26,LF,France,10748,6372,830,30,4376,1756,1790,3546,800
2024-07-27,LF,France,11540,6813,764,12,4727,2010,1953,3963,752
2024-07-28,LF,France,11587,6747,706,9,4840,2082,2052,4134,697
2024-07-29,LF,France,11328,6428,866,22,4900,2019,2015,4034,844
2024-07-30,LF,France,10898,6227,822,36,4671,1926,1923,3849,786
2024-01-01,UG,Georgia,518,395,0,0,123,58,65,123,0
2024-01-02,UG,Georgia,614,462,0,0,152,76,76,152,0
2024-01-03,UG,Georgia,590,453,2,0,137,68,67,135,2
2024-01-04,UG,Georgia,601,461,0,0,140,69,71,140,0
2024-01-05,UG,Georgia,641,487,3,0,154,76,75,151,3
2024-01-06,UG,Georgia,616,476,0,0,140,71,69,140,0
2024-01-07,UG,Georgia,628,476,2,0,152,74,76,150,2
2024-01-08,UG,Georgia,602,461,0,0,141,73,68,141,0
2024-01-09,UG,Georgia,609,463,0,0,146,72,74,146,0
2024-01-10,UG,Georgia,588,452,3,0,136,66,67,133,3
2024-01-11,UG,Georgia,599,458,3,0,141,70,68,138,3
2024-01-12,UG,Georgia,627,484,0,0,143,69,74,143,0
2024-01-13,UG,Georgia,604,473,1,0,131,66,64,130,1
2024-01-14,UG,Georgia,621,469,0,0,152,77,75,152,0
2024-01-15,UG,Georgia,563,433,2,0,130,66,62,128,2
2024-01-16,UG,Georgia,592,460,1,1,132,64,67,131,0
2024-01-17,UG,Georgia,545,412,2,0,133,66,65,131,2
2024-01-18,UG,Georgia,575,430,0,0,145,73,72,145,0
2024-01-19,UG,Georgia,592,452,2,0,140,67,71,138,2
2024-01-20,UG,Georgia,608,484,0,0,124,63,61,124,0
2024-01-21,UG,Georgia,595,450,2,0,145,71,72,143,2
2024-01-22,UG,Georgia,556,441,0,0,115,57,58,115,0
2024-01-23,UG,Georgia,575,444,0,0,131,64,67,131,0
2024-01-24,UG,Georgia,577,459,2,0,118,58,58,116,2
2024-01-25,UG,Georgia,598,463,0,0,135,67,68,135,0
2024-01-26,UG,Georgia,590,445,2,0,145,73,70,143,2
2024-01-27,UG,Georgia,587,459,1,0,128,65,62,127,1
2024-01-28,UG,Georgia,608,468,2,0,140,70,68,138,2
2024-01-29,UG,Georgia,526,419,0,0,107,55,52,107,0
2024-01-30,UG,Georgia,569,447,0,0,122,61,61,122,0
2024-01-31,UG,Georgia,557,446,2,0,111,55,54,109,2
2024-02-01,UG,Georgia,541,410,0,0,131,63,68,131,0
2024-02-02,UG,Georgia,599,457,1,1,142,71,70,141,0
2024-02-03,UG,Georgia,583,468,0,0,115,57,58,115,0
2024-02-04,UG,Georgia,601,466,0,0,135,66,69,135,0
2024-02-05,UG,Georgia,549,440,0,0,109,56,53,109,0
2024-02-06,UG,Georgia,559,435,0,0,124,62,62,124,0
2024-02-07,UG,Georgia,538,425,0,0,113,57,56,113,0
2024-02-08,UG,Georgia,557,410,1,0,147,71,75,146,1
2024-02-09,UG,Georgia,582,439,0,0,143,72,71,143,0
2024-02-10,UG,Georgia,576,441,2,0,135,66,67,133,2
2024-02-11,UG,Georgia,590,453,2,0,137,67,68,135,2
2024-02-12,UG,Georgia,533,421,0,0,112,57,55,112,0
2024-02-13,UG,Georgia,512,382,1,0,130,64,65,129,1
2024-02-14,UG,Georgia,516,404,1,0,112,56,55,111,1
2024-02-15,UG,Georgia,537,403,0,0,134,67,67,134,0
2024-02-16,UG,Georgia,551,428,1,0,123,65,57,122,1
2024-02-17,UG,Georgia,572,442,0,0,130,60,70,130,0
2024-02-18,UG,Georgia,605,460,0,0,145,73,72,145,0
2024-02-19,UG,Georgia,529,418,1,1,111,55,55,110,0
2024-02-20,UG,Georgia,552,431,0,0,121,60,61,121,0
2024-02-21,UG,Georgia,535,425,1,1,110,56,53,109,0
2024-02-22,UG,Georgia,566,427,0,0,139,66,73,139,0
2024-02-23,UG,Georgia,618,473,1,1,145,75,69,144,0
2024-02-24,UG,Georgia,585,460,0,0,125,63,62,125,0
2024-02-25,UG,Georgia,640,496,0,0,144,71,73,144,0
2024-02-26,UG,Georgia,567,452,0,0,115,59,56,115,0
2024-02-27,UG,Georgia,575,446,0,0,129,64,65,129,0
2024-02-28,UG,Georgia,548,428,0,0,120,57,63,120,0
2024-02-29,UG,Georgia,570,426,0,0,144,73,71,144,0
2024-03-01,UG,Georgia,599,457,0,0,142,73,69,142,0
2024-03-02,UG,Georgia,607,480,0,0,127,62,65,127,0
2024-03-03,UG,Georgia,617,478,0,0,139,68,71,139,0
2024-03-04,UG,Georgia,549,431,1,0,118,61,56,117,1
2024-03-05,UG,Georgia,577,437,0,0,140,66,74,140,0
2024-03-06,UG,Georgia,555,440,2,0,115,57,56,113,2
2024-03-07,UG,Georgia,596,448,1,0,148,73,74,147,1
2024-03-08,UG,Georgia,587,442,1,0,145,74,70,144,1
2024-03-09,UG,Georgia,586,462,0,0,124,61,63,124,0
2024-03-10,UG,Georgia,609,463,2,0,146,74,70,144,2
2024-03-11,UG,Georgia,563,448,0,0,115,58,57,115,0
2024-03-12,UG,Georgia,595,453,0,0,142,70,72,142,0
2024-03-13,UG,Georgia,551,449,0,0,102,53,49,102,0
2024-03-14,UG,Georgia,574,431,0,0,143,67,76,143,0
2024-03-15,UG,Georgia,601,456,0,0,145,75,70,145,0
2024-03-16,UG,Georgia,640,507,1,1,133,67,65,132,0
2024-03-17,UG,Georgia,647,498,0,0,149,74,75,149,0
2024-03-18,UG,Georgia,586,462,0,0,124,60,64,124,0
2024-03-19,UG,Georgia,615,472,4,0,143,71,68,139,4
2024-03-20,UG,Georgia,605,488,1,0,117,56,60,116,1
2024-03-21,UG,Georgia,641,486,3,0,155,77,75,152,3
2024-03-22,UG,Georgia,620,483,0,0,137,70,67,137,0
2024-03-23,UG,Georgia,613,484,0,0,129,63,66,129,0
2024-03-24,UG,Georgia,651,496,2,0,155,78,75,153,2
2024-03-25,UG,Georgia,577,456,1,1,121,62,58,120,0
2024-03-26,UG,Georgia,609,475,3,1,134,62,69,131,2
2024-03-27,UG,Georgia,604,491,0,0,113,57,56,113,0
2024-03-28,UG,Georgia,615,467,2,0,148,72,74,146,2
2024-03-29,UG,Georgia,635,492,0,0,143,72,71,143,0
2024-03-30,UG,Georgia,682,537,0,0,145,72,73,145,0
2024-03-31,UG,Georgia,678,534,2,0,144,69,73,142,2
2024-04-01,UG,Georgia,589,463,0,0,126,64,62,126,0
2024-04-02,UG,Georgia,665,525,2,0,140,71,67,138,2
2024-04-03,UG,Georgia,615,482,0,0,133,66,67,133,0
2024-04-04,UG,Georgia,661,514,3,0,147,73,71,144,3
2024-04-05,UG,Georgia,669,512,1,1,157,76,80,156,0
2024-04-06,UG,Georgia,679,531,1,1,148,75,72,147,0
2024-04-07,UG,Georgia,683,524,2,0,159,80,77,157,2
2024-04-08,UG,Georgia,651,505,0,0,146,72,74,146,0
2024-04-09,UG,Georgia,709,532,3,0,177,86,88,174,3
2024-04-10,UG,Georgia,669,508,2,0,161,79,80,159,2
2024-04-11,UG,Georgia,712,545,2,0,167,84,81,165,2
2024-04-12,UG,Georgia,732,577,1,0,155,74,80,154,1
2024-04-13,UG,Georgia,763,595,0,0,168,84,84,168,0
2024-04-14,UG,Georgia,845,676,2,0,169,84,83,167,2
2024-04-15,UG,Georgia,734,589,0,0,145,74,71,145,0
2024-04-16,UG,Georgia,796,643,2,0,153,75,76,151,2
2024-04-17,UG,Georgia,771,634,0,0,137,66,71,137,0
2024-04-18,UG,Georgia,842,668,2,0,174,92,80,172,2
2024-04-19,UG,Georgia,849,697,0,0,152,73,79,152,0
2024-04-20,UG,Georgia,847,690,0,0,157,80,77,157,0
2024-04-21,UG,Georgia,855,694,2,0,161,79,80,159,2
2024-04-22,UG,Georgia,769,627,1,0,142,71,70,141,1
2024-04-23,UG,Georgia,812,663,2,0,149,74,73,147,2
2024-04-24,UG,Georgia,791,644,1,1,147,73,73,146,0
2024-04-25,UG,Georgia,854,694,1,0,160,79,80,159,1
2024-04-26,UG,Georgia,865,714,0,0,151,74,77,151,0
2024-04-27,UG,Georgia,883,737,0,0,146,74,72,146,0
2024-04-28,UG,Georgia,875,723,0,0,152,77,75,152,0
2024-04-29,UG,Georgia,805,661,2,0,144,70,72,142,2
2024-04-30,UG,Georgia,850,687,2,0,163,80,81,161,2
2024-05-01,UG,Georgia,851,697,0,0,154,73,81,154,0
2024-05-02,UG,Georgia,842,672,3,0,170,87,80,167,3
2024-05-03,UG,Georgia,871,703,0,0,168,83,85,168,0
2024-05-04,UG,Georgia,857,702,0,0,155,77,78,155,0
2024-05-05,UG,Georgia,868,697,2,0,171,84,85,169,2
2024-05-06,UG,Georgia,787,627,0,0,160,81,79,160,0
2024-05-07,UG,Georgia,828,673,4,0,155,76,75,151,4
2024-05-08,UG,Georgia,861,714,2,0,147,70,75,145,2
2024-05-09,UG,Georgia,891,713,3,1,178,92,83,175,2
2024-05-10,UG,Georgia,876,712,0,0,164,78,86,164,0
2024-05-11,UG,Georgia,908,753,0,0,155,79,76,155,0
2024-05-12,UG,Georgia,894,720,2,0,174,85,87,172,2
2024-05-13,UG,Georgia,828,667,0,0,161,81,80,161,0
2024-05-14,UG,Georgia,877,718,2,0,159,81,76,157,2
2024-05-15,UG,Georgia,866,709,0,0,157,76,81,157,0
2024-05-16,UG,Georgia,893,709,3,1,184,93,88,181,2
2024-05-17,UG,Georgia,879,708,0,0,171,83,88,171,0
2024-05-18,UG,Georgia,903,752,0,0,151,78,73,151,0
2024-05-19,UG,Georgia,899,723,2,0,176,84,90,174,2
2024-05-20,UG,Georgia,805,640,0,0,165,81,84,165,0
2024-05-21,UG,Georgia,830,676,2,0,154,78,74,152,2
2024-05-22,UG,Georgia,848,676,2,1,172,80,90,170,1
2024-05-23,UG,Georgia,884,707,2,0,177,90,85,175,2
2024-05-24,UG,Georgia,868,696,0,0,172,86,86,172,0
2024-05-25,UG,Georgia,889,725,0,0,164,85,79,164,0
2024-05-26,UG,Georgia,882,709,2,0,173,82,89,171,2
2024-05-27,UG,Georgia,808,640,0,0,168,86,82,168,0
2024-05-28,UG,Georgia,823,667,2,0,156,79,75,154,2
2024-05-29,UG,Georgia,877,716,0,0,161,77,84,161,0
2024-05-30,UG,Georgia,871,680,5,0,191,96,90,186,5
2024-05-31,UG,Georgia,888,709,0,0,179,89,90,179,0
2024-06-01,UG,Georgia,921,757,0,0,164,82,82,164,0
2024-06-02,UG,Georgia,931,744,0,0,187,91,96,187,0
2024-06-03,UG,Georgia,859,677,0,0,182,94,88,182,0
2024-06-04,UG,Georgia,884,722,3,1,162,81,78,159,2
2024-06-05,UG,Georgia,912,735,3,1,177,83,91,174,2
2024-06-06,UG,Georgia,898,714,2,0,184,95,87,182,2
2024-06-07,UG,Georgia,932,736,0,0,196,95,101,196,0
2024-06-08,UG,Georgia,933,764,0,0,169,86,83,169,0
2024-06-09,UG,Georgia,919,737,2,0,182,89,91,180,2
2024-06-10,UG,Georgia,908,720,1,1,188,94,93,187,0
2024-06-11,UG,Georgia,871,704,2,0,167,85,80,165,2
2024-06-12,UG,Georgia,899,721,0,0,178,84,94,178,0
2024-06-13,UG,Georgia,919,723,2,0,196,100,94,194,2
2024-06-14,UG,Georgia,980,758,0,0,222,108,114,222,0
2024-06-15,UG,Georgia,951,759,0,0,192,98,94,192,0
2024-06-16,UG,Georgia,956,737,2,0,219,109,108,217,2
2024-06-17,UG,Georgia,886,674,0,0,212,106,106,212,0
2024-06-18,UG,Georgia,901,696,5,1,205,103,97,200,4
2024-06-19,UG,Georgia,930,708,0,0,222,105,117,222,0
2024-06-20,UG,Georgia,902,690,2,0,212,106,104,210,2
2024-06-21,UG,Georgia,924,698,2,0,226,112,112,224,2
2024-06-22,UG,Georgia,965,775,0,0,190,99,91,190,0
2024-06-23,UG,Georgia,969,753,3,0,216,101,112,213,3
2024-06-24,UG,Georgia,887,692,0,0,195,98,97,195,0
2024-06-25,UG,Georgia,872,676,3,0,196,99,94,193,3
2024-06-26,UG,Georgia,900,696,2,0,204,100,102,202,2
2024-06-27,UG,Georgia,919,704,2,0,215,109,104,213,2
2024-06-28,UG,Georgia,956,747,2,0,209,100,107,207,2
2024-06-29,UG,Georgia,912,720,0,0,192,99,93,192,0
2024-06-30,UG,Georgia,929,724,2,0,205,97,106,203,2
2024-07-01,UG,Georgia,922,712,4,1,210,102,104,206,3
2024-07-02,UG,Georgia,914,705,3,1,209,106,100,206,2
2024-07-03,UG,Georgia,948,750,2,1,198,96,100,196,1
2024-07-04,UG,Georgia,934,727,4,1,207,103,100,203,3
2024-07-05,UG,Georgia,947,723,5,0,224,111,108,219,5
2024-07-06,UG,Georgia,873,697,0,0,176,88,88,176,0
2024-07-07,UG,Georgia,929,713,2,0,216,104,110,214,2
2024-07-08,UG,Georgia,893,690,4,0,203,100,99,199,4
2024-07-09,UG,Georgia,873,677,2,0,196,100,94,194,2
2024-07-10,UG,Georgia,917,702,1,1,215,103,111,214,0
2024-07-11,UG,Georgia,934,716,2,0,218,112,104,216,2
2024-07-12,UG,Georgia,940,712,2,0,228,110,116,226,2
2024-07-13,UG,Georgia,892,702,0,0,190,97,93,190,0
2024-07-14,UG,Georgia,948,734,3,0,214,105,106,211,3
2024-07-15,UG,Georgia,885,668,2,0,217,107,108,215,2
2024-07-16,UG,Georgia,902,699,0,0,203,102,101,203,0
2024-07-17,UG,Georgia,906,689,1,1,217,106,110,216,0
2024-07-18,UG,Georgia,927,705,2,0,222,113,107,220,2
2024-07-19,UG,Georgia,916,702,2,0,214,103,109,212,2
2024-07-20,UG,Georgia,886,692,1,0,194,100,93,193,1
2024-07-21,UG,Georgia,866,662,2,0,204,98,104,202,2
2024-07-22,UG,Georgia,857,648,2,0,209,104,103,207,2
2024-07-23,UG,Georgia,862,648,2,0,214,109,103,212,2
2024-07-24,UG,Georgia,887,670,0,0,217,104,113,217,0
2024-07-25,UG,Georgia,906,674,3,1,232,120,109,229,2
2024-07-26,UG,Georgia,906,682,2,0,224,108,114,222,2
2024-07-27,UG,Georgia,885,703,0,0,182,95,87,182,0
2024-07-28,UG,Georgia,911,695,2,0,216,104,110,214,2
2024-07-29,UG,Georgia,889,678,3,1,211,106,102,208,2
2024-07-30,UG,Georgia,863,659,2,0,204,101,101,202,2
2024-01-01,ED,Germany,5950,3008,227,3,2942,1384,1331,2715,224
2024-01-02,ED,Germany,6684,3097,354,11,3587,1631,1602,3233,343
2024-01-03,ED,Germany,6843,3132,360,22,3711,1679,1672,3351,338
2024-01-04,ED,Germany,6920,3155,369,17,3765,1693,1703,3396,352
2024-01-05,ED,Germany,7406,3332,424,25,4074,1814,1836,3650,399
2024-01-06,ED,Germany,6900,3391,266,4,3509,1632,1611,3243,262
2024-01-07,ED,Germany,7149,3354,319,1,3795,1721,1755,3476,318
2024-01-08,ED,Germany,6997,3097,496,17,3900,1692,1712,3404,479
2024-01-09,ED,Germany,6082,2540,546,22,3542,1494,1502,2996,524
2024-01-10,ED,Germany,6303,2636,594,34,3667,1540,1533,3073,560
2024-01-11,ED,Germany,6487,2762,573,19,3725,1576,1576,3152,554
2024-01-12,ED,Germany,6996,3134,458,7,3862,1706,1698,3404,451
2024-01-13,ED,Germany,6150,3063,291,5,3087,1406,1390,2796,286
2024-01-14,ED,Germany,6700,3199,353,7,3501,1557,1591,3148,346
2024-01-15,ED,Germany,6547,2965,452,11,3582,1527,1603,3130,441
2024-01-16,ED,Germany,5794,2444,536,27,3350,1411,1403,2814,509
2024-01-17,ED,Germany,4886,2547,314,22,2339,1007,1018,2025,292
2024-01-18,ED,Germany,6041,2766,454,22,3275,1414,1407,2821,432
2024-01-19,ED,Germany,7066,3121,547,23,3945,1727,1671,3398,524
2024-01-20,ED,Germany,6168,3038,385,10,3130,1384,1361,2745,375
2024-01-21,ED,Germany,6453,3036,415,14,3417,1485,1517,3002,401
2024-01-22,ED,Germany,6534,2867,484,16,3667,1582,1601,3183,468
2024-01-23,ED,Germany,5891,2401,616,43,3490,1441,1433,2874,573
2024-01-24,ED,Germany,5949,2435,523,16,3514,1501,1490,2991,507
2024-01-25,ED,Germany,6479,2669,645,31,3810,1575,1590,3165,614
2024-01-26,ED,Germany,6941,3039,568,20,3902,1673,1661,3334,548
2024-01-27,ED,Germany,6349,3096,447,15,3253,1415,1391,2806,432
2024-01-28,ED,Germany,6693,3132,449,6,3561,1552,1560,3112,443
2024-01-29,ED,Germany,6839,3013,598,18,3826,1582,1646,3228,580
2024-01-30,ED,Germany,6085,2502,640,34,3583,1473,1470,2943,606
2024-01-31,ED,Germany,6401,2648,678,23,3753,1562,1513,3075,655
2024-02-01,ED,Germany,5986,2793,489,25,3193,1340,1364,2704,464
2024-02-02,ED,Germany,7166,3015,604,28,4151,1790,1757,3547,576
2024-02-03,ED,Germany,6321,3076,353,4,3245,1469,1423,2892,349
2024-02-04,ED,Germany,6747,3220,354,3,3527,1565,1608,3173,351
2024-02-05,ED,Germany,6865,2970,574,26,3895,1637,1684,3321,548
2024-02-06,ED,Germany,6095,2523,589,37,3572,1489,1494,2983,552
2024-02-07,ED,Germany,5602,2644,407,31,2958,1257,1294,2551,376
2024-02-08,ED,Germany,6763,2907,589,31,3856,1682,1585,3267,558
2024-02-09,ED,Germany,7439,3245,565,21,4194,1808,1821,3629,544
2024-02-10,ED,Germany,6912,3385,455,13,3527,1562,1510,3072,442
2024-02-11,ED,Germany,6974,3322,361,5,3652,1647,1644,3291,356
2024-02-12,ED,Germany,6936,3058,517,19,3878,1650,1711,3361,498
2024-02-13,ED,Germany,6291,2504,634,31,3787,1569,1584,3153,603
2024-02-14,ED,Germany,6698,2737,594,26,3961,1695,1672,3367,568
2024-02-15,ED,Germany,7200,2953,710,18,4247,1750,1787,3537,692
2024-02-16,ED,Germany,7787,3319,656,25,4468,1895,1917,3812,631
2024-02-17,ED,Germany,7094,3464,419,7,3630,1635,1576,3211,412
2024-02-18,ED,Germany,7394,3447,476,6,3947,1740,1731,3471,470
2024-02-19,ED,Germany,7232,3194,621,16,4038,1684,1733,3417,605
2024-02-20,ED,Germany,5677,2684,463,40,2993,1241,1289,2530,423
2024-02-21,ED,Germany,6858,2873,733,42,3985,1652,1600,3252,691
2024-02-22,ED,Germany,7135,3084,629,26,4051,1747,1675,3422,603
2024-02-23,ED,Germany,7702,3401,633,16,4301,1817,1851,3668,617
2024-02-24,ED,Germany,6949,3414,399,11,3535,1582,1554,3136,388
2024-02-25,ED,Germany,7320,3424,460,8,3896,1713,1723,3436,452
2024-02-26,ED,Germany,7424,3248,621,35,4176,1760,1795,3555,586
2024-02-27,ED,Germany,6642,2707,692,43,3935,1615,1628,3243,649
2024-02-28,ED,Germany,7023,2865,696,31,4158,1719,1743,3462,665
2024-02-29,ED,Germany,7458,3079,760,34,4379,1822,1797,3619,726
2024-03-01,ED,Germany,7824,3361,668,20,4463,1905,1890,3795,648
2024-03-02,ED,Germany,6935,3379,381,15,3556,1600,1575,3175,366
2024-03-03,ED,Germany,7475,3488,486,8,3987,1743,1758,3501,478
2024-03-04,ED,Germany,7638,3289,672,28,4349,1813,1864,3677,644
2024-03-05,ED,Germany,6849,2772,714,48,4077,1690,1673,3363,666
2024-03-06,ED,Germany,7040,2908,694,25,4132,1712,1726,3438,669
2024-03-07,ED,Germany,6464,3111,536,39,3353,1373,1444,2817,497
2024-03-08,ED,Germany,6958,3421,521,31,3537,1515,1501,3016,490
2024-03-09,ED,Germany,6702,3357,357,4,3345,1556,1432,2988,353
2024-03-10,ED,Germany,7457,3437,491,6,4020,1753,1776,3529,485
2024-03-11,ED,Germany,7721,3394,669,28,4327,1809,1849,3658,641
2024-03-12,ED,Germany,6313,2823,564,28,3490,1449,1477,2926,536
2024-03-13,ED,Germany,6705,2884,595,24,3821,1628,1598,3226,571
2024-03-14,ED,Germany,7290,3063,672,26,4227,1790,1765,3555,646
2024-03-15,ED,Germany,8091,3398,674,19,4693,2012,2007,4019,655
2024-03-16,ED,Germany,7013,3302,421,10,3711,1657,1633,3290,411
2024-03-17,ED,Germany,7625,3490,478,8,4135,1810,1847,3657,470
2024-03-18,ED,Germany,7808,3354,687,29,4454,1871,1896,3767,658
2024-03-19,ED,Germany,7067,2791,743,32,4276,1751,1782,3533,711
2024-03-20,ED,Germany,7520,3001,800,38,4519,1870,1849,3719,762
2024-03-21,ED,Germany,7735,3148,732,26,4587,1930,1925,3855,706
2024-03-22,ED,Germany,8417,3469,748,32,4948,2100,2100,4200,716
2024-03-23,ED,Germany,7235,3335,384,7,3900,1791,1725,3516,377
2024-03-24,ED,Germany,7440,3303,360,5,4137,1876,1901,3777,355
2024-03-25,ED,Germany,7732,3262,617,23,4470,1919,1934,3853,594
2024-03-26,ED,Germany,7369,3005,668,27,4364,1850,1846,3696,641
2024-03-27,ED,Germany,7761,3252,688,31,4509,1925,1896,3821,657
2024-03-28,ED,Germany,7866,3340,612,29,4526,1972,1942,3914,583
2024-03-29,ED,Germany,7740,3430,514,7,4310,1910,1886,3796,507
2024-03-30,ED,Germany,7220,3315,409,8,3905,1741,1755,3496,401
2024-03-31,ED,Germany,7910,3665,387,3,4245,1924,1934,3858,384
2024-04-01,ED,Germany,7995,3717,401,4,4278,1921,1956,3877,397
2024-04-02,ED,Germany,7989,3362,550,16,4627,2031,2046,4077,534
2024-04-03,ED,Germany,8287,3484,614,36,4803,2102,2087,4189,578
2024-04-04,ED,Germany,8334,3547,590,29,4787,2097,2100,4197,561
2024-04-05,ED,Germany,8769,3700,677,24,5069,2200,2192,4392,653
2024-04-06,ED,Germany,7897,3506,474,6,4391,1955,1962,3917,468
2024-04-07,ED,Germany,8449,3731,494,7,4718,2112,2112,4224,487
2024-04-08,ED,Germany,8538,3647,702,34,4891,2071,2118,4189,668
2024-04-09,ED,Germany,8238,3447,711,32,4791,2042,2038,4080,679
2024-04-10,ED,Germany,8688,3593,781,30,5095,2174,2140,4314,751
2024-04-11,ED,Germany,8776,3678,782,27,5098,2162,2154,4316,755
2024-04-12,ED,Germany,8893,3772,713,20,5121,2196,2212,4408,693
2024-04-13,ED,Germany,7847,3463,481,5,4384,1970,1933,3903,476
2024-04-14,ED,Germany,8298,3629,510,7,4669,2060,2099,4159,503
2024-04-15,ED,Germany,8331,3548,644,21,4783,2035,2104,4139,623
2024-04-16,ED,Germany,8225,3442,601,28,4783,2067,2115,4182,573
2024-04-17,ED,Germany,8634,3546,705,23,5088,2198,2185,4383,682
2024-04-18,ED,Germany,8798,3671,726,26,5127,2213,2188,4401,700
2024-04-19,ED,Germany,8820,3796,631,16,5024,2198,2195,4393,615
2024-04-20,ED,Germany,7883,3567,438,2,4316,1962,1916,3878,436
2024-04-21,ED,Germany,8450,3818,471,3,4632,2079,2082,4161,468
2024-04-22,ED,Germany,8604,3702,659,41,4902,2104,2139,4243,618
2024-04-23,ED,Germany,8355,3502,691,37,4853,2085,2077,4162,654
2024-04-24,ED,Germany,8699,3610,705,39,5089,2199,2185,4384,666
2024-04-25,ED,Germany,8711,3708,761,39,5003,2132,2110,4242,722
2024-04-26,ED,Germany,9199,3824,745,33,5375,2329,2301,4630,712
2024-04-27,ED,Germany,8165,3633,507,20,4532,2034,1991,4025,487
2024-04-28,ED,Germany,8573,3874,482,9,4699,2096,2121,4217,473
2024-04-29,ED,Germany,8829,3745,746,38,5084,2149,2189,4338,708
2024-04-30,ED,Germany,8675,3611,742,40,5064,2138,2184,4322,702
2024-05-01,ED,Germany,8709,3886,527,7,4823,2165,2131,4296,520
2024-05-02,ED,Germany,8688,3794,627,30,4894,2134,2133,4267,597
2024-05-03,ED,Germany,9253,4032,667,26,5221,2294,2260,4554,641
2024-05-04,ED,Germany,8394,3789,508,11,4605,2060,2037,4097,497
2024-05-05,ED,Germany,8928,4086,475,5,4842,2186,2181,4367,470
2024-05-06,ED,Germany,8995,3937,678,26,5058,2170,2210,4380,652
2024-05-07,ED,Germany,9059,3865,732,46,5194,2231,2231,4462,686
2024-05-08,ED,Germany,9502,4014,785,40,5488,2393,2310,4703,745
2024-05-09,ED,Germany,9062,4023,532,13,5039,2267,2240,4507,519
2024-05-10,ED,Germany,9088,3974,611,28,5114,2269,2234,4503,583
2024-05-11,ED,Germany,8499,3869,443,13,4630,2091,2096,4187,430
2024-05-12,ED,Germany,9332,4256,534,7,5076,2225,2317,4542,527
2024-05-13,ED,Germany,9371,4066,703,28,5305,2283,2319,4602,675
2024-05-14,ED,Germany,9305,3963,755,32,5342,2269,2318,4587,723
2024-05-15,ED,Germany,9493,4032,769,32,5461,2361,2331,4692,737
2024-05-16,ED,Germany,9430,4009,700,26,5421,2366,2355,4721,674
2024-05-17,ED,Germany,9905,4199,696,28,5706,2516,2494,5010,668
2024-05-18,ED,Germany,8698,3873,428,13,4825,2219,2178,4397,415
2024-05-19,ED,Germany,8946,4021,417,6,4925,2265,2243,4508,411
2024-05-20,ED,Germany,9113,4042,539,5,5071,2233,2299,4532,534
2024-05-21,ED,Germany,9180,3895,664,43,5285,2306,2315,4621,621
2024-05-22,ED,Germany,9303,3879,673,39,5424,2384,2367,4751,634
2024-05-23,ED,Germany,9634,4094,762,30,5540,2392,2386,4778,732
2024-05-24,ED,Germany,9686,4157,630,17,5529,2446,2453,4899,613
2024-05-25,ED,Germany,8701,3909,435,12,4792,2199,2158,4357,423
2024-05-26,ED,Germany,9364,4214,524,12,5150,2299,2327,4626,512
2024-05-27,ED,Germany,9406,4115,642,14,5291,2303,2346,4649,628
2024-05-28,ED,Germany,9271,3960,683,34,5311,2312,2316,4628,649
2024-05-29,ED,Germany,9481,3913,709,37,5568,2445,2414,4859,672
2024-05-30,ED,Germany,9268,4031,575,10,5237,2357,2305,4662,565
2024-05-31,ED,Germany,9690,4182,574,20,5508,2469,2465,4934,554
2024-06-01,ED,Germany,9037,4149,401,7,4888,2267,2220,4487,394
2024-06-02,ED,Germany,9582,4296,507,11,5286,2333,2446,4779,496
2024-06-03,ED,Germany,9457,4060,671,31,5397,2329,2397,4726,640
2024-06-04,ED,Germany,9293,3859,714,22,5434,2361,2359,4720,692
2024-06-05,ED,Germany,9420,3923,723,24,5497,2387,2387,4774,699
2024-06-06,ED,Germany,9692,4008,808,86,5684,2453,2423,4876,722
2024-06-07,ED,Germany,9682,4075,674,16,5607,2483,2450,4933,658
2024-06-08,ED,Germany,8640,3830,417,5,4810,2211,2182,4393,412
2024-06-09,ED,Germany,9178,4117,458,5,5061,2290,2313,4603,453
2024-06-10,ED,Germany,9452,3991,675,22,5461,2364,2422,4786,653
2024-06-11,ED,Germany,9205,3822,737,19,5383,2338,2308,4646,718
2024-06-12,ED,Germany,9539,3941,790,35,5598,2415,2393,4808,755
2024-06-13,ED,Germany,9838,4153,760,31,5685,2468,2457,4925,729
2024-06-14,ED,Germany,9970,4258,706,26,5712,2519,2487,5006,680
2024-06-15,ED,Germany,9203,4198,454,7,5005,2289,2262,4551,447
2024-06-16,ED,Germany,9662,4432,498,9,5230,2342,2390,4732,489
2024-06-17,ED,Germany,9564,4098,700,35,5466,2374,2392,4766,665
2024-06-18,ED,Germany,9352,3895,718,40,5457,2358,2381,4739,678
2024-06-19,ED,Germany,9692,4021,758,26,5671,2467,2446,4913,732
2024-06-20,ED,Germany,10118,4213,851,38,5905,2535,2519,5054,813
2024-06-21,ED,Germany,9608,4034,607,22,5574,2472,2495,4967,585
2024-06-22,ED,Germany,8935,3953,507,8,4982,2272,2203,4475,499
2024-06-23,ED,Germany,9477,4217,542,7,5260,2337,2381,4718,535
2024-06-24,ED,Germany,9740,4243,735,43,5497,2376,2386,4762,692
2024-06-25,ED,Germany,9819,4236,755,40,5583,2395,2433,4828,715
2024-06-26,ED,Germany,9474,3960,761,39,5514,2370,2383,4753,722
2024-06-27,ED,Germany,9401,4063,629,27,5338,2397,2312,4709,602
2024-06-28,ED,Germany,9713,4219,642,17,5494,2419,2433,4852,625
2024-06-29,ED,Germany,8972,4142,445,6,4830,2182,2203,4385,439
2024-06-30,ED,Germany,9278,4218,459,5,5060,2301,2300,4601,454
2024-07-01,ED,Germany,9525,4174,638,21,5351,2342,2371,4713,617
2024-07-02,ED,Germany,9508,4105,695,28,5403,2343,2365,4708,667
2024-07-03,ED,Germany,9880,4321,740,27,5559,2431,2388,4819,713
2024-07-04,ED,Germany,9724,4231,725,22,5493,2394,2374,4768,703
2024-07-05,ED,Germany,9829,4175,672,19,5654,2476,2506,4982,653
2024-07-06,ED,Germany,8951,4058,405,7,4893,2258,2230,4488,398
2024-07-07,ED,Germany,9416,4304,434,5,5112,2362,2316,4678,429
2024-07-08,ED,Germany,9582,4214,640,37,5368,2335,2393,4728,603
2024-07-09,ED,Germany,9518,4100,697,30,5418,2348,2373,4721,667
2024-07-10,ED,Germany,9620,4093,731,34,5527,2390,2406,4796,697
2024-07-11,ED,Germany,10033,4412,745,39,5621,2474,2402,4876,706
2024-07-12,ED,Germany,9456,4249,531,22,5207,2347,2329,4676,509
2024-07-13,ED,Germany,9152,4198,431,7,4954,2262,2261,4523,424
2024-07-14,ED,Germany,9656,4300,504,9,5356,2350,2502,4852,495
2024-07-15,ED,Germany,10130,4332,669,23,5798,2629,2500,5129,646
2024-07-16,ED,Germany,9605,4269,633,27,5336,2356,2347,4703,606
2024-07-17,ED,Germany,9720,4229,653,34,5491,2431,2407,4838,619
2024-07-18,ED,Germany,9857,4337,656,39,5520,2432,2432,4864,617
2024-07-19,ED,Germany,9044,3933,578,21,5111,2271,2262,4533,557
2024-07-20,ED,Germany,8916,4086,416,12,4830,2221,2193,4414,404
2024-07-21,ED,Germany,9074,4200,373,8,4874,2254,2247,4501,365
2024-07-22,ED,Germany,9720,4395,593,30,5325,2347,2385,4732,563
2024-07-23,ED,Germany,9270,4137,540,27,5133,2284,2309,4593,513
2024-07-24,ED,Germany,9736,4277,680,54,5459,2394,2385,4779,626
2024-07-25,ED,Germany,9764,4350,709,43,5414,2361,2344,4705,666
2024-07-26,ED,Germany,9998,4478,606,21,5520,2451,2463,4914,585
2024-07-27,ED,Germany,9013,4131,393,12,4882,2263,2226,4489,381
2024-07-28,ED,Germany,9415,4251,480,8,5164,2342,2342,4684,472
2024-07-29,ED,Germany,9733,4356,636,37,5377,2352,2389,4741,599
2024-07-30,ED,Germany,9460,4169,638,35,5291,2324,2329,4653,603
2024-01-01,LG,Greece,1580,995,210,0,585,187,188,375,210
2024-01-02,LG,Greece,1757,1033,270,9,724,229,225,454,261
2024-01-03,LG,Greece,1757,1050,255,19,707,225,227,452,236
2024-01-04,LG,Greece,1773,1093,279,17,680,205,196,401,262
2024-01-05,LG,Greece,1912,1164,297,21,748,225,226,451,276
2024-01-06,LG,Greece,1963,1289,258,4,674,204,212,416,254
2024-01-07,LG,Greece,1932,1216,256,5,716,233,227,460,251
2024-01-08,LG,Greece,1713,1002,297,9,711,210,204,414,288
2024-01-09,LG,Greece,1524,960,249,24,564,156,159,315,225
2024-01-10,LG,Greece,1504,918,251,22,586,168,167,335,229
2024-01-11,LG,Greece,1644,1028,294,27,616,163,159,322,267
2024-01-12,LG,Greece,1614,937,283,16,677,195,199,394,267
2024-01-13,LG,Greece,1609,1086,230,6,523,146,147,293,224
2024-01-14,LG,Greece,1694,1092,243,10,602,180,179,359,233
2024-01-15,LG,Greece,1490,871,258,7,619,181,180,361,251
2024-01-16,LG,Greece,1378,847,250,22,531,143,138,281,228
2024-01-17,LG,Greece,1407,841,248,25,566,158,160,318,223
2024-01-18,LG,Greece,1486,907,273,26,579,153,153,306,247
2024-01-19,LG,Greece,1605,948,278,17,657,189,190,379,261
2024-01-20,LG,Greece,1562,1057,220,5,505,142,143,285,215
2024-01-21,LG,Greece,1615,1054,213,1,561,176,172,348,212
2024-01-22,LG,Greece,1469,856,248,16,613,176,189,365,232
2024-01-23,LG,Greece,1376,810,268,37,566,152,146,298,231
2024-01-24,LG,Greece,1379,828,252,38,551,149,150,299,214
2024-01-25,LG,Greece,1499,891,285,24,608,166,157,323,261
2024-01-26,LG,Greece,1549,901,271,14,648,186,191,377,257
2024-01-27,LG,Greece,1574,1060,226,14,514,143,145,288,212
2024-01-28,LG,Greece,1571,1001,228,5,570,172,170,342,223
2024-01-29,LG,Greece,1469,843,267,24,626,181,178,359,243
2024-01-30,LG,Greece,1370,839,251,29,531,140,140,280,222
2024-01-31,LG,Greece,1485,909,262,21,576,158,156,314,241
2024-02-01,LG,Greece,1583,951,286,15,632,171,175,346,271
2024-02-02,LG,Greece,1674,982,283,16,692,206,203,409,267
2024-02-03,LG,Greece,1619,1095,227,8,524,149,148,297,219
2024-02-04,LG,Greece,1710,1113,243,9,597,181,173,354,234
2024-02-05,LG,Greece,1593,941,284,22,652,183,185,368,262
2024-02-06,LG,Greece,1439,875,268,31,564,147,149,296,237
2024-02-07,LG,Greece,1451,865,265,19,586,163,158,321,246
2024-02-08,LG,Greece,1669,1001,295,23,668,188,185,373,272
2024-02-09,LG,Greece,1754,1034,306,7,720,205,209,414,299
2024-02-10,LG,Greece,1697,1136,230,4,561,163,168,331,226
2024-02-11,LG,Greece,1748,1139,229,1,609,191,189,380,228
2024-02-12,LG,Greece,1541,897,266,10,644,188,190,378,256
2024-02-13,LG,Greece,1496,897,288,19,599,155,156,311,269
2024-02-14,LG,Greece,1553,943,254,20,610,178,178,356,234
2024-02-15,LG,Greece,1700,1061,271,22,639,182,186,368,249
2024-02-16,LG,Greece,1802,1090,288,12,712,215,209,424,276
2024-02-17,LG,Greece,1768,1212,233,13,556,162,161,323,220
2024-02-18,LG,Greece,1818,1155,253,10,663,209,201,410,243
2024-02-19,LG,Greece,1632,953,276,15,679,197,206,403,261
2024-02-20,LG,Greece,1429,861,259,27,568,157,152,309,232
2024-02-21,LG,Greece,1477,864,240,20,613,184,189,373,220
2024-02-22,LG,Greece,1597,970,261,22,627,186,180,366,239
2024-02-23,LG,Greece,1694,1004,271,13,690,209,210,419,258
2024-02-24,LG,Greece,1749,1174,234,8,575,168,173,341,226
2024-02-25,LG,Greece,1799,1138,245,3,661,210,206,416,242
2024-02-26,LG,Greece,1632,971,246,6,661,204,211,415,240
2024-02-27,LG,Greece,1487,839,292,36,648,184,172,356,256
2024-02-28,LG,Greece,1482,927,254,35,555,146,155,301,219
2024-02-29,LG,Greece,1706,1009,288,9,697,201,208,409,279
2024-03-01,LG,Greece,1809,1072,272,8,737,229,236,465,264
2024-03-02,LG,Greece,1790,1163,239,5,627,195,193,388,234
2024-03-03,LG,Greece,1892,1210,251,7,682,218,213,431,244
2024-03-04,LG,Greece,1749,1032,291,15,717,212,214,426,276
2024-03-05,LG,Greece,1598,958,280,27,640,181,179,360,253
2024-03-06,LG,Greece,1697,1025,280,30,672,198,194,392,250
2024-03-07,LG,Greece,1704,1034,281,18,670,192,197,389,263
2024-03-08,LG,Greece,1800,1076,304,15,724,210,210,420,289
2024-03-09,LG,Greece,1816,1195,251,11,621,186,184,370,240
2024-03-10,LG,Greece,1953,1268,248,5,685,220,217,437,243
2024-03-11,LG,Greece,1708,972,292,18,736,221,223,444,274
2024-03-12,LG,Greece,1570,916,293,30,654,178,183,361,263
2024-03-13,LG,Greece,1658,997,272,28,661,196,193,389,244
2024-03-14,LG,Greece,1780,1051,299,33,729,215,215,430,266
2024-03-15,LG,Greece,1913,1104,322,26,809,240,247,487,296
2024-03-16,LG,Greece,1829,1214,233,6,615,197,185,382,227
2024-03-17,LG,Greece,1816,1203,180,3,613,218,215,433,177
2024-03-18,LG,Greece,1687,999,263,7,688,208,217,425,256
2024-03-19,LG,Greece,1750,1088,284,16,662,191,187,378,268
2024-03-20,LG,Greece,1690,1002,278,40,688,205,205,410,238
2024-03-21,LG,Greece,1783,1043,304,29,740,217,219,436,275
2024-03-22,LG,Greece,2001,1193,314,16,808,249,245,494,298
2024-03-23,LG,Greece,2020,1335,238,15,685,220,227,447,223
2024-03-24,LG,Greece,2115,1422,219,10,693,238,236,474,209
2024-03-25,LG,Greece,1865,1121,277,11,744,234,233,467,266
2024-03-26,LG,Greece,1849,1114,297,17,735,218,220,438,280
2024-03-27,LG,Greece,1837,1126,269,23,711,221,221,442,246
2024-03-28,LG,Greece,1993,1205,296,26,788,237,255,492,270
2024-03-29,LG,Greece,2057,1217,323,28,840,258,259,517,295
2024-03-30,LG,Greece,2133,1406,246,11,727,234,247,481,235
2024-03-31,LG,Greece,2403,1436,284,6,967,350,333,683,278
2024-04-01,LG,Greece,2269,1265,336,16,1004,328,340,668,320
2024-04-02,LG,Greece,2158,1200,336,30,958,315,307,622,306
2024-04-03,LG,Greece,2163,1206,325,19,957,311,321,632,306
2024-04-04,LG,Greece,2198,1218,333,20,980,329,318,647,313
2024-04-05,LG,Greece,2238,1207,336,24,1031,348,347,695,312
2024-04-06,LG,Greece,2567,1518,292,11,1049,378,379,757,281
2024-04-07,LG,Greece,2574,1542,284,5,1032,373,375,748,279
2024-04-08,LG,Greece,2294,1286,327,15,1008,341,340,681,312
2024-04-09,LG,Greece,2325,1360,308,15,965,333,324,657,293
2024-04-10,LG,Greece,2364,1364,326,19,1000,329,345,674,307
2024-04-11,LG,Greece,2427,1371,333,19,1056,363,360,723,314
2024-04-12,LG,Greece,2513,1406,345,16,1107,376,386,762,329
2024-04-13,LG,Greece,2709,1582,289,13,1127,421,417,838,276
2024-04-14,LG,Greece,2896,1751,298,7,1145,425,422,847,291
2024-04-15,LG,Greece,2496,1401,345,17,1095,372,378,750,328
2024-04-16,LG,Greece,2412,1396,319,17,1016,351,346,697,302
2024-04-17,LG,Greece,2414,1363,330,21,1051,362,359,721,309
2024-04-18,LG,Greece,2528,1348,361,26,1180,406,413,819,335
2024-04-19,LG,Greece,2815,1590,357,9,1225,440,428,868,348
2024-04-20,LG,Greece,3048,1776,301,11,1272,483,488,971,290
2024-04-21,LG,Greece,2955,1636,324,6,1319,501,494,995,318
2024-04-22,LG,Greece,2531,1358,362,16,1173,407,404,811,346
2024-04-23,LG,Greece,2428,1307,325,22,1121,396,400,796,303
2024-04-24,LG,Greece,2545,1381,380,35,1164,388,396,784,345
2024-04-25,LG,Greece,2653,1424,391,21,1229,417,421,838,370
2024-04-26,LG,Greece,2745,1380,403,19,1365,480,482,962,384
2024-04-27,LG,Greece,3124,1625,337,11,1499,574,588,1162,326
2024-04-28,LG,Greece,2996,1529,369,13,1467,557,541,1098,356
2024-04-29,LG,Greece,2583,1266,397,19,1317,462,458,920,378
2024-04-30,LG,Greece,2704,1376,388,20,1328,470,470,940,368
2024-05-01,LG,Greece,2930,1448,417,17,1482,531,534,1065,400
2024-05-02,LG,Greece,2890,1438,400,12,1452,525,527,1052,388
2024-05-03,LG,Greece,3005,1485,367,13,1520,570,583,1153,354
2024-05-04,LG,Greece,3244,1589,331,3,1655,665,659,1324,328
2024-05-05,LG,Greece,3149,1559,274,8,1590,660,656,1316,266
2024-05-06,LG,Greece,2860,1398,390,9,1462,540,532,1072,381
2024-05-07,LG,Greece,2921,1362,411,11,1559,571,577,1148,400
2024-05-08,LG,Greece,2979,1446,419,29,1533,550,564,1114,390
2024-05-09,LG,Greece,2987,1384,422,17,1603,590,591,1181,405
2024-05-10,LG,Greece,2957,1361,378,10,1596,609,609,1218,368
2024-05-11,LG,Greece,3371,1550,375,13,1821,730,716,1446,362
2024-05-12,LG,Greece,3290,1496,389,9,1794,705,700,1405,380
2024-05-13,LG,Greece,2875,1332,396,13,1543,570,577,1147,383
2024-05-14,LG,Greece,2907,1314,399,42,1593,600,594,1194,357
2024-05-15,LG,Greece,2851,1320,412,24,1531,560,559,1119,388
2024-05-16,LG,Greece,3017,1382,438,33,1635,596,601,1197,405
2024-05-17,LG,Greece,3153,1394,415,22,1759,664,680,1344,393
2024-05-18,LG,Greece,3514,1585,363,18,1929,788,778,1566,345
2024-05-19,LG,Greece,3461,1560,377,8,1901,761,763,1524,369
2024-05-20,LG,Greece,3074,1375,444,22,1699,631,624,1255,422
2024-05-21,LG,Greece,3069,1385,431,39,1684,626,627,1253,392
2024-05-22,LG,Greece,3085,1457,445,33,1628,590,593,1183,412
2024-05-23,LG,Greece,3278,1503,431,24,1775,670,674,1344,407
2024-05-24,LG,Greece,3302,1461,413,17,1841,712,716,1428,396
2024-05-25,LG,Greece,3582,1593,358,3,1989,815,816,1631,355
2024-05-26,LG,Greece,3564,1561,381,8,2003,813,809,1622,373
2024-05-27,LG,Greece,3259,1430,448,32,1829,693,688,1381,416
2024-05-28,LG,Greece,3238,1412,431,30,1826,690,705,1395,401
2024-05-29,LG,Greece,3303,1477,416,26,1826,694,716,1410,390
2024-05-30,LG,Greece,3378,1464,456,29,1914,740,718,1458,427
2024-05-31,LG,Greece,3406,1431,421,14,1975,769,785,1554,407
2024-06-01,LG,Greece,3964,1658,411,6,2306,950,945,1895,405
2024-06-02,LG,Greece,3941,1669,452,10,2272,915,905,1820,442
2024-06-03,LG,Greece,3599,1570,485,27,2029,771,773,1544,458
2024-06-04,LG,Greece,3613,1533,493,35,2080,792,795,1587,458
2024-06-05,LG,Greece,3643,1606,486,31,2037,778,773,1551,455
2024-06-06,LG,Greece,3722,1599,510,30,2123,811,802,1613,480
2024-06-07,LG,Greece,3673,1478,494,16,2195,835,866,1701,478
2024-06-08,LG,Greece,4005,1637,432,12,2368,975,961,1936,420
2024-06-09,LG,Greece,3942,1650,459,7,2292,921,912,1833,452
2024-06-10,LG,Greece,3750,1584,493,22,2166,836,837,1673,471
2024-06-11,LG,Greece,3645,1488,481,33,2157,843,833,1676,448
2024-06-12,LG,Greece,3625,1506,468,21,2119,824,827,1651,447
2024-06-13,LG,Greece,3827,1685,495,17,2142,817,830,1647,478
2024-06-14,LG,Greece,4059,1795,496,23,2264,880,888,1768,473
2024-06-15,LG,Greece,4152,1695,442,11,2457,1009,1006,2015,431
2024-06-16,LG,Greece,3986,1610,477,7,2376,952,947,1899,470
2024-06-17,LG,Greece,3782,1562,498,19,2220,861,861,1722,479
2024-06-18,LG,Greece,3845,1577,519,35,2268,875,874,1749,484
2024-06-19,LG,Greece,3794,1560,509,31,2234,860,865,1725,478
2024-06-20,LG,Greece,3938,1655,510,21,2283,884,889,1773,489
2024-06-21,LG,Greece,3923,1545,513,12,2378,928,937,1865,501
2024-06-22,LG,Greece,4306,1789,450,13,2517,1038,1029,2067,437
2024-06-23,LG,Greece,4203,1760,471,12,2443,986,986,1972,459
2024-06-24,LG,Greece,4018,1689,497,17,2329,916,916,1832,480
2024-06-25,LG,Greece,4018,1625,509,22,2393,943,941,1884,487
2024-06-26,LG,Greece,4067,1801,494,30,2266,885,887,1772,464
2024-06-27,LG,Greece,4232,1909,480,20,2323,917,926,1843,460
2024-06-28,LG,Greece,4174,1705,516,21,2469,975,978,1953,495
2024-06-29,LG,Greece,4414,1799,447,8,2615,1084,1084,2168,439
2024-06-30,LG,Greece,4410,1827,492,8,2583,1046,1045,2091,484
2024-07-01,LG,Greece,4238,1756,529,24,2482,973,980,1953,505
2024-07-02,LG,Greece,4361,1897,512,31,2464,984,968,1952,481
2024-07-03,LG,Greece,4259,1830,507,23,2429,956,966,1922,484
2024-07-04,LG,Greece,4138,1728,485,15,2410,962,963,1925,470
2024-07-05,LG,Greece,4160,1638,526,21,2522,992,1004,1996,505
2024-07-06,LG,Greece,4491,1756,480,11,2735,1132,1123,2255,469
2024-07-07,LG,Greece,4515,1788,507,11,2727,1110,1110,2220,496
2024-07-08,LG,Greece,4207,1720,509,20,2487,1001,977,1978,489
2024-07-09,LG,Greece,4250,1716,509,33,2534,1016,1009,2025,476
2024-07-10,LG,Greece,4256,1754,525,24,2502,984,993,1977,501
2024-07-11,LG,Greece,4331,1793,518,29,2538,1007,1013,2020,489
2024-07-12,LG,Greece,4254,1671,522,17,2583,1017,1044,2061,505
2024-07-13,LG,Greece,4631,1843,479,11,2788,1164,1145,2309,468
2024-07-14,LG,Greece,4577,1885,491,7,2692,1094,1107,2201,484
2024-07-15,LG,Greece,4310,1703,545,25,2607,1036,1026,2062,520
2024-07-16,LG,Greece,4395,1775,529,28,2620,1043,1048,2091,501
2024-07-17,LG,Greece,4401,1823,522,32,2578,1034,1022,2056,490
2024-07-18,LG,Greece,4321,1790,511,26,2531,1002,1018,2020,485
2024-07-19,LG,Greece,4225,1723,543,17,2502,964,995,1959,526
2024-07-20,LG,Greece,4634,1850,487,12,2784,1154,1143,2297,475
2024-07-21,LG,Greece,4779,1993,513,9,2786,1138,1135,2273,504
2024-07-22,LG,Greece,4421,1818,537,20,2603,1038,1028,2066,517
2024-07-23,LG,Greece,4455,1820,515,36,2635,1069,1051,2120,479
2024-07-24,LG,Greece,4467,1893,516,19,2574,1022,1036,2058,497
2024-07-25,LG,Greece,4448,1851,522,15,2597,1035,1040,2075,507
2024-07-26,LG,Greece,4239,1680,515,14,2559,1019,1025,2044,501
2024-07-27,LG,Greece,4604,1788,454,10,2816,1184,1178,2362,444
2024-07-28,LG,Greece,4592,1850,487,10,2742,1124,1131,2255,477
2024-07-29,LG,Greece,4223,1710,512,17,2513,1008,993,2001,495
2024-07-30,LG,Greece,4379,1766,520,23,2613,1052,1041,2093,497
2024-01-01,LH,Hungary,2200,1898,2,0,302,150,150,300,2
2024-01-02,LH,Hungary,2294,1991,0,0,303,151,152,303,0
2024-01-03,LH,Hungary,2407,2072,1,1,335,167,167,334,0
2024-01-04,LH,Hungary,2483,2177,1,0,306,157,148,305,1
2024-01-05,LH,Hungary,2562,2215,5,2,347,169,173,342,3
2024-01-06,LH,Hungary,2499,2239,0,0,260,131,129,260,0
2024-01-07,LH,Hungary,2580,2272,0,0,308,151,157,308,0
2024-01-08,LH,Hungary,2446,2115,2,0,331,165,164,329,2
2024-01-09,LH,Hungary,2198,1952,1,1,246,127,118,245,0
2024-01-10,LH,Hungary,2294,2014,1,0,280,137,142,279,1
2024-01-11,LH,Hungary,2321,2041,3,1,280,138,139,277,2
2024-01-12,LH,Hungary,2420,2095,3,3,325,159,163,322,0
2024-01-13,LH,Hungary,2237,1993,1,1,244,121,122,243,0
2024-01-14,LH,Hungary,2339,2043,0,0,296,147,149,296,0
2024-01-15,LH,Hungary,2270,1935,6,1,335,166,163,329,5
2024-01-16,LH,Hungary,2037,1789,5,2,248,125,118,243,3
2024-01-17,LH,Hungary,2014,1723,6,0,291,144,141,285,6
2024-01-18,LH,Hungary,2194,1924,1,1,270,133,136,269,0
2024-01-19,LH,Hungary,2386,2053,2,0,333,161,170,331,2
2024-01-20,LH,Hungary,2314,2065,5,3,249,129,115,244,2
2024-01-21,LH,Hungary,2337,2059,0,0,278,137,141,278,0
2024-01-22,LH,Hungary,2266,1940,2,0,326,163,161,324,2
2024-01-23,LH,Hungary,2037,1786,3,1,251,126,122,248,2
2024-01-24,LH,Hungary,2048,1763,2,0,285,141,142,283,2
2024-01-25,LH,Hungary,2189,1910,4,0,279,136,139,275,4
2024-01-26,LH,Hungary,2285,1947,7,1,338,161,170,331,6
2024-01-27,LH,Hungary,2211,1965,3,0,246,125,118,243,3
2024-01-28,LH,Hungary,2346,2055,1,0,291,146,144,290,1
2024-01-29,LH,Hungary,2151,1828,4,2,323,163,156,319,2
2024-01-30,LH,Hungary,2062,1808,1,1,254,125,128,253,0
2024-01-31,LH,Hungary,2084,1794,6,1,290,141,143,284,5
2024-02-01,LH,Hungary,2067,1786,4,2,281,138,139,277,2
2024-02-02,LH,Hungary,2315,1990,1,0,325,162,162,324,1
2024-02-03,LH,Hungary,2191,1953,1,1,238,119,118,237,0
2024-02-04,LH,Hungary,2275,1984,2,2,291,141,148,289,0
2024-02-05,LH,Hungary,2102,1801,1,1,301,154,146,300,0
2024-02-06,LH,Hungary,2017,1774,2,1,243,121,120,241,1
2024-02-07,LH,Hungary,2043,1755,5,1,288,142,141,283,4
2024-02-08,LH,Hungary,2218,1938,6,0,280,134,140,274,6
2024-02-09,LH,Hungary,2306,1978,3,3,328,168,157,325,0
2024-02-10,LH,Hungary,2049,1801,3,0,248,122,123,245,3
2024-02-11,LH,Hungary,2273,1980,0,0,293,145,148,293,0
2024-02-12,LH,Hungary,2209,1884,6,1,325,162,157,319,5
2024-02-13,LH,Hungary,2031,1791,1,0,240,120,119,239,1
2024-02-14,LH,Hungary,2147,1836,8,3,311,153,150,303,5
2024-02-15,LH,Hungary,2235,1948,4,1,287,138,145,283,3
2024-02-16,LH,Hungary,2389,2039,6,4,350,172,172,344,2
2024-02-17,LH,Hungary,2325,2064,2,0,261,131,128,259,2
2024-02-18,LH,Hungary,2424,2112,1,0,312,151,160,311,1
2024-02-19,LH,Hungary,2242,1918,4,0,324,163,157,320,4
2024-02-20,LH,Hungary,2070,1824,5,0,246,123,118,241,5
2024-02-21,LH,Hungary,2105,1810,7,1,295,141,147,288,6
2024-02-22,LH,Hungary,2282,1986,5,3,296,142,149,291,2
2024-02-23,LH,Hungary,2428,2081,3,0,347,175,169,344,3
2024-02-24,LH,Hungary,2331,2077,1,0,254,125,128,253,1
2024-02-25,LH,Hungary,2446,2137,1,0,309,150,158,308,1
2024-02-26,LH,Hungary,2305,1964,8,0,341,172,161,333,8
2024-02-27,LH,Hungary,2151,1889,3,1,262,131,128,259,2
2024-02-28,LH,Hungary,2215,1902,5,2,313,154,154,308,3
2024-02-29,LH,Hungary,2318,2020,4,2,298,150,144,294,2
2024-03-01,LH,Hungary,2448,2104,6,4,344,170,168,338,2
2024-03-02,LH,Hungary,2389,2121,1,0,268,131,136,267,1
2024-03-03,LH,Hungary,2489,2165,1,0,324,158,165,323,1
2024-03-04,LH,Hungary,2325,1972,9,6,353,174,170,344,3
2024-03-05,LH,Hungary,2166,1906,6,2,260,128,126,254,4
2024-03-06,LH,Hungary,2271,1951,10,2,320,155,155,310,8
2024-03-07,LH,Hungary,2240,1949,5,4,291,141,145,286,1
2024-03-08,LH,Hungary,2361,2026,4,2,335,167,164,331,2
2024-03-09,LH,Hungary,2365,2086,3,1,279,138,138,276,2
2024-03-10,LH,Hungary,2469,2145,0,0,324,159,165,324,0
2024-03-11,LH,Hungary,2298,1950,2,0,348,175,171,346,2
2024-03-12,LH,Hungary,2137,1883,1,1,254,130,123,253,0
2024-03-13,LH,Hungary,2190,1889,7,3,301,144,150,294,4
2024-03-14,LH,Hungary,2267,1955,3,1,312,155,154,309,2
2024-03-15,LH,Hungary,2494,2140,6,2,354,176,172,348,4
2024-03-16,LH,Hungary,2483,2197,0,0,286,143,143,286,0
2024-03-17,LH,Hungary,2566,2216,2,1,350,170,178,348,1
2024-03-18,LH,Hungary,2423,2067,1,1,356,180,175,355,0
2024-03-19,LH,Hungary,2161,1869,8,4,292,138,146,284,4
2024-03-20,LH,Hungary,2362,2022,11,8,340,167,162,329,3
2024-03-21,LH,Hungary,2395,2072,14,10,323,154,155,309,4
2024-03-22,LH,Hungary,2581,2202,3,1,379,187,189,376,2
2024-03-23,LH,Hungary,2603,2298,4,1,305,150,151,301,3
2024-03-24,LH,Hungary,2595,2255,4,1,340,168,168,336,3
2024-03-25,LH,Hungary,2440,2068,6,2,372,183,183,366,4
2024-03-26,LH,Hungary,2440,2107,6,5,333,162,165,327,1
2024-03-27,LH,Hungary,2548,2199,7,5,349,174,168,342,2
2024-03-28,LH,Hungary,2573,2229,1,0,344,170,173,343,1
2024-03-29,LH,Hungary,2641,2277,0,0,364,180,184,364,0
2024-03-30,LH,Hungary,2670,2379,0,0,291,147,144,291,0
2024-03-31,LH,Hungary,2830,2492,0,0,338,171,167,338,0
2024-04-01,LH,Hungary,2628,2264,3,0,364,182,179,361,3
2024-04-02,LH,Hungary,2732,2378,2,1,354,177,175,352,1
2024-04-03,LH,Hungary,2697,2347,3,0,350,174,173,347,3
2024-04-04,LH,Hungary,2733,2366,4,2,367,181,182,363,2
2024-04-05,LH,Hungary,2824,2432,8,5,392,192,192,384,3
2024-04-06,LH,Hungary,2771,2466,0,0,305,152,153,305,0
2024-04-07,LH,Hungary,2750,2390,2,1,360,175,183,358,1
2024-04-08,LH,Hungary,2665,2276,10,7,389,191,188,379,3
2024-04-09,LH,Hungary,2632,2276,7,6,356,177,172,349,1
2024-04-10,LH,Hungary,2624,2257,7,5,367,177,183,360,2
2024-04-11,LH,Hungary,2778,2400,2,1,378,188,188,376,1
2024-04-12,LH,Hungary,2754,2364,9,6,390,193,188,381,3
2024-04-13,LH,Hungary,2703,2407,5,4,296,144,147,291,1
2024-04-14,LH,Hungary,2512,2178,0,0,334,165,169,334,0
2024-04-15,LH,Hungary,2565,2192,2,1,373,187,184,371,1
2024-04-16,LH,Hungary,2590,2249,1,0,341,172,168,340,1
2024-04-17,LH,Hungary,2612,2261,2,1,351,177,172,349,1
2024-04-18,LH,Hungary,2678,2293,4,0,385,184,197,381,4
2024-04-19,LH,Hungary,2743,2339,4,0,404,198,202,400,4
2024-04-20,LH,Hungary,2764,2458,2,0,306,155,149,304,2
2024-04-21,LH,Hungary,2899,2528,2,0,371,183,186,369,2
2024-04-22,LH,Hungary,2621,2226,6,0,395,199,190,389,6
2024-04-23,LH,Hungary,2581,2221,11,4,360,173,176,349,7
2024-04-24,LH,Hungary,2746,2384,3,1,362,177,182,359,2
2024-04-25,LH,Hungary,2840,2453,5,2,387,193,189,382,3
2024-04-26,LH,Hungary,3054,2640,5,3,414,210,199,409,2
2024-04-27,LH,Hungary,3170,2861,3,1,309,150,156,306,2
2024-04-28,LH,Hungary,3158,2802,2,0,356,175,179,354,2
2024-04-29,LH,Hungary,2756,2371,5,2,385,192,188,380,3
2024-04-30,LH,Hungary,2852,2490,3,1,362,180,179,359,2
2024-05-01,LH,Hungary,2985,2614,4,2,371,185,182,367,2
2024-05-02,LH,Hungary,2883,2518,4,2,365,179,182,361,2
2024-05-03,LH,Hungary,3033,2643,6,3,390,197,187,384,3
2024-05-04,LH,Hungary,3172,2873,2,0,299,147,150,297,2
2024-05-05,LH,Hungary,3261,2903,0,0,358,177,181,358,0
2024-05-06,LH,Hungary,2901,2498,5,3,403,194,204,398,2
2024-05-07,LH,Hungary,2987,2632,2,1,355,180,173,353,1
2024-05-08,LH,Hungary,3035,2659,4,2,376,185,187,372,2
2024-05-09,LH,Hungary,3048,2649,5,3,399,191,203,394,2
2024-05-10,LH,Hungary,3182,2788,4,3,394,201,189,390,1
2024-05-11,LH,Hungary,3420,3112,1,1,308,154,153,307,0
2024-05-12,LH,Hungary,3312,2946,2,1,366,179,185,364,1
2024-05-13,LH,Hungary,3052,2655,8,5,397,200,189,389,3
2024-05-14,LH,Hungary,3123,2734,7,3,389,191,191,382,4
2024-05-15,LH,Hungary,3149,2762,1,1,387,191,195,386,0
2024-05-16,LH,Hungary,3137,2746,2,2,391,195,194,389,0
2024-05-17,LH,Hungary,3258,2871,1,1,387,192,194,386,0
2024-05-18,LH,Hungary,3480,3156,1,0,324,161,162,323,1
2024-05-19,LH,Hungary,3410,3069,1,0,341,170,170,340,1
2024-05-20,LH,Hungary,3054,2670,1,0,384,189,194,383,1
2024-05-21,LH,Hungary,3229,2842,4,3,387,194,189,383,1
2024-05-22,LH,Hungary,3204,2790,9,2,414,206,199,405,7
2024-05-23,LH,Hungary,3146,2765,8,3,381,186,187,373,5
2024-05-24,LH,Hungary,3258,2889,2,1,369,179,188,367,1
2024-05-25,LH,Hungary,3556,3233,1,1,323,166,156,322,0
2024-05-26,LH,Hungary,3519,3167,1,1,352,170,181,351,0
2024-05-27,LH,Hungary,3254,2851,11,7,403,195,197,392,4
2024-05-28,LH,Hungary,3274,2917,8,4,357,177,172,349,4
2024-05-29,LH,Hungary,3396,2980,3,2,416,204,209,413,1
2024-05-30,LH,Hungary,3356,2967,3,1,389,194,192,386,2
2024-05-31,LH,Hungary,3459,3075,4,0,384,188,192,380,4
2024-06-01,LH,Hungary,3702,3368,4,0,334,170,160,330,4
2024-06-02,LH,Hungary,3786,3378,3,0,408,204,201,405,3
2024-06-03,LH,Hungary,3512,3120,10,4,392,191,191,382,6
2024-06-04,LH,Hungary,3423,3040,2,0,383,190,191,381,2
2024-06-05,LH,Hungary,3572,3165,6,6,407,201,200,401,0
2024-06-06,LH,Hungary,3461,3059,7,5,402,199,196,395,2
2024-06-07,LH,Hungary,3621,3210,1,0,411,204,206,410,1
2024-06-08,LH,Hungary,3784,3460,1,1,324,165,158,323,0
2024-06-09,LH,Hungary,3739,3349,0,0,390,189,201,390,0
2024-06-10,LH,Hungary,3385,3004,0,0,381,192,189,381,0
2024-06-11,LH,Hungary,3586,3189,1,1,397,199,197,396,0
2024-06-12,LH,Hungary,3583,3179,4,4,404,200,200,400,0
2024-06-13,LH,Hungary,3511,3105,9,3,406,196,201,397,6
2024-06-14,LH,Hungary,3621,3181,6,4,440,214,220,434,2
2024-06-15,LH,Hungary,3813,3421,3,2,392,196,193,389,1
2024-06-16,LH,Hungary,3890,3471,2,0,419,212,205,417,2
2024-06-17,LH,Hungary,3590,3159,8,7,431,212,211,423,1
2024-06-18,LH,Hungary,3532,3122,4,2,410,199,207,406,2
2024-06-19,LH,Hungary,3724,3252,5,3,472,234,233,467,2
2024-06-20,LH,Hungary,3599,3170,3,1,429,216,210,426,2
2024-06-21,LH,Hungary,3709,3273,7,4,436,214,215,429,3
2024-06-22,LH,Hungary,3651,3301,0,0,350,173,177,350,0
2024-06-23,LH,Hungary,3716,3286,0,0,430,221,209,430,0
2024-06-24,LH,Hungary,3655,3232,3,1,423,210,210,420,2
2024-06-25,LH,Hungary,3832,3430,6,4,402,198,198,396,2
2024-06-26,LH,Hungary,3496,3117,3,2,379,194,182,376,1
2024-06-27,LH,Hungary,3500,3093,2,2,407,199,206,405,0
2024-06-28,LH,Hungary,3681,3238,2,1,443,216,225,441,1
2024-06-29,LH,Hungary,3708,3363,1,1,345,175,169,344,0
2024-06-30,LH,Hungary,3722,3315,3,0,407,196,208,404,3
2024-07-01,LH,Hungary,3828,3406,5,0,422,212,205,417,5
2024-07-02,LH,Hungary,3644,3223,2,0,421,212,207,419,2
2024-07-03,LH,Hungary,3741,3294,6,6,447,220,221,441,0
2024-07-04,LH,Hungary,3624,3206,5,0,418,208,205,413,5
2024-07-05,LH,Hungary,3753,3328,3,1,425,206,216,422,2
2024-07-06,LH,Hungary,3836,3468,2,1,368,185,181,366,1
2024-07-07,LH,Hungary,3931,3510,1,0,421,207,213,420,1
2024-07-08,LH,Hungary,3666,3263,4,4,403,203,196,399,0
2024-07-09,LH,Hungary,3738,3306,7,6,432,210,215,425,1
2024-07-10,LH,Hungary,3665,3239,2,2,426,215,209,424,0
2024-07-11,LH,Hungary,3753,3330,6,1,423,205,212,417,5
2024-07-12,LH,Hungary,3789,3369,3,1,420,214,203,417,2
2024-07-13,LH,Hungary,3873,3506,0,0,367,178,189,367,0
2024-07-14,LH,Hungary,3801,3385,0,0,416,207,209,416,0
2024-07-15,LH,Hungary,3671,3253,3,1,418,206,209,415,2
2024-07-16,LH,Hungary,3703,3301,5,3,402,197,200,397,2
2024-07-17,LH,Hungary,3824,3363,5,1,461,228,228,456,4
2024-07-18,LH,Hungary,3741,3290,4,2,451,217,230,447,2
2024-07-19,LH,Hungary,3836,3434,2,2,402,199,201,400,0
2024-07-20,LH,Hungary,3833,3463,1,1,370,179,190,369,0
2024-07-21,LH,Hungary,3777,3316,3,0,461,231,227,458,3
2024-07-22,LH,Hungary,3861,3404,4,2,457,239,214,453,2
2024-07-23,LH,Hungary,3787,3371,3,2,416,206,207,413,1
2024-07-24,LH,Hungary,3776,3358,2,0,418,211,205,416,2
2024-07-25,LH,Hungary,3737,3323,7,3,414,204,203,407,4
2024-07-26,LH,Hungary,3938,3496,0,0,442,219,223,442,0
2024-07-27,LH,Hungary,3861,3502,2,1,359,183,174,357,1
2024-07-28,LH,Hungary,4050,3638,1,0,412,197,214,411,1
2024-07-29,LH,Hungary,3660,3246,3,1,414,211,200,411,2
2024-07-30,LH,Hungary,3741,3336,0,0,405,199,206,405,0
2024-01-01,EI,Ireland,1317,585,9,0,732,360,363,723,9
2024-01-02,EI,Ireland,1310,592,18,4,718,350,350,700,14
2024-01-03,EI,Ireland,1427,695,17,4,732,355,360,715,13
2024-01-04,EI,Ireland,1452,691,18,4,761,371,372,743,14
2024-01-05,EI,Ireland,1595,749,22,6,846,412,412,824,16
2024-01-06,EI,Ireland,1456,748,14,2,708,346,348,694,12
2024-01-07,EI,Ireland,1592,781,11,1,811,398,402,800,10
2024-01-08,EI,Ireland,1471,721,17,3,750,372,361,733,14
2024-01-09,EI,Ireland,1261,738,19,2,523,252,252,504,17
2024-01-10,EI,Ireland,1198,655,17,3,543,263,263,526,14
2024-01-11,EI,Ireland,1343,738,21,5,605,292,292,584,16
2024-01-12,EI,Ireland,1443,690,26,14,753,361,366,727,12
2024-01-13,EI,Ireland,1287,670,11,3,617,304,302,606,8
2024-01-14,EI,Ireland,1289,591,9,1,698,340,349,689,8
2024-01-15,EI,Ireland,1394,702,18,5,692,342,332,674,13
2024-01-16,EI,Ireland,1176,631,19,5,545,261,265,526,14
2024-01-17,EI,Ireland,1145,614,14,3,531,262,255,517,11
2024-01-18,EI,Ireland,1238,634,17,4,604,294,293,587,13
2024-01-19,EI,Ireland,1520,773,16,7,747,366,365,731,9
2024-01-20,EI,Ireland,1198,589,8,0,609,301,300,601,8
2024-01-21,EI,Ireland,1107,621,12,0,486,233,241,474,12
2024-01-22,EI,Ireland,1164,442,11,1,722,355,356,711,10
2024-01-23,EI,Ireland,1078,551,11,1,527,255,261,516,10
2024-01-24,EI,Ireland,1090,512,22,6,578,278,278,556,16
2024-01-25,EI,Ireland,1217,588,18,4,629,307,304,611,14
2024-01-26,EI,Ireland,1398,642,20,5,756,368,368,736,15
2024-01-27,EI,Ireland,1278,672,9,1,606,298,299,597,8
2024-01-28,EI,Ireland,1307,589,12,3,718,353,353,706,9
2024-01-29,EI,Ireland,1320,634,16,4,686,335,335,670,12
2024-01-30,EI,Ireland,1165,606,19,6,559,267,273,540,13
2024-01-31,EI,Ireland,1042,466,16,6,576,284,276,560,10
2024-02-01,EI,Ireland,1267,639,22,6,628,306,300,606,16
2024-02-02,EI,Ireland,1407,587,22,7,820,398,400,798,15
2024-02-03,EI,Ireland,1170,524,14,4,646,316,316,632,10
2024-02-04,EI,Ireland,1245,493,12,2,752,367,373,740,10
2024-02-05,EI,Ireland,1297,596,19,6,701,343,339,682,13
2024-02-06,EI,Ireland,1176,629,15,3,547,265,267,532,12
2024-02-07,EI,Ireland,1188,607,26,7,581,280,275,555,19
2024-02-08,EI,Ireland,1306,681,14,1,625,303,308,611,13
2024-02-09,EI,Ireland,1517,705,17,3,812,400,395,795,14
2024-02-10,EI,Ireland,1412,749,12,2,663,328,323,651,10
2024-02-11,EI,Ireland,1369,634,12,3,735,362,361,723,9
2024-02-12,EI,Ireland,1262,556,16,2,706,344,346,690,14
2024-02-13,EI,Ireland,1211,662,14,2,549,266,269,535,12
2024-02-14,EI,Ireland,1231,629,21,5,602,293,288,581,16
2024-02-15,EI,Ireland,1359,715,17,5,644,309,318,627,12
2024-02-16,EI,Ireland,1551,738,20,4,813,400,393,793,16
2024-02-17,EI,Ireland,1351,700,8,0,651,319,324,643,8
2024-02-18,EI,Ireland,1383,604,14,3,779,379,386,765,11
2024-02-19,EI,Ireland,1535,817,18,4,718,355,345,700,14
2024-02-20,EI,Ireland,1091,527,19,4,564,274,271,545,15
2024-02-21,EI,Ireland,1125,521,16,3,604,293,295,588,13
2024-02-22,EI,Ireland,1107,456,19,5,651,316,316,632,14
2024-02-23,EI,Ireland,1300,500,20,3,800,387,393,780,17
2024-02-24,EI,Ireland,1344,679,13,1,665,328,324,652,12
2024-02-25,EI,Ireland,1440,666,13,0,774,378,383,761,13
2024-02-26,EI,Ireland,1382,647,17,2,735,362,356,718,15
2024-02-27,EI,Ireland,1163,579,24,4,584,277,283,560,20
2024-02-28,EI,Ireland,1339,726,18,2,613,299,296,595,16
2024-02-29,EI,Ireland,1365,680,21,6,685,331,333,664,15
2024-03-01,EI,Ireland,1494,728,13,2,766,382,371,753,11
2024-03-02,EI,Ireland,1362,668,13,3,694,339,342,681,10
2024-03-03,EI,Ireland,1402,633,12,3,769,377,380,757,9
2024-03-04,EI,Ireland,1437,696,17,4,741,362,362,724,13
2024-03-05,EI,Ireland,1200,598,13,1,602,293,296,589,12
2024-03-06,EI,Ireland,1227,592,19,0,635,308,308,616,19
2024-03-07,EI,Ireland,1306,624,16,2,682,335,331,666,14
2024-03-08,EI,Ireland,1486,660,17,0,826,399,410,809,17
2024-03-09,EI,Ireland,1415,740,9,1,675,337,329,666,8
2024-03-10,EI,Ireland,1537,742,14,4,795,388,393,781,10
2024-03-11,EI,Ireland,1422,645,13,2,777,388,376,764,11
2024-03-12,EI,Ireland,1242,612,19,3,630,304,307,611,16
2024-03-13,EI,Ireland,1262,611,16,3,651,320,315,635,13
2024-03-14,EI,Ireland,1417,702,16,4,715,345,354,699,12
2024-03-15,EI,Ireland,1716,809,26,7,907,437,444,881,19
2024-03-16,EI,Ireland,1490,741,8,0,749,371,370,741,8
2024-03-17,EI,Ireland,1501,668,13,2,833,413,407,820,11
2024-03-18,EI,Ireland,1517,726,11,1,791,395,385,780,10
2024-03-19,EI,Ireland,1382,697,21,6,685,332,332,664,15
2024-03-20,EI,Ireland,1245,532,17,5,713,345,351,696,12
2024-03-21,EI,Ireland,1503,740,17,4,763,374,372,746,13
2024-03-22,EI,Ireland,1543,691,13,2,852,415,424,839,11
2024-03-23,EI,Ireland,1363,642,8,3,721,357,356,713,5
2024-03-24,EI,Ireland,1494,693,9,0,801,397,395,792,9
2024-03-25,EI,Ireland,1376,566,16,1,810,399,395,794,15
2024-03-26,EI,Ireland,1443,724,16,4,719,351,352,703,12
2024-03-27,EI,Ireland,1445,716,17,5,729,355,357,712,12
2024-03-28,EI,Ireland,1612,784,16,4,828,405,407,812,12
2024-03-29,EI,Ireland,1525,682,16,2,843,414,413,827,14
2024-03-30,EI,Ireland,1393,688,10,0,705,349,346,695,10
2024-03-31,EI,Ireland,1623,814,10,1,809,402,397,799,9
2024-04-01,EI,Ireland,1573,769,9,1,804,397,398,795,8
2024-04-02,EI,Ireland,1513,686,21,8,827,404,402,806,13
2024-04-03,EI,Ireland,1560,730,20,4,830,405,405,810,16
2024-04-04,EI,Ireland,1647,782,19,3,865,421,425,846,16
2024-04-05,EI,Ireland,1593,729,17,1,864,421,426,847,16
2024-04-06,EI,Ireland,1396,707,7,1,689,343,339,682,6
2024-04-07,EI,Ireland,1647,785,9,4,862,422,431,853,5
2024-04-08,EI,Ireland,1563,722,18,1,841,415,408,823,17
2024-04-09,EI,Ireland,1505,684,17,2,821,399,405,804,15
2024-04-10,EI,Ireland,1766,915,21,2,851,410,420,830,19
2024-04-11,EI,Ireland,1736,853,25,6,883,430,428,858,19
2024-04-12,EI,Ireland,1727,857,16,1,870,431,423,854,15
2024-04-13,EI,Ireland,1661,880,12,2,781,385,384,769,10
2024-04-14,EI,Ireland,1618,781,13,3,837,414,410,824,10
2024-04-15,EI,Ireland,1681,847,9,2,834,412,413,825,7
2024-04-16,EI,Ireland,1622,797,17,4,825,404,404,808,13
2024-04-17,EI,Ireland,1632,795,19,6,837,408,410,818,13
2024-04-18,EI,Ireland,1656,788,18,4,868,423,427,850,14
2024-04-19,EI,Ireland,1758,862,17,5,896,438,441,879,12
2024-04-20,EI,Ireland,1598,818,8,0,780,387,385,772,8
2024-04-21,EI,Ireland,1742,906,13,1,836,413,410,823,12
2024-04-22,EI,Ireland,1802,939,18,7,863,415,430,845,11
2024-04-23,EI,Ireland,1776,946,18,6,830,410,402,812,12
2024-04-24,EI,Ireland,1636,782,15,3,854,421,418,839,12
2024-04-25,EI,Ireland,1607,776,20,3,831,398,413,811,17
2024-04-26,EI,Ireland,1714,803,17,3,911,452,442,894,14
2024-04-27,EI,Ireland,1582,796,10,0,786,388,388,776,10
2024-04-28,EI,Ireland,1662,825,11,1,837,415,411,826,10
2024-04-29,EI,Ireland,1718,868,14,3,850,420,416,836,11
2024-04-30,EI,Ireland,1718,870,15,2,848,414,419,833,13
2024-05-01,EI,Ireland,1725,879,15,3,846,417,414,831,12
2024-05-02,EI,Ireland,1759,844,19,5,915,446,450,896,14
2024-05-03,EI,Ireland,1834,915,23,5,919,448,448,896,18
2024-05-04,EI,Ireland,1776,910,16,2,866,420,430,850,14
2024-05-05,EI,Ireland,1710,815,17,5,895,441,437,878,12
2024-05-06,EI,Ireland,1697,826,18,3,871,426,427,853,15
2024-05-07,EI,Ireland,1762,883,17,1,879,431,431,862,16
2024-05-08,EI,Ireland,1696,807,16,4,889,440,433,873,12
2024-05-09,EI,Ireland,1931,973,25,8,958,456,477,933,17
2024-05-10,EI,Ireland,1830,909,22,6,921,454,445,899,16
2024-05-11,EI,Ireland,1702,854,9,1,848,423,416,839,8
2024-05-12,EI,Ireland,1713,798,13,2,915,455,447,902,11
2024-05-13,EI,Ireland,1691,813,15,3,878,435,428,863,12
2024-05-14,EI,Ireland,1710,830,19,3,880,422,439,861,16
2024-05-15,EI,Ireland,1809,910,19,4,899,442,438,880,15
2024-05-16,EI,Ireland,1934,978,20,3,956,460,476,936,17
2024-05-17,EI,Ireland,1916,965,35,18,951,459,457,916,17
2024-05-18,EI,Ireland,1740,884,14,5,856,424,418,842,9
2024-05-19,EI,Ireland,1865,960,15,1,905,446,444,890,14
2024-05-20,EI,Ireland,1850,963,14,2,887,443,430,873,12
2024-05-21,EI,Ireland,1821,905,17,5,916,442,457,899,12
2024-05-22,EI,Ireland,1925,937,43,5,988,459,486,945,38
2024-05-23,EI,Ireland,1855,865,19,2,990,495,476,971,17
2024-05-24,EI,Ireland,1927,972,26,7,955,467,462,929,19
2024-05-25,EI,Ireland,1717,811,14,0,906,447,445,892,14
2024-05-26,EI,Ireland,1692,772,11,1,920,453,456,909,10
2024-05-27,EI,Ireland,1699,793,12,3,906,452,442,894,9
2024-05-28,EI,Ireland,1796,885,28,10,911,442,441,883,18
2024-05-29,EI,Ireland,1833,911,18,3,922,452,452,904,15
2024-05-30,EI,Ireland,1987,1024,20,3,963,466,477,943,17
2024-05-31,EI,Ireland,1970,998,16,3,972,478,478,956,13
2024-06-01,EI,Ireland,1817,936,11,0,881,437,433,870,11
2024-06-02,EI,Ireland,1803,857,11,0,946,469,466,935,11
2024-06-03,EI,Ireland,1695,787,11,1,908,450,447,897,10
2024-06-04,EI,Ireland,1795,881,16,1,914,452,446,898,15
2024-06-05,EI,Ireland,1871,943,18,4,928,454,456,910,14
2024-06-06,EI,Ireland,1950,998,20,6,952,466,466,932,14
2024-06-07,EI,Ireland,1998,1037,18,2,961,473,470,943,16
2024-06-08,EI,Ireland,1860,990,8,0,870,430,432,862,8
2024-06-09,EI,Ireland,1939,1014,17,4,925,451,457,908,13
2024-06-10,EI,Ireland,1874,957,14,1,917,457,446,903,13
2024-06-11,EI,Ireland,1997,1095,19,3,902,435,448,883,16
2024-06-12,EI,Ireland,1928,963,17,2,965,469,479,948,15
2024-06-13,EI,Ireland,1858,886,16,2,972,482,474,956,14
2024-06-14,EI,Ireland,1808,827,14,2,981,483,484,967,12
2024-06-15,EI,Ireland,1584,703,9,0,881,439,433,872,9
2024-06-16,EI,Ireland,1783,865,9,0,918,453,456,909,9
2024-06-17,EI,Ireland,1818,885,18,6,933,458,457,915,12
2024-06-18,EI,Ireland,1902,982,17,2,920,450,453,903,15
2024-06-19,EI,Ireland,1894,960,18,2,934,457,459,916,16
2024-06-20,EI,Ireland,1895,919,21,4,976,472,483,955,17
2024-06-21,EI,Ireland,1710,750,18,4,960,472,470,942,14
2024-06-22,EI,Ireland,1854,945,12,2,909,450,447,897,10
2024-06-23,EI,Ireland,1926,982,12,1,944,463,469,932,11
2024-06-24,EI,Ireland,1916,987,23,10,929,457,449,906,13
2024-06-25,EI,Ireland,1812,849,24,9,963,468,471,939,15
2024-06-26,EI,Ireland,1660,746,23,3,914,449,442,891,20
2024-06-27,EI,Ireland,1606,652,16,1,954,464,474,938,15
2024-06-28,EI,Ireland,1917,963,21,2,954,468,465,933,19
2024-06-29,EI,Ireland,1786,974,12,1,812,403,397,800,11
2024-06-30,EI,Ireland,1778,850,16,1,928,456,456,912,15
2024-07-01,EI,Ireland,1721,795,21,4,926,458,447,905,17
2024-07-02,EI,Ireland,1637,717,20,5,920,447,453,900,15
2024-07-03,EI,Ireland,1547,632,25,5,915,449,441,890,20
2024-07-04,EI,Ireland,1695,762,18,4,933,454,461,915,14
2024-07-05,EI,Ireland,1796,869,15,1,927,452,460,912,14
2024-07-06,EI,Ireland,1715,829,14,1,886,434,438,872,13
2024-07-07,EI,Ireland,1714,790,15,0,924,463,446,909,15
2024-07-08,EI,Ireland,1862,955,20,5,907,446,441,887,15
2024-07-09,EI,Ireland,1813,912,21,6,901,441,439,880,15
2024-07-10,EI,Ireland,1906,983,18,4,923,449,456,905,14
2024-07-11,EI,Ireland,1972,1021,18,6,951,468,465,933,12
2024-07-12,EI,Ireland,2041,1098,17,0,943,463,463,926,17
2024-07-13,EI,Ireland,1837,934,12,2,903,441,450,891,10
2024-07-14,EI,Ireland,2038,1126,13,3,912,449,450,899,10
2024-07-15,EI,Ireland,1918,1001,16,5,917,452,449,901,11
2024-07-16,EI,Ireland,1778,842,23,4,936,454,459,913,19
2024-07-17,EI,Ireland,1654,725,25,11,929,453,451,904,14
2024-07-18,EI,Ireland,1828,854,17,3,974,481,476,957,14
2024-07-19,EI,Ireland,1729,803,19,3,926,450,457,907,16
2024-07-20,EI,Ireland,1500,612,11,1,888,441,436,877,10
2024-07-21,EI,Ireland,1785,862,14,0,923,453,456,909,14
2024-07-22,EI,Ireland,1810,890,19,7,920,452,449,901,12
2024-07-23,EI,Ireland,1829,877,17,5,952,466,469,935,12
2024-07-24,EI,Ireland,1890,936,19,4,954,469,466,935,15
2024-07-25,EI,Ireland,1772,808,17,2,964,472,475,947,15
2024-07-26,EI,Ireland,1664,719,20,3,945,457,468,925,17
2024-07-27,EI,Ireland,1883,981,10,1,902,445,447,892,9
2024-07-28,EI,Ireland,1800,856,13,1,944,472,459,931,12
2024-07-29,EI,Ireland,1922,1016,17,3,906,449,440,889,14
2024-07-30,EI,Ireland,1908,945,20,6,963,464,479,943,14
2024-01-01,LL,Israel,188,3,23,4,185,82,80,162,19
2024-01-02,LL,Israel,186,6,27,2,180,77,76,153,25
2024-01-03,LL,Israel,179,10,19,1,169,76,74,150,18
2024-01-04,LL,Israel,213,6,33,1,207,87,87,174,32
2024-01-05,LL,Israel,145,18,21,2,127,51,55,106,19
2024-01-06,LL,Israel,102,8,17,2,94,37,40,77,15
2024-01-07,LL,Israel,212,0,29,6,212,93,90,183,23
2024-01-08,LL,Israel,210,8,22,3,202,91,89,180,19
2024-01-09,LL,Israel,188,23,19,1,165,75,71,146,18
2024-01-10,LL,Israel,193,2,25,3,191,81,85,166,22
2024-01-11,LL,Israel,241,2,34,4,239,100,105,205,30
2024-01-12,LL,Israel,151,19,14,1,132,57,61,118,13
2024-01-13,LL,Israel,109,-3,21,2,112,44,47,91,19
2024-01-14,LL,Israel,222,-6,25,4,228,105,98,203,21
2024-01-15,LL,Israel,197,9,16,1,188,86,86,172,15
2024-01-16,LL,Israel,173,13,25,4,160,68,67,135,21
2024-01-17,LL,Israel,191,6,24,3,185,79,82,161,21
2024-01-18,LL,Israel,227,2,28,0,225,99,98,197,28
2024-01-19,LL,Israel,145,16,13,1,129,59,57,116,12
2024-01-20,LL,Israel,99,-3,19,1,102,41,42,83,18
2024-01-21,LL,Israel,236,-3,28,2,239,105,106,211,26
2024-01-22,LL,Israel,221,12,17,1,209,95,97,192,16
2024-01-23,LL,Israel,178,7,25,2,171,72,74,146,23
2024-01-24,LL,Israel,210,2,30,1,208,92,86,178,29
2024-01-25,LL,Israel,224,4,21,1,220,96,103,199,20
2024-01-26,LL,Israel,145,17,15,2,128,57,56,113,13
2024-01-27,LL,Israel,97,0,17,1,97,41,39,80,16
2024-01-28,LL,Israel,241,-7,38,3,248,105,105,210,35
2024-01-29,LL,Israel,201,10,20,2,191,88,83,171,18
2024-01-30,LL,Israel,179,3,25,4,176,73,78,151,21
2024-01-31,LL,Israel,202,0,20,4,202,95,87,182,16
2024-02-01,LL,Israel,250,4,29,5,246,108,109,217,24
2024-02-02,LL,Israel,168,22,18,4,146,65,63,128,14
2024-02-03,LL,Israel,115,3,19,2,112,44,49,93,17
2024-02-04,LL,Israel,250,-2,22,3,252,118,112,230,19
2024-02-05,LL,Israel,220,9,22,3,211,92,97,189,19
2024-02-06,LL,Israel,209,13,26,4,196,88,82,170,22
2024-02-07,LL,Israel,204,-3,29,5,207,88,90,178,24
2024-02-08,LL,Israel,270,1,29,3,269,117,123,240,26
2024-02-09,LL,Israel,161,25,12,2,136,65,59,124,10
2024-02-10,LL,Israel,115,4,15,1,111,46,50,96,14
2024-02-11,LL,Israel,245,-6,22,2,251,115,114,229,20
2024-02-12,LL,Israel,224,17,21,1,207,95,91,186,20
2024-02-13,LL,Israel,218,7,26,2,211,95,90,185,24
2024-02-14,LL,Israel,220,0,31,2,220,91,98,189,29
2024-02-15,LL,Israel,256,5,24,2,251,112,115,227,22
2024-02-16,LL,Israel,177,21,15,3,156,73,68,141,12
2024-02-17,LL,Israel,121,0,19,2,121,50,52,102,17
2024-02-18,LL,Israel,270,0,36,4,270,120,114,234,32
2024-02-19,LL,Israel,236,16,16,1,220,101,103,204,15
2024-02-20,LL,Israel,226,6,29,4,220,95,96,191,25
2024-02-21,LL,Israel,249,8,20,2,241,109,112,221,18
2024-02-22,LL,Israel,285,12,43,5,273,111,119,230,38
2024-02-23,LL,Israel,188,25,14,2,163,79,70,149,12
2024-02-24,LL,Israel,121,3,21,5,118,47,50,97,16
2024-02-25,LL,Israel,269,5,31,3,264,118,115,233,28
2024-02-26,LL,Israel,265,24,25,5,241,110,106,216,20
2024-02-27,LL,Israel,218,11,33,2,207,86,88,174,31
2024-02-28,LL,Israel,230,7,25,2,223,98,100,198,23
2024-02-29,LL,Israel,300,25,31,3,275,123,121,244,28
2024-03-01,LL,Israel,211,38,11,3,173,81,81,162,8
2024-03-02,LL,Israel,163,23,19,3,140,60,61,121,16
2024-03-03,LL,Israel,322,19,26,2,303,138,139,277,24
2024-03-04,LL,Israel,279,29,25,2,250,114,111,225,23
2024-03-05,LL,Israel,270,24,28,4,246,110,108,218,24
2024-03-06,LL,Israel,273,4,30,4,269,118,121,239,26
2024-03-07,LL,Israel,319,24,28,3,295,133,134,267,25
2024-03-08,LL,Israel,215,37,15,3,178,85,78,163,12
2024-03-09,LL,Israel,151,15,19,1,136,55,62,117,18
2024-03-10,LL,Israel,326,20,36,1,306,137,133,270,35
2024-03-11,LL,Israel,293,23,26,6,270,125,119,244,20
2024-03-12,LL,Israel,294,20,36,2,274,117,121,238,34
2024-03-13,LL,Israel,282,23,35,2,259,111,113,224,33
2024-03-14,LL,Israel,340,52,23,1,288,133,132,265,22
2024-03-15,LL,Israel,294,114,17,3,180,81,82,163,14
2024-03-16,LL,Israel,216,58,22,3,158,67,69,136,19
2024-03-17,LL,Israel,375,40,30,1,335,154,151,305,29
2024-03-18,LL,Israel,311,47,19,0,264,125,120,245,19
2024-03-19,LL,Israel,300,48,28,4,252,113,111,224,24
2024-03-20,LL,Israel,313,45,23,4,268,122,123,245,19
2024-03-21,LL,Israel,370,67,25,2,303,136,142,278,23
2024-03-22,LL,Israel,311,123,12,2,188,91,85,176,10
2024-03-23,LL,Israel,236,92,21,3,144,56,67,123,18
2024-03-24,LL,Israel,371,68,23,2,303,140,140,280,21
2024-03-25,LL,Israel,353,58,31,4,295,137,127,264,27
2024-03-26,LL,Israel,305,41,25,2,264,115,124,239,23
2024-03-27,LL,Israel,320,40,31,4,280,125,124,249,27
2024-03-28,LL,Israel,367,56,31,6,311,141,139,280,25
2024-03-29,LL,Israel,263,81,18,1,182,83,81,164,17
2024-03-30,LL,Israel,204,58,20,1,146,63,63,126,19
2024-03-31,LL,Israel,410,44,42,5,366,159,165,324,37
2024-04-01,LL,Israel,388,48,53,4,340,144,143,287,49
2024-04-02,LL,Israel,330,48,21,2,282,132,129,261,19
2024-04-03,LL,Israel,385,50,43,0,335,146,146,292,43
2024-04-04,LL,Israel,412,55,42,4,357,158,157,315,38
2024-04-05,LL,Israel,296,83,18,1,213,101,94,195,17
2024-04-06,LL,Israel,263,90,19,1,173,74,80,154,18
2024-04-07,LL,Israel,440,63,44,3,377,166,167,333,41
2024-04-08,LL,Israel,409,65,26,2,344,160,158,318,24
2024-04-09,LL,Israel,406,58,38,4,348,156,154,310,34
2024-04-10,LL,Israel,423,67,35,2,356,160,161,321,33
2024-04-11,LL,Israel,502,101,35,3,401,183,183,366,32
2024-04-12,LL,Israel,376,120,26,1,256,119,111,230,25
2024-04-13,LL,Israel,247,91,18,2,156,76,62,138,16
2024-04-14,LL,Israel,290,47,8,0,243,114,121,235,8
2024-04-15,LL,Israel,369,46,23,3,323,147,153,300,20
2024-04-16,LL,Israel,414,49,28,4,365,165,172,337,24
2024-04-17,LL,Israel,439,56,33,3,383,171,179,350,30
2024-04-18,LL,Israel,489,46,36,3,443,204,203,407,33
2024-04-19,LL,Israel,352,70,14,1,282,139,129,268,13
2024-04-20,LL,Israel,313,58,22,3,255,109,124,233,19
2024-04-21,LL,Israel,503,51,25,1,452,214,213,427,24
2024-04-22,LL,Israel,355,61,29,3,294,135,130,265,26
2024-04-23,LL,Israel,312,39,13,1,273,132,128,260,12
2024-04-24,LL,Israel,441,44,32,4,397,184,181,365,28
2024-04-25,LL,Israel,493,80,30,2,413,192,191,383,28
2024-04-26,LL,Israel,373,100,20,1,273,129,124,253,19
2024-04-27,LL,Israel,336,109,18,2,227,102,107,209,16
2024-04-28,LL,Israel,426,81,24,1,345,161,160,321,23
2024-04-29,LL,Israel,353,59,22,1,294,134,138,272,21
2024-04-30,LL,Israel,504,63,31,2,441,202,208,410,29
2024-05-01,LL,Israel,469,79,27,2,390,180,183,363,25
2024-05-02,LL,Israel,495,106,35,5,389,181,173,354,30
2024-05-03,LL,Israel,402,154,12,1,248,114,122,236,11
2024-05-04,LL,Israel,358,141,24,2,217,99,94,193,22
2024-05-05,LL,Israel,432,72,29,3,360,165,166,331,26
2024-05-06,LL,Israel,404,77,31,3,327,150,146,296,28
2024-05-07,LL,Israel,414,74,27,2,340,158,155,313,25
2024-05-08,LL,Israel,407,75,30,5,332,147,155,302,25
2024-05-09,LL,Israel,503,81,50,6,422,187,185,372,44
2024-05-10,LL,Israel,319,101,15,3,218,106,97,203,12
2024-05-11,LL,Israel,312,124,24,2,188,80,84,164,22
2024-05-12,LL,Israel,442,70,25,3,372,169,178,347,22
2024-05-13,LL,Israel,374,76,16,0,298,140,142,282,16
2024-05-14,LL,Israel,371,66,13,1,305,145,147,292,12
2024-05-15,LL,Israel,445,68,40,5,377,169,168,337,35
2024-05-16,LL,Israel,464,75,35,4,389,177,177,354,31
2024-05-17,LL,Israel,312,97,13,3,215,107,95,202,10
2024-05-18,LL,Israel,258,80,22,2,178,73,83,156,20
2024-05-19,LL,Israel,449,46,37,5,403,184,182,366,32
2024-05-20,LL,Israel,400,56,30,1,344,159,155,314,29
2024-05-21,LL,Israel,403,70,33,4,333,152,148,300,29
2024-05-22,LL,Israel,435,73,44,7,362,157,161,318,37
2024-05-23,LL,Israel,519,115,39,3,404,184,181,365,36
2024-05-24,LL,Israel,369,138,13,2,231,111,107,218,11
2024-05-25,LL,Israel,311,129,24,2,182,76,82,158,22
2024-05-26,LL,Israel,480,63,53,4,417,176,188,364,49
2024-05-27,LL,Israel,415,61,34,7,354,162,158,320,27
2024-05-28,LL,Israel,401,63,34,2,338,153,151,304,32
2024-05-29,LL,Israel,402,63,28,6,339,154,157,311,22
2024-05-30,LL,Israel,466,65,38,4,401,183,180,363,34
2024-05-31,LL,Israel,342,95,14,1,247,122,111,233,13
2024-06-01,LL,Israel,264,86,22,2,178,72,84,156,20
2024-06-02,LL,Israel,447,46,39,3,401,177,185,362,36
2024-06-03,LL,Israel,436,61,34,4,375,174,167,341,30
2024-06-04,LL,Israel,435,63,31,3,372,172,169,341,28
2024-06-05,LL,Israel,423,64,28,4,359,164,167,331,24
2024-06-06,LL,Israel,481,73,27,2,408,192,189,381,25
2024-06-07,LL,Israel,377,89,12,0,288,141,135,276,12
2024-06-08,LL,Israel,299,86,19,1,213,92,102,194,18
2024-06-09,LL,Israel,488,56,33,4,432,195,204,399,29
2024-06-10,LL,Israel,492,66,34,3,426,196,196,392,31
2024-06-11,LL,Israel,416,80,24,1,336,160,152,312,23
2024-06-12,LL,Israel,300,67,15,2,233,107,111,218,13
2024-06-13,LL,Israel,537,96,40,2,441,204,197,401,38
2024-06-14,LL,Israel,431,130,16,1,301,145,140,285,15
2024-06-15,LL,Israel,354,100,31,1,254,107,116,223,30
2024-06-16,LL,Israel,514,63,29,3,451,208,214,422,26
2024-06-17,LL,Israel,481,67,27,4,414,193,194,387,23
2024-06-18,LL,Israel,477,58,24,2,419,199,196,395,22
2024-06-19,LL,Israel,478,82,30,4,396,182,184,366,26
2024-06-20,LL,Israel,561,99,28,2,462,221,213,434,26
2024-06-21,LL,Israel,412,126,19,2,286,137,130,267,17
2024-06-22,LL,Israel,342,106,24,1,236,103,109,212,23
2024-06-23,LL,Israel,533,75,35,1,458,207,216,423,34
2024-06-24,LL,Israel,523,81,33,3,442,206,203,409,30
2024-06-25,LL,Israel,485,66,25,4,419,200,194,394,21
2024-06-26,LL,Israel,518,82,36,5,436,200,200,400,31
2024-06-27,LL,Israel,596,126,36,2,470,218,216,434,34
2024-06-28,LL,Israel,450,142,15,3,308,151,142,293,12
2024-06-29,LL,Israel,337,99,22,2,238,103,113,216,20
2024-06-30,LL,Israel,566,82,39,4,484,225,220,445,35
2024-07-01,LL,Israel,492,89,27,5,403,185,191,376,22
2024-07-02,LL,Israel,511,70,17,2,441,212,212,424,15
2024-07-03,LL,Israel,534,92,36,2,442,205,201,406,34
2024-07-04,LL,Israel,595,90,32,2,505,236,237,473,30
2024-07-05,LL,Israel,401,104,16,0,297,144,137,281,16
2024-07-06,LL,Israel,357,96,18,1,261,120,123,243,17
2024-07-07,LL,Israel,528,61,39,4,467,210,218,428,35
2024-07-08,LL,Israel,494,77,27,2,417,194,196,390,25
2024-07-09,LL,Israel,527,69,27,6,458,218,213,431,21
2024-07-10,LL,Israel,515,87,27,1,428,199,202,401,26
2024-07-11,LL,Israel,615,104,40,3,511,235,236,471,37
2024-07-12,LL,Israel,427,125,14,1,302,150,138,288,13
2024-07-13,LL,Israel,372,118,21,2,254,113,120,233,19
2024-07-14,LL,Israel,566,79,35,1,487,226,226,452,34
2024-07-15,LL,Israel,521,73,29,7,448,206,213,419,22
2024-07-16,LL,Israel,557,89,40,4,468,215,213,428,36
2024-07-17,LL,Israel,526,81,36,4,445,201,208,409,32
2024-07-18,LL,Israel,610,104,43,4,506,233,230,463,39
2024-07-19,LL,Israel,458,129,19,4,329,164,146,310,15
2024-07-20,LL,Israel,389,116,21,1,273,122,130,252,20
2024-07-21,LL,Israel,570,75,35,3,495,230,230,460,32
2024-07-22,LL,Israel,526,74,29,3,452,209,214,423,26
2024-07-23,LL,Israel,544,71,25,5,473,223,225,448,20
2024-07-24,LL,Israel,550,85,27,2,465,219,219,438,25
2024-07-25,LL,Israel,629,111,36,0,518,243,239,482,36
2024-07-26,LL,Israel,410,96,15,0,314,153,146,299,15
2024-07-27,LL,Israel,384,95,23,3,289,128,138,266,20
2024-07-28,LL,Israel,585,66,42,4,519,233,244,477,38
2024-07-29,LL,Israel,521,69,36,5,452,211,205,416,31
2024-07-30,LL,Israel,523,57,22,2,466,225,219,444,20
2024-01-01,LI,Italy,4331,1335,664,3,2996,1171,1161,2332,661
2024-01-02,LI,Italy,4525,1480,713,11,3045,1164,1168,2332,702
2024-01-03,LI,Italy,4530,1457,755,29,3073,1156,1162,2318,726
2024-01-04,LI,Italy,4476,1361,776,25,3115,1167,1172,2339,751
2024-01-05,LI,Italy,4863,1584,750,19,3279,1260,1269,2529,731
2024-01-06,LI,Italy,4633,1643,672,5,2990,1159,1159,2318,667
2024-01-07,LI,Italy,4907,1669,728,10,3238,1250,1260,2510,718
2024-01-08,LI,Italy,4554,1425,769,25,3129,1187,1173,2360,744
2024-01-09,LI,Italy,3624,1165,625,22,2459,916,918,1834,603
2024-01-10,LI,Italy,3687,1204,670,27,2483,898,915,1813,643
2024-01-11,LI,Italy,3791,1235,659,21,2556,944,953,1897,638
2024-01-12,LI,Italy,4432,1363,753,19,3069,1145,1171,2316,734
2024-01-13,LI,Italy,4004,1388,604,15,2616,1016,996,2012,589
2024-01-14,LI,Italy,4277,1464,620,9,2813,1091,1102,2193,611
2024-01-15,LI,Italy,4191,1262,714,26,2929,1110,1105,2215,688
2024-01-16,LI,Italy,3408,1103,617,34,2305,848,840,1688,583
2024-01-17,LI,Italy,3414,1053,653,34,2361,847,861,1708,619
2024-01-18,LI,Italy,3596,1107,635,30,2489,931,923,1854,605
2024-01-19,LI,Italy,4365,1350,738,34,3015,1137,1140,2277,704
2024-01-20,LI,Italy,3886,1338,591,10,2548,984,973,1957,581
2024-01-21,LI,Italy,4201,1392,634,9,2809,1083,1092,2175,625
2024-01-22,LI,Italy,4134,1232,736,34,2902,1098,1068,2166,702
2024-01-23,LI,Italy,3377,1020,656,33,2357,842,859,1701,623
2024-01-24,LI,Italy,3545,1144,645,34,2401,866,890,1756,611
2024-01-25,LI,Italy,3712,1165,646,41,2547,953,948,1901,605
2024-01-26,LI,Italy,4332,1295,749,18,3037,1141,1147,2288,731
2024-01-27,LI,Italy,3895,1309,601,10,2586,1007,978,1985,591
2024-01-28,LI,Italy,4144,1344,617,9,2800,1084,1099,2183,608
2024-01-29,LI,Italy,4127,1188,722,25,2939,1112,1105,2217,697
2024-01-30,LI,Italy,3401,1027,635,27,2374,874,865,1739,608
2024-01-31,LI,Italy,3582,1151,640,28,2431,901,890,1791,612
2024-02-01,LI,Italy,3754,1176,639,20,2578,968,971,1939,619
2024-02-02,LI,Italy,4420,1358,727,10,3062,1151,1184,2335,717
2024-02-03,LI,Italy,4056,1441,604,8,2615,1014,997,2011,596
2024-02-04,LI,Italy,4366,1475,635,12,2891,1129,1127,2256,623
2024-02-05,LI,Italy,4289,1302,718,11,2987,1144,1125,2269,707
2024-02-06,LI,Italy,3523,1089,620,15,2434,908,906,1814,605
2024-02-07,LI,Italy,3557,1118,637,17,2439,899,903,1802,620
2024-02-08,LI,Italy,3863,1166,656,21,2697,1018,1023,2041,635
2024-02-09,LI,Italy,4373,1384,680,12,2989,1142,1167,2309,668
2024-02-10,LI,Italy,4132,1391,589,5,2741,1079,1073,2152,584
2024-02-11,LI,Italy,4322,1419,631,6,2903,1130,1142,2272,625
2024-02-12,LI,Italy,4353,1249,782,22,3104,1160,1162,2322,760
2024-02-13,LI,Italy,3552,1091,611,20,2461,940,910,1850,591
2024-02-14,LI,Italy,3823,1195,635,19,2628,992,1001,1993,616
2024-02-15,LI,Italy,4138,1342,659,17,2796,1067,1070,2137,642
2024-02-16,LI,Italy,4737,1491,766,13,3246,1238,1242,2480,753
2024-02-17,LI,Italy,4240,1434,602,6,2806,1114,1090,2204,596
2024-02-18,LI,Italy,4575,1507,639,4,3068,1202,1227,2429,635
2024-02-19,LI,Italy,4437,1301,720,7,3136,1213,1203,2416,713
2024-02-20,LI,Italy,3541,1093,606,15,2448,920,922,1842,591
2024-02-21,LI,Italy,3891,1210,680,14,2681,985,1016,2001,666
2024-02-22,LI,Italy,4006,1252,635,19,2754,1049,1070,2119,616
2024-02-23,LI,Italy,4652,1411,739,9,3241,1252,1250,2502,730
2024-02-24,LI,Italy,4359,1538,620,9,2821,1114,1087,2201,611
2024-02-25,LI,Italy,4587,1533,633,6,3054,1209,1212,2421,627
2024-02-26,LI,Italy,4565,1412,749,20,3153,1213,1191,2404,729
2024-02-27,LI,Italy,3768,1223,620,21,2545,946,979,1925,599
2024-02-28,LI,Italy,3929,1213,673,22,2716,1030,1013,2043,651
2024-02-29,LI,Italy,4052,1265,649,22,2787,1068,1070,2138,627
2024-03-01,LI,Italy,4872,1503,775,17,3369,1290,1304,2594,758
2024-03-02,LI,Italy,4454,1578,628,16,2876,1126,1122,2248,612
2024-03-03,LI,Italy,4717,1595,662,13,3122,1230,1230,2460,649
2024-03-04,LI,Italy,4677,1438,761,24,3239,1248,1230,2478,737
2024-03-05,LI,Italy,3840,1237,625,33,2603,981,997,1978,592
2024-03-06,LI,Italy,3963,1265,637,25,2698,1029,1032,2061,612
2024-03-07,LI,Italy,4090,1324,682,37,2766,1039,1045,2084,645
2024-03-08,LI,Italy,4715,1471,763,16,3244,1227,1254,2481,747
2024-03-09,LI,Italy,4335,1502,589,11,2833,1138,1106,2244,578
2024-03-10,LI,Italy,4724,1592,637,7,3132,1240,1255,2495,630
2024-03-11,LI,Italy,4756,1521,732,12,3235,1250,1253,2503,720
2024-03-12,LI,Italy,3877,1231,639,24,2646,1002,1005,2007,615
2024-03-13,LI,Italy,4061,1294,677,23,2767,1039,1051,2090,654
2024-03-14,LI,Italy,4324,1347,719,21,2977,1116,1142,2258,698
2024-03-15,LI,Italy,4937,1534,779,21,3403,1313,1311,2624,758
2024-03-16,LI,Italy,4432,1456,645,8,2976,1176,1155,2331,637
2024-03-17,LI,Italy,4711,1516,655,8,3195,1265,1275,2540,647
2024-03-18,LI,Italy,4680,1378,783,19,3302,1265,1254,2519,764
2024-03-19,LI,Italy,3998,1258,668,23,2740,1040,1032,2072,645
2024-03-20,LI,Italy,4134,1257,726,26,2877,1068,1083,2151,700
2024-03-21,LI,Italy,4318,1267,747,20,3051,1155,1149,2304,727
2024-03-22,LI,Italy,5032,1581,787,14,3451,1331,1333,2664,773
2024-03-23,LI,Italy,4619,1613,646,8,3006,1182,1178,2360,638
2024-03-24,LI,Italy,4867,1676,674,8,3191,1255,1262,2517,666
2024-03-25,LI,Italy,4901,1519,800,18,3382,1301,1281,2582,782
2024-03-26,LI,Italy,4438,1404,747,26,3034,1131,1156,2287,721
2024-03-27,LI,Italy,4558,1399,755,24,3159,1191,1213,2404,731
2024-03-28,LI,Italy,4908,1505,799,18,3403,1310,1294,2604,781
2024-03-29,LI,Italy,5159,1633,803,22,3526,1352,1371,2723,781
2024-03-30,LI,Italy,4619,1603,662,8,3016,1196,1158,2354,654
2024-03-31,LI,Italy,5376,1839,709,6,3537,1407,1421,2828,703
2024-04-01,LI,Italy,5750,1888,829,8,3862,1527,1506,3033,821
2024-04-02,LI,Italy,5512,1752,872,22,3760,1437,1451,2888,850
2024-04-03,LI,Italy,5447,1699,872,30,3748,1440,1436,2876,842
2024-04-04,LI,Italy,5672,1737,893,27,3935,1517,1525,3042,866
2024-04-05,LI,Italy,5824,1917,866,17,3907,1505,1536,3041,849
2024-04-06,LI,Italy,5788,2129,761,12,3659,1442,1456,2898,749
2024-04-07,LI,Italy,6041,2140,802,5,3901,1552,1547,3099,797
2024-04-08,LI,Italy,5697,1787,874,33,3910,1530,1506,3036,841
2024-04-09,LI,Italy,5502,1739,868,24,3763,1446,1449,2895,844
2024-04-10,LI,Italy,5609,1814,862,37,3795,1464,1469,2933,825
2024-04-11,LI,Italy,5893,1880,927,35,4013,1532,1554,3086,892
2024-04-12,LI,Italy,6000,1969,874,14,4031,1577,1580,3157,860
2024-04-13,LI,Italy,5854,2181,780,11,3673,1438,1455,2893,769
2024-04-14,LI,Italy,6154,2254,798,8,3900,1553,1549,3102,790
2024-04-15,LI,Italy,6071,1947,909,15,4124,1615,1600,3215,894
2024-04-16,LI,Italy,5715,1807,890,12,3908,1490,1528,3018,878
2024-04-17,LI,Italy,5847,1865,901,18,3982,1525,1556,3081,883
2024-04-18,LI,Italy,6119,1978,926,10,4141,1601,1614,3215,916
2024-04-19,LI,Italy,6399,2127,914,18,4272,1688,1670,3358,896
2024-04-20,LI,Italy,6138,2312,779,5,3826,1534,1513,3047,774
2024-04-21,LI,Italy,6317,2258,807,7,4059,1642,1610,3252,800
2024-04-22,LI,Italy,6031,1898,911,14,4133,1623,1599,3222,897
2024-04-23,LI,Italy,5748,1856,875,24,3892,1518,1499,3017,851
2024-04-24,LI,Italy,5801,1880,849,17,3921,1526,1546,3072,832
2024-04-25,LI,Italy,5511,1815,828,12,3696,1436,1432,2868,816
2024-04-26,LI,Italy,6086,2067,833,6,4019,1587,1599,3186,827
2024-04-27,LI,Italy,5979,2295,741,8,3684,1471,1472,2943,733
2024-04-28,LI,Italy,6151,2213,820,8,3938,1549,1569,3118,812
2024-04-29,LI,Italy,6084,1979,884,20,4105,1627,1594,3221,864
2024-04-30,LI,Italy,5849,1975,841,18,3874,1520,1513,3033,823
2024-05-01,LI,Italy,5937,2127,800,6,3810,1496,1514,3010,794
2024-05-02,LI,Italy,6236,2227,872,20,4009,1555,1582,3137,852
2024-05-03,LI,Italy,6426,2286,871,13,4140,1628,1641,3269,858
2024-05-04,LI,Italy,6436,2559,771,10,3877,1546,1560,3106,761
2024-05-05,LI,Italy,6608,2503,807,8,4105,1658,1640,3298,799
2024-05-06,LI,Italy,6394,2179,895,12,4215,1660,1660,3320,883
2024-05-07,LI,Italy,6120,2124,889,19,3996,1555,1552,3107,870
2024-05-08,LI,Italy,6430,2326,913,15,4104,1587,1604,3191,898
2024-05-09,LI,Italy,6565,2244,973,15,4321,1652,1696,3348,958
2024-05-10,LI,Italy,6440,2233,906,22,4207,1638,1663,3301,884
2024-05-11,LI,Italy,6487,2533,804,17,3954,1579,1571,3150,787
2024-05-12,LI,Italy,6959,2689,854,13,4270,1746,1670,3416,841
2024-05-13,LI,Italy,6450,2202,904,21,4248,1668,1676,3344,883
2024-05-14,LI,Italy,6037,2028,888,14,4009,1557,1564,3121,874
2024-05-15,LI,Italy,6231,2073,916,15,4158,1624,1618,3242,901
2024-05-16,LI,Italy,6446,2185,943,11,4261,1648,1670,3318,932
2024-05-17,LI,Italy,6698,2302,922,17,4396,1711,1763,3474,905
2024-05-18,LI,Italy,6540,2522,815,15,4018,1585,1618,3203,800
2024-05-19,LI,Italy,6748,2540,841,12,4208,1708,1659,3367,829
2024-05-20,LI,Italy,6611,2287,928,12,4324,1724,1672,3396,916
2024-05-21,LI,Italy,6255,2209,870,15,4046,1580,1596,3176,855
2024-05-22,LI,Italy,6489,2310,903,15,4179,1627,1649,3276,888
2024-05-23,LI,Italy,6805,2445,924,15,4360,1700,1736,3436,909
2024-05-24,LI,Italy,7045,2551,962,14,4494,1751,1781,3532,948
2024-05-25,LI,Italy,6744,2736,824,7,4008,1587,1597,3184,817
2024-05-26,LI,Italy,6945,2672,864,9,4273,1725,1684,3409,855
2024-05-27,LI,Italy,6950,2490,944,15,4460,1774,1742,3516,929
2024-05-28,LI,Italy,6365,2379,892,17,3986,1545,1549,3094,875
2024-05-29,LI,Italy,6609,2316,931,13,4293,1691,1671,3362,918
2024-05-30,LI,Italy,6804,2464,914,14,4340,1694,1732,3426,900
2024-05-31,LI,Italy,6917,2484,929,10,4433,1737,1767,3504,919
2024-06-01,LI,Italy,7170,2855,929,14,4315,1708,1678,3386,915
2024-06-02,LI,Italy,7403,2830,933,8,4573,1834,1806,3640,925
2024-06-03,LI,Italy,6932,2428,973,14,4504,1769,1762,3531,959
2024-06-04,LI,Italy,6532,2323,922,16,4209,1650,1637,3287,906
2024-06-05,LI,Italy,6819,2437,955,14,4382,1715,1712,3427,941
2024-06-06,LI,Italy,7031,2539,1009,12,4492,1724,1759,3483,997
2024-06-07,LI,Italy,7267,2694,952,12,4573,1789,1832,3621,940
2024-06-08,LI,Italy,7161,2832,925,9,4329,1704,1700,3404,916
2024-06-09,LI,Italy,7320,2762,964,7,4558,1809,1785,3594,957
2024-06-10,LI,Italy,7196,2583,964,6,4613,1835,1814,3649,958
2024-06-11,LI,Italy,6821,2479,963,20,4342,1679,1700,3379,943
2024-06-12,LI,Italy,6914,2535,954,18,4379,1711,1714,3425,936
2024-06-13,LI,Italy,7186,2619,996,18,4567,1782,1789,3571,978
2024-06-14,LI,Italy,7449,2724,991,17,4725,1856,1878,3734,974
2024-06-15,LI,Italy,7250,2767,958,7,4483,1764,1761,3525,951
2024-06-16,LI,Italy,7418,2720,1012,7,4698,1847,1839,3686,1005
2024-06-17,LI,Italy,7057,2489,946,16,4568,1810,1812,3622,930
2024-06-18,LI,Italy,6802,2480,956,11,4322,1683,1683,3366,945
2024-06-19,LI,Italy,6973,2534,953,10,4439,1745,1741,3486,943
2024-06-20,LI,Italy,7199,2570,1024,21,4629,1794,1811,3605,1003
2024-06-21,LI,Italy,7401,2760,982,17,4641,1822,1837,3659,965
2024-06-22,LI,Italy,7616,3161,954,9,4455,1740,1761,3501,945
2024-06-23,LI,Italy,7610,2935,984,7,4675,1861,1830,3691,977
2024-06-24,LI,Italy,7376,2700,1006,18,4676,1845,1825,3670,988
2024-06-25,LI,Italy,7030,2614,990,20,4416,1712,1714,3426,970
2024-06-26,LI,Italy,7348,2847,984,19,4501,1751,1766,3517,965
2024-06-27,LI,Italy,7809,3097,1014,20,4712,1841,1857,3698,994
2024-06-28,LI,Italy,7643,2918,1035,24,4725,1837,1853,3690,1011
2024-06-29,LI,Italy,7550,2995,1016,10,4555,1758,1781,3539,1006
2024-06-30,LI,Italy,8064,3253,1070,10,4811,1884,1857,3741,1060
2024-07-01,LI,Italy,7662,2860,1053,23,4802,1876,1873,3749,1030
2024-07-02,LI,Italy,7501,2900,1014,19,4601,1801,1786,3587,995
2024-07-03,LI,Italy,7437,2768,994,14,4669,1841,1834,3675,980
2024-07-04,LI,Italy,7601,2822,1053,12,4779,1863,1863,3726,1041
2024-07-05,LI,Italy,7604,2899,999,6,4705,1843,1863,3706,993
2024-07-06,LI,Italy,7847,3241,980,6,4606,1820,1806,3626,974
2024-07-07,LI,Italy,8045,3207,1053,4,4838,1898,1887,3785,1049
2024-07-08,LI,Italy,7548,2778,1040,23,4770,1859,1871,3730,1017
2024-07-09,LI,Italy,7433,2842,1046,23,4591,1772,1773,3545,1023
2024-07-10,LI,Italy,7792,3119,1031,22,4673,1826,1816,3642,1009
2024-07-11,LI,Italy,7748,3007,1045,20,4741,1837,1859,3696,1025
2024-07-12,LI,Italy,7845,3024,1056,12,4821,1872,1893,3765,1044
2024-07-13,LI,Italy,8152,3458,1011,11,4694,1847,1836,3683,1000
2024-07-14,LI,Italy,8154,3276,1044,10,4878,1935,1899,3834,1034
2024-07-15,LI,Italy,7847,2928,1076,19,4919,1911,1932,3843,1057
2024-07-16,LI,Italy,7582,2929,1037,16,4653,1797,1819,3616,1021
2024-07-17,LI,Italy,7710,3080,978,13,4630,1821,1831,3652,965
2024-07-18,LI,Italy,7830,3001,1082,18,4829,1882,1865,3747,1064
2024-07-19,LI,Italy,7419,2832,1010,10,4587,1760,1817,3577,1000
2024-07-20,LI,Italy,7930,3279,1008,9,4651,1833,1810,3643,999
2024-07-21,LI,Italy,8095,3371,1049,8,4724,1849,1826,3675,1041
2024-07-22,LI,Italy,7724,2921,1020,9,4803,1893,1890,3783,1011
2024-07-23,LI,Italy,7487,2979,959,9,4508,1773,1776,3549,950
2024-07-24,LI,Italy,7752,3014,1033,17,4738,1853,1852,3705,1016
2024-07-25,LI,Italy,7717,3008,1042,18,4709,1838,1829,3667,1024
2024-07-26,LI,Italy,7732,2933,1064,11,4799,1861,1874,3735,1053
2024-07-27,LI,Italy,8055,3301,1017,12,4754,1861,1876,3737,1005
2024-07-28,LI,Italy,8380,3416,1092,14,4964,1932,1940,3872,1078
2024-07-29,LI,Italy,7682,2860,1019,12,4822,1912,1891,3803,1007
2024-07-30,LI,Italy,7329,2752,1033,17,4577,1776,1768,3544,1016
2024-01-01,EV,Latvia,466,312,0,0,154,78,76,154,0
2024-01-02,EV,Latvia,484,343,2,2,141,70,69,139,0
2024-01-03,EV,Latvia,477,335,3,3,142,70,69,139,0
2024-01-04,EV,Latvia,513,341,1,1,172,86,85,171,0
2024-01-05,EV,Latvia,548,377,0,0,171,86,85,171,0
2024-01-06,EV,Latvia,506,363,1,1,143,71,71,142,0
2024-01-07,EV,Latvia,555,384,0,0,171,82,89,171,0
2024-01-08,EV,Latvia,558,376,1,1,182,91,90,181,0
2024-01-09,EV,Latvia,423,322,1,1,101,49,51,100,0
2024-01-10,EV,Latvia,422,319,4,4,103,49,50,99,0
2024-01-11,EV,Latvia,450,322,2,2,128,65,61,126,0
2024-01-12,EV,Latvia,475,316,0,0,159,81,78,159,0
2024-01-13,EV,Latvia,448,322,0,0,126,62,64,126,0
2024-01-14,EV,Latvia,487,336,0,0,151,74,77,151,0
2024-01-15,EV,Latvia,485,316,0,0,169,84,85,169,0
2024-01-16,EV,Latvia,351,264,0,0,87,44,43,87,0
2024-01-17,EV,Latvia,396,293,1,1,103,52,50,102,0
2024-01-18,EV,Latvia,423,309,1,1,114,57,56,113,0
2024-01-19,EV,Latvia,478,328,0,0,150,76,74,150,0
2024-01-20,EV,Latvia,433,315,0,0,118,58,60,118,0
2024-01-21,EV,Latvia,503,355,0,0,148,75,73,148,0
2024-01-22,EV,Latvia,486,321,2,2,165,80,83,163,0
2024-01-23,EV,Latvia,387,293,0,0,94,48,46,94,0
2024-01-24,EV,Latvia,405,302,1,1,103,49,53,102,0
2024-01-25,EV,Latvia,438,325,0,0,113,58,55,113,0
2024-01-26,EV,Latvia,498,346,0,0,152,78,74,152,0
2024-01-27,EV,Latvia,445,319,2,2,126,59,65,124,0
2024-01-28,EV,Latvia,492,345,1,1,147,74,72,146,0
2024-01-29,EV,Latvia,508,342,1,1,166,82,83,165,0
2024-01-30,EV,Latvia,354,272,0,0,82,41,41,82,0
2024-01-31,EV,Latvia,390,291,0,0,99,48,51,99,0
2024-02-01,EV,Latvia,375,267,1,1,108,55,52,107,0
2024-02-02,EV,Latvia,425,282,2,2,143,72,69,141,0
2024-02-03,EV,Latvia,440,319,0,0,121,59,62,121,0
2024-02-04,EV,Latvia,493,343,0,0,150,74,76,150,0
2024-02-05,EV,Latvia,487,321,0,0,166,81,85,166,0
2024-02-06,EV,Latvia,378,280,0,0,98,50,48,98,0
2024-02-07,EV,Latvia,371,277,0,0,94,48,46,94,0
2024-02-08,EV,Latvia,439,318,1,1,121,59,61,120,0
2024-02-09,EV,Latvia,470,305,0,0,165,85,80,165,0
2024-02-10,EV,Latvia,405,283,1,1,122,60,61,121,0
2024-02-11,EV,Latvia,475,322,0,0,153,78,75,153,0
2024-02-12,EV,Latvia,480,315,0,0,165,81,84,165,0
2024-02-13,EV,Latvia,344,244,0,0,100,51,49,100,0
2024-02-14,EV,Latvia,406,303,1,1,103,49,53,102,0
2024-02-15,EV,Latvia,442,315,3,3,127,64,60,124,0
2024-02-16,EV,Latvia,511,350,2,2,161,79,80,159,0
2024-02-17,EV,Latvia,442,315,0,0,127,64,63,127,0
2024-02-18,EV,Latvia,508,355,0,0,153,77,76,153,0
2024-02-19,EV,Latvia,511,341,1,1,170,85,84,169,0
2024-02-20,EV,Latvia,371,275,0,0,96,47,49,96,0
2024-02-21,EV,Latvia,429,322,0,0,107,54,53,107,0
2024-02-22,EV,Latvia,463,340,3,3,123,62,58,120,0
2024-02-23,EV,Latvia,526,360,4,4,166,80,82,162,0
2024-02-24,EV,Latvia,433,303,0,0,130,61,69,130,0
2024-02-25,EV,Latvia,519,355,0,0,164,82,82,164,0
2024-02-26,EV,Latvia,498,321,0,0,177,90,87,177,0
2024-02-27,EV,Latvia,383,284,0,0,99,49,50,99,0
2024-02-28,EV,Latvia,433,324,0,0,109,55,54,109,0
2024-02-29,EV,Latvia,473,343,1,1,130,67,62,129,0
2024-03-01,EV,Latvia,532,356,4,4,176,85,87,172,0
2024-03-02,EV,Latvia,455,313,2,2,142,68,72,140,0
2024-03-03,EV,Latvia,518,350,0,0,168,83,85,168,0
2024-03-04,EV,Latvia,528,339,7,7,189,91,91,182,0
2024-03-05,EV,Latvia,392,283,4,4,109,54,51,105,0
2024-03-06,EV,Latvia,466,345,5,4,121,60,56,116,1
2024-03-07,EV,Latvia,480,348,4,4,132,63,65,128,0
2024-03-08,EV,Latvia,511,341,2,2,170,83,85,168,0
2024-03-09,EV,Latvia,462,324,2,2,138,68,68,136,0
2024-03-10,EV,Latvia,533,373,0,0,160,79,81,160,0
2024-03-11,EV,Latvia,538,350,4,4,188,93,91,184,0
2024-03-12,EV,Latvia,390,273,1,1,117,58,58,116,0
2024-03-13,EV,Latvia,461,326,6,6,135,67,62,129,0
2024-03-14,EV,Latvia,499,351,7,7,148,70,71,141,0
2024-03-15,EV,Latvia,536,365,5,5,171,80,86,166,0
2024-03-16,EV,Latvia,472,331,2,2,141,69,70,139,0
2024-03-17,EV,Latvia,519,352,0,0,167,83,84,167,0
2024-03-18,EV,Latvia,530,341,2,2,189,95,92,187,0
2024-03-19,EV,Latvia,407,287,2,2,120,59,59,118,0
2024-03-20,EV,Latvia,476,336,2,2,140,69,69,138,0
2024-03-21,EV,Latvia,490,335,6,6,155,76,73,149,0
2024-03-22,EV,Latvia,567,392,3,3,175,86,86,172,0
2024-03-23,EV,Latvia,470,330,3,3,140,67,70,137,0
2024-03-24,EV,Latvia,535,364,0,0,171,86,85,171,0
2024-03-25,EV,Latvia,536,355,1,1,181,92,88,180,0
2024-03-26,EV,Latvia,459,320,4,4,139,68,67,135,0
2024-03-27,EV,Latvia,512,355,6,6,157,73,78,151,0
2024-03-28,EV,Latvia,510,346,3,3,164,82,79,161,0
2024-03-29,EV,Latvia,529,358,2,2,171,86,83,169,0
2024-03-30,EV,Latvia,495,348,2,2,147,73,72,145,0
2024-03-31,EV,Latvia,578,402,1,1,176,88,87,175,0
2024-04-01,EV,Latvia,569,386,4,4,183,90,89,179,0
2024-04-02,EV,Latvia,526,356,5,5,170,80,85,165,0
2024-04-03,EV,Latvia,569,381,3,3,188,95,90,185,0
2024-04-04,EV,Latvia,559,386,5,5,173,84,84,168,0
2024-04-05,EV,Latvia,567,383,4,4,184,91,89,180,0
2024-04-06,EV,Latvia,527,379,1,1,148,73,74,147,0
2024-04-07,EV,Latvia,596,422,1,1,174,87,86,173,0
2024-04-08,EV,Latvia,608,419,6,6,189,90,93,183,0
2024-04-09,EV,Latvia,555,388,4,3,167,78,85,163,1
2024-04-10,EV,Latvia,601,406,8,8,195,96,91,187,0
2024-04-11,EV,Latvia,580,405,10,10,175,83,82,165,0
2024-04-12,EV,Latvia,621,434,5,5,187,93,89,182,0
2024-04-13,EV,Latvia,552,408,2,2,144,69,73,142,0
2024-04-14,EV,Latvia,600,435,0,0,165,83,82,165,0
2024-04-15,EV,Latvia,602,415,4,4,187,90,93,183,0
2024-04-16,EV,Latvia,553,385,4,4,168,82,82,164,0
2024-04-17,EV,Latvia,599,418,4,4,181,91,86,177,0
2024-04-18,EV,Latvia,594,409,4,4,185,87,94,181,0
2024-04-19,EV,Latvia,607,421,4,2,186,94,88,182,2
2024-04-20,EV,Latvia,549,409,2,2,140,67,71,138,0
2024-04-21,EV,Latvia,621,443,2,2,178,86,90,176,0
2024-04-22,EV,Latvia,615,431,0,0,184,92,92,184,0
2024-04-23,EV,Latvia,541,366,3,3,175,85,87,172,0
2024-04-24,EV,Latvia,630,447,6,6,183,89,88,177,0
2024-04-25,EV,Latvia,609,418,5,5,191,94,92,186,0
2024-04-26,EV,Latvia,647,452,4,4,195,94,97,191,0
2024-04-27,EV,Latvia,584,435,3,3,149,73,73,146,0
2024-04-28,EV,Latvia,679,502,0,0,177,89,88,177,0
2024-04-29,EV,Latvia,673,484,7,7,189,92,90,182,0
2024-04-30,EV,Latvia,593,424,3,3,169,83,83,166,0
2024-05-01,EV,Latvia,677,487,4,3,190,93,93,186,1
2024-05-02,EV,Latvia,658,471,3,3,187,91,93,184,0
2024-05-03,EV,Latvia,673,480,4,4,193,94,95,189,0
2024-05-04,EV,Latvia,639,469,3,3,170,79,88,167,0
2024-05-05,EV,Latvia,675,485,2,2,190,99,89,188,0
2024-05-06,EV,Latvia,662,478,1,1,184,91,92,183,0
2024-05-07,EV,Latvia,634,441,10,10,193,89,94,183,0
2024-05-08,EV,Latvia,667,466,7,7,201,99,95,194,0
2024-05-09,EV,Latvia,681,487,7,7,194,94,93,187,0
2024-05-10,EV,Latvia,662,469,3,3,193,96,94,190,0
2024-05-11,EV,Latvia,637,453,6,6,184,88,90,178,0
2024-05-12,EV,Latvia,685,499,1,1,186,94,91,185,0
2024-05-13,EV,Latvia,691,491,3,3,200,97,100,197,0
2024-05-14,EV,Latvia,642,449,4,4,193,94,95,189,0
2024-05-15,EV,Latvia,656,470,4,4,186,91,91,182,0
2024-05-16,EV,Latvia,682,485,2,2,197,96,99,195,0
2024-05-17,EV,Latvia,702,502,5,3,200,100,95,195,2
2024-05-18,EV,Latvia,660,469,2,2,191,91,98,189,0
2024-05-19,EV,Latvia,688,489,0,0,199,103,96,199,0
2024-05-20,EV,Latvia,689,490,4,4,199,97,98,195,0
2024-05-21,EV,Latvia,642,440,5,5,202,97,100,197,0
2024-05-22,EV,Latvia,674,475,3,3,199,100,96,196,0
2024-05-23,EV,Latvia,664,471,7,7,193,95,91,186,0
2024-05-24,EV,Latvia,663,466,5,5,197,96,96,192,0
2024-05-25,EV,Latvia,650,475,4,4,175,84,87,171,0
2024-05-26,EV,Latvia,692,500,4,4,192,94,94,188,0
2024-05-27,EV,Latvia,695,502,5,5,193,95,93,188,0
2024-05-28,EV,Latvia,646,450,3,3,196,94,99,193,0
2024-05-29,EV,Latvia,683,491,2,2,192,96,94,190,0
2024-05-30,EV,Latvia,685,492,3,3,193,97,93,190,0
2024-05-31,EV,Latvia,681,486,4,4,195,95,96,191,0
2024-06-01,EV,Latvia,687,500,5,5,187,90,92,182,0
2024-06-02,EV,Latvia,749,551,3,3,198,99,96,195,0
2024-06-03,EV,Latvia,731,534,4,3,197,95,98,193,1
2024-06-04,EV,Latvia,702,498,2,2,204,101,101,202,0
2024-06-05,EV,Latvia,730,535,2,2,195,97,96,193,0
2024-06-06,EV,Latvia,707,509,3,3,198,97,98,195,0
2024-06-07,EV,Latvia,708,506,2,2,202,102,98,200,0
2024-06-08,EV,Latvia,682,502,4,4,180,89,87,176,0
2024-06-09,EV,Latvia,754,553,1,1,201,98,102,200,0
2024-06-10,EV,Latvia,717,508,5,4,209,100,104,204,1
2024-06-11,EV,Latvia,688,467,4,3,221,112,105,217,1
2024-06-12,EV,Latvia,718,521,6,6,197,96,95,191,0
2024-06-13,EV,Latvia,719,515,3,3,204,97,104,201,0
2024-06-14,EV,Latvia,722,505,2,2,217,107,108,215,0
2024-06-15,EV,Latvia,699,511,3,2,188,91,94,185,1
2024-06-16,EV,Latvia,712,515,3,2,197,98,96,194,1
2024-06-17,EV,Latvia,688,501,1,1,187,93,93,186,0
2024-06-18,EV,Latvia,684,481,4,4,203,99,100,199,0
2024-06-19,EV,Latvia,722,520,8,8,202,97,97,194,0
2024-06-20,EV,Latvia,727,534,0,0,193,97,96,193,0
2024-06-21,EV,Latvia,703,500,3,3,203,100,100,200,0
2024-06-22,EV,Latvia,664,467,3,3,197,98,96,194,0
2024-06-23,EV,Latvia,727,540,0,0,187,96,91,187,0
2024-06-24,EV,Latvia,700,514,3,3,186,89,94,183,0
2024-06-25,EV,Latvia,678,477,6,6,201,97,98,195,0
2024-06-26,EV,Latvia,698,508,5,5,190,95,90,185,0
2024-06-27,EV,Latvia,691,496,2,2,195,98,95,193,0
2024-06-28,EV,Latvia,704,499,3,3,205,101,101,202,0
2024-06-29,EV,Latvia,667,486,2,2,181,87,92,179,0
2024-06-30,EV,Latvia,733,542,2,2,191,95,94,189,0
2024-07-01,EV,Latvia,699,508,6,6,191,92,93,185,0
2024-07-02,EV,Latvia,692,488,3,3,204,101,100,201,0
2024-07-03,EV,Latvia,750,542,6,6,208,100,102,202,0
2024-07-04,EV,Latvia,703,510,6,6,193,96,91,187,0
2024-07-05,EV,Latvia,706,512,2,2,194,96,96,192,0
2024-07-06,EV,Latvia,729,542,3,3,187,90,94,184,0
2024-07-07,EV,Latvia,746,548,1,1,198,97,100,197,0
2024-07-08,EV,Latvia,712,506,9,9,206,98,99,197,0
2024-07-09,EV,Latvia,698,494,5,5,204,101,98,199,0
2024-07-10,EV,Latvia,749,543,10,10,206,97,99,196,0
2024-07-11,EV,Latvia,687,486,7,6,201,97,97,194,1
2024-07-12,EV,Latvia,738,532,10,8,206,99,97,196,2
2024-07-13,EV,Latvia,701,506,6,6,195,94,95,189,0
2024-07-14,EV,Latvia,741,546,2,1,195,98,95,193,1
2024-07-15,EV,Latvia,707,504,3,2,203,97,103,200,1
2024-07-16,EV,Latvia,691,484,7,7,207,100,100,200,0
2024-07-17,EV,Latvia,726,524,10,9,202,97,95,192,1
2024-07-18,EV,Latvia,712,511,12,10,201,94,95,189,2
2024-07-19,EV,Latvia,727,520,7,6,207,101,99,200,1
2024-07-20,EV,Latvia,713,524,6,6,189,89,94,183,0
2024-07-21,EV,Latvia,752,546,5,4,206,105,96,201,1
2024-07-22,EV,Latvia,728,523,10,9,205,93,102,195,1
2024-07-23,EV,Latvia,703,485,11,9,218,104,103,207,2
2024-07-24,EV,Latvia,751,541,6,6,210,104,100,204,0
2024-07-25,EV,Latvia,715,518,6,4,197,96,95,191,2
2024-07-26,EV,Latvia,713,512,8,4,201,96,97,193,4
2024-07-27,EV,Latvia,711,512,3,3,199,97,99,196,0
2024-07-28,EV,Latvia,743,549,3,3,194,98,93,191,0
2024-07-29,EV,Latvia,700,524,1,1,176,88,87,175,0
2024-07-30,EV,Latvia,693,488,6,6,205,97,102,199,0
2024-01-01,EY,Lithuania,419,309,1,1,110,51,58,109,0
2024-01-02,EY,Lithuania,473,334,7,6,139,64,68,132,1
2024-01-03,EY,Lithuania,473,328,5,4,145,73,67,140,1
2024-01-04,EY,Lithuania,501,365,3,3,136,65,68,133,0
2024-01-05,EY,Lithuania,512,364,7,6,148,71,70,141,1
2024-01-06,EY,Lithuania,493,353,3,3,140,68,69,137,0
2024-01-07,EY,Lithuania,524,385,5,3,139,67,67,134,2
2024-01-08,EY,Lithuania,507,367,8,7,140,66,66,132,1
2024-01-09,EY,Lithuania,414,300,9,8,114,53,52,105,1
2024-01-10,EY,Lithuania,401,282,0,0,119,61,58,119,0
2024-01-11,EY,Lithuania,426,299,8,8,127,57,62,119,0
2024-01-12,EY,Lithuania,439,299,2,2,140,71,67,138,0
2024-01-13,EY,Lithuania,403,291,2,1,112,55,55,110,1
2024-01-14,EY,Lithuania,446,320,1,1,126,62,63,125,0
2024-01-15,EY,Lithuania,448,316,1,0,132,65,66,131,1
2024-01-16,EY,Lithuania,348,243,5,4,105,49,51,100,1
2024-01-17,EY,Lithuania,360,242,9,8,118,54,55,109,1
2024-01-18,EY,Lithuania,390,263,9,8,127,60,58,118,1
2024-01-19,EY,Lithuania,432,286,6,3,146,70,70,140,3
2024-01-20,EY,Lithuania,387,277,2,2,110,55,53,108,0
2024-01-21,EY,Lithuania,441,322,1,0,119,58,60,118,1
2024-01-22,EY,Lithuania,428,298,1,0,130,64,65,129,1
2024-01-23,EY,Lithuania,369,262,8,8,107,50,49,99,0
2024-01-24,EY,Lithuania,364,250,4,4,114,56,54,110,0
2024-01-25,EY,Lithuania,394,272,4,3,122,58,60,118,1
2024-01-26,EY,Lithuania,439,295,8,8,144,69,67,136,0
2024-01-27,EY,Lithuania,394,281,4,3,113,56,53,109,1
2024-01-28,EY,Lithuania,420,291,2,1,129,60,67,127,1
2024-01-29,EY,Lithuania,436,307,2,1,129,64,63,127,1
2024-01-30,EY,Lithuania,338,233,7,6,105,48,50,98,1
2024-01-31,EY,Lithuania,354,234,7,7,120,59,54,113,0
2024-02-01,EY,Lithuania,358,250,5,4,108,48,55,103,1
2024-02-02,EY,Lithuania,398,262,5,4,136,66,65,131,1
2024-02-03,EY,Lithuania,395,291,5,3,104,50,49,99,2
2024-02-04,EY,Lithuania,433,310,3,3,123,58,62,120,0
2024-02-05,EY,Lithuania,435,306,4,4,129,62,63,125,0
2024-02-06,EY,Lithuania,349,251,5,5,98,46,47,93,0
2024-02-07,EY,Lithuania,363,255,6,5,108,54,48,102,1
2024-02-08,EY,Lithuania,389,270,7,5,119,54,58,112,2
2024-02-09,EY,Lithuania,438,300,7,7,138,67,64,131,0
2024-02-10,EY,Lithuania,392,278,2,1,114,57,55,112,1
2024-02-11,EY,Lithuania,425,295,0,0,130,63,67,130,0
2024-02-12,EY,Lithuania,431,304,2,2,127,62,63,125,0
2024-02-13,EY,Lithuania,350,248,3,2,102,50,49,99,1
2024-02-14,EY,Lithuania,386,261,8,8,125,59,58,117,0
2024-02-15,EY,Lithuania,418,281,8,6,137,66,63,129,2
2024-02-16,EY,Lithuania,429,296,5,4,133,64,64,128,1
2024-02-17,EY,Lithuania,410,292,5,5,118,56,57,113,0
2024-02-18,EY,Lithuania,441,300,5,3,141,68,68,136,2
2024-02-19,EY,Lithuania,437,304,9,8,133,62,62,124,1
2024-02-20,EY,Lithuania,348,246,9,8,102,47,46,93,1
2024-02-21,EY,Lithuania,391,266,3,3,125,61,61,122,0
2024-02-22,EY,Lithuania,416,294,9,9,122,52,61,113,0
2024-02-23,EY,Lithuania,456,313,7,4,143,70,66,136,3
2024-02-24,EY,Lithuania,408,290,3,3,118,58,57,115,0
2024-02-25,EY,Lithuania,455,322,3,1,133,64,66,130,2
2024-02-26,EY,Lithuania,460,326,4,4,134,64,66,130,0
2024-02-27,EY,Lithuania,358,254,2,1,104,52,50,102,1
2024-02-28,EY,Lithuania,372,257,1,1,115,58,56,114,0
2024-02-29,EY,Lithuania,407,283,12,12,124,56,56,112,0
2024-03-01,EY,Lithuania,462,325,9,9,137,67,61,128,0
2024-03-02,EY,Lithuania,430,311,7,3,119,56,56,112,4
2024-03-03,EY,Lithuania,460,324,1,1,136,67,68,135,0
2024-03-04,EY,Lithuania,477,329,10,8,148,68,70,138,2
2024-03-05,EY,Lithuania,376,260,11,6,116,52,53,105,5
2024-03-06,EY,Lithuania,413,279,11,10,134,63,60,123,1
2024-03-07,EY,Lithuania,432,304,10,9,128,58,60,118,1
2024-03-08,EY,Lithuania,453,312,11,7,141,65,65,130,4
2024-03-09,EY,Lithuania,423,309,2,1,114,57,55,112,1
2024-03-10,EY,Lithuania,464,326,4,2,138,64,70,134,2
2024-03-11,EY,Lithuania,465,336,2,1,129,64,63,127,1
2024-03-12,EY,Lithuania,373,263,6,6,110,49,55,104,0
2024-03-13,EY,Lithuania,421,282,6,6,139,68,65,133,0
2024-03-14,EY,Lithuania,460,319,10,7,141,66,65,131,3
2024-03-15,EY,Lithuania,486,327,11,9,159,72,76,148,2
2024-03-16,EY,Lithuania,437,315,5,4,122,61,56,117,1
2024-03-17,EY,Lithuania,453,316,1,1,137,65,71,136,0
2024-03-18,EY,Lithuania,479,329,6,5,150,72,72,144,1
2024-03-19,EY,Lithuania,388,259,11,11,129,61,57,118,0
2024-03-20,EY,Lithuania,433,288,11,8,145,66,68,134,3
2024-03-21,EY,Lithuania,433,285,14,13,148,70,64,134,1
2024-03-22,EY,Lithuania,495,340,4,3,155,74,77,151,1
2024-03-23,EY,Lithuania,432,312,4,4,120,60,56,116,0
2024-03-24,EY,Lithuania,478,338,1,1,140,68,71,139,0
2024-03-25,EY,Lithuania,479,328,10,9,151,69,72,141,1
2024-03-26,EY,Lithuania,429,289,10,8,140,64,66,130,2
2024-03-27,EY,Lithuania,459,300,8,8,159,74,77,151,0
2024-03-28,EY,Lithuania,486,324,7,7,162,77,78,155,0
2024-03-29,EY,Lithuania,465,321,9,9,144,70,65,135,0
2024-03-30,EY,Lithuania,449,320,6,5,129,65,58,123,1
2024-03-31,EY,Lithuania,518,367,2,2,151,75,74,149,0
2024-04-01,EY,Lithuania,495,356,6,5,139,66,67,133,1
2024-04-02,EY,Lithuania,504,337,10,7,167,79,78,157,3
2024-04-03,EY,Lithuania,503,344,5,4,159,76,78,154,1
2024-04-04,EY,Lithuania,521,353,9,9,168,82,77,159,0
2024-04-05,EY,Lithuania,536,372,5,4,164,78,81,159,1
2024-04-06,EY,Lithuania,464,341,1,1,123,62,60,122,0
2024-04-07,EY,Lithuania,565,397,3,1,168,81,84,165,2
2024-04-08,EY,Lithuania,525,366,8,7,159,76,75,151,1
2024-04-09,EY,Lithuania,506,348,7,7,158,76,75,151,0
2024-04-10,EY,Lithuania,536,357,10,8,179,81,88,169,2
2024-04-11,EY,Lithuania,534,348,6,6,186,89,91,180,0
2024-04-12,EY,Lithuania,555,387,6,6,168,83,79,162,0
2024-04-13,EY,Lithuania,472,349,4,2,123,58,61,119,2
2024-04-14,EY,Lithuania,537,372,2,1,165,82,81,163,1
2024-04-15,EY,Lithuania,552,390,6,6,162,78,78,156,0
2024-04-16,EY,Lithuania,513,352,8,7,161,77,76,153,1
2024-04-17,EY,Lithuania,525,356,8,8,169,82,79,161,0
2024-04-18,EY,Lithuania,539,376,6,5,163,78,79,157,1
2024-04-19,EY,Lithuania,571,396,8,8,175,82,85,167,0
2024-04-20,EY,Lithuania,497,370,2,2,127,65,60,125,0
2024-04-21,EY,Lithuania,572,401,3,2,171,81,87,168,1
2024-04-22,EY,Lithuania,540,384,0,0,156,77,79,156,0
2024-04-23,EY,Lithuania,531,365,11,10,166,78,77,155,1
2024-04-24,EY,Lithuania,571,396,6,6,175,83,86,169,0
2024-04-25,EY,Lithuania,572,399,7,7,173,86,80,166,0
2024-04-26,EY,Lithuania,602,418,13,11,184,87,84,171,2
2024-04-27,EY,Lithuania,559,425,2,2,134,66,66,132,0
2024-04-28,EY,Lithuania,639,461,3,1,178,86,89,175,2
2024-04-29,EY,Lithuania,626,459,13,13,167,74,80,154,0
2024-04-30,EY,Lithuania,581,412,13,12,169,81,75,156,1
2024-05-01,EY,Lithuania,623,445,10,10,178,84,84,168,0
2024-05-02,EY,Lithuania,648,463,12,12,185,87,86,173,0
2024-05-03,EY,Lithuania,642,457,8,7,185,90,87,177,1
2024-05-04,EY,Lithuania,619,477,2,2,142,71,69,140,0
2024-05-05,EY,Lithuania,667,483,2,1,184,87,95,182,1
2024-05-06,EY,Lithuania,640,470,5,5,170,85,80,165,0
2024-05-07,EY,Lithuania,623,451,8,8,172,80,84,164,0
2024-05-08,EY,Lithuania,618,430,8,8,188,91,89,180,0
2024-05-09,EY,Lithuania,658,473,9,8,185,87,89,176,1
2024-05-10,EY,Lithuania,647,461,5,5,186,91,90,181,0
2024-05-11,EY,Lithuania,640,491,5,5,149,73,71,144,0
2024-05-12,EY,Lithuania,681,507,1,1,174,87,86,173,0
2024-05-13,EY,Lithuania,663,468,19,15,195,86,90,176,4
2024-05-14,EY,Lithuania,615,432,11,9,183,87,85,172,2
2024-05-15,EY,Lithuania,609,415,17,11,194,87,90,177,6
2024-05-16,EY,Lithuania,634,435,12,12,199,94,93,187,0
2024-05-17,EY,Lithuania,670,455,13,9,215,105,97,202,4
2024-05-18,EY,Lithuania,635,480,4,3,155,76,75,151,1
2024-05-19,EY,Lithuania,670,493,0,0,177,86,91,177,0
2024-05-20,EY,Lithuania,656,474,10,10,182,88,84,172,0
2024-05-21,EY,Lithuania,646,458,8,6,188,87,93,180,2
2024-05-22,EY,Lithuania,636,444,9,7,192,93,90,183,2
2024-05-23,EY,Lithuania,644,451,11,9,193,89,93,182,2
2024-05-24,EY,Lithuania,645,452,9,7,193,95,89,184,2
2024-05-25,EY,Lithuania,628,481,4,3,147,72,71,143,1
2024-05-26,EY,Lithuania,681,491,3,2,190,92,95,187,1
2024-05-27,EY,Lithuania,676,486,16,13,190,86,88,174,3
2024-05-28,EY,Lithuania,665,474,12,12,191,88,91,179,0
2024-05-29,EY,Lithuania,664,459,10,7,205,100,95,195,3
2024-05-30,EY,Lithuania,666,473,10,8,193,94,89,183,2
2024-05-31,EY,Lithuania,676,473,7,6,203,101,95,196,1
2024-06-01,EY,Lithuania,664,512,4,4,152,77,71,148,0
2024-06-02,EY,Lithuania,700,514,3,3,186,88,95,183,0
2024-06-03,EY,Lithuania,694,503,10,10,191,87,94,181,0
2024-06-04,EY,Lithuania,692,505,11,10,187,87,89,176,1
2024-06-05,EY,Lithuania,677,487,9,9,190,91,90,181,0
2024-06-06,EY,Lithuania,702,505,16,13,197,90,91,181,3
2024-06-07,EY,Lithuania,692,497,12,10,195,94,89,183,2
2024-06-08,EY,Lithuania,662,509,5,5,153,75,73,148,0
2024-06-09,EY,Lithuania,712,526,0,0,186,92,94,186,0
2024-06-10,EY,Lithuania,690,513,8,6,177,85,84,169,2
2024-06-11,EY,Lithuania,697,514,6,5,183,89,88,177,1
2024-06-12,EY,Lithuania,680,492,7,6,188,90,91,181,1
2024-06-13,EY,Lithuania,685,483,11,10,202,96,95,191,1
2024-06-14,EY,Lithuania,660,473,2,2,187,95,90,185,0
2024-06-15,EY,Lithuania,665,511,5,3,154,77,72,149,2
2024-06-16,EY,Lithuania,682,495,2,2,187,89,96,185,0
2024-06-17,EY,Lithuania,671,483,10,8,188,89,89,178,2
2024-06-18,EY,Lithuania,666,482,7,6,184,88,89,177,1
2024-06-19,EY,Lithuania,664,472,5,5,192,93,94,187,0
2024-06-20,EY,Lithuania,696,497,9,7,199,95,95,190,2
2024-06-21,EY,Lithuania,673,478,9,7,195,94,92,186,2
2024-06-22,EY,Lithuania,634,467,5,2,167,81,81,162,3
2024-06-23,EY,Lithuania,689,503,4,4,186,90,92,182,0
2024-06-24,EY,Lithuania,675,492,13,8,183,84,86,170,5
2024-06-25,EY,Lithuania,670,478,13,9,192,90,89,179,4
2024-06-26,EY,Lithuania,633,453,13,10,180,82,85,167,3
2024-06-27,EY,Lithuania,675,484,10,9,191,91,90,181,1
2024-06-28,EY,Lithuania,671,485,14,11,186,87,85,172,3
2024-06-29,EY,Lithuania,642,492,5,3,150,75,70,145,2
2024-06-30,EY,Lithuania,695,510,2,2,185,93,90,183,0
2024-07-01,EY,Lithuania,646,481,6,6,165,79,80,159,0
2024-07-02,EY,Lithuania,661,498,9,9,163,77,77,154,0
2024-07-03,EY,Lithuania,688,508,7,7,180,88,85,173,0
2024-07-04,EY,Lithuania,685,501,11,10,184,86,87,173,1
2024-07-05,EY,Lithuania,667,483,10,7,184,85,89,174,3
2024-07-06,EY,Lithuania,680,525,3,3,155,77,75,152,0
2024-07-07,EY,Lithuania,701,517,2,1,184,90,92,182,1
2024-07-08,EY,Lithuania,687,512,13,11,175,81,81,162,2
2024-07-09,EY,Lithuania,644,482,8,8,162,76,78,154,0
2024-07-10,EY,Lithuania,706,522,8,8,184,88,88,176,0
2024-07-11,EY,Lithuania,641,455,9,7,186,88,89,177,2
2024-07-12,EY,Lithuania,683,503,10,9,180,84,86,170,1
2024-07-13,EY,Lithuania,645,497,1,1,148,75,72,147,0
2024-07-14,EY,Lithuania,707,525,0,0,182,94,88,182,0
2024-07-15,EY,Lithuania,674,492,8,8,182,85,89,174,0
2024-07-16,EY,Lithuania,647,478,13,10,169,79,77,156,3
2024-07-17,EY,Lithuania,676,497,14,12,179,83,82,165,2
2024-07-18,EY,Lithuania,671,492,7,7,179,83,89,172,0
2024-07-19,EY,Lithuania,667,492,12,9,175,85,78,163,3
2024-07-20,EY,Lithuania,654,502,6,6,152,73,73,146,0
2024-07-21,EY,Lithuania,700,528,1,1,172,83,88,171,0
2024-07-22,EY,Lithuania,691,509,9,8,182,88,85,173,1
2024-07-23,EY,Lithuania,660,490,8,8,170,81,81,162,0
2024-07-24,EY,Lithuania,684,504,8,7,180,85,87,172,1
2024-07-25,EY,Lithuania,663,480,11,10,183,84,88,172,1
2024-07-26,EY,Lithuania,658,474,12,11,184,87,85,172,1
2024-07-27,EY,Lithuania,676,524,3,3,152,76,73,149,0
2024-07-28,EY,Lithuania,690,524,2,2,166,82,82,164,0
2024-07-29,EY,Lithuania,646,487,1,1,159,76,82,158,0
2024-07-30,EY,Lithuania,670,507,12,11,163,77,74,151,1
2024-01-01,LM,Malta,352,196,0,0,156,79,77,156,0
2024-01-02,LM,Malta,316,174,3,3,142,69,70,139,0
2024-01-03,LM,Malta,342,198,2,2,144,71,71,142,0
2024-01-04,LM,Malta,331,190,1,1,141,67,73,140,0
2024-01-05,LM,Malta,366,188,2,2,178,89,87,176,0
2024-01-06,LM,Malta,381,213,0,0,168,85,83,168,0
2024-01-07,LM,Malta,376,235,0,0,141,70,71,141,0
2024-01-08,LM,Malta,394,228,0,0,166,83,83,166,0
2024-01-09,LM,Malta,302,214,0,0,88,42,46,88,0
2024-01-10,LM,Malta,293,200,2,2,93,46,45,91,0
2024-01-11,LM,Malta,310,200,4,4,110,53,53,106,0
2024-01-12,LM,Malta,337,176,1,1,161,83,77,160,0
2024-01-13,LM,Malta,347,194,0,0,153,74,79,153,0
2024-01-14,LM,Malta,318,176,0,0,142,70,72,142,0
2024-01-15,LM,Malta,341,189,0,0,152,76,76,152,0
2024-01-16,LM,Malta,256,173,0,0,83,42,41,83,0
2024-01-17,LM,Malta,256,168,1,1,88,43,44,87,0
2024-01-18,LM,Malta,293,189,1,1,104,52,51,103,0
2024-01-19,LM,Malta,312,163,1,1,149,75,73,148,0
2024-01-20,LM,Malta,346,201,1,1,145,71,73,144,0
2024-01-21,LM,Malta,327,195,0,0,132,64,68,132,0
2024-01-22,LM,Malta,329,176,0,0,153,78,75,153,0
2024-01-23,LM,Malta,266,181,0,0,85,44,41,85,0
2024-01-24,LM,Malta,255,170,1,1,85,41,43,84,0
2024-01-25,LM,Malta,291,178,0,0,113,56,57,113,0
2024-01-26,LM,Malta,314,159,1,1,155,78,76,154,0
2024-01-27,LM,Malta,319,169,1,1,150,74,75,149,0
2024-01-28,LM,Malta,317,184,1,1,133,64,68,132,0
2024-01-29,LM,Malta,317,168,0,0,149,79,70,149,0
2024-01-30,LM,Malta,240,164,0,0,76,37,39,76,0
2024-01-31,LM,Malta,271,179,3,3,92,46,43,89,0
2024-02-01,LM,Malta,287,181,2,2,106,50,54,104,0
2024-02-02,LM,Malta,336,182,3,3,154,75,76,151,0
2024-02-03,LM,Malta,324,177,2,2,147,73,72,145,0
2024-02-04,LM,Malta,329,198,1,1,131,64,66,130,0
2024-02-05,LM,Malta,340,193,0,0,147,72,75,147,0
2024-02-06,LM,Malta,263,176,3,3,87,42,42,84,0
2024-02-07,LM,Malta,272,178,2,2,94,46,46,92,0
2024-02-08,LM,Malta,301,186,3,3,115,57,55,112,0
2024-02-09,LM,Malta,324,166,1,1,158,80,77,157,0
2024-02-10,LM,Malta,338,190,0,0,148,72,76,148,0
2024-02-11,LM,Malta,353,215,0,0,138,68,70,138,0
2024-02-12,LM,Malta,354,200,1,1,154,77,76,153,0
2024-02-13,LM,Malta,283,188,0,0,95,48,47,95,0
2024-02-14,LM,Malta,299,204,1,1,95,48,46,94,0
2024-02-15,LM,Malta,304,196,1,1,108,53,54,107,0
2024-02-16,LM,Malta,343,186,2,2,157,76,79,155,0
2024-02-17,LM,Malta,325,170,2,2,155,78,75,153,0
2024-02-18,LM,Malta,313,175,2,2,138,66,70,136,0
2024-02-19,LM,Malta,340,179,2,2,161,80,79,159,0
2024-02-20,LM,Malta,247,158,1,1,89,42,46,88,0
2024-02-21,LM,Malta,254,150,0,0,104,52,52,104,0
2024-02-22,LM,Malta,295,179,0,0,116,63,53,116,0
2024-02-23,LM,Malta,326,170,1,1,156,77,78,155,0
2024-02-24,LM,Malta,357,203,1,1,154,76,77,153,0
2024-02-25,LM,Malta,363,222,0,0,141,68,73,141,0
2024-02-26,LM,Malta,365,206,1,1,159,77,81,158,0
2024-02-27,LM,Malta,283,184,4,4,99,47,48,95,0
2024-02-28,LM,Malta,288,178,1,1,110,57,52,109,0
2024-02-29,LM,Malta,297,187,0,0,110,55,55,110,0
2024-03-01,LM,Malta,389,217,3,3,172,84,85,169,0
2024-03-02,LM,Malta,391,223,1,1,168,86,81,167,0
2024-03-03,LM,Malta,378,227,0,0,151,73,78,151,0
2024-03-04,LM,Malta,394,224,2,2,170,86,82,168,0
2024-03-05,LM,Malta,313,225,0,0,88,44,44,88,0
2024-03-06,LM,Malta,318,207,3,3,111,53,55,108,0
2024-03-07,LM,Malta,322,215,1,1,107,53,53,106,0
2024-03-08,LM,Malta,383,225,2,2,158,81,75,156,0
2024-03-09,LM,Malta,391,224,1,1,167,82,84,166,0
2024-03-10,LM,Malta,376,219,1,1,157,76,80,156,0
2024-03-11,LM,Malta,377,215,0,0,162,81,81,162,0
2024-03-12,LM,Malta,282,202,1,1,80,40,39,79,0
2024-03-13,LM,Malta,321,222,0,0,99,52,47,99,0
2024-03-14,LM,Malta,323,199,1,1,124,63,60,123,0
2024-03-15,LM,Malta,366,189,2,2,177,86,89,175,0
2024-03-16,LM,Malta,365,200,1,1,165,83,81,164,0
2024-03-17,LM,Malta,323,180,1,1,143,70,72,142,0
2024-03-18,LM,Malta,367,195,2,2,172,85,85,170,0
2024-03-19,LM,Malta,280,175,4,4,105,49,52,101,0
2024-03-20,LM,Malta,301,182,4,4,119,54,61,115,0
2024-03-21,LM,Malta,297,170,3,3,127,64,60,124,0
2024-03-22,LM,Malta,368,186,0,0,182,91,91,182,0
2024-03-23,LM,Malta,359,185,0,0,174,87,87,174,0
2024-03-24,LM,Malta,335,185,0,0,150,74,76,150,0
2024-03-25,LM,Malta,386,201,1,1,185,92,92,184,0
2024-03-26,LM,Malta,337,218,0,0,119,60,59,119,0
2024-03-27,LM,Malta,352,206,0,0,146,73,73,146,0
2024-03-28,LM,Malta,393,200,0,0,193,96,97,193,0
2024-03-29,LM,Malta,367,182,1,1,185,93,91,184,0
2024-03-30,LM,Malta,383,215,1,1,168,83,84,167,0
2024-03-31,LM,Malta,403,216,0,0,187,94,93,187,0
2024-04-01,LM,Malta,419,233,0,0,186,95,91,186,0
2024-04-02,LM,Malta,360,192,0,0,168,84,84,168,0
2024-04-03,LM,Malta,355,175,0,0,180,88,92,180,0
2024-04-04,LM,Malta,376,163,3,3,213,104,106,210,0
2024-04-05,LM,Malta,361,168,6,6,193,93,94,187,0
2024-04-06,LM,Malta,350,164,2,2,186,92,92,184,0
2024-04-07,LM,Malta,378,192,3,3,186,91,92,183,0
2024-04-08,LM,Malta,377,201,3,3,176,87,86,173,0
2024-04-09,LM,Malta,397,221,2,2,176,89,85,174,0
2024-04-10,LM,Malta,395,216,1,1,179,89,89,178,0
2024-04-11,LM,Malta,447,216,1,1,231,115,115,230,0
2024-04-12,LM,Malta,417,220,3,3,197,96,98,194,0
2024-04-13,LM,Malta,387,205,0,0,182,92,90,182,0
2024-04-14,LM,Malta,414,219,0,0,195,98,97,195,0
2024-04-15,LM,Malta,398,202,0,0,196,98,98,196,0
2024-04-16,LM,Malta,402,237,0,0,165,82,83,165,0
2024-04-17,LM,Malta,396,207,2,2,189,93,94,187,0
2024-04-18,LM,Malta,409,196,1,1,213,109,103,212,0
2024-04-19,LM,Malta,426,232,0,0,194,98,96,194,0
2024-04-20,LM,Malta,425,230,0,0,195,95,100,195,0
2024-04-21,LM,Malta,410,225,1,1,185,93,91,184,0
2024-04-22,LM,Malta,423,223,1,1,200,99,100,199,0
2024-04-23,LM,Malta,382,207,0,0,175,88,87,175,0
2024-04-24,LM,Malta,373,182,1,1,191,91,99,190,0
2024-04-25,LM,Malta,432,221,0,0,211,107,104,211,0
2024-04-26,LM,Malta,441,241,0,0,200,105,95,200,0
2024-04-27,LM,Malta,414,219,2,2,195,94,99,193,0
2024-04-28,LM,Malta,417,225,0,0,192,95,97,192,0
2024-04-29,LM,Malta,383,198,0,0,185,93,92,185,0
2024-04-30,LM,Malta,372,199,1,1,173,87,85,172,0
2024-05-01,LM,Malta,422,235,0,0,187,89,98,187,0
2024-05-02,LM,Malta,436,212,1,1,224,116,107,223,0
2024-05-03,LM,Malta,427,230,1,1,197,97,99,196,0
2024-05-04,LM,Malta,422,224,1,1,198,98,99,197,0
2024-05-05,LM,Malta,412,210,1,1,202,100,101,201,0
2024-05-06,LM,Malta,388,182,2,2,206,104,100,204,0
2024-05-07,LM,Malta,355,179,2,2,176,86,88,174,0
2024-05-08,LM,Malta,395,204,0,0,191,95,96,191,0
2024-05-09,LM,Malta,405,186,0,0,219,111,108,219,0
2024-05-10,LM,Malta,419,216,1,1,203,102,100,202,0
2024-05-11,LM,Malta,392,201,3,3,191,93,95,188,0
2024-05-12,LM,Malta,377,177,1,1,200,102,97,199,0
2024-05-13,LM,Malta,380,172,4,4,208,100,104,204,0
2024-05-14,LM,Malta,363,172,1,1,191,93,97,190,0
2024-05-15,LM,Malta,368,170,2,2,198,96,100,196,0
2024-05-16,LM,Malta,402,174,3,3,228,112,113,225,0
2024-05-17,LM,Malta,388,184,2,2,204,100,102,202,0
2024-05-18,LM,Malta,389,183,3,3,206,103,100,203,0
2024-05-19,LM,Malta,405,196,3,3,209,103,103,206,0
2024-05-20,LM,Malta,407,190,4,4,217,108,105,213,0
2024-05-21,LM,Malta,363,179,3,3,184,89,92,181,0
2024-05-22,LM,Malta,407,203,0,0,204,99,105,204,0
2024-05-23,LM,Malta,440,212,5,5,228,113,110,223,0
2024-05-24,LM,Malta,441,226,2,2,215,107,106,213,0
2024-05-25,LM,Malta,413,212,0,0,201,102,99,201,0
2024-05-26,LM,Malta,412,214,0,0,198,96,102,198,0
2024-05-27,LM,Malta,421,196,3,3,225,108,114,222,0
2024-05-28,LM,Malta,400,210,1,1,190,98,91,189,0
2024-05-29,LM,Malta,389,192,2,2,197,99,96,195,0
2024-05-30,LM,Malta,455,229,3,3,226,112,111,223,0
2024-05-31,LM,Malta,461,256,3,3,205,100,102,202,0
2024-06-01,LM,Malta,475,262,1,1,213,106,106,212,0
2024-06-02,LM,Malta,475,258,0,0,217,106,111,217,0
2024-06-03,LM,Malta,442,229,0,0,213,108,105,213,0
2024-06-04,LM,Malta,431,242,3,3,189,94,92,186,0
2024-06-05,LM,Malta,426,222,0,0,204,99,105,204,0
2024-06-06,LM,Malta,469,232,0,0,237,118,119,237,0
2024-06-07,LM,Malta,447,243,1,1,204,105,98,203,0
2024-06-08,LM,Malta,444,237,1,1,207,103,103,206,0
2024-06-09,LM,Malta,467,252,1,1,215,107,107,214,0
2024-06-10,LM,Malta,427,206,1,1,221,110,110,220,0
2024-06-11,LM,Malta,410,222,0,0,188,93,95,188,0
2024-06-12,LM,Malta,417,221,1,1,196,97,98,195,0
2024-06-13,LM,Malta,471,243,2,2,228,115,111,226,0
2024-06-14,LM,Malta,417,216,0,0,201,102,99,201,0
2024-06-15,LM,Malta,426,220,2,2,206,104,100,204,0
2024-06-16,LM,Malta,436,223,1,1,213,105,107,212,0
2024-06-17,LM,Malta,403,186,2,2,217,107,108,215,0
2024-06-18,LM,Malta,407,221,1,1,186,92,93,185,0
2024-06-19,LM,Malta,405,193,2,2,212,103,107,210,0
2024-06-20,LM,Malta,456,226,1,1,230,115,114,229,0
2024-06-21,LM,Malta,469,250,1,1,219,111,107,218,0
2024-06-22,LM,Malta,483,276,4,4,207,104,99,203,0
2024-06-23,LM,Malta,519,299,1,1,220,108,111,219,0
2024-06-24,LM,Malta,468,245,0,0,223,110,113,223,0
2024-06-25,LM,Malta,462,263,1,1,199,100,98,198,0
2024-06-26,LM,Malta,453,240,1,1,213,104,108,212,0
2024-06-27,LM,Malta,522,275,1,1,247,122,124,246,0
2024-06-28,LM,Malta,493,265,2,2,228,112,114,226,0
2024-06-29,LM,Malta,510,291,2,2,219,112,105,217,0
2024-06-30,LM,Malta,509,294,2,2,215,105,108,213,0
2024-07-01,LM,Malta,474,251,3,3,223,112,108,220,0
2024-07-02,LM,Malta,464,268,3,3,196,96,97,193,0
2024-07-03,LM,Malta,457,242,0,0,215,108,107,215,0
2024-07-04,LM,Malta,501,266,0,0,235,118,117,235,0
2024-07-05,LM,Malta,435,215,1,1,220,111,108,219,0
2024-07-06,LM,Malta,487,271,1,1,216,107,108,215,0
2024-07-07,LM,Malta,468,246,1,1,222,109,112,221,0
2024-07-08,LM,Malta,441,208,5,5,233,115,113,228,0
2024-07-09,LM,Malta,473,262,5,5,211,101,105,206,0
2024-07-10,LM,Malta,442,226,5,5,216,107,104,211,0
2024-07-11,LM,Malta,479,243,4,4,236,116,116,232,0
2024-07-12,LM,Malta,462,238,3,3,224,110,111,221,0
2024-07-13,LM,Malta,472,248,3,3,224,108,113,221,0
2024-07-14,LM,Malta,495,260,3,3,235,116,116,232,0
2024-07-15,LM,Malta,446,218,2,2,228,114,112,226,0
2024-07-16,LM,Malta,417,212,3,3,205,99,103,202,0
2024-07-17,LM,Malta,432,210,2,2,222,112,108,220,0
2024-07-18,LM,Malta,482,246,3,3,236,119,114,233,0
2024-07-19,LM,Malta,460,239,1,1,221,109,111,220,0
2024-07-20,LM,Malta,494,274,0,0,220,108,112,220,0
2024-07-21,LM,Malta,483,261,1,1,222,110,111,221,0
2024-07-22,LM,Malta,461,235,2,2,226,115,109,224,0
2024-07-23,LM,Malta,428,226,0,0,202,97,105,202,0
2024-07-24,LM,Malta,462,245,1,1,217,110,106,216,0
2024-07-25,LM,Malta,500,260,0,0,240,119,121,240,0
2024-07-26,LM,Malta,451,231,1,1,220,111,108,219,0
2024-07-27,LM,Malta,479,267,0,0,212,108,104,212,0
2024-07-28,LM,Malta,514,288,2,2,226,111,113,224,0
2024-07-29,LM,Malta,454,233,1,1,221,112,108,220,0
2024-07-30,LM,Malta,451,249,0,0,202,98,104,202,0
2024-01-01,LU,Moldova,29,-1,0,0,30,13,17,30,0
2024-01-02,LU,Moldova,62,1,0,0,61,32,29,61,0
2024-01-03,LU,Moldova,60,-1,0,0,61,30,31,61,0
2024-01-04,LU,Moldova,62,-2,0,0,64,31,33,64,0
2024-01-05,LU,Moldova,68,2,0,0,66,32,34,66,0
2024-01-06,LU,Moldova,62,1,0,0,61,32,29,61,0
2024-01-07,LU,Moldova,68,-2,0,0,70,35,35,70,0
2024-01-08,LU,Moldova,37,4,0,0,33,16,17,33,0
2024-01-09,LU,Moldova,65,-1,0,0,66,34,32,66,0
2024-01-10,LU,Moldova,62,-1,0,0,63,31,32,63,0
2024-01-11,LU,Moldova,60,-1,0,0,61,31,30,61,0
2024-01-12,LU,Moldova,65,1,0,0,64,32,32,64,0
2024-01-13,LU,Moldova,54,1,0,0,53,28,25,53,0
2024-01-14,LU,Moldova,63,0,0,0,63,31,32,63,0
2024-01-15,LU,Moldova,58,1,1,1,57,27,29,56,0
2024-01-16,LU,Moldova,71,0,0,0,71,35,36,71,0
2024-01-17,LU,Moldova,59,2,0,0,57,29,28,57,0
2024-01-18,LU,Moldova,59,0,0,0,59,29,30,59,0
2024-01-19,LU,Moldova,60,0,0,0,60,30,30,60,0
2024-01-20,LU,Moldova,53,1,0,0,52,27,25,52,0
2024-01-21,LU,Moldova,69,0,0,0,69,34,35,69,0
2024-01-22,LU,Moldova,56,1,0,0,55,27,28,55,0
2024-01-23,LU,Moldova,62,-1,0,0,63,33,30,63,0
2024-01-24,LU,Moldova,60,3,0,0,57,28,29,57,0
2024-01-25,LU,Moldova,61,-2,0,0,63,30,33,63,0
2024-01-26,LU,Moldova,67,1,0,0,66,33,33,66,0
2024-01-27,LU,Moldova,54,0,0,0,54,29,25,54,0
2024-01-28,LU,Moldova,65,-1,0,0,66,32,34,66,0
2024-01-29,LU,Moldova,51,3,0,0,48,25,23,48,0
2024-01-30,LU,Moldova,65,-3,0,0,68,31,37,68,0
2024-01-31,LU,Moldova,62,3,0,0,59,32,27,59,0
2024-02-01,LU,Moldova,60,-2,0,0,62,30,32,62,0
2024-02-02,LU,Moldova,70,1,0,0,69,35,34,69,0
2024-02-03,LU,Moldova,47,0,0,0,47,24,23,47,0
2024-02-04,LU,Moldova,60,-1,0,0,61,30,31,61,0
2024-02-05,LU,Moldova,55,3,0,0,52,26,26,52,0
2024-02-06,LU,Moldova,65,-2,1,1,67,33,33,66,0
2024-02-07,LU,Moldova,57,2,0,0,55,28,27,55,0
2024-02-08,LU,Moldova,57,-2,0,0,59,29,30,59,0
2024-02-09,LU,Moldova,62,0,0,0,62,31,31,62,0
2024-02-10,LU,Moldova,53,0,0,0,53,27,26,53,0
2024-02-11,LU,Moldova,58,-2,0,0,60,28,32,60,0
2024-02-12,LU,Moldova,52,4,0,0,48,25,23,48,0
2024-02-13,LU,Moldova,62,-2,0,0,64,32,32,64,0
2024-02-14,LU,Moldova,53,2,0,0,51,25,26,51,0
2024-02-15,LU,Moldova,53,-2,0,0,55,28,27,55,0
2024-02-16,LU,Moldova,66,0,0,0,66,33,33,66,0
2024-02-17,LU,Moldova,56,3,0,0,53,27,26,53,0
2024-02-18,LU,Moldova,67,0,0,0,67,32,35,67,0
2024-02-19,LU,Moldova,61,2,0,0,59,30,29,59,0
2024-02-20,LU,Moldova,61,-1,0,0,62,32,30,62,0
2024-02-21,LU,Moldova,51,1,0,0,50,24,26,50,0
2024-02-22,LU,Moldova,55,-1,1,1,56,28,27,55,0
2024-02-23,LU,Moldova,61,-1,0,0,62,31,31,62,0
2024-02-24,LU,Moldova,51,1,0,0,50,26,24,50,0
2024-02-25,LU,Moldova,65,1,0,0,64,32,32,64,0
2024-02-26,LU,Moldova,55,0,0,0,55,27,28,55,0
2024-02-27,LU,Moldova,67,-1,0,0,68,35,33,68,0
2024-02-28,LU,Moldova,52,0,0,0,52,25,27,52,0
2024-02-29,LU,Moldova,55,-1,0,0,56,28,28,56,0
2024-03-01,LU,Moldova,65,0,0,0,65,30,35,65,0
2024-03-02,LU,Moldova,55,0,0,0,55,30,25,55,0
2024-03-03,LU,Moldova,66,0,0,0,66,32,34,66,0
2024-03-04,LU,Moldova,48,2,0,0,46,23,23,46,0
2024-03-05,LU,Moldova,63,-2,0,0,65,32,33,65,0
2024-03-06,LU,Moldova,62,2,0,0,60,31,29,60,0
2024-03-07,LU,Moldova,62,-1,0,0,63,31,32,63,0
2024-03-08,LU,Moldova,61,0,0,0,61,30,31,61,0
2024-03-09,LU,Moldova,61,0,0,0,61,31,30,61,0
2024-03-10,LU,Moldova,62,0,0,0,62,31,31,62,0
2024-03-11,LU,Moldova,57,2,0,0,55,28,27,55,0
2024-03-12,LU,Moldova,72,-3,4,4,75,36,35,71,0
2024-03-13,LU,Moldova,57,3,0,0,54,27,27,54,0
2024-03-14,LU,Moldova,60,-1,0,0,61,30,31,61,0
2024-03-15,LU,Moldova,71,0,0,0,71,36,35,71,0
2024-03-16,LU,Moldova,52,1,0,0,51,27,24,51,0
2024-03-17,LU,Moldova,69,-1,0,0,70,34,36,70,0
2024-03-18,LU,Moldova,58,2,1,1,56,26,29,55,0
2024-03-19,LU,Moldova,69,-2,0,0,71,36,35,71,0
2024-03-20,LU,Moldova,58,3,0,0,55,28,27,55,0
2024-03-21,LU,Moldova,62,-2,0,0,64,32,32,64,0
2024-03-22,LU,Moldova,67,0,0,0,67,32,35,67,0
2024-03-23,LU,Moldova,65,1,0,0,64,33,31,64,0
2024-03-24,LU,Moldova,64,0,0,0,64,31,33,64,0
2024-03-25,LU,Moldova,61,2,0,0,59,30,29,59,0
2024-03-26,LU,Moldova,71,-3,0,0,74,37,37,74,0
2024-03-27,LU,Moldova,62,3,0,0,59,30,29,59,0
2024-03-28,LU,Moldova,61,-2,0,0,63,31,32,63,0
2024-03-29,LU,Moldova,71,1,0,0,70,35,35,70,0
2024-03-30,LU,Moldova,57,0,0,0,57,29,28,57,0
2024-03-31,LU,Moldova,67,0,0,0,67,32,35,67,0
2024-04-01,LU,Moldova,69,1,0,0,68,35,33,68,0
2024-04-02,LU,Moldova,59,-2,0,0,61,30,31,61,0
2024-04-03,LU,Moldova,81,1,0,0,80,40,40,80,0
2024-04-04,LU,Moldova,70,2,0,0,68,35,33,68,0
2024-04-05,LU,Moldova,61,-4,0,0,65,33,32,65,0
2024-04-06,LU,Moldova,68,3,0,0,65,33,32,65,0
2024-04-07,LU,Moldova,72,-1,0,0,73,36,37,73,0
2024-04-08,LU,Moldova,67,1,0,0,66,32,34,66,0
2024-04-09,LU,Moldova,66,-1,0,0,67,33,34,67,0
2024-04-10,LU,Moldova,75,2,0,0,73,37,36,73,0
2024-04-11,LU,Moldova,75,0,1,1,75,35,39,74,0
2024-04-12,LU,Moldova,68,-3,0,0,71,37,34,71,0
2024-04-13,LU,Moldova,72,3,0,0,69,35,34,69,0
2024-04-14,LU,Moldova,65,-3,0,0,68,33,35,68,0
2024-04-15,LU,Moldova,71,4,0,0,67,36,31,67,0
2024-04-16,LU,Moldova,65,-2,0,0,67,34,33,67,0
2024-04-17,LU,Moldova,73,3,0,0,70,34,36,70,0
2024-04-18,LU,Moldova,65,-1,0,0,66,32,34,66,0
2024-04-19,LU,Moldova,66,-2,0,0,68,35,33,68,0
2024-04-20,LU,Moldova,79,0,0,0,79,38,41,79,0
2024-04-21,LU,Moldova,72,0,0,0,72,36,36,72,0
2024-04-22,LU,Moldova,70,5,0,0,65,33,32,65,0
2024-04-23,LU,Moldova,66,-1,0,0,67,34,33,67,0
2024-04-24,LU,Moldova,75,1,0,0,74,38,36,74,0
2024-04-25,LU,Moldova,70,-3,0,0,73,35,38,73,0
2024-04-26,LU,Moldova,78,2,0,0,76,40,36,76,0
2024-04-27,LU,Moldova,78,0,0,0,78,38,40,78,0
2024-04-28,LU,Moldova,65,0,0,0,65,33,32,65,0
2024-04-29,LU,Moldova,69,2,0,0,67,33,34,67,0
2024-04-30,LU,Moldova,78,-3,0,0,81,41,40,81,0
2024-05-01,LU,Moldova,84,0,0,0,84,40,44,84,0
2024-05-02,LU,Moldova,80,1,0,0,79,39,40,79,0
2024-05-03,LU,Moldova,77,-3,0,0,80,41,39,80,0
2024-05-04,LU,Moldova,109,1,0,0,108,52,56,108,0
2024-05-05,LU,Moldova,80,1,0,0,79,40,39,79,0
2024-05-06,LU,Moldova,74,1,0,0,73,37,36,73,0
2024-05-07,LU,Moldova,88,1,0,0,87,44,43,87,0
2024-05-08,LU,Moldova,100,0,0,0,100,48,52,100,0
2024-05-09,LU,Moldova,88,2,0,0,86,44,42,86,0
2024-05-10,LU,Moldova,85,-3,0,0,88,43,45,88,0
2024-05-11,LU,Moldova,99,0,0,0,99,49,50,99,0
2024-05-12,LU,Moldova,81,0,0,0,81,43,38,81,0
2024-05-13,LU,Moldova,88,2,0,0,86,42,44,86,0
2024-05-14,LU,Moldova,93,0,0,0,93,48,45,93,0
2024-05-15,LU,Moldova,104,1,0,0,103,49,54,103,0
2024-05-16,LU,Moldova,88,0,0,0,88,45,43,88,0
2024-05-17,LU,Moldova,84,-1,0,0,85,44,41,85,0
2024-05-18,LU,Moldova,105,-2,0,0,107,51,56,107,0
2024-05-19,LU,Moldova,88,1,0,0,87,46,41,87,0
2024-05-20,LU,Moldova,90,3,0,0,87,42,45,87,0
2024-05-21,LU,Moldova,86,-4,0,0,90,43,47,90,0
2024-05-22,LU,Moldova,105,3,0,0,102,52,50,102,0
2024-05-23,LU,Moldova,86,-3,0,0,89,44,45,89,0
2024-05-24,LU,Moldova,90,1,0,0,89,47,42,89,0
2024-05-25,LU,Moldova,121,-1,0,0,122,60,62,122,0
2024-05-26,LU,Moldova,99,2,0,0,97,50,47,97,0
2024-05-27,LU,Moldova,97,1,0,0,96,47,49,96,0
2024-05-28,LU,Moldova,100,0,0,0,100,51,49,100,0
2024-05-29,LU,Moldova,110,1,0,0,109,54,55,109,0
2024-05-30,LU,Moldova,107,1,0,0,106,51,55,106,0
2024-05-31,LU,Moldova,101,-3,0,0,104,51,53,104,0
2024-06-01,LU,Moldova,112,2,0,0,110,56,54,110,0
2024-06-02,LU,Moldova,106,2,0,0,104,53,51,104,0
2024-06-03,LU,Moldova,106,4,0,0,102,51,51,102,0
2024-06-04,LU,Moldova,104,-1,0,0,105,53,52,105,0
2024-06-05,LU,Moldova,110,-1,0,0,111,54,57,111,0
2024-06-06,LU,Moldova,103,-1,2,2,104,50,52,102,0
2024-06-07,LU,Moldova,105,1,0,0,104,54,50,104,0
2024-06-08,LU,Moldova,116,-1,0,0,117,58,59,117,0
2024-06-09,LU,Moldova,122,3,0,0,119,61,58,119,0
2024-06-10,LU,Moldova,111,0,0,0,111,53,58,111,0
2024-06-11,LU,Moldova,116,2,0,0,114,58,56,114,0
2024-06-12,LU,Moldova,124,-2,0,0,126,63,63,126,0
2024-06-13,LU,Moldova,102,5,0,0,97,48,49,97,0
2024-06-14,LU,Moldova,105,2,0,0,103,52,51,103,0
2024-06-15,LU,Moldova,127,-2,0,0,129,63,66,129,0
2024-06-16,LU,Moldova,115,1,0,0,114,58,56,114,0
2024-06-17,LU,Moldova,112,1,0,0,111,53,58,111,0
2024-06-18,LU,Moldova,107,0,0,0,107,56,51,107,0
2024-06-19,LU,Moldova,122,-1,0,0,123,60,63,123,0
2024-06-20,LU,Moldova,110,2,0,0,108,53,55,108,0
2024-06-21,LU,Moldova,106,-3,0,0,109,57,52,109,0
2024-06-22,LU,Moldova,114,1,0,0,113,56,57,113,0
2024-06-23,LU,Moldova,115,2,0,0,113,58,55,113,0
2024-06-24,LU,Moldova,103,-1,0,0,104,50,54,104,0
2024-06-25,LU,Moldova,110,1,0,0,109,58,51,109,0
2024-06-26,LU,Moldova,114,-6,0,0,120,56,64,120,0
2024-06-27,LU,Moldova,121,2,0,0,119,61,58,119,0
2024-06-28,LU,Moldova,113,4,0,0,109,55,54,109,0
2024-06-29,LU,Moldova,121,-2,0,0,123,61,62,123,0
2024-06-30,LU,Moldova,112,1,0,0,111,57,54,111,0
2024-07-01,LU,Moldova,102,-1,0,0,103,47,56,103,0
2024-07-02,LU,Moldova,110,2,0,0,108,57,51,108,0
2024-07-03,LU,Moldova,123,-2,0,0,125,61,64,125,0
2024-07-04,LU,Moldova,118,5,0,0,113,58,55,113,0
2024-07-05,LU,Moldova,108,-2,0,0,110,54,56,110,0
2024-07-06,LU,Moldova,116,1,0,0,115,57,58,115,0
2024-07-07,LU,Moldova,114,0,0,0,114,58,56,114,0
2024-07-08,LU,Moldova,107,2,0,0,105,49,56,105,0
2024-07-09,LU,Moldova,112,1,1,1,111,59,51,110,0
2024-07-10,LU,Moldova,115,-6,0,0,121,59,62,121,0
2024-07-11,LU,Moldova,113,5,1,1,108,54,53,107,0
2024-07-12,LU,Moldova,104,-1,1,1,105,52,52,104,0
2024-07-13,LU,Moldova,108,0,0,0,108,53,55,108,0
2024-07-14,LU,Moldova,112,2,2,2,110,56,52,108,0
2024-07-15,LU,Moldova,123,-1,1,1,124,58,65,123,0
2024-07-16,LU,Moldova,111,2,0,0,109,57,52,109,0
2024-07-17,LU,Moldova,115,-1,0,0,116,58,58,116,0
2024-07-18,LU,Moldova,105,-2,0,0,107,54,53,107,0
2024-07-19,LU,Moldova,111,-1,0,0,112,54,58,112,0
2024-07-20,LU,Moldova,120,1,0,0,119,60,59,119,0
2024-07-21,LU,Moldova,111,5,0,0,106,55,51,106,0
2024-07-22,LU,Moldova,111,-3,0,0,114,54,60,114,0
2024-07-23,LU,Moldova,114,4,0,0,110,57,53,110,0
2024-07-24,LU,Moldova,123,-2,0,0,125,61,64,125,0
2024-07-25,LU,Moldova,112,1,0,0,111,56,55,111,0
2024-07-26,LU,Moldova,115,0,0,0,115,57,58,115,0
2024-07-27,LU,Moldova,113,1,0,0,112,57,55,112,0
2024-07-28,LU,Moldova,115,2,0,0,113,58,55,113,0
2024-07-29,LU,Moldova,110,0,0,0,110,52,58,110,0
2024-07-30,LU,Moldova,110,1,0,0,109,56,53,109,0
2024-01-01,GM,Morocco,1436,791,55,0,645,292,298,590,55
2024-01-02,GM,Morocco,1570,899,71,2,671,302,298,600,69
2024-01-03,GM,Morocco,1539,886,78,6,653,294,281,575,72
2024-01-04,GM,Morocco,1559,939,61,1,620,280,279,559,60
2024-01-05,GM,Morocco,1615,921,68,0,694,315,311,626,68
2024-01-06,GM,Morocco,1849,1138,55,2,711,328,328,656,53
2024-01-07,GM,Morocco,1657,1002,69,0,655,290,296,586,69
2024-01-08,GM,Morocco,1488,818,73,2,670,299,298,597,71
2024-01-09,GM,Morocco,1229,749,63,2,480,207,210,417,61
2024-01-10,GM,Morocco,1220,733,68,2,487,213,206,419,66
2024-01-11,GM,Morocco,1283,796,60,0,487,214,213,427,60
2024-01-12,GM,Morocco,1427,818,76,2,609,265,268,533,74
2024-01-13,GM,Morocco,1661,1049,49,1,612,282,281,563,48
2024-01-14,GM,Morocco,1506,927,60,0,579,262,257,519,60
2024-01-15,GM,Morocco,1295,720,65,5,575,256,254,510,60
2024-01-16,GM,Morocco,1142,706,63,3,436,188,185,373,60
2024-01-17,GM,Morocco,1074,638,63,4,436,190,183,373,59
2024-01-18,GM,Morocco,1175,729,57,5,446,191,198,389,52
2024-01-19,GM,Morocco,1325,741,72,0,584,261,251,512,72
2024-01-20,GM,Morocco,1586,1010,48,1,576,264,264,528,47
2024-01-21,GM,Morocco,1429,871,62,0,558,249,247,496,62
2024-01-22,GM,Morocco,1250,687,68,4,563,242,253,495,64
2024-01-23,GM,Morocco,1108,689,65,2,419,178,176,354,63
2024-01-24,GM,Morocco,1114,646,80,3,468,195,193,388,77
2024-01-25,GM,Morocco,1239,767,66,1,472,204,202,406,65
2024-01-26,GM,Morocco,1387,791,73,1,596,266,257,523,72
2024-01-27,GM,Morocco,1587,1000,52,1,587,266,269,535,51
2024-01-28,GM,Morocco,1471,912,59,0,559,252,248,500,59
2024-01-29,GM,Morocco,1263,714,57,3,549,245,247,492,54
2024-01-30,GM,Morocco,1115,710,45,2,405,181,179,360,43
2024-01-31,GM,Morocco,1095,655,62,2,440,190,188,378,60
2024-02-01,GM,Morocco,1226,758,66,5,468,203,199,402,61
2024-02-02,GM,Morocco,1410,809,80,3,601,257,264,521,77
2024-02-03,GM,Morocco,1611,1023,52,1,588,273,263,536,51
2024-02-04,GM,Morocco,1467,909,60,1,558,250,248,498,59
2024-02-05,GM,Morocco,1276,722,61,2,554,245,248,493,59
2024-02-06,GM,Morocco,1183,735,65,4,448,192,191,383,61
2024-02-07,GM,Morocco,1211,737,74,12,474,204,196,400,62
2024-02-08,GM,Morocco,1338,865,63,5,473,203,207,410,58
2024-02-09,GM,Morocco,1402,847,56,0,555,250,249,499,56
2024-02-10,GM,Morocco,1757,1105,56,1,652,297,299,596,55
2024-02-11,GM,Morocco,1534,959,53,0,575,259,263,522,53
2024-02-12,GM,Morocco,1348,767,66,4,581,255,260,515,62
2024-02-13,GM,Morocco,1256,778,59,6,478,208,211,419,53
2024-02-14,GM,Morocco,1270,760,68,4,510,222,220,442,64
2024-02-15,GM,Morocco,1373,861,61,5,512,228,223,451,56
2024-02-16,GM,Morocco,1486,849,73,4,637,285,279,564,69
2024-02-17,GM,Morocco,1703,1037,55,0,666,307,304,611,55
2024-02-18,GM,Morocco,1578,973,57,0,605,275,273,548,57
2024-02-19,GM,Morocco,1373,762,62,2,611,271,278,549,60
2024-02-20,GM,Morocco,1282,781,55,3,501,224,222,446,52
2024-02-21,GM,Morocco,1238,722,65,3,516,227,224,451,62
2024-02-22,GM,Morocco,1360,839,67,5,521,227,227,454,62
2024-02-23,GM,Morocco,1501,860,68,1,641,288,285,573,67
2024-02-24,GM,Morocco,1746,1083,44,0,663,311,308,619,44
2024-02-25,GM,Morocco,1574,949,67,0,625,281,277,558,67
2024-02-26,GM,Morocco,1373,740,62,1,633,282,289,571,61
2024-02-27,GM,Morocco,1325,808,61,2,517,229,227,456,59
2024-02-28,GM,Morocco,1275,741,75,5,534,230,229,459,70
2024-02-29,GM,Morocco,1411,850,80,4,561,241,240,481,76
2024-03-01,GM,Morocco,1509,857,78,3,652,291,283,574,75
2024-03-02,GM,Morocco,1756,1104,51,0,652,299,302,601,51
2024-03-03,GM,Morocco,1605,991,61,0,614,278,275,553,61
2024-03-04,GM,Morocco,1416,794,60,3,622,279,283,562,57
2024-03-05,GM,Morocco,1310,782,75,5,528,226,227,453,70
2024-03-06,GM,Morocco,1307,777,72,5,530,227,231,458,67
2024-03-07,GM,Morocco,1355,825,64,2,530,233,233,466,62
2024-03-08,GM,Morocco,1505,840,74,1,665,294,297,591,73
2024-03-09,GM,Morocco,1788,1116,55,0,672,308,309,617,55
2024-03-10,GM,Morocco,1585,975,62,0,610,278,270,548,62
2024-03-11,GM,Morocco,1369,781,62,8,588,259,267,526,54
2024-03-12,GM,Morocco,1292,818,57,4,474,206,211,417,53
2024-03-13,GM,Morocco,1238,760,57,2,478,211,210,421,55
2024-03-14,GM,Morocco,1320,863,53,2,457,202,202,404,51
2024-03-15,GM,Morocco,1494,887,70,1,607,268,269,537,69
2024-03-16,GM,Morocco,1735,1111,53,0,624,290,281,571,53
2024-03-17,GM,Morocco,1555,971,62,2,584,260,262,522,60
2024-03-18,GM,Morocco,1348,765,70,2,583,256,257,513,68
2024-03-19,GM,Morocco,1277,831,60,3,446,194,192,386,57
2024-03-20,GM,Morocco,1201,715,72,4,486,211,203,414,68
2024-03-21,GM,Morocco,1244,796,59,2,448,189,200,389,57
2024-03-22,GM,Morocco,1431,826,84,3,605,265,256,521,81
2024-03-23,GM,Morocco,1677,1065,47,3,612,284,281,565,44
2024-03-24,GM,Morocco,1528,948,63,1,580,257,260,517,62
2024-03-25,GM,Morocco,1358,804,48,0,554,250,256,506,48
2024-03-26,GM,Morocco,1300,823,47,0,477,214,216,430,47
2024-03-27,GM,Morocco,1339,790,82,5,549,234,233,467,77
2024-03-28,GM,Morocco,1389,872,59,0,517,230,228,458,59
2024-03-29,GM,Morocco,1414,812,63,1,602,274,265,539,62
2024-03-30,GM,Morocco,1755,1145,47,0,610,279,284,563,47
2024-03-31,GM,Morocco,1454,866,70,0,588,262,256,518,70
2024-04-01,GM,Morocco,1408,785,91,2,623,263,269,532,89
2024-04-02,GM,Morocco,1371,802,78,5,569,250,241,491,73
2024-04-03,GM,Morocco,1325,764,80,1,561,242,239,481,79
2024-04-04,GM,Morocco,1379,800,90,6,579,242,247,489,84
2024-04-05,GM,Morocco,1436,828,91,8,608,259,258,517,83
2024-04-06,GM,Morocco,1655,1014,59,0,641,289,293,582,59
2024-04-07,GM,Morocco,1478,883,67,0,595,265,263,528,67
2024-04-08,GM,Morocco,1340,722,89,3,618,260,269,529,86
2024-04-09,GM,Morocco,1412,793,90,6,619,266,263,529,84
2024-04-10,GM,Morocco,1324,705,70,0,619,275,274,549,70
2024-04-11,GM,Morocco,1343,753,52,0,590,268,270,538,52
2024-04-12,GM,Morocco,1367,734,72,2,633,281,280,561,70
2024-04-13,GM,Morocco,1651,976,62,0,675,309,304,613,62
2024-04-14,GM,Morocco,1466,818,75,1,648,285,288,573,74
2024-04-15,GM,Morocco,1320,667,81,1,653,287,285,572,80
2024-04-16,GM,Morocco,1377,739,82,2,638,283,273,556,80
2024-04-17,GM,Morocco,1363,709,88,4,654,280,286,566,84
2024-04-18,GM,Morocco,1389,754,70,4,635,281,284,565,66
2024-04-19,GM,Morocco,1387,724,90,1,663,290,283,573,89
2024-04-20,GM,Morocco,1596,914,61,0,682,311,310,621,61
2024-04-21,GM,Morocco,1452,793,71,1,659,294,294,588,70
2024-04-22,GM,Morocco,1344,690,80,4,654,286,288,574,76
2024-04-23,GM,Morocco,1361,738,76,6,623,275,272,547,70
2024-04-24,GM,Morocco,1356,692,84,4,664,289,291,580,80
2024-04-25,GM,Morocco,1224,671,78,3,553,235,240,475,75
2024-04-26,GM,Morocco,1370,711,78,1,659,293,288,581,77
2024-04-27,GM,Morocco,1556,876,68,1,680,301,311,612,67
2024-04-28,GM,Morocco,1379,733,76,0,646,291,279,570,76
2024-04-29,GM,Morocco,1341,691,80,6,650,283,287,570,74
2024-04-30,GM,Morocco,1385,748,88,9,637,274,275,549,79
2024-05-01,GM,Morocco,1321,664,84,3,657,286,287,573,81
2024-05-02,GM,Morocco,1351,700,85,7,651,285,281,566,78
2024-05-03,GM,Morocco,1322,653,101,9,669,281,287,568,92
2024-05-04,GM,Morocco,1501,826,68,0,675,309,298,607,68
2024-05-05,GM,Morocco,1387,717,73,1,670,303,294,597,72
2024-05-06,GM,Morocco,1364,680,96,6,684,291,297,588,90
2024-05-07,GM,Morocco,1319,678,92,9,641,281,268,549,83
2024-05-08,GM,Morocco,1320,665,80,4,655,288,287,575,76
2024-05-09,GM,Morocco,1330,702,74,7,628,267,287,554,67
2024-05-10,GM,Morocco,1321,643,99,12,678,295,284,579,87
2024-05-11,GM,Morocco,1494,827,69,1,667,302,296,598,68
2024-05-12,GM,Morocco,1350,689,81,3,661,294,286,580,78
2024-05-13,GM,Morocco,1329,645,104,15,684,290,290,580,89
2024-05-14,GM,Morocco,1283,675,70,0,608,270,268,538,70
2024-05-15,GM,Morocco,1292,652,93,11,640,276,271,547,82
2024-05-16,GM,Morocco,1345,701,81,10,644,281,282,563,71
2024-05-17,GM,Morocco,1283,623,101,15,660,281,278,559,86
2024-05-18,GM,Morocco,1464,806,79,1,658,287,292,579,78
2024-05-19,GM,Morocco,1319,679,85,0,640,277,278,555,85
2024-05-20,GM,Morocco,1311,634,108,14,677,286,283,569,94
2024-05-21,GM,Morocco,1262,643,95,6,619,261,263,524,89
2024-05-22,GM,Morocco,1290,636,111,7,654,273,270,543,104
2024-05-23,GM,Morocco,1252,612,85,7,640,277,278,555,78
2024-05-24,GM,Morocco,1270,572,115,11,698,296,287,583,104
2024-05-25,GM,Morocco,1446,806,82,1,640,277,281,558,81
2024-05-26,GM,Morocco,1310,686,83,0,624,272,269,541,83
2024-05-27,GM,Morocco,1290,594,118,18,696,289,289,578,100
2024-05-28,GM,Morocco,1278,636,108,10,642,267,267,534,98
2024-05-29,GM,Morocco,1291,617,120,11,674,281,273,554,109
2024-05-30,GM,Morocco,1333,675,108,13,658,272,278,550,95
2024-05-31,GM,Morocco,1357,656,123,15,701,292,286,578,108
2024-06-01,GM,Morocco,1494,825,74,1,669,302,293,595,73
2024-06-02,GM,Morocco,1359,679,88,1,680,297,295,592,87
2024-06-03,GM,Morocco,1331,639,95,6,692,296,301,597,89
2024-06-04,GM,Morocco,1285,650,95,7,635,271,269,540,88
2024-06-05,GM,Morocco,1316,616,125,11,700,289,286,575,114
2024-06-06,GM,Morocco,1373,709,94,10,664,282,288,570,84
2024-06-07,GM,Morocco,1311,614,104,5,697,294,299,593,99
2024-06-08,GM,Morocco,1503,837,68,4,666,300,298,598,64
2024-06-09,GM,Morocco,1345,662,78,1,683,300,305,605,77
2024-06-10,GM,Morocco,1335,630,89,4,705,311,305,616,85
2024-06-11,GM,Morocco,1315,665,82,2,650,286,282,568,80
2024-06-12,GM,Morocco,1344,649,99,6,695,301,295,596,93
2024-06-13,GM,Morocco,1371,683,91,5,688,299,298,597,86
2024-06-14,GM,Morocco,1345,621,102,2,724,316,306,622,100
2024-06-15,GM,Morocco,1507,835,76,0,672,293,303,596,76
2024-06-16,GM,Morocco,1391,707,78,0,684,305,301,606,78
2024-06-17,GM,Morocco,1358,699,85,1,659,286,288,574,84
2024-06-18,GM,Morocco,1284,682,65,0,602,270,267,537,65
2024-06-19,GM,Morocco,1334,657,96,3,677,289,292,581,93
2024-06-20,GM,Morocco,1425,727,89,7,698,298,311,609,82
2024-06-21,GM,Morocco,1377,659,95,5,718,313,310,623,90
2024-06-22,GM,Morocco,1522,815,78,1,707,314,315,629,77
2024-06-23,GM,Morocco,1474,707,89,1,767,338,340,678,88
2024-06-24,GM,Morocco,1426,696,95,2,730,318,317,635,93
2024-06-25,GM,Morocco,1423,708,100,5,715,314,301,615,95
2024-06-26,GM,Morocco,1357,629,107,4,728,308,313,621,103
2024-06-27,GM,Morocco,1443,738,71,0,705,323,311,634,71
2024-06-28,GM,Morocco,1407,653,93,0,754,327,334,661,93
2024-06-29,GM,Morocco,1520,809,72,0,711,318,321,639,72
2024-06-30,GM,Morocco,1465,706,87,0,759,337,335,672,87
2024-07-01,GM,Morocco,1483,728,92,2,755,334,329,663,90
2024-07-02,GM,Morocco,1440,714,87,2,726,317,322,639,85
2024-07-03,GM,Morocco,1405,704,81,4,701,311,309,620,77
2024-07-04,GM,Morocco,1487,767,63,0,720,329,328,657,63
2024-07-05,GM,Morocco,1432,688,92,4,744,335,317,652,88
2024-07-06,GM,Morocco,1565,857,66,1,708,317,325,642,65
2024-07-07,GM,Morocco,1442,711,77,0,731,324,330,654,77
2024-07-08,GM,Morocco,1459,736,80,1,723,325,318,643,79
2024-07-09,GM,Morocco,1437,731,88,1,706,307,311,618,87
2024-07-10,GM,Morocco,1440,712,111,6,728,310,307,617,105
2024-07-11,GM,Morocco,1492,774,83,8,718,320,315,635,75
2024-07-12,GM,Morocco,1429,684,100,3,745,321,324,645,97
2024-07-13,GM,Morocco,1583,857,88,1,726,321,317,638,87
2024-07-14,GM,Morocco,1447,711,84,0,736,325,327,652,84
2024-07-15,GM,Morocco,1478,745,98,0,733,319,316,635,98
2024-07-16,GM,Morocco,1456,721,96,7,735,320,319,639,89
2024-07-17,GM,Morocco,1447,719,111,9,728,309,308,617,102
2024-07-18,GM,Morocco,1489,764,87,7,725,322,316,638,80
2024-07-19,GM,Morocco,1385,666,102,7,719,305,312,617,95
2024-07-20,GM,Morocco,1571,864,81,2,707,315,311,626,79
2024-07-21,GM,Morocco,1473,732,86,0,741,327,328,655,86
2024-07-22,GM,Morocco,1489,746,96,8,743,321,326,647,88
2024-07-23,GM,Morocco,1509,765,99,2,744,323,322,645,97
2024-07-24,GM,Morocco,1430,714,98,3,716,308,310,618,95
2024-07-25,GM,Morocco,1543,772,101,1,771,343,327,670,100
2024-07-26,GM,Morocco,1382,675,94,2,707,300,313,613,92
2024-07-27,GM,Morocco,1588,876,68,0,712,322,322,644,68
2024-07-28,GM,Morocco,1523,762,89,0,761,340,332,672,89
2024-07-29,GM,Morocco,1482,746,92,3,736,320,324,644,89
2024-07-30,GM,Morocco,1504,773,81,0,731,328,322,650,81
2024-01-01,EH,Netherlands,2834,1442,10,1,1392,694,688,1382,9
2024-01-02,EH,Netherlands,2939,1571,19,2,1368,667,682,1349,17
2024-01-03,EH,Netherlands,3119,1660,43,10,1459,711,705,1416,33
2024-01-04,EH,Netherlands,3131,1621,48,10,1510,736,726,1462,38
2024-01-05,EH,Netherlands,3194,1669,40,12,1525,738,747,1485,28
2024-01-06,EH,Netherlands,3089,1719,7,1,1370,669,694,1363,6
2024-01-07,EH,Netherlands,3191,1691,15,1,1500,752,733,1485,14
2024-01-08,EH,Netherlands,3066,1629,50,12,1437,692,695,1387,38
2024-01-09,EH,Netherlands,2675,1331,62,14,1344,637,645,1282,48
2024-01-10,EH,Netherlands,2754,1383,62,12,1371,655,654,1309,50
2024-01-11,EH,Netherlands,2911,1459,55,17,1452,710,687,1397,38
2024-01-12,EH,Netherlands,3184,1709,56,18,1475,696,723,1419,38
2024-01-13,EH,Netherlands,2809,1564,16,4,1245,618,611,1229,12
2024-01-14,EH,Netherlands,3063,1683,17,2,1380,682,681,1363,15
2024-01-15,EH,Netherlands,2740,1498,31,5,1242,596,615,1211,26
2024-01-16,EH,Netherlands,2444,1269,41,5,1175,571,563,1134,36
2024-01-17,EH,Netherlands,2463,1178,39,4,1285,630,616,1246,35
2024-01-18,EH,Netherlands,2740,1339,41,4,1401,684,676,1360,37
2024-01-19,EH,Netherlands,3124,1633,61,8,1491,712,718,1430,53
2024-01-20,EH,Netherlands,2703,1474,24,3,1229,598,607,1205,21
2024-01-21,EH,Netherlands,2753,1423,24,3,1330,647,659,1306,21
2024-01-22,EH,Netherlands,2815,1506,46,3,1309,652,611,1263,43
2024-01-23,EH,Netherlands,2566,1283,48,8,1283,605,630,1235,40
2024-01-24,EH,Netherlands,2438,1168,36,4,1270,624,610,1234,32
2024-01-25,EH,Netherlands,2821,1377,35,3,1444,702,707,1409,32
2024-01-26,EH,Netherlands,2902,1562,42,3,1340,650,648,1298,39
2024-01-27,EH,Netherlands,2734,1509,19,2,1225,600,606,1206,17
2024-01-28,EH,Netherlands,3021,1598,30,2,1423,701,692,1393,28
2024-01-29,EH,Netherlands,3004,1530,43,9,1474,716,715,1431,34
2024-01-30,EH,Netherlands,2640,1331,46,4,1309,627,636,1263,42
2024-01-31,EH,Netherlands,2696,1309,69,9,1387,650,668,1318,60
2024-02-01,EH,Netherlands,2785,1325,60,9,1460,709,691,1400,51
2024-02-02,EH,Netherlands,3128,1622,49,11,1506,735,722,1457,38
2024-02-03,EH,Netherlands,2742,1505,16,2,1237,610,611,1221,14
2024-02-04,EH,Netherlands,3029,1616,16,4,1413,701,696,1397,12
2024-02-05,EH,Netherlands,3052,1552,40,1,1500,726,734,1460,39
2024-02-06,EH,Netherlands,2623,1306,44,3,1317,635,638,1273,41
2024-02-07,EH,Netherlands,2713,1323,47,5,1390,672,671,1343,42
2024-02-08,EH,Netherlands,3005,1489,28,2,1516,751,737,1488,26
2024-02-09,EH,Netherlands,3273,1717,61,9,1556,750,745,1495,52
2024-02-10,EH,Netherlands,3028,1709,16,1,1319,646,657,1303,15
2024-02-11,EH,Netherlands,3101,1659,14,3,1442,714,714,1428,11
2024-02-12,EH,Netherlands,3077,1574,45,8,1503,729,729,1458,37
2024-02-13,EH,Netherlands,2795,1410,57,10,1385,663,665,1328,47
2024-02-14,EH,Netherlands,2862,1420,31,4,1442,701,710,1411,27
2024-02-15,EH,Netherlands,3042,1506,42,14,1536,756,738,1494,28
2024-02-16,EH,Netherlands,3315,1705,63,18,1610,757,790,1547,45
2024-02-17,EH,Netherlands,3141,1692,24,8,1449,721,704,1425,16
2024-02-18,EH,Netherlands,3207,1705,3,2,1502,755,744,1499,1
2024-02-19,EH,Netherlands,3206,1668,44,15,1538,749,745,1494,29
2024-02-20,EH,Netherlands,2761,1322,74,14,1439,682,683,1365,60
2024-02-21,EH,Netherlands,2933,1432,61,15,1501,718,722,1440,46
2024-02-22,EH,Netherlands,2961,1450,57,15,1511,725,729,1454,42
2024-02-23,EH,Netherlands,3205,1642,48,9,1563,768,747,1515,39
2024-02-24,EH,Netherlands,2996,1585,18,4,1411,685,708,1393,14
2024-02-25,EH,Netherlands,3265,1709,18,3,1556,772,766,1538,15
2024-02-26,EH,Netherlands,3131,1565,40,11,1566,766,760,1526,29
2024-02-27,EH,Netherlands,2847,1408,63,9,1439,681,695,1376,54
2024-02-28,EH,Netherlands,2945,1440,58,14,1505,727,720,1447,44
2024-02-29,EH,Netherlands,3086,1541,48,16,1545,757,740,1497,32
2024-03-01,EH,Netherlands,3342,1747,70,17,1595,763,762,1525,53
2024-03-02,EH,Netherlands,2985,1612,22,7,1373,670,681,1351,15
2024-03-03,EH,Netherlands,3244,1740,21,6,1504,742,741,1483,15
2024-03-04,EH,Netherlands,3238,1674,40,13,1564,767,757,1524,27
2024-03-05,EH,Netherlands,2921,1468,67,19,1453,689,697,1386,48
2024-03-06,EH,Netherlands,3030,1493,59,16,1537,736,742,1478,43
2024-03-07,EH,Netherlands,3093,1418,64,16,1675,795,816,1611,48
2024-03-08,EH,Netherlands,3316,1654,75,22,1662,806,781,1587,53
2024-03-09,EH,Netherlands,2995,1589,17,5,1406,695,694,1389,12
2024-03-10,EH,Netherlands,3305,1761,16,5,1544,763,765,1528,11
2024-03-11,EH,Netherlands,3235,1651,56,18,1584,763,765,1528,38
2024-03-12,EH,Netherlands,2792,1350,65,20,1442,690,687,1377,45
2024-03-13,EH,Netherlands,2971,1455,61,16,1516,724,731,1455,45
2024-03-14,EH,Netherlands,3144,1528,67,22,1616,779,770,1549,45
2024-03-15,EH,Netherlands,3375,1770,57,15,1605,776,772,1548,42
2024-03-16,EH,Netherlands,3033,1681,28,8,1352,663,661,1324,20
2024-03-17,EH,Netherlands,3266,1758,14,2,1508,749,745,1494,12
2024-03-18,EH,Netherlands,3308,1704,67,21,1604,769,768,1537,46
2024-03-19,EH,Netherlands,2905,1450,57,12,1455,697,701,1398,45
2024-03-20,EH,Netherlands,3058,1542,46,7,1516,734,736,1470,39
2024-03-21,EH,Netherlands,3214,1622,63,9,1592,769,760,1529,54
2024-03-22,EH,Netherlands,3366,1788,40,9,1578,773,765,1538,31
2024-03-23,EH,Netherlands,3008,1662,6,0,1346,673,667,1340,6
2024-03-24,EH,Netherlands,3004,1700,5,2,1304,645,654,1299,3
2024-03-25,EH,Netherlands,3272,1725,48,12,1547,753,746,1499,36
2024-03-26,EH,Netherlands,3047,1586,67,10,1461,697,697,1394,57
2024-03-27,EH,Netherlands,3220,1702,64,3,1518,725,729,1454,61
2024-03-28,EH,Netherlands,3222,1644,48,10,1578,762,768,1530,38
2024-03-29,EH,Netherlands,3332,1758,53,8,1574,772,749,1521,45
2024-03-30,EH,Netherlands,3018,1708,19,3,1310,644,647,1291,16
2024-03-31,EH,Netherlands,3251,1762,13,5,1489,736,740,1476,8
2024-04-01,EH,Netherlands,3443,1829,29,4,1614,787,798,1585,25
2024-04-02,EH,Netherlands,3343,1745,65,12,1598,762,771,1533,53
2024-04-03,EH,Netherlands,3388,1801,48,8,1587,773,766,1539,40
2024-04-04,EH,Netherlands,3368,1765,61,11,1603,772,770,1542,50
2024-04-05,EH,Netherlands,3465,1845,35,9,1620,793,792,1585,26
2024-04-06,EH,Netherlands,3213,1733,34,1,1480,723,723,1446,33
2024-04-07,EH,Netherlands,3327,1767,18,4,1560,766,776,1542,14
2024-04-08,EH,Netherlands,3495,1835,49,16,1660,801,810,1611,33
2024-04-09,EH,Netherlands,3226,1667,53,10,1559,754,752,1506,43
2024-04-10,EH,Netherlands,3497,1851,68,21,1646,783,795,1578,47
2024-04-11,EH,Netherlands,3459,1823,51,21,1636,800,785,1585,30
2024-04-12,EH,Netherlands,3563,1882,57,17,1681,819,805,1624,40
2024-04-13,EH,Netherlands,3196,1724,24,7,1472,722,726,1448,17
2024-04-14,EH,Netherlands,3319,1747,25,7,1572,772,775,1547,18
2024-04-15,EH,Netherlands,3110,1786,34,4,1324,634,656,1290,30
2024-04-16,EH,Netherlands,3347,1784,52,12,1563,761,750,1511,40
2024-04-17,EH,Netherlands,3489,1860,60,14,1629,794,775,1569,46
2024-04-18,EH,Netherlands,3585,1866,68,16,1719,823,828,1651,52
2024-04-19,EH,Netherlands,3544,1885,28,3,1659,818,813,1631,25
2024-04-20,EH,Netherlands,3223,1726,11,2,1497,746,740,1486,9
2024-04-21,EH,Netherlands,3493,1873,14,2,1620,800,806,1606,12
2024-04-22,EH,Netherlands,3567,1841,54,14,1726,837,835,1672,40
2024-04-23,EH,Netherlands,3428,1775,70,12,1653,790,793,1583,58
2024-04-24,EH,Netherlands,3520,1857,45,10,1663,810,808,1618,35
2024-04-25,EH,Netherlands,3555,1871,60,17,1684,808,816,1624,43
2024-04-26,EH,Netherlands,3663,1928,54,18,1735,837,844,1681,36
2024-04-27,EH,Netherlands,3281,1734,11,2,1547,768,768,1536,9
2024-04-28,EH,Netherlands,3472,1834,15,0,1638,816,807,1623,15
2024-04-29,EH,Netherlands,3521,1769,58,13,1752,846,848,1694,45
2024-04-30,EH,Netherlands,3475,1799,65,16,1676,806,805,1611,49
2024-05-01,EH,Netherlands,3593,1927,55,16,1666,801,810,1611,39
2024-05-02,EH,Netherlands,3619,1916,76,19,1703,814,813,1627,57
2024-05-03,EH,Netherlands,3731,1998,45,19,1733,848,840,1688,26
2024-05-04,EH,Netherlands,3367,1802,20,6,1565,774,771,1545,14
2024-05-05,EH,Netherlands,3538,1894,12,1,1644,810,822,1632,11
2024-05-06,EH,Netherlands,3664,1912,63,13,1752,857,832,1689,50
2024-05-07,EH,Netherlands,3595,1870,73,15,1725,826,826,1652,58
2024-05-08,EH,Netherlands,3764,2034,44,4,1730,844,842,1686,40
2024-05-09,EH,Netherlands,3632,1926,45,3,1706,832,829,1661,42
2024-05-10,EH,Netherlands,3723,2007,41,8,1716,839,836,1675,33
2024-05-11,EH,Netherlands,3407,1824,26,5,1583,773,784,1557,21
2024-05-12,EH,Netherlands,3694,1983,21,9,1711,838,852,1690,12
2024-05-13,EH,Netherlands,3766,1986,46,13,1780,868,866,1734,33
2024-05-14,EH,Netherlands,3765,2017,63,9,1748,833,852,1685,54
2024-05-15,EH,Netherlands,3823,2082,58,13,1741,847,836,1683,45
2024-05-16,EH,Netherlands,3774,1992,67,11,1782,854,861,1715,56
2024-05-17,EH,Netherlands,3788,2043,58,15,1745,853,834,1687,43
2024-05-18,EH,Netherlands,3492,1901,39,10,1591,778,774,1552,29
2024-05-19,EH,Netherlands,3547,1944,8,3,1603,795,800,1595,5
2024-05-20,EH,Netherlands,3673,1987,28,5,1686,823,835,1658,23
2024-05-21,EH,Netherlands,3658,1970,71,10,1688,805,812,1617,61
2024-05-22,EH,Netherlands,3673,2007,53,12,1666,807,806,1613,41
2024-05-23,EH,Netherlands,3870,2120,60,13,1750,843,847,1690,47
2024-05-24,EH,Netherlands,3807,2078,28,4,1729,858,843,1701,24
2024-05-25,EH,Netherlands,3437,1882,18,1,1555,765,772,1537,17
2024-05-26,EH,Netherlands,3610,1960,12,1,1650,821,817,1638,11
2024-05-27,EH,Netherlands,3700,1922,62,17,1778,856,860,1716,45
2024-05-28,EH,Netherlands,3667,1935,60,9,1732,837,835,1672,51
2024-05-29,EH,Netherlands,3735,1996,62,13,1739,839,838,1677,49
2024-05-30,EH,Netherlands,3830,2056,67,10,1774,852,855,1707,57
2024-05-31,EH,Netherlands,3843,2096,50,10,1747,862,835,1697,40
2024-06-01,EH,Netherlands,3580,2013,11,3,1567,778,778,1556,8
2024-06-02,EH,Netherlands,3853,2198,9,1,1655,816,830,1646,8
2024-06-03,EH,Netherlands,3714,1972,60,13,1742,840,842,1682,47
2024-06-04,EH,Netherlands,3652,1929,50,5,1723,831,842,1673,45
2024-06-05,EH,Netherlands,3728,1987,52,14,1741,839,850,1689,38
2024-06-06,EH,Netherlands,3738,1966,52,8,1772,864,856,1720,44
2024-06-07,EH,Netherlands,3770,2004,45,9,1766,871,850,1721,36
2024-06-08,EH,Netherlands,3446,1858,18,3,1588,787,783,1570,15
2024-06-09,EH,Netherlands,3680,1990,26,6,1690,830,834,1664,20
2024-06-10,EH,Netherlands,3699,1932,58,14,1767,851,858,1709,44
2024-06-11,EH,Netherlands,3636,1926,68,12,1710,817,825,1642,56
2024-06-12,EH,Netherlands,3755,2014,58,17,1741,844,839,1683,41
2024-06-13,EH,Netherlands,3883,2085,87,21,1798,855,856,1711,66
2024-06-14,EH,Netherlands,3891,2100,56,15,1791,867,868,1735,41
2024-06-15,EH,Netherlands,3558,1964,16,2,1594,794,784,1578,14
2024-06-16,EH,Netherlands,3782,2082,11,0,1700,839,850,1689,11
2024-06-17,EH,Netherlands,3902,2105,56,13,1797,864,877,1741,43
2024-06-18,EH,Netherlands,3792,2054,72,18,1738,826,840,1666,54
2024-06-19,EH,Netherlands,3884,2100,80,18,1784,849,855,1704,62
2024-06-20,EH,Netherlands,3898,2100,56,18,1798,876,866,1742,38
2024-06-21,EH,Netherlands,3889,2151,41,12,1738,855,842,1697,29
2024-06-22,EH,Netherlands,3503,1890,24,3,1613,795,794,1589,21
2024-06-23,EH,Netherlands,3784,2099,21,4,1685,825,839,1664,17
2024-06-24,EH,Netherlands,3940,2163,80,20,1777,847,850,1697,60
2024-06-25,EH,Netherlands,3867,2129,82,17,1738,831,825,1656,65
2024-06-26,EH,Netherlands,3796,2065,69,17,1731,829,833,1662,52
2024-06-27,EH,Netherlands,3769,1996,84,15,1773,845,844,1689,69
2024-06-28,EH,Netherlands,3696,1977,58,17,1719,834,827,1661,41
2024-06-29,EH,Netherlands,3628,2069,21,5,1559,773,765,1538,16
2024-06-30,EH,Netherlands,3737,2059,18,1,1678,820,840,1660,17
2024-07-01,EH,Netherlands,3712,1975,62,20,1737,843,832,1675,42
2024-07-02,EH,Netherlands,3699,1994,66,15,1705,816,823,1639,51
2024-07-03,EH,Netherlands,3839,2093,59,15,1746,838,849,1687,44
2024-07-04,EH,Netherlands,3861,2086,61,13,1775,856,858,1714,48
2024-07-05,EH,Netherlands,3873,2086,47,15,1787,877,863,1740,32
2024-07-06,EH,Netherlands,3447,1897,24,1,1550,767,759,1526,23
2024-07-07,EH,Netherlands,3813,2091,27,1,1722,842,853,1695,26
2024-07-08,EH,Netherlands,3838,2057,56,13,1781,865,860,1725,43
2024-07-09,EH,Netherlands,3756,2062,84,23,1694,795,815,1610,61
2024-07-10,EH,Netherlands,3878,2127,51,10,1751,852,848,1700,41
2024-07-11,EH,Netherlands,4003,2198,72,17,1805,865,868,1733,55
2024-07-12,EH,Netherlands,3870,2127,53,11,1743,860,830,1690,42
2024-07-13,EH,Netherlands,3661,2051,24,4,1610,789,797,1586,20
2024-07-14,EH,Netherlands,3891,2180,32,4,1711,840,839,1679,28
2024-07-15,EH,Netherlands,4102,2270,66,14,1832,882,884,1766,52
2024-07-16,EH,Netherlands,3712,1995,69,8,1717,816,832,1648,61
2024-07-17,EH,Netherlands,3804,2019,62,13,1785,861,862,1723,49
2024-07-18,EH,Netherlands,3927,2125,66,11,1802,869,867,1736,55
2024-07-19,EH,Netherlands,3469,1979,44,9,1490,716,730,1446,35
2024-07-20,EH,Netherlands,3611,1962,35,6,1649,812,802,1614,29
2024-07-21,EH,Netherlands,3705,2023,14,0,1682,839,829,1668,14
2024-07-22,EH,Netherlands,3795,2017,50,10,1778,865,863,1728,40
2024-07-23,EH,Netherlands,3751,2051,57,11,1700,811,832,1643,46
2024-07-24,EH,Netherlands,3862,2109,55,16,1753,846,852,1698,39
2024-07-25,EH,Netherlands,3887,2100,69,18,1787,862,856,1718,51
2024-07-26,EH,Netherlands,4008,2230,57,8,1778,862,859,1721,49
2024-07-27,EH,Netherlands,3562,1949,22,5,1613,802,789,1591,17
2024-07-28,EH,Netherlands,3817,2105,21,4,1712,846,845,1691,17
2024-07-29,EH,Netherlands,3923,2143,60,19,1780,854,866,1720,41
2024-07-30,EH,Netherlands,3820,2073,67,14,1747,841,839,1680,53
2024-01-01,LW,North Macedonia,443,385,0,0,58,28,30,58,0
2024-01-02,LW,North Macedonia,473,406,0,0,67,36,31,67,0
2024-01-03,LW,North Macedonia,474,416,0,0,58,29,29,58,0
2024-01-04,LW,North Macedonia,461,393,0,0,68,31,37,68,0
2024-01-05,LW,North Macedonia,492,441,0,0,51,29,22,51,0
2024-01-06,LW,North Macedonia,569,496,0,0,73,32,41,73,0
2024-01-07,LW,North Macedonia,533,460,0,0,73,36,37,73,0
2024-01-08,LW,North Macedonia,441,376,0,0,65,33,32,65,0
2024-01-09,LW,North Macedonia,362,292,0,0,70,35,35,70,0
2024-01-10,LW,North Macedonia,354,292,0,0,62,31,31,62,0
2024-01-11,LW,North Macedonia,397,333,0,0,64,32,32,64,0
2024-01-12,LW,North Macedonia,452,384,0,0,68,34,34,68,0
2024-01-13,LW,North Macedonia,446,378,0,0,68,34,34,68,0
2024-01-14,LW,North Macedonia,477,411,0,0,66,33,33,66,0
2024-01-15,LW,North Macedonia,420,353,0,0,67,33,34,67,0
2024-01-16,LW,North Macedonia,345,274,0,0,71,36,35,71,0
2024-01-17,LW,North Macedonia,360,298,0,0,62,30,32,62,0
2024-01-18,LW,North Macedonia,362,293,0,0,69,35,34,69,0
2024-01-19,LW,North Macedonia,354,295,0,0,59,30,29,59,0
2024-01-20,LW,North Macedonia,373,310,0,0,63,31,32,63,0
2024-01-21,LW,North Macedonia,451,383,0,0,68,33,35,68,0
2024-01-22,LW,North Macedonia,370,307,0,0,63,34,29,63,0
2024-01-23,LW,North Macedonia,322,272,0,0,50,25,25,50,0
2024-01-24,LW,North Macedonia,380,324,0,0,56,28,28,56,0
2024-01-25,LW,North Macedonia,351,300,0,0,51,26,25,51,0
2024-01-26,LW,North Macedonia,417,362,0,0,55,26,29,55,0
2024-01-27,LW,North Macedonia,365,305,0,0,60,31,29,60,0
2024-01-28,LW,North Macedonia,424,369,0,0,55,27,28,55,0
2024-01-29,LW,North Macedonia,376,318,0,0,58,29,29,58,0
2024-01-30,LW,North Macedonia,332,284,0,0,48,24,24,48,0
2024-01-31,LW,North Macedonia,411,358,0,0,53,26,27,53,0
2024-02-01,LW,North Macedonia,405,352,0,0,53,28,25,53,0
2024-02-02,LW,North Macedonia,418,360,0,0,58,28,30,58,0
2024-02-03,LW,North Macedonia,411,357,0,0,54,28,26,54,0
2024-02-04,LW,North Macedonia,428,376,0,0,52,25,27,52,0
2024-02-05,LW,North Macedonia,411,355,0,0,56,29,27,56,0
2024-02-06,LW,North Macedonia,323,271,0,0,52,26,26,52,0
2024-02-07,LW,North Macedonia,354,301,0,0,53,26,27,53,0
2024-02-08,LW,North Macedonia,425,368,0,0,57,29,28,57,0
2024-02-09,LW,North Macedonia,473,420,0,0,53,26,27,53,0
2024-02-10,LW,North Macedonia,485,434,0,0,51,26,25,51,0
2024-02-11,LW,North Macedonia,472,416,0,0,56,26,30,56,0
2024-02-12,LW,North Macedonia,397,343,0,0,54,28,26,54,0
2024-02-13,LW,North Macedonia,334,278,0,0,56,28,28,56,0
2024-02-14,LW,North Macedonia,377,324,0,0,53,26,27,53,0
2024-02-15,LW,North Macedonia,435,383,0,0,52,28,24,52,0
2024-02-16,LW,North Macedonia,479,422,0,0,57,27,30,57,0
2024-02-17,LW,North Macedonia,467,416,0,0,51,26,25,51,0
2024-02-18,LW,North Macedonia,493,439,0,0,54,26,28,54,0
2024-02-19,LW,North Macedonia,441,382,0,0,59,30,29,59,0
2024-02-20,LW,North Macedonia,349,298,0,0,51,25,26,51,0
2024-02-21,LW,North Macedonia,392,339,0,0,53,27,26,53,0
2024-02-22,LW,North Macedonia,411,363,0,0,48,25,23,48,0
2024-02-23,LW,North Macedonia,468,410,0,0,58,28,30,58,0
2024-02-24,LW,North Macedonia,451,401,0,0,50,26,24,50,0
2024-02-25,LW,North Macedonia,441,385,0,0,56,27,29,56,0
2024-02-26,LW,North Macedonia,400,342,0,0,58,30,28,58,0
2024-02-27,LW,North Macedonia,349,296,0,0,53,25,28,53,0
2024-02-28,LW,North Macedonia,401,345,0,0,56,28,28,56,0
2024-02-29,LW,North Macedonia,407,358,0,0,49,26,23,49,0
2024-03-01,LW,North Macedonia,403,346,0,0,57,28,29,57,0
2024-03-02,LW,North Macedonia,418,367,0,0,51,26,25,51,0
2024-03-03,LW,North Macedonia,490,433,0,0,57,28,29,57,0
2024-03-04,LW,North Macedonia,407,348,0,0,59,29,30,59,0
2024-03-05,LW,North Macedonia,344,291,0,0,53,27,26,53,0
2024-03-06,LW,North Macedonia,387,334,0,0,53,26,27,53,0
2024-03-07,LW,North Macedonia,369,324,0,0,45,22,23,45,0
2024-03-08,LW,North Macedonia,399,344,0,0,55,28,27,55,0
2024-03-09,LW,North Macedonia,437,387,0,0,50,26,24,50,0
2024-03-10,LW,North Macedonia,527,476,0,0,51,25,26,51,0
2024-03-11,LW,North Macedonia,390,335,0,0,55,28,27,55,0
2024-03-12,LW,North Macedonia,305,254,0,0,51,25,26,51,0
2024-03-13,LW,North Macedonia,397,340,0,0,57,28,29,57,0
2024-03-14,LW,North Macedonia,407,365,0,0,42,22,20,42,0
2024-03-15,LW,North Macedonia,489,435,0,0,54,26,28,54,0
2024-03-16,LW,North Macedonia,427,371,0,0,56,28,28,56,0
2024-03-17,LW,North Macedonia,500,447,0,0,53,27,26,53,0
2024-03-18,LW,North Macedonia,407,350,0,0,57,28,29,57,0
2024-03-19,LW,North Macedonia,409,357,0,0,52,26,26,52,0
2024-03-20,LW,North Macedonia,471,419,0,0,52,26,26,52,0
2024-03-21,LW,North Macedonia,489,436,0,0,53,26,27,53,0
2024-03-22,LW,North Macedonia,581,524,0,0,57,30,27,57,0
2024-03-23,LW,North Macedonia,573,524,0,0,49,25,24,49,0
2024-03-24,LW,North Macedonia,579,517,0,0,62,30,32,62,0
2024-03-25,LW,North Macedonia,476,417,0,0,59,29,30,59,0
2024-03-26,LW,North Macedonia,459,410,0,0,49,26,23,49,0
2024-03-27,LW,North Macedonia,541,480,0,0,61,30,31,61,0
2024-03-28,LW,North Macedonia,527,464,0,0,63,31,32,63,0
2024-03-29,LW,North Macedonia,574,514,0,0,60,29,31,60,0
2024-03-30,LW,North Macedonia,581,524,0,0,57,28,29,57,0
2024-03-31,LW,North Macedonia,732,665,0,0,67,33,34,67,0
2024-04-01,LW,North Macedonia,630,569,0,0,61,32,29,61,0
2024-04-02,LW,North Macedonia,596,534,0,0,62,30,32,62,0
2024-04-03,LW,North Macedonia,624,556,0,0,68,34,34,68,0
2024-04-04,LW,North Macedonia,592,529,0,0,63,30,33,63,0
2024-04-05,LW,North Macedonia,718,650,0,0,68,35,33,68,0
2024-04-06,LW,North Macedonia,763,699,1,0,64,31,32,63,1
2024-04-07,LW,North Macedonia,771,704,0,0,67,34,33,67,0
2024-04-08,LW,North Macedonia,708,645,0,0,63,33,30,63,0
2024-04-09,LW,North Macedonia,729,673,0,0,56,27,29,56,0
2024-04-10,LW,North Macedonia,719,650,0,0,69,35,34,69,0
2024-04-11,LW,North Macedonia,658,602,0,0,56,27,29,56,0
2024-04-12,LW,North Macedonia,776,702,0,0,74,37,37,74,0
2024-04-13,LW,North Macedonia,836,769,0,0,67,33,34,67,0
2024-04-14,LW,North Macedonia,846,772,0,0,74,37,37,74,0
2024-04-15,LW,North Macedonia,742,668,0,0,74,39,35,74,0
2024-04-16,LW,North Macedonia,680,613,0,0,67,32,35,67,0
2024-04-17,LW,North Macedonia,696,620,0,0,76,38,38,76,0
2024-04-18,LW,North Macedonia,685,615,0,0,70,34,36,70,0
2024-04-19,LW,North Macedonia,766,687,0,0,79,40,39,79,0
2024-04-20,LW,North Macedonia,852,790,0,0,62,31,31,62,0
2024-04-21,LW,North Macedonia,797,726,0,0,71,35,36,71,0
2024-04-22,LW,North Macedonia,670,599,0,0,71,37,34,71,0
2024-04-23,LW,North Macedonia,679,609,0,0,70,34,36,70,0
2024-04-24,LW,North Macedonia,713,631,0,0,82,42,40,82,0
2024-04-25,LW,North Macedonia,712,644,0,0,68,34,34,68,0
2024-04-26,LW,North Macedonia,729,654,0,0,75,37,38,75,0
2024-04-27,LW,North Macedonia,890,830,0,0,60,30,30,60,0
2024-04-28,LW,North Macedonia,814,739,0,0,75,37,38,75,0
2024-04-29,LW,North Macedonia,735,664,0,0,71,37,34,71,0
2024-04-30,LW,North Macedonia,762,700,0,0,62,29,33,62,0
2024-05-01,LW,North Macedonia,838,768,0,0,70,36,34,70,0
2024-05-02,LW,North Macedonia,732,668,0,0,64,31,33,64,0
2024-05-03,LW,North Macedonia,788,717,0,0,71,38,33,71,0
2024-05-04,LW,North Macedonia,947,885,0,0,62,30,32,62,0
2024-05-05,LW,North Macedonia,936,868,0,0,68,34,34,68,0
2024-05-06,LW,North Macedonia,827,761,0,0,66,34,32,66,0
2024-05-07,LW,North Macedonia,833,766,0,0,67,32,35,67,0
2024-05-08,LW,North Macedonia,854,772,0,0,82,43,39,82,0
2024-05-09,LW,North Macedonia,830,762,0,0,68,32,36,68,0
2024-05-10,LW,North Macedonia,894,821,0,0,73,37,36,73,0
2024-05-11,LW,North Macedonia,984,918,0,0,66,34,32,66,0
2024-05-12,LW,North Macedonia,963,891,0,0,72,36,36,72,0
2024-05-13,LW,North Macedonia,773,706,0,0,67,35,32,67,0
2024-05-14,LW,North Macedonia,862,795,0,0,67,32,35,67,0
2024-05-15,LW,North Macedonia,802,726,0,0,76,40,36,76,0
2024-05-16,LW,North Macedonia,781,706,0,0,75,35,40,75,0
2024-05-17,LW,North Macedonia,844,769,0,0,75,38,37,75,0
2024-05-18,LW,North Macedonia,996,932,0,0,64,33,31,64,0
2024-05-19,LW,North Macedonia,1001,928,0,0,73,36,37,73,0
2024-05-20,LW,North Macedonia,897,829,0,0,68,36,32,68,0
2024-05-21,LW,North Macedonia,861,797,0,0,64,30,34,64,0
2024-05-22,LW,North Macedonia,943,865,0,0,78,39,39,78,0
2024-05-23,LW,North Macedonia,938,875,0,0,63,30,33,63,0
2024-05-24,LW,North Macedonia,1015,944,0,0,71,37,34,71,0
2024-05-25,LW,North Macedonia,1040,981,0,0,59,30,29,59,0
2024-05-26,LW,North Macedonia,1051,976,0,0,75,37,38,75,0
2024-05-27,LW,North Macedonia,946,874,0,0,72,39,33,72,0
2024-05-28,LW,North Macedonia,942,878,0,0,64,28,36,64,0
2024-05-29,LW,North Macedonia,975,895,2,1,80,41,37,78,1
2024-05-30,LW,North Macedonia,924,859,1,1,65,31,33,64,0
2024-05-31,LW,North Macedonia,949,875,0,0,74,37,37,74,0
2024-06-01,LW,North Macedonia,1099,1033,0,0,66,32,34,66,0
2024-06-02,LW,North Macedonia,1053,976,0,0,77,39,38,77,0
2024-06-03,LW,North Macedonia,872,798,0,0,74,38,36,74,0
2024-06-04,LW,North Macedonia,923,859,0,0,64,31,33,64,0
2024-06-05,LW,North Macedonia,973,886,0,0,87,44,43,87,0
2024-06-06,LW,North Macedonia,937,869,0,0,68,34,34,68,0
2024-06-07,LW,North Macedonia,984,912,0,0,72,35,37,72,0
2024-06-08,LW,North Macedonia,1063,998,0,0,65,33,32,65,0
2024-06-09,LW,North Macedonia,987,915,0,0,72,35,37,72,0
2024-06-10,LW,North Macedonia,954,879,0,0,75,41,34,75,0
2024-06-11,LW,North Macedonia,892,828,0,0,64,29,35,64,0
2024-06-12,LW,North Macedonia,984,901,0,0,83,42,41,83,0
2024-06-13,LW,North Macedonia,976,906,0,0,70,35,35,70,0
2024-06-14,LW,North Macedonia,1012,929,0,0,83,40,43,83,0
2024-06-15,LW,North Macedonia,1101,1038,0,0,63,32,31,63,0
2024-06-16,LW,North Macedonia,1036,961,0,0,75,37,38,75,0
2024-06-17,LW,North Macedonia,996,923,0,0,73,39,34,73,0
2024-06-18,LW,North Macedonia,1078,1013,0,0,65,30,35,65,0
2024-06-19,LW,North Macedonia,964,880,0,0,84,41,43,84,0
2024-06-20,LW,North Macedonia,1030,953,0,0,77,39,38,77,0
2024-06-21,LW,North Macedonia,1019,945,0,0,74,38,36,74,0
2024-06-22,LW,North Macedonia,1114,1046,0,0,68,33,35,68,0
2024-06-23,LW,North Macedonia,1104,1027,0,0,77,38,39,77,0
2024-06-24,LW,North Macedonia,924,848,0,0,76,41,35,76,0
2024-06-25,LW,North Macedonia,1050,982,0,0,68,31,37,68,0
2024-06-26,LW,North Macedonia,1077,1006,0,0,71,38,33,71,0
2024-06-27,LW,North Macedonia,944,870,0,0,74,37,37,74,0
2024-06-28,LW,North Macedonia,1137,1056,0,0,81,38,43,81,0
2024-06-29,LW,North Macedonia,1205,1140,0,0,65,36,29,65,0
2024-06-30,LW,North Macedonia,1136,1056,0,0,80,37,43,80,0
2024-07-01,LW,North Macedonia,1082,996,0,0,86,45,41,86,0
2024-07-02,LW,North Macedonia,1074,994,0,0,80,36,44,80,0
2024-07-03,LW,North Macedonia,1151,1045,1,1,106,53,52,105,0
2024-07-04,LW,North Macedonia,1112,1027,0,0,85,42,43,85,0
2024-07-05,LW,North Macedonia,1083,994,0,0,89,45,44,89,0
2024-07-06,LW,North Macedonia,1174,1098,0,0,76,39,37,76,0
2024-07-07,LW,North Macedonia,1123,1042,0,0,81,39,42,81,0
2024-07-08,LW,North Macedonia,1101,1023,0,0,78,42,36,78,0
2024-07-09,LW,North Macedonia,1147,1062,0,0,85,40,45,85,0
2024-07-10,LW,North Macedonia,1132,1043,0,0,89,46,43,89,0
2024-07-11,LW,North Macedonia,1158,1079,0,0,79,37,42,79,0
2024-07-12,LW,North Macedonia,1103,1019,0,0,84,44,40,84,0
2024-07-13,LW,North Macedonia,1240,1159,0,0,81,41,40,81,0
2024-07-14,LW,North Macedonia,1210,1132,0,0,78,39,39,78,0
2024-07-15,LW,North Macedonia,1111,1027,0,0,84,44,40,84,0
2024-07-16,LW,North Macedonia,1169,1088,0,0,81,36,45,81,0
2024-07-17,LW,North Macedonia,1173,1075,0,0,98,50,48,98,0
2024-07-18,LW,North Macedonia,1019,937,0,0,82,40,42,82,0
2024-07-19,LW,North Macedonia,1024,943,0,0,81,43,38,81,0
2024-07-20,LW,North Macedonia,1233,1157,0,0,76,41,35,76,0
2024-07-21,LW,North Macedonia,1205,1123,0,0,82,38,44,82,0
2024-07-22,LW,North Macedonia,1047,960,0,0,87,45,42,87,0
2024-07-23,LW,North Macedonia,1132,1050,0,0,82,39,43,82,0
2024-07-24,LW,North Macedonia,1155,1062,0,0,93,49,44,93,0
2024-07-25,LW,North Macedonia,1124,1041,0,0,83,39,44,83,0
2024-07-26,LW,North Macedonia,1099,1012,0,0,87,45,42,87,0
2024-07-27,LW,North Macedonia,1186,1108,0,0,78,39,39,78,0
2024-07-28,LW,North Macedonia,1137,1061,0,0,76,37,39,76,0
2024-07-29,LW,North Macedonia,1038,949,0,0,89,47,42,89,0
2024-07-30,LW,North Macedonia,1106,1034,0,0,72,34,38,72,0
2024-01-01,EN,Norway,1184,265,501,1,919,207,211,418,500
2024-01-02,EN,Norway,1402,237,750,2,1165,211,204,415,748
2024-01-03,EN,Norway,1407,218,738,5,1189,222,229,451,733
2024-01-04,EN,Norway,1490,217,775,2,1273,248,250,498,773
2024-01-05,EN,Norway,1415,198,713,6,1217,250,254,504,707
2024-01-06,EN,Norway,887,222,247,4,665,215,203,418,243
2024-01-07,EN,Norway,1240,230,515,2,1010,240,255,495,513
2024-01-08,EN,Norway,1380,145,772,11,1235,238,225,463,761
2024-01-09,EN,Norway,1317,143,800,8,1174,185,189,374,792
2024-01-10,EN,Norway,1395,165,792,13,1230,218,220,438,779
2024-01-11,EN,Norway,1436,180,809,21,1256,224,223,447,788
2024-01-12,EN,Norway,1448,184,784,18,1264,240,240,480,766
2024-01-13,EN,Norway,753,200,209,6,553,175,169,344,203
2024-01-14,EN,Norway,1208,224,534,4,984,219,231,450,530
2024-01-15,EN,Norway,1308,185,731,8,1123,199,193,392,723
2024-01-16,EN,Norway,1188,190,680,10,998,159,159,318,670
2024-01-17,EN,Norway,1206,185,690,9,1021,162,169,331,681
2024-01-18,EN,Norway,1285,204,672,12,1081,206,203,409,660
2024-01-19,EN,Norway,1433,175,773,17,1258,243,242,485,756
2024-01-20,EN,Norway,887,211,303,6,676,191,182,373,297
2024-01-21,EN,Norway,1310,268,605,4,1042,212,225,437,601
2024-01-22,EN,Norway,1282,200,692,3,1082,199,191,390,689
2024-01-23,EN,Norway,1424,213,827,28,1211,188,196,384,799
2024-01-24,EN,Norway,1410,209,796,8,1201,204,201,405,788
2024-01-25,EN,Norway,1546,196,875,21,1350,238,237,475,854
2024-01-26,EN,Norway,1510,211,796,7,1299,249,254,503,789
2024-01-27,EN,Norway,838,205,251,6,633,193,189,382,245
2024-01-28,EN,Norway,1250,240,564,4,1010,220,226,446,560
2024-01-29,EN,Norway,1110,174,496,14,936,220,220,440,482
2024-01-30,EN,Norway,1247,161,708,7,1086,191,187,378,701
2024-01-31,EN,Norway,1152,129,613,16,1023,204,206,410,597
2024-02-01,EN,Norway,1158,156,568,12,1002,216,218,434,556
2024-02-02,EN,Norway,1413,192,747,6,1221,236,238,474,741
2024-02-03,EN,Norway,803,193,239,5,610,189,182,371,234
2024-02-04,EN,Norway,1233,200,570,9,1033,226,237,463,561
2024-02-05,EN,Norway,1512,168,866,13,1344,240,238,478,853
2024-02-06,EN,Norway,1358,153,822,12,1205,188,195,383,810
2024-02-07,EN,Norway,1303,160,754,15,1143,196,193,389,739
2024-02-08,EN,Norway,1453,168,814,12,1285,235,236,471,802
2024-02-09,EN,Norway,1513,166,809,11,1347,270,268,538,798
2024-02-10,EN,Norway,903,185,302,2,718,212,204,416,300
2024-02-11,EN,Norway,1331,240,594,3,1091,243,254,497,591
2024-02-12,EN,Norway,1502,203,838,8,1299,230,231,461,830
2024-02-13,EN,Norway,1404,183,825,10,1221,200,196,396,815
2024-02-14,EN,Norway,1489,195,844,10,1294,225,225,450,834
2024-02-15,EN,Norway,1507,176,839,9,1331,244,248,492,830
2024-02-16,EN,Norway,1477,158,786,6,1319,264,269,533,780
2024-02-17,EN,Norway,966,189,322,13,777,227,228,455,309
2024-02-18,EN,Norway,1316,246,555,4,1070,254,261,515,551
2024-02-19,EN,Norway,1506,187,800,6,1319,261,258,519,794
2024-02-20,EN,Norway,1371,174,796,9,1197,201,200,401,787
2024-02-21,EN,Norway,1526,205,836,16,1321,240,245,485,820
2024-02-22,EN,Norway,1606,248,829,2,1358,264,265,529,827
2024-02-23,EN,Norway,1532,242,747,5,1290,271,272,543,742
2024-02-24,EN,Norway,931,262,245,5,669,216,208,424,240
2024-02-25,EN,Norway,1376,246,601,5,1130,258,271,529,596
2024-02-26,EN,Norway,1591,190,871,17,1401,265,265,530,854
2024-02-27,EN,Norway,1461,200,817,14,1261,222,222,444,803
2024-02-28,EN,Norway,1575,206,860,16,1369,252,257,509,844
2024-02-29,EN,Norway,1395,197,723,3,1198,239,236,475,720
2024-03-01,EN,Norway,1541,187,804,6,1354,274,276,550,798
2024-03-02,EN,Norway,952,220,281,3,732,227,224,451,278
2024-03-03,EN,Norway,1403,236,646,5,1167,252,269,521,641
2024-03-04,EN,Norway,1651,195,907,13,1456,279,270,549,894
2024-03-05,EN,Norway,1576,159,933,9,1417,238,246,484,924
2024-03-06,EN,Norway,1608,181,900,13,1427,264,263,527,887
2024-03-07,EN,Norway,1625,166,932,20,1459,261,266,527,912
2024-03-08,EN,Norway,1612,190,878,21,1422,276,268,544,857
2024-03-09,EN,Norway,896,180,286,5,716,217,213,430,281
2024-03-10,EN,Norway,1349,209,611,5,1140,258,271,529,606
2024-03-11,EN,Norway,1614,176,897,15,1438,273,268,541,882
2024-03-12,EN,Norway,1569,191,914,25,1378,231,233,464,889
2024-03-13,EN,Norway,1576,166,899,5,1410,252,259,511,894
2024-03-14,EN,Norway,1644,160,924,20,1484,283,277,560,904
2024-03-15,EN,Norway,1632,198,848,8,1434,296,290,586,840
2024-03-16,EN,Norway,788,178,239,2,610,188,183,371,237
2024-03-17,EN,Norway,1368,200,634,6,1168,262,272,534,628
2024-03-18,EN,Norway,1604,229,846,13,1375,266,263,529,833
2024-03-19,EN,Norway,1568,211,893,2,1357,234,230,464,891
2024-03-20,EN,Norway,1700,228,930,11,1472,270,272,542,919
2024-03-21,EN,Norway,1646,201,893,12,1445,277,275,552,881
2024-03-22,EN,Norway,1620,200,835,13,1420,291,294,585,822
2024-03-23,EN,Norway,971,220,284,3,751,234,233,467,281
2024-03-24,EN,Norway,1289,208,557,2,1081,260,264,524,555
2024-03-25,EN,Norway,1440,188,731,8,1252,267,254,521,723
2024-03-26,EN,Norway,1352,153,727,5,1199,241,231,472,722
2024-03-27,EN,Norway,1477,186,749,3,1291,270,272,542,746
2024-03-28,EN,Norway,1132,198,414,3,934,261,259,520,411
2024-03-29,EN,Norway,883,180,230,1,703,234,239,473,229
2024-03-30,EN,Norway,810,180,208,2,630,213,209,422,206
2024-03-31,EN,Norway,1257,199,548,4,1058,252,258,510,544
2024-04-01,EN,Norway,1507,195,735,5,1312,287,290,577,730
2024-04-02,EN,Norway,1643,193,867,6,1450,293,290,583,861
2024-04-03,EN,Norway,1665,196,885,7,1469,293,291,584,878
2024-04-04,EN,Norway,1688,219,878,4,1469,295,296,591,874
2024-04-05,EN,Norway,1665,217,821,7,1448,313,314,627,814
2024-04-06,EN,Norway,943,170,277,5,773,251,245,496,272
2024-04-07,EN,Norway,1380,217,591,5,1163,286,286,572,586
2024-04-08,EN,Norway,1725,214,908,13,1511,301,302,603,895
2024-04-09,EN,Norway,1761,224,937,14,1537,300,300,600,923
2024-04-10,EN,Norway,1722,195,927,5,1527,298,302,600,922
2024-04-11,EN,Norway,1726,207,915,13,1519,300,304,604,902
2024-04-12,EN,Norway,1680,221,853,9,1459,305,301,606,844
2024-04-13,EN,Norway,995,197,329,10,798,232,237,469,319
2024-04-14,EN,Norway,1400,203,626,0,1197,287,284,571,626
2024-04-15,EN,Norway,1742,221,929,5,1521,297,295,592,924
2024-04-16,EN,Norway,1768,221,947,8,1547,300,300,600,939
2024-04-17,EN,Norway,1750,199,939,14,1551,306,306,612,925
2024-04-18,EN,Norway,1751,196,931,11,1555,313,311,624,920
2024-04-19,EN,Norway,1652,196,846,11,1456,309,301,610,835
2024-04-20,EN,Norway,964,183,303,12,781,235,243,478,291
2024-04-21,EN,Norway,1416,196,629,9,1220,292,299,591,620
2024-04-22,EN,Norway,1725,196,915,21,1529,305,309,614,894
2024-04-23,EN,Norway,1745,176,944,8,1569,313,312,625,936
2024-04-24,EN,Norway,1702,181,914,5,1521,304,303,607,909
2024-04-25,EN,Norway,1513,145,795,4,1368,286,287,573,791
2024-04-26,EN,Norway,1750,242,876,11,1508,317,315,632,865
2024-04-27,EN,Norway,1036,229,305,4,807,252,250,502,301
2024-04-28,EN,Norway,1415,227,612,7,1188,287,289,576,605
2024-04-29,EN,Norway,1693,223,851,12,1470,311,308,619,839
2024-04-30,EN,Norway,1676,223,842,9,1453,308,303,611,833
2024-05-01,EN,Norway,1374,186,592,5,1188,296,300,596,587
2024-05-02,EN,Norway,1693,215,852,8,1478,314,312,626,844
2024-05-03,EN,Norway,1675,191,858,15,1484,313,313,626,843
2024-05-04,EN,Norway,998,186,284,13,812,260,268,528,271
2024-05-05,EN,Norway,1478,236,639,4,1242,301,302,603,635
2024-05-06,EN,Norway,1712,239,859,8,1473,310,304,614,851
2024-05-07,EN,Norway,1723,237,884,14,1486,300,302,602,870
2024-05-08,EN,Norway,1751,196,921,15,1555,317,317,634,906
2024-05-09,EN,Norway,1407,220,626,4,1187,284,277,561,622
2024-05-10,EN,Norway,1443,182,690,10,1261,285,286,571,680
2024-05-11,EN,Norway,1025,185,291,8,840,272,277,549,283
2024-05-12,EN,Norway,1447,219,604,2,1228,310,314,624,602
2024-05-13,EN,Norway,1774,247,891,13,1527,317,319,636,878
2024-05-14,EN,Norway,1736,211,887,12,1525,321,317,638,875
2024-05-15,EN,Norway,1741,206,887,15,1535,322,326,648,872
2024-05-16,EN,Norway,1815,249,912,20,1566,330,324,654,892
2024-05-17,EN,Norway,1192,278,355,0,914,279,280,559,355
2024-05-18,EN,Norway,1097,218,293,6,879,295,291,586,287
2024-05-19,EN,Norway,1296,240,488,1,1056,279,289,568,487
2024-05-20,EN,Norway,1618,255,735,5,1363,314,314,628,730
2024-05-21,EN,Norway,1778,230,917,10,1548,318,313,631,907
2024-05-22,EN,Norway,1764,196,918,14,1568,327,323,650,904
2024-05-23,EN,Norway,1798,227,917,5,1571,327,327,654,912
2024-05-24,EN,Norway,1727,253,845,4,1474,313,316,629,841
2024-05-25,EN,Norway,1105,223,301,6,882,292,289,581,295
2024-05-26,EN,Norway,1485,271,601,4,1214,302,311,613,597
2024-05-27,EN,Norway,1837,265,926,5,1572,324,322,646,921
2024-05-28,EN,Norway,1795,249,921,5,1546,313,312,625,916
2024-05-29,EN,Norway,1824,239,922,9,1585,330,333,663,913
2024-05-30,EN,Norway,1854,247,951,9,1607,332,324,656,942
2024-05-31,EN,Norway,1812,274,880,11,1538,328,330,658,869
2024-06-01,EN,Norway,1133,242,297,5,891,298,296,594,292
2024-06-02,EN,Norway,1490,245,636,4,1245,301,308,609,632
2024-06-03,EN,Norway,1854,211,955,5,1643,344,344,688,950
2024-06-04,EN,Norway,1825,218,946,9,1607,333,328,661,937
2024-06-05,EN,Norway,1865,253,944,5,1612,336,332,668,939
2024-06-06,EN,Norway,1905,288,949,6,1617,335,333,668,943
2024-06-07,EN,Norway,1753,276,825,10,1477,324,328,652,815
2024-06-08,EN,Norway,1162,233,319,0,929,309,301,610,319
2024-06-09,EN,Norway,1544,265,638,4,1279,315,326,641,634
2024-06-10,EN,Norway,1873,269,938,8,1604,333,333,666,930
2024-06-11,EN,Norway,1822,247,911,8,1575,330,334,664,903
2024-06-12,EN,Norway,1868,271,904,6,1597,343,350,693,898
2024-06-13,EN,Norway,1884,275,942,8,1609,333,334,667,934
2024-06-14,EN,Norway,1813,274,853,6,1539,342,344,686,847
2024-06-15,EN,Norway,1153,245,282,3,908,314,312,626,279
2024-06-16,EN,Norway,1551,317,595,4,1234,315,324,639,591
2024-06-17,EN,Norway,1929,291,936,6,1638,354,348,702,930
2024-06-18,EN,Norway,1905,273,956,7,1632,338,338,676,949
2024-06-19,EN,Norway,1849,247,905,11,1602,347,350,697,894
2024-06-20,EN,Norway,1897,272,896,13,1625,362,367,729,883
2024-06-21,EN,Norway,1852,290,847,13,1562,360,355,715,834
2024-06-22,EN,Norway,1173,254,286,7,919,321,312,633,279
2024-06-23,EN,Norway,1475,250,562,8,1225,329,334,663,554
2024-06-24,EN,Norway,1832,277,812,8,1555,363,380,743,804
2024-06-25,EN,Norway,1779,267,779,14,1512,372,361,733,765
2024-06-26,EN,Norway,1762,274,754,8,1488,367,367,734,746
2024-06-27,EN,Norway,1787,290,753,13,1497,371,373,744,740
2024-06-28,EN,Norway,1771,308,711,7,1463,376,376,752,704
2024-06-29,EN,Norway,1209,252,289,6,957,339,329,668,283
2024-06-30,EN,Norway,1488,281,533,7,1207,337,337,674,526
2024-07-01,EN,Norway,1759,300,747,14,1459,355,357,712,733
2024-07-02,EN,Norway,1729,297,726,9,1432,354,352,706,717
2024-07-03,EN,Norway,1779,340,713,5,1439,365,361,726,708
2024-07-04,EN,Norway,1784,322,737,3,1462,363,362,725,734
2024-07-05,EN,Norway,1697,278,682,7,1419,368,369,737,675
2024-07-06,EN,Norway,1241,262,302,3,979,341,336,677,299
2024-07-07,EN,Norway,1497,281,534,4,1216,336,346,682,530
2024-07-08,EN,Norway,1751,294,738,12,1457,359,360,719,726
2024-07-09,EN,Norway,1685,255,730,12,1430,352,348,700,718
2024-07-10,EN,Norway,1686,284,699,6,1402,351,352,703,693
2024-07-11,EN,Norway,1754,290,716,5,1464,375,373,748,711
2024-07-12,EN,Norway,1717,255,711,11,1462,374,377,751,700
2024-07-13,EN,Norway,1230,252,295,8,978,338,345,683,287
2024-07-14,EN,Norway,1507,294,532,5,1213,339,342,681,527
2024-07-15,EN,Norway,1748,284,725,1,1464,372,367,739,724
2024-07-16,EN,Norway,1652,269,704,7,1383,338,341,679,697
2024-07-17,EN,Norway,1691,285,698,2,1406,354,354,708,696
2024-07-18,EN,Norway,1748,293,723,10,1455,363,369,732,713
2024-07-19,EN,Norway,1688,284,697,6,1404,361,346,707,691
2024-07-20,EN,Norway,1237,273,299,8,964,333,332,665,291
2024-07-21,EN,Norway,1527,340,516,5,1187,330,341,671,511
2024-07-22,EN,Norway,1789,334,728,5,1455,364,363,727,723
2024-07-23,EN,Norway,1686,277,698,8,1409,352,359,711,690
2024-07-24,EN,Norway,1680,259,694,6,1421,364,363,727,688
2024-07-25,EN,Norway,1714,265,731,14,1449,362,356,718,717
2024-07-26,EN,Norway,1695,320,659,3,1375,358,358,716,656
2024-07-27,EN,Norway,1240,266,307,7,974,334,333,667,300
2024-07-28,EN,Norway,1446,256,529,5,1190,330,331,661,524
2024-07-29,EN,Norway,1669,221,726,8,1448,357,365,722,718
2024-07-30,EN,Norway,1736,266,758,9,1470,357,355,712,749
2024-01-01,EP,Poland,1570,682,62,0,888,416,410,826,62
2024-01-02,EP,Poland,1647,676,76,3,971,444,451,895,73
2024-01-03,EP,Poland,1649,650,92,8,999,454,453,907,84
2024-01-04,EP,Poland,1693,679,93,10,1014,469,452,921,83
2024-01-05,EP,Poland,1839,713,129,34,1126,488,509,997,95
2024-01-06,EP,Poland,1725,752,61,2,973,453,459,912,59
2024-01-07,EP,Poland,1701,717,79,6,984,454,451,905,73
2024-01-08,EP,Poland,1752,668,117,15,1084,479,488,967,102
2024-01-09,EP,Poland,1407,560,110,16,847,364,373,737,94
2024-01-10,EP,Poland,1405,568,89,10,837,376,372,748,79
2024-01-11,EP,Poland,1483,567,89,3,916,416,411,827,86
2024-01-12,EP,Poland,1710,667,107,11,1043,461,475,936,96
2024-01-13,EP,Poland,1601,681,59,2,920,437,424,861,57
2024-01-14,EP,Poland,1625,664,80,2,961,438,443,881,78
2024-01-15,EP,Poland,1634,628,105,9,1006,452,449,901,96
2024-01-16,EP,Poland,1375,518,111,22,857,367,379,746,89
2024-01-17,EP,Poland,1294,506,104,13,788,343,341,684,91
2024-01-18,EP,Poland,1443,566,98,10,877,397,382,779,88
2024-01-19,EP,Poland,1724,663,120,21,1061,468,473,941,99
2024-01-20,EP,Poland,1545,636,70,5,909,416,423,839,65
2024-01-21,EP,Poland,1574,633,89,10,941,427,425,852,79
2024-01-22,EP,Poland,1684,648,110,16,1036,461,465,926,94
2024-01-23,EP,Poland,1378,554,110,15,824,358,356,714,95
2024-01-24,EP,Poland,1359,531,86,8,828,368,374,742,78
2024-01-25,EP,Poland,1490,566,98,8,924,420,406,826,90
2024-01-26,EP,Poland,1731,648,138,14,1083,470,475,945,124
2024-01-27,EP,Poland,1506,630,64,4,876,406,406,812,60
2024-01-28,EP,Poland,1605,654,79,8,951,432,440,872,71
2024-01-29,EP,Poland,1719,645,144,35,1074,467,463,930,109
2024-01-30,EP,Poland,1364,494,135,35,870,367,368,735,100
2024-01-31,EP,Poland,1375,498,118,27,877,379,380,759,91
2024-02-01,EP,Poland,1424,489,110,15,935,417,408,825,95
2024-02-02,EP,Poland,1701,623,122,13,1078,472,484,956,109
2024-02-03,EP,Poland,1516,657,58,4,859,404,397,801,54
2024-02-04,EP,Poland,1584,656,76,5,928,426,426,852,71
2024-02-05,EP,Poland,1715,650,118,12,1065,472,475,947,106
2024-02-06,EP,Poland,1362,522,114,18,840,359,367,726,96
2024-02-07,EP,Poland,1342,513,99,12,829,363,367,730,87
2024-02-08,EP,Poland,1532,565,127,35,967,425,415,840,92
2024-02-09,EP,Poland,1684,621,104,11,1063,480,479,959,93
2024-02-10,EP,Poland,1547,643,74,12,904,411,419,830,62
2024-02-11,EP,Poland,1614,668,92,17,946,431,423,854,75
2024-02-12,EP,Poland,1705,645,117,20,1060,469,474,943,97
2024-02-13,EP,Poland,1414,548,125,29,866,371,370,741,96
2024-02-14,EP,Poland,1433,554,119,28,879,385,375,760,91
2024-02-15,EP,Poland,1593,596,135,29,997,434,428,862,106
2024-02-16,EP,Poland,1777,641,133,29,1136,502,501,1003,104
2024-02-17,EP,Poland,1560,653,65,10,907,417,425,842,55
2024-02-18,EP,Poland,1665,685,86,14,980,447,447,894,72
2024-02-19,EP,Poland,1731,651,120,20,1080,475,485,960,100
2024-02-20,EP,Poland,1343,490,108,21,853,372,373,745,87
2024-02-21,EP,Poland,1433,559,108,22,874,386,380,766,86
2024-02-22,EP,Poland,1573,593,125,28,980,432,423,855,97
2024-02-23,EP,Poland,1807,686,134,19,1121,483,504,987,115
2024-02-24,EP,Poland,1624,707,75,20,917,422,420,842,55
2024-02-25,EP,Poland,1697,681,105,21,1016,459,452,911,84
2024-02-26,EP,Poland,1770,661,125,22,1109,493,491,984,103
2024-02-27,EP,Poland,1440,545,124,30,895,382,389,771,94
2024-02-28,EP,Poland,1487,558,118,19,929,410,401,811,99
2024-02-29,EP,Poland,1586,585,121,29,1001,437,443,880,92
2024-03-01,EP,Poland,1858,677,140,33,1181,520,521,1041,107
2024-03-02,EP,Poland,1719,744,94,25,975,440,441,881,69
2024-03-03,EP,Poland,1756,720,101,21,1036,466,469,935,80
2024-03-04,EP,Poland,1798,673,135,17,1125,488,502,990,118
2024-03-05,EP,Poland,1413,532,110,7,881,390,381,771,103
2024-03-06,EP,Poland,1474,573,116,17,901,397,388,785,99
2024-03-07,EP,Poland,1512,587,126,21,925,406,393,799,105
2024-03-08,EP,Poland,1791,679,147,32,1112,479,486,965,115
2024-03-09,EP,Poland,1620,689,77,15,931,421,433,854,62
2024-03-10,EP,Poland,1682,670,90,12,1012,463,459,922,78
2024-03-11,EP,Poland,1758,659,119,23,1099,489,491,980,96
2024-03-12,EP,Poland,1384,524,116,23,860,380,364,744,93
2024-03-13,EP,Poland,1449,572,115,26,877,379,383,762,89
2024-03-14,EP,Poland,1599,602,132,23,997,431,434,865,109
2024-03-15,EP,Poland,1890,706,140,22,1184,516,528,1044,118
2024-03-16,EP,Poland,1631,665,74,13,966,446,446,892,61
2024-03-17,EP,Poland,1701,672,76,5,1029,476,477,953,71
2024-03-18,EP,Poland,1776,675,107,13,1101,496,498,994,94
2024-03-19,EP,Poland,1480,565,114,26,915,396,405,801,88
2024-03-20,EP,Poland,1572,598,121,27,974,423,430,853,94
2024-03-21,EP,Poland,1676,618,145,34,1058,468,445,913,111
2024-03-22,EP,Poland,1917,737,126,26,1180,527,527,1054,100
2024-03-23,EP,Poland,1689,711,85,13,978,449,444,893,72
2024-03-24,EP,Poland,1741,728,86,14,1013,461,466,927,72
2024-03-25,EP,Poland,1789,656,123,15,1133,497,513,1010,108
2024-03-26,EP,Poland,1621,592,144,23,1029,443,442,885,121
2024-03-27,EP,Poland,1681,628,145,27,1053,456,452,908,118
2024-03-28,EP,Poland,1747,690,117,30,1057,477,463,940,87
2024-03-29,EP,Poland,1810,690,114,21,1120,499,507,1006,93
2024-03-30,EP,Poland,1691,708,58,7,983,461,464,925,51
2024-03-31,EP,Poland,1825,823,77,0,1002,466,459,925,77
2024-04-01,EP,Poland,1856,769,98,5,1087,494,495,989,93
2024-04-02,EP,Poland,1862,747,118,12,1115,496,501,997,106
2024-04-03,EP,Poland,1845,720,119,14,1125,503,503,1006,105
2024-04-04,EP,Poland,1923,759,129,28,1164,521,514,1035,101
2024-04-05,EP,Poland,1993,795,148,41,1198,524,526,1050,107
2024-04-06,EP,Poland,1809,756,84,17,1053,485,484,969,67
2024-04-07,EP,Poland,1992,871,100,15,1121,507,514,1021,85
2024-04-08,EP,Poland,1992,766,162,30,1226,533,531,1064,132
2024-04-09,EP,Poland,1870,737,144,28,1133,489,500,989,116
2024-04-10,EP,Poland,1921,757,142,33,1164,513,509,1022,109
2024-04-11,EP,Poland,1907,741,116,17,1166,532,518,1050,99
2024-04-12,EP,Poland,2004,775,142,29,1229,547,540,1087,113
2024-04-13,EP,Poland,1820,760,83,20,1060,483,494,977,63
2024-04-14,EP,Poland,1875,794,100,16,1081,493,488,981,84
2024-04-15,EP,Poland,1970,772,141,34,1198,527,530,1057,107
2024-04-16,EP,Poland,1873,727,122,21,1146,516,508,1024,101
2024-04-17,EP,Poland,1881,719,133,30,1162,514,515,1029,103
2024-04-18,EP,Poland,1949,751,129,31,1198,537,532,1069,98
2024-04-19,EP,Poland,2042,795,130,35,1247,558,559,1117,95
2024-04-20,EP,Poland,1840,781,70,11,1059,490,499,989,59
2024-04-21,EP,Poland,2008,864,98,13,1144,523,523,1046,85
2024-04-22,EP,Poland,1984,785,133,30,1199,525,541,1066,103
2024-04-23,EP,Poland,1867,695,140,29,1172,511,521,1032,111
2024-04-24,EP,Poland,1989,772,126,17,1217,545,546,1091,109
2024-04-25,EP,Poland,2057,800,114,26,1257,573,570,1143,88
2024-04-26,EP,Poland,2230,848,163,32,1382,611,608,1219,131
2024-04-27,EP,Poland,2149,897,86,16,1252,585,581,1166,70
2024-04-28,EP,Poland,2212,935,90,8,1277,594,593,1187,82
2024-04-29,EP,Poland,2072,840,133,22,1232,556,543,1099,111
2024-04-30,EP,Poland,1992,802,123,29,1190,539,528,1067,94
2024-05-01,EP,Poland,1995,830,101,11,1165,529,535,1064,90
2024-05-02,EP,Poland,2061,826,99,10,1235,569,567,1136,89
2024-05-03,EP,Poland,2103,849,98,13,1254,581,575,1156,85
2024-05-04,EP,Poland,2202,953,92,18,1249,577,580,1157,74
2024-05-05,EP,Poland,2355,1011,101,7,1344,610,633,1243,94
2024-05-06,EP,Poland,2166,886,128,26,1280,572,580,1152,102
2024-05-07,EP,Poland,2086,859,141,29,1227,540,546,1086,112
2024-05-08,EP,Poland,2134,835,160,33,1299,577,562,1139,127
2024-05-09,EP,Poland,2164,837,170,39,1327,580,577,1157,131
2024-05-10,EP,Poland,2216,876,145,40,1340,599,596,1195,105
2024-05-11,EP,Poland,2261,1034,90,17,1227,563,574,1137,73
2024-05-12,EP,Poland,2325,995,113,24,1330,609,608,1217,89
2024-05-13,EP,Poland,2218,912,132,25,1306,583,591,1174,107
2024-05-14,EP,Poland,2097,860,135,25,1237,557,545,1102,110
2024-05-15,EP,Poland,2183,850,170,42,1333,574,589,1163,128
2024-05-16,EP,Poland,2215,849,157,36,1366,606,603,1209,121
2024-05-17,EP,Poland,2347,957,138,27,1390,632,620,1252,111
2024-05-18,EP,Poland,2288,1064,90,16,1224,566,568,1134,74
2024-05-19,EP,Poland,2349,1013,111,15,1336,610,615,1225,96
2024-05-20,EP,Poland,2241,942,152,33,1299,571,576,1147,119
2024-05-21,EP,Poland,2158,894,150,41,1264,562,552,1114,109
2024-05-22,EP,Poland,2142,854,137,26,1288,568,583,1151,111
2024-05-23,EP,Poland,2182,858,132,26,1324,599,593,1192,106
2024-05-24,EP,Poland,2346,942,137,28,1404,636,631,1267,109
2024-05-25,EP,Poland,2391,1092,116,26,1299,590,593,1183,90
2024-05-26,EP,Poland,2428,1048,101,13,1380,642,637,1279,88
2024-05-27,EP,Poland,2361,997,144,23,1364,604,616,1220,121
2024-05-28,EP,Poland,2231,902,134,30,1329,595,600,1195,104
2024-05-29,EP,Poland,2355,946,137,22,1409,646,626,1272,115
2024-05-30,EP,Poland,2224,905,85,6,1319,618,616,1234,79
2024-05-31,EP,Poland,2389,986,115,24,1403,649,639,1288,91
2024-06-01,EP,Poland,2432,1133,85,9,1299,609,605,1214,76
2024-06-02,EP,Poland,2505,1098,93,10,1407,644,670,1314,83
2024-06-03,EP,Poland,2384,1010,125,22,1374,629,620,1249,103
2024-06-04,EP,Poland,2296,898,143,30,1398,621,634,1255,113
2024-06-05,EP,Poland,2420,968,147,45,1452,662,643,1305,102
2024-06-06,EP,Poland,2378,961,134,36,1417,636,647,1283,98
2024-06-07,EP,Poland,2462,961,150,34,1501,679,672,1351,116
2024-06-08,EP,Poland,2445,1097,97,12,1348,627,624,1251,85
2024-06-09,EP,Poland,2576,1113,100,19,1463,677,686,1363,81
2024-06-10,EP,Poland,2444,1004,139,35,1440,658,643,1301,104
2024-06-11,EP,Poland,2387,979,167,43,1408,610,631,1241,124
2024-06-12,EP,Poland,2456,966,161,36,1490,667,662,1329,125
2024-06-13,EP,Poland,2390,954,141,40,1436,653,642,1295,101
2024-06-14,EP,Poland,2546,978,148,37,1568,710,710,1420,111
2024-06-15,EP,Poland,2506,1145,93,19,1361,632,636,1268,74
2024-06-16,EP,Poland,2577,1114,100,19,1463,680,683,1363,81
2024-06-17,EP,Poland,2481,1018,147,37,1463,660,656,1316,110
2024-06-18,EP,Poland,2409,971,142,37,1438,644,652,1296,105
2024-06-19,EP,Poland,2465,953,154,43,1512,679,679,1358,111
2024-06-20,EP,Poland,2490,989,139,33,1501,682,680,1362,106
2024-06-21,EP,Poland,2604,1087,136,30,1517,699,682,1381,106
2024-06-22,EP,Poland,2451,1094,91,12,1357,636,630,1266,79
2024-06-23,EP,Poland,2584,1092,102,14,1492,691,699,1390,88
2024-06-24,EP,Poland,2513,1070,132,27,1443,658,653,1311,105
2024-06-25,EP,Poland,2454,994,143,28,1460,657,660,1317,115
2024-06-26,EP,Poland,2431,963,148,30,1468,661,659,1320,118
2024-06-27,EP,Poland,2511,1014,130,15,1497,686,681,1367,115
2024-06-28,EP,Poland,2616,1103,119,21,1513,694,700,1394,98
2024-06-29,EP,Poland,2497,1139,98,20,1358,626,634,1260,78
2024-06-30,EP,Poland,2598,1144,92,20,1454,687,675,1362,72
2024-07-01,EP,Poland,2523,1070,152,26,1453,649,652,1301,126
2024-07-02,EP,Poland,2408,977,137,30,1431,644,650,1294,107
2024-07-03,EP,Poland,2549,1060,136,20,1489,675,678,1353,116
2024-07-04,EP,Poland,2558,1049,153,40,1509,676,680,1356,113
2024-07-05,EP,Poland,2575,1068,112,32,1507,700,695,1395,80
2024-07-06,EP,Poland,2518,1173,85,13,1345,629,631,1260,72
2024-07-07,EP,Poland,2605,1154,92,11,1451,677,682,1359,81
2024-07-08,EP,Poland,2546,1069,152,38,1477,659,666,1325,114
2024-07-09,EP,Poland,2482,1024,147,37,1458,658,653,1311,110
2024-07-10,EP,Poland,2516,1042,143,36,1474,665,666,1331,107
2024-07-11,EP,Poland,2515,1018,140,36,1497,676,681,1357,104
2024-07-12,EP,Poland,2650,1132,138,24,1518,700,680,1380,114
2024-07-13,EP,Poland,2531,1162,98,20,1369,635,636,1271,78
2024-07-14,EP,Poland,2609,1133,94,11,1476,690,692,1382,83
2024-07-15,EP,Poland,2591,1109,137,28,1482,672,673,1345,109
2024-07-16,EP,Poland,2442,1014,122,24,1428,651,655,1306,98
2024-07-17,EP,Poland,2527,1061,130,26,1466,671,665,1336,104
2024-07-18,EP,Poland,2539,1039,126,29,1500,690,684,1374,97
2024-07-19,EP,Poland,2516,1051,123,24,1465,677,665,1342,99
2024-07-20,EP,Poland,2506,1161,93,16,1345,624,628,1252,77
2024-07-21,EP,Poland,2609,1165,85,14,1444,676,683,1359,71
2024-07-22,EP,Poland,2531,1083,129,26,1448,654,665,1319,103
2024-07-23,EP,Poland,2490,1035,129,29,1455,662,664,1326,100
2024-07-24,EP,Poland,2500,1032,143,31,1468,662,663,1325,112
2024-07-25,EP,Poland,2494,1033,121,24,1461,675,665,1340,97
2024-07-26,EP,Poland,2656,1123,133,21,1533,697,703,1400,112
2024-07-27,EP,Poland,2508,1160,87,13,1348,635,626,1261,74
2024-07-28,EP,Poland,2588,1126,88,7,1462,681,693,1374,81
2024-07-29,EP,Poland,2552,1070,150,24,1482,664,668,1332,126
2024-07-30,EP,Poland,2483,1034,134,29,1449,657,658,1315,105
2024-01-01,LP,Portugal,2050,988,148,0,1062,451,463,914,148
2024-01-02,LP,Portugal,2213,1078,192,0,1135,476,467,943,192
2024-01-03,LP,Portugal,2049,1014,176,1,1035,440,419,859,175
2024-01-04,LP,Portugal,2192,1106,153,1,1086,460,473,933,152
2024-01-05,LP,Portugal,2299,1192,150,1,1107,480,477,957,149
2024-01-06,LP,Portugal,2530,1398,139,0,1132,503,490,993,139
2024-01-07,LP,Portugal,2331,1235,136,3,1096,479,481,960,133
2024-01-08,LP,Portugal,2067,1033,147,0,1034,435,452,887,147
2024-01-09,LP,Portugal,1850,1035,135,1,815,343,337,680,134
2024-01-10,LP,Portugal,1692,922,131,2,770,326,313,639,129
2024-01-11,LP,Portugal,1824,983,126,2,841,352,363,715,124
2024-01-12,LP,Portugal,1980,999,158,3,981,413,410,823,155
2024-01-13,LP,Portugal,2055,1159,132,4,896,380,384,764,128
2024-01-14,LP,Portugal,2006,1007,131,0,999,441,427,868,131
2024-01-15,LP,Portugal,1837,892,144,1,945,393,408,801,143
2024-01-16,LP,Portugal,1603,886,120,2,717,302,295,597,118
2024-01-17,LP,Portugal,1538,842,128,1,696,282,286,568,127
2024-01-18,LP,Portugal,1775,955,139,4,820,340,341,681,135
2024-01-19,LP,Portugal,1936,1004,138,0,932,400,394,794,138
2024-01-20,LP,Portugal,2099,1236,129,1,863,365,369,734,128
2024-01-21,LP,Portugal,2021,1100,125,0,921,399,397,796,125
2024-01-22,LP,Portugal,1846,930,133,0,916,387,396,783,133
2024-01-23,LP,Portugal,1648,914,143,3,734,301,290,591,140
2024-01-24,LP,Portugal,1498,780,125,0,718,294,299,593,125
2024-01-25,LP,Portugal,1704,877,141,1,827,340,346,686,140
2024-01-26,LP,Portugal,1911,957,152,2,954,410,392,802,150
2024-01-27,LP,Portugal,2058,1186,128,0,872,371,373,744,128
2024-01-28,LP,Portugal,2018,1048,130,0,970,417,423,840,130
2024-01-29,LP,Portugal,1761,854,138,0,907,379,390,769,138
2024-01-30,LP,Portugal,1657,918,134,3,739,308,297,605,131
2024-01-31,LP,Portugal,1687,947,124,0,740,316,300,616,124
2024-02-01,LP,Portugal,1834,991,142,0,843,346,355,701,142
2024-02-02,LP,Portugal,2024,1045,147,1,979,415,417,832,146
2024-02-03,LP,Portugal,2179,1267,124,0,912,396,392,788,124
2024-02-04,LP,Portugal,2023,1023,135,0,1000,430,435,865,135
2024-02-05,LP,Portugal,1873,882,142,2,991,420,429,849,140
2024-02-06,LP,Portugal,1779,990,127,2,789,331,331,662,125
2024-02-07,LP,Portugal,1631,886,127,1,745,316,302,618,126
2024-02-08,LP,Portugal,1870,977,123,2,893,377,393,770,121
2024-02-09,LP,Portugal,2070,999,174,1,1071,454,443,897,173
2024-02-10,LP,Portugal,2291,1237,132,4,1054,461,461,922,128
2024-02-11,LP,Portugal,2128,1088,129,0,1040,453,458,911,129
2024-02-12,LP,Portugal,1941,908,138,1,1033,441,454,895,137
2024-02-13,LP,Portugal,1774,927,141,1,847,353,353,706,140
2024-02-14,LP,Portugal,1750,876,148,2,874,371,355,726,146
2024-02-15,LP,Portugal,2076,1071,145,2,1005,431,429,860,143
2024-02-16,LP,Portugal,2213,1132,147,2,1081,468,466,934,145
2024-02-17,LP,Portugal,2353,1269,138,2,1084,471,475,946,136
2024-02-18,LP,Portugal,2198,1096,131,2,1102,486,485,971,129
2024-02-19,LP,Portugal,2046,964,157,1,1082,457,468,925,156
2024-02-20,LP,Portugal,1859,977,141,0,882,374,367,741,141
2024-02-21,LP,Portugal,1748,863,136,0,885,380,369,749,136
2024-02-22,LP,Portugal,2006,997,144,0,1009,431,434,865,144
2024-02-23,LP,Portugal,2163,1093,145,0,1070,463,462,925,145
2024-02-24,LP,Portugal,2384,1298,138,0,1086,473,475,948,138
2024-02-25,LP,Portugal,2171,1079,130,0,1092,482,480,962,130
2024-02-26,LP,Portugal,2193,1104,153,1,1089,459,477,936,152
2024-02-27,LP,Portugal,1900,1019,141,4,881,372,368,740,137
2024-02-28,LP,Portugal,1802,915,143,4,887,380,364,744,139
2024-02-29,LP,Portugal,1931,951,142,1,980,419,419,838,141
2024-03-01,LP,Portugal,2226,1128,142,0,1098,475,481,956,142
2024-03-02,LP,Portugal,2400,1340,125,0,1060,468,467,935,125
2024-03-03,LP,Portugal,2209,1110,137,0,1099,481,481,962,137
2024-03-04,LP,Portugal,2038,928,149,0,1110,479,482,961,149
2024-03-05,LP,Portugal,1929,1006,141,0,923,391,391,782,141
2024-03-06,LP,Portugal,1866,969,138,1,897,383,376,759,137
2024-03-07,LP,Portugal,2118,1123,147,0,995,422,426,848,147
2024-03-08,LP,Portugal,2195,1123,157,0,1072,464,451,915,157
2024-03-09,LP,Portugal,2431,1359,126,1,1072,464,482,946,125
2024-03-10,LP,Portugal,2309,1184,138,0,1125,498,489,987,138
2024-03-11,LP,Portugal,2065,956,144,1,1109,479,486,965,143
2024-03-12,LP,Portugal,1886,979,139,1,907,381,387,768,138
2024-03-13,LP,Portugal,1838,958,142,0,880,378,360,738,142
2024-03-14,LP,Portugal,2067,1034,154,2,1033,436,443,879,152
2024-03-15,LP,Portugal,2162,1052,142,1,1110,488,480,968,141
2024-03-16,LP,Portugal,2284,1155,146,0,1129,485,498,983,146
2024-03-17,LP,Portugal,2158,1023,139,2,1135,499,497,996,137
2024-03-18,LP,Portugal,2130,995,151,0,1135,485,499,984,151
2024-03-19,LP,Portugal,1871,937,139,0,934,396,399,795,139
2024-03-20,LP,Portugal,1859,933,137,0,926,407,382,789,137
2024-03-21,LP,Portugal,2100,1051,146,3,1049,449,454,903,143
2024-03-22,LP,Portugal,2238,1094,146,3,1144,500,498,998,143
2024-03-23,LP,Portugal,2475,1312,160,2,1163,502,501,1003,158
2024-03-24,LP,Portugal,2380,1209,160,5,1171,508,503,1011,155
2024-03-25,LP,Portugal,2255,1129,160,8,1126,474,492,966,152
2024-03-26,LP,Portugal,2067,1006,161,6,1061,451,449,900,155
2024-03-27,LP,Portugal,1974,944,155,2,1030,441,434,875,153
2024-03-28,LP,Portugal,2165,1054,156,1,1111,471,484,955,155
2024-03-29,LP,Portugal,2230,1099,147,1,1131,493,491,984,146
2024-03-30,LP,Portugal,2517,1368,134,1,1149,507,508,1015,133
2024-03-31,LP,Portugal,2478,1211,178,0,1267,548,541,1089,178
2024-04-01,LP,Portugal,2338,1074,174,0,1264,537,553,1090,174
2024-04-02,LP,Portugal,2196,976,172,0,1220,522,526,1048,172
2024-04-03,LP,Portugal,2100,946,144,4,1154,509,501,1010,140
2024-04-04,LP,Portugal,2225,985,174,2,1240,531,535,1066,172
2024-04-05,LP,Portugal,2181,938,174,7,1243,541,528,1069,167
2024-04-06,LP,Portugal,2530,1170,179,1,1360,591,590,1181,178
2024-04-07,LP,Portugal,2437,1133,176,2,1304,565,563,1128,174
2024-04-08,LP,Portugal,2278,1009,185,0,1269,536,548,1084,185
2024-04-09,LP,Portugal,2241,1044,157,0,1197,519,521,1040,157
2024-04-10,LP,Portugal,2104,946,156,3,1158,507,495,1002,153
2024-04-11,LP,Portugal,2220,957,181,3,1263,542,540,1082,178
2024-04-12,LP,Portugal,2200,930,180,0,1270,551,539,1090,180
2024-04-13,LP,Portugal,2431,1127,163,1,1304,570,571,1141,162
2024-04-14,LP,Portugal,2323,1033,169,2,1290,559,562,1121,167
2024-04-15,LP,Portugal,2212,929,196,2,1283,540,547,1087,194
2024-04-16,LP,Portugal,2163,980,158,1,1183,511,514,1025,157
2024-04-17,LP,Portugal,2067,908,168,2,1159,495,496,991,166
2024-04-18,LP,Portugal,2220,968,177,2,1252,542,533,1075,175
2024-04-19,LP,Portugal,2232,957,186,2,1275,548,541,1089,184
2024-04-20,LP,Portugal,2442,1147,167,0,1295,563,565,1128,167
2024-04-21,LP,Portugal,2286,1009,171,0,1277,554,552,1106,171
2024-04-22,LP,Portugal,2207,934,184,1,1273,541,548,1089,183
2024-04-23,LP,Portugal,2215,1011,169,2,1204,515,520,1035,167
2024-04-24,LP,Portugal,2158,949,181,1,1209,512,516,1028,180
2024-04-25,LP,Portugal,2114,949,180,0,1165,495,490,985,180
2024-04-26,LP,Portugal,2217,939,179,1,1278,554,545,1099,178
2024-04-27,LP,Portugal,2452,1137,175,1,1315,569,571,1140,174
2024-04-28,LP,Portugal,2304,995,176,0,1309,574,559,1133,176
2024-04-29,LP,Portugal,2165,894,184,1,1271,530,557,1087,183
2024-04-30,LP,Portugal,2206,970,173,1,1236,536,527,1063,172
2024-05-01,LP,Portugal,2125,919,165,2,1206,521,520,1041,163
2024-05-02,LP,Portugal,2337,1047,181,2,1290,557,552,1109,179
2024-05-03,LP,Portugal,2275,978,193,2,1297,552,552,1104,191
2024-05-04,LP,Portugal,2388,1042,180,1,1346,584,582,1166,179
2024-05-05,LP,Portugal,2241,927,181,1,1314,564,569,1133,180
2024-05-06,LP,Portugal,2250,929,184,0,1321,564,573,1137,184
2024-05-07,LP,Portugal,2178,898,182,8,1280,547,551,1098,174
2024-05-08,LP,Portugal,2103,839,182,6,1264,536,546,1082,176
2024-05-09,LP,Portugal,2205,898,188,8,1307,560,559,1119,180
2024-05-10,LP,Portugal,2235,898,198,6,1337,576,563,1139,192
2024-05-11,LP,Portugal,2375,1020,186,4,1355,585,584,1169,182
2024-05-12,LP,Portugal,2212,863,178,2,1349,596,575,1171,176
2024-05-13,LP,Portugal,2111,838,181,4,1273,541,551,1092,177
2024-05-14,LP,Portugal,2147,900,169,3,1247,533,545,1078,166
2024-05-15,LP,Portugal,2136,877,181,0,1259,542,536,1078,181
2024-05-16,LP,Portugal,2227,915,182,3,1312,570,560,1130,179
2024-05-17,LP,Portugal,2141,844,181,0,1297,555,561,1116,181
2024-05-18,LP,Portugal,2369,1031,171,0,1338,580,587,1167,171
2024-05-19,LP,Portugal,2225,905,171,0,1320,577,572,1149,171
2024-05-20,LP,Portugal,2214,873,186,1,1341,570,585,1155,185
2024-05-21,LP,Portugal,2140,886,168,0,1254,544,542,1086,168
2024-05-22,LP,Portugal,2148,882,167,0,1266,549,550,1099,167
2024-05-23,LP,Portugal,2123,792,189,0,1331,576,566,1142,189
2024-05-24,LP,Portugal,2113,777,186,0,1336,570,580,1150,186
2024-05-25,LP,Portugal,2299,952,173,1,1347,581,593,1174,172
2024-05-26,LP,Portugal,2200,839,194,2,1361,584,583,1167,192
2024-05-27,LP,Portugal,2108,759,188,4,1349,584,577,1161,184
2024-05-28,LP,Portugal,2079,806,173,0,1273,547,553,1100,173
2024-05-29,LP,Portugal,2055,788,175,3,1267,545,547,1092,172
2024-05-30,LP,Portugal,2204,852,189,5,1352,582,581,1163,184
2024-05-31,LP,Portugal,2192,832,198,6,1360,583,579,1162,192
2024-06-01,LP,Portugal,2459,1005,194,6,1454,631,629,1260,188
2024-06-02,LP,Portugal,2214,827,191,0,1387,600,596,1196,191
2024-06-03,LP,Portugal,2199,810,199,0,1389,595,595,1190,199
2024-06-04,LP,Portugal,2077,780,162,4,1297,567,568,1135,158
2024-06-05,LP,Portugal,2087,786,184,0,1301,560,557,1117,184
2024-06-06,LP,Portugal,2272,869,200,1,1403,609,594,1203,199
2024-06-07,LP,Portugal,2250,829,241,3,1421,585,595,1180,238
2024-06-08,LP,Portugal,2484,1049,206,0,1435,617,612,1229,206
2024-06-09,LP,Portugal,2291,902,209,1,1389,595,585,1180,208
2024-06-10,LP,Portugal,2275,876,211,1,1399,586,602,1188,210
2024-06-11,LP,Portugal,2219,864,206,1,1355,576,573,1149,205
2024-06-12,LP,Portugal,2265,926,207,1,1339,572,560,1132,206
2024-06-13,LP,Portugal,2367,939,203,1,1428,616,609,1225,202
2024-06-14,LP,Portugal,2226,836,229,0,1390,575,586,1161,229
2024-06-15,LP,Portugal,2392,934,209,3,1458,624,625,1249,206
2024-06-16,LP,Portugal,2315,880,219,0,1435,610,606,1216,219
2024-06-17,LP,Portugal,2281,849,212,0,1432,611,609,1220,212
2024-06-18,LP,Portugal,2263,908,204,2,1355,571,580,1151,202
2024-06-19,LP,Portugal,2328,985,214,1,1343,564,565,1129,213
2024-06-20,LP,Portugal,2553,1142,213,3,1411,600,598,1198,210
2024-06-21,LP,Portugal,2477,1082,228,3,1395,588,579,1167,225
2024-06-22,LP,Portugal,2537,1057,214,1,1480,629,637,1266,213
2024-06-23,LP,Portugal,2354,964,213,0,1390,589,588,1177,213
2024-06-24,LP,Portugal,2384,939,221,3,1445,610,614,1224,218
2024-06-25,LP,Portugal,2390,978,218,7,1412,596,598,1194,211
2024-06-26,LP,Portugal,2338,983,221,6,1355,565,569,1134,215
2024-06-27,LP,Portugal,2472,1022,217,8,1450,613,620,1233,209
2024-06-28,LP,Portugal,2355,937,223,8,1418,597,598,1195,215
2024-06-29,LP,Portugal,2566,1087,219,6,1479,634,626,1260,213
2024-06-30,LP,Portugal,2628,1190,222,8,1438,617,599,1216,214
2024-07-01,LP,Portugal,2555,1087,222,9,1468,616,630,1246,213
2024-07-02,LP,Portugal,2518,1087,218,7,1431,606,607,1213,211
2024-07-03,LP,Portugal,2446,1035,217,3,1411,604,590,1194,214
2024-07-04,LP,Portugal,2558,1084,224,3,1474,626,624,1250,221
2024-07-05,LP,Portugal,2423,989,221,2,1434,607,606,1213,219
2024-07-06,LP,Portugal,2700,1197,214,1,1503,641,648,1289,213
2024-07-07,LP,Portugal,2525,1039,215,1,1486,643,628,1271,214
2024-07-08,LP,Portugal,2411,965,204,4,1446,615,627,1242,200
2024-07-09,LP,Portugal,2344,926,208,6,1418,608,602,1210,202
2024-07-10,LP,Portugal,2298,909,220,3,1389,591,578,1169,217
2024-07-11,LP,Portugal,2402,965,214,0,1437,603,620,1223,214
2024-07-12,LP,Portugal,2348,909,224,4,1439,611,604,1215,220
2024-07-13,LP,Portugal,2553,1057,209,3,1496,642,645,1287,206
2024-07-14,LP,Portugal,2430,968,226,4,1462,624,612,1236,222
2024-07-15,LP,Portugal,2367,920,207,0,1447,613,627,1240,207
2024-07-16,LP,Portugal,2380,947,206,2,1433,614,613,1227,204
2024-07-17,LP,Portugal,2399,975,219,3,1424,604,601,1205,216
2024-07-18,LP,Portugal,2520,1049,222,1,1471,625,624,1249,221
2024-07-19,LP,Portugal,2331,907,230,1,1424,599,595,1194,229
2024-07-20,LP,Portugal,2591,1100,194,1,1491,644,653,1297,193
2024-07-21,LP,Portugal,2485,1020,233,1,1465,626,606,1232,232
2024-07-22,LP,Portugal,2461,1002,215,0,1459,617,627,1244,215
2024-07-23,LP,Portugal,2477,1024,212,2,1453,612,629,1241,210
2024-07-24,LP,Portugal,2385,987,217,2,1398,603,578,1181,215
2024-07-25,LP,Portugal,2512,1053,213,3,1459,617,629,1246,210
2024-07-26,LP,Portugal,2306,901,223,1,1405,591,591,1182,222
2024-07-27,LP,Portugal,2534,1017,227,2,1517,645,645,1290,225
2024-07-28,LP,Portugal,2472,989,226,2,1483,629,628,1257,224
2024-07-29,LP,Portugal,2467,1000,220,1,1467,618,629,1247,219
2024-07-30,LP,Portugal,2413,968,212,0,1445,613,620,1233,212
2024-01-01,LR,Romania,1675,1297,13,4,378,180,185,365,9
2024-01-02,LR,Romania,1794,1361,30,4,433,201,202,403,26
2024-01-03,LR,Romania,1920,1412,50,9,508,226,232,458,41
2024-01-04,LR,Romania,1955,1452,50,7,503,226,227,453,43
2024-01-05,LR,Romania,2011,1498,52,5,513,228,233,461,47
2024-01-06,LR,Romania,1970,1538,26,4,432,204,202,406,22
2024-01-07,LR,Romania,2031,1541,35,4,490,224,231,455,31
2024-01-08,LR,Romania,1917,1414,48,0,503,226,229,455,48
2024-01-09,LR,Romania,1838,1392,55,8,446,199,192,391,47
2024-01-10,LR,Romania,1889,1406,57,9,483,209,217,426,48
2024-01-11,LR,Romania,1879,1424,65,6,455,198,192,390,59
2024-01-12,LR,Romania,1940,1436,69,8,504,218,217,435,61
2024-01-13,LR,Romania,1853,1451,30,7,402,190,182,372,23
2024-01-14,LR,Romania,1882,1437,33,5,445,204,208,412,28
2024-01-15,LR,Romania,1850,1343,60,11,507,221,226,447,49
2024-01-16,LR,Romania,1705,1297,59,14,408,177,172,349,45
2024-01-17,LR,Romania,1697,1256,70,10,441,183,188,371,60
2024-01-18,LR,Romania,1815,1380,68,11,435,185,182,367,57
2024-01-19,LR,Romania,1908,1418,72,7,490,206,212,418,65
2024-01-20,LR,Romania,1829,1467,26,4,362,171,165,336,22
2024-01-21,LR,Romania,1854,1422,43,7,432,193,196,389,36
2024-01-22,LR,Romania,1810,1334,69,9,476,205,202,407,60
2024-01-23,LR,Romania,1728,1318,64,6,410,173,173,346,58
2024-01-24,LR,Romania,1732,1334,42,2,398,179,177,356,40
2024-01-25,LR,Romania,1855,1419,92,20,436,172,172,344,72
2024-01-26,LR,Romania,1833,1362,74,11,471,202,195,397,63
2024-01-27,LR,Romania,1753,1390,28,4,363,170,165,335,24
2024-01-28,LR,Romania,1873,1449,32,5,424,193,199,392,27
2024-01-29,LR,Romania,1741,1268,78,9,473,193,202,395,69
2024-01-30,LR,Romania,1767,1346,73,15,421,175,173,348,58
2024-01-31,LR,Romania,1767,1312,78,14,455,189,188,377,64
2024-02-01,LR,Romania,1709,1288,72,11,421,175,174,349,61
2024-02-02,LR,Romania,1853,1398,56,7,455,200,199,399,49
2024-02-03,LR,Romania,1776,1423,25,4,353,164,164,328,21
2024-02-04,LR,Romania,1838,1430,32,7,408,186,190,376,25
2024-02-05,LR,Romania,1728,1279,65,8,449,190,194,384,57
2024-02-06,LR,Romania,1711,1308,61,14,403,174,168,342,47
2024-02-07,LR,Romania,1745,1316,73,7,429,174,182,356,66
2024-02-08,LR,Romania,1858,1427,80,10,431,178,173,351,70
2024-02-09,LR,Romania,1899,1406,73,13,493,211,209,420,60
2024-02-10,LR,Romania,1795,1424,37,9,371,165,169,334,28
2024-02-11,LR,Romania,1831,1409,39,9,422,192,191,383,30
2024-02-12,LR,Romania,1748,1274,61,10,474,207,206,413,51
2024-02-13,LR,Romania,1723,1299,80,11,424,171,173,344,69
2024-02-14,LR,Romania,1781,1315,85,16,466,185,196,381,69
2024-02-15,LR,Romania,1839,1379,93,17,460,188,179,367,76
2024-02-16,LR,Romania,1909,1410,79,14,499,211,209,420,65
2024-02-17,LR,Romania,1855,1456,37,6,399,186,176,362,31
2024-02-18,LR,Romania,1924,1485,32,4,439,200,207,407,28
2024-02-19,LR,Romania,1771,1297,65,16,474,203,206,409,49
2024-02-20,LR,Romania,1710,1307,77,14,403,166,160,326,63
2024-02-21,LR,Romania,1783,1339,79,12,444,179,186,365,67
2024-02-22,LR,Romania,1842,1420,64,7,422,181,177,358,57
2024-02-23,LR,Romania,1936,1436,76,12,500,209,215,424,64
2024-02-24,LR,Romania,1873,1469,37,8,404,184,183,367,29
2024-02-25,LR,Romania,1912,1489,32,5,423,195,196,391,27
2024-02-26,LR,Romania,1819,1327,73,17,492,207,212,419,56
2024-02-27,LR,Romania,1844,1381,82,19,463,192,189,381,63
2024-02-28,LR,Romania,1816,1373,79,14,443,179,185,364,65
2024-02-29,LR,Romania,1894,1426,87,8,468,189,192,381,79
2024-03-01,LR,Romania,1927,1434,77,13,493,210,206,416,64
2024-03-02,LR,Romania,1905,1510,30,7,395,181,184,365,23
2024-03-03,LR,Romania,1971,1548,36,7,423,194,193,387,29
2024-03-04,LR,Romania,1820,1320,74,15,500,212,214,426,59
2024-03-05,LR,Romania,1777,1345,75,11,432,180,177,357,64
2024-03-06,LR,Romania,1877,1399,74,12,478,197,207,404,62
2024-03-07,LR,Romania,1812,1381,80,11,431,180,171,351,69
2024-03-08,LR,Romania,1890,1426,74,12,464,198,192,390,62
2024-03-09,LR,Romania,1852,1463,35,7,389,176,178,354,28
2024-03-10,LR,Romania,1937,1498,40,9,439,197,202,399,31
2024-03-11,LR,Romania,1820,1330,62,12,490,210,218,428,50
2024-03-12,LR,Romania,1795,1358,73,7,437,183,181,364,66
2024-03-13,LR,Romania,1806,1360,83,5,446,182,181,363,78
2024-03-14,LR,Romania,1885,1406,105,17,479,190,184,374,88
2024-03-15,LR,Romania,1971,1463,77,15,508,212,219,431,62
2024-03-16,LR,Romania,1924,1528,36,10,396,181,179,360,26
2024-03-17,LR,Romania,1973,1536,36,5,437,202,199,401,31
2024-03-18,LR,Romania,1855,1369,70,13,486,207,209,416,57
2024-03-19,LR,Romania,1754,1311,73,10,443,183,187,370,63
2024-03-20,LR,Romania,1942,1446,75,19,496,209,212,421,56
2024-03-21,LR,Romania,1956,1492,81,12,464,190,193,383,69
2024-03-22,LR,Romania,2039,1548,75,13,491,208,208,416,62
2024-03-23,LR,Romania,1987,1577,37,9,410,188,185,373,28
2024-03-24,LR,Romania,1981,1545,36,10,436,202,198,400,26
2024-03-25,LR,Romania,1869,1376,54,7,493,215,224,439,47
2024-03-26,LR,Romania,1906,1453,81,13,453,187,185,372,68
2024-03-27,LR,Romania,2063,1575,74,10,488,206,208,414,64
2024-03-28,LR,Romania,2071,1606,73,10,465,197,195,392,63
2024-03-29,LR,Romania,2089,1555,90,14,534,220,224,444,76
2024-03-30,LR,Romania,2045,1635,42,9,410,189,179,368,33
2024-03-31,LR,Romania,2134,1648,54,9,486,209,223,432,45
2024-04-01,LR,Romania,2026,1488,93,21,538,225,220,445,72
2024-04-02,LR,Romania,2011,1519,63,5,492,214,215,429,58
2024-04-03,LR,Romania,2080,1577,74,12,503,212,217,429,62
2024-04-04,LR,Romania,2080,1574,79,20,506,217,210,427,59
2024-04-05,LR,Romania,2123,1578,84,14,545,231,230,461,70
2024-04-06,LR,Romania,2073,1646,34,7,427,200,193,393,27
2024-04-07,LR,Romania,2027,1542,43,6,485,218,224,442,37
2024-04-08,LR,Romania,1957,1448,74,20,509,213,222,435,54
2024-04-09,LR,Romania,1954,1460,68,18,494,215,211,426,50
2024-04-10,LR,Romania,1978,1478,66,9,500,215,219,434,57
2024-04-11,LR,Romania,2050,1527,72,15,523,226,225,451,57
2024-04-12,LR,Romania,2043,1498,72,12,545,236,237,473,60
2024-04-13,LR,Romania,2053,1632,31,8,421,198,192,390,23
2024-04-14,LR,Romania,1822,1345,37,8,477,217,223,440,29
2024-04-15,LR,Romania,1922,1383,72,15,539,230,237,467,57
2024-04-16,LR,Romania,1993,1495,70,11,498,215,213,428,59
2024-04-17,LR,Romania,1959,1466,53,4,493,221,219,440,49
2024-04-18,LR,Romania,2028,1497,70,13,531,232,229,461,57
2024-04-19,LR,Romania,1975,1398,69,9,577,252,256,508,60
2024-04-20,LR,Romania,2017,1550,33,9,467,221,213,434,24
2024-04-21,LR,Romania,2021,1538,34,7,483,225,224,449,27
2024-04-22,LR,Romania,1914,1402,60,10,512,223,229,452,50
2024-04-23,LR,Romania,1900,1419,42,4,481,222,217,439,38
2024-04-24,LR,Romania,2075,1527,67,10,548,240,241,481,57
2024-04-25,LR,Romania,2082,1561,53,8,521,232,236,468,45
2024-04-26,LR,Romania,2289,1696,70,12,593,261,262,523,58
2024-04-27,LR,Romania,2366,1874,33,5,492,232,227,459,28
2024-04-28,LR,Romania,2301,1804,41,8,497,226,230,456,33
2024-04-29,LR,Romania,2032,1515,56,12,517,233,228,461,44
2024-04-30,LR,Romania,2133,1608,53,11,525,242,230,472,42
2024-05-01,LR,Romania,2158,1658,39,10,500,227,234,461,29
2024-05-02,LR,Romania,2150,1658,44,8,492,224,224,448,36
2024-05-03,LR,Romania,2209,1687,33,6,522,244,245,489,27
2024-05-04,LR,Romania,2309,1841,21,7,468,223,224,447,14
2024-05-05,LR,Romania,2317,1846,13,4,471,231,227,458,9
2024-05-06,LR,Romania,2037,1535,38,8,502,228,236,464,30
2024-05-07,LR,Romania,2211,1686,57,6,525,236,232,468,51
2024-05-08,LR,Romania,2273,1729,62,8,544,241,241,482,54
2024-05-09,LR,Romania,2299,1758,65,11,541,240,236,476,54
2024-05-10,LR,Romania,2360,1764,77,9,596,258,261,519,68
2024-05-11,LR,Romania,2482,1988,37,9,494,231,226,457,28
2024-05-12,LR,Romania,2373,1873,40,6,500,226,234,460,34
2024-05-13,LR,Romania,2223,1690,66,12,533,235,232,467,54
2024-05-14,LR,Romania,2330,1777,80,14,553,235,238,473,66
2024-05-15,LR,Romania,2358,1783,72,12,575,252,251,503,60
2024-05-16,LR,Romania,2414,1868,75,16,546,236,235,471,59
2024-05-17,LR,Romania,2483,1895,67,7,588,258,263,521,60
2024-05-18,LR,Romania,2509,2034,33,7,475,227,215,442,26
2024-05-19,LR,Romania,2498,2004,33,4,494,226,235,461,29
2024-05-20,LR,Romania,2228,1686,60,11,542,243,239,482,49
2024-05-21,LR,Romania,2372,1838,70,14,534,228,236,464,56
2024-05-22,LR,Romania,2364,1822,71,10,542,237,234,471,61
2024-05-23,LR,Romania,2373,1826,67,8,547,240,240,480,59
2024-05-24,LR,Romania,2406,1848,67,10,558,248,243,491,57
2024-05-25,LR,Romania,2600,2109,40,6,491,227,224,451,34
2024-05-26,LR,Romania,2540,2044,38,8,496,228,230,458,30
2024-05-27,LR,Romania,2348,1791,75,21,557,240,242,482,54
2024-05-28,LR,Romania,2349,1835,68,11,514,219,227,446,57
2024-05-29,LR,Romania,2540,1969,75,11,571,248,248,496,64
2024-05-30,LR,Romania,2519,1971,67,9,548,244,237,481,58
2024-05-31,LR,Romania,2446,1863,68,9,583,252,263,515,59
2024-06-01,LR,Romania,2713,2189,31,3,524,253,240,493,28
2024-06-02,LR,Romania,2663,2125,39,7,538,244,255,499,32
2024-06-03,LR,Romania,2581,1980,65,10,601,265,271,536,55
2024-06-04,LR,Romania,2423,1868,64,8,555,246,245,491,56
2024-06-05,LR,Romania,2636,2052,66,14,584,256,262,518,52
2024-06-06,LR,Romania,2472,1893,73,15,579,255,251,506,58
2024-06-07,LR,Romania,2604,1967,73,11,637,281,283,564,62
2024-06-08,LR,Romania,2724,2184,35,4,540,257,248,505,31
2024-06-09,LR,Romania,2609,2070,32,1,539,254,253,507,31
2024-06-10,LR,Romania,2539,1882,66,10,657,291,300,591,56
2024-06-11,LR,Romania,2663,2058,72,13,605,268,265,533,59
2024-06-12,LR,Romania,2716,2101,87,17,615,265,263,528,70
2024-06-13,LR,Romania,2596,1954,73,8,642,281,288,569,65
2024-06-14,LR,Romania,2598,1964,73,10,634,285,276,561,63
2024-06-15,LR,Romania,2722,2166,40,6,556,264,252,516,34
2024-06-16,LR,Romania,2749,2173,49,12,576,256,271,527,37
2024-06-17,LR,Romania,2596,1930,64,9,666,302,300,602,55
2024-06-18,LR,Romania,2565,1924,66,14,641,285,290,575,52
2024-06-19,LR,Romania,2663,2028,78,15,635,283,274,557,63
2024-06-20,LR,Romania,2614,1986,68,11,628,280,280,560,57
2024-06-21,LR,Romania,2696,2054,66,9,642,289,287,576,57
2024-06-22,LR,Romania,2688,2150,30,4,538,254,254,508,26
2024-06-23,LR,Romania,2792,2232,32,3,560,260,268,528,29
2024-06-24,LR,Romania,2617,1992,56,6,625,284,285,569,50
2024-06-25,LR,Romania,2788,2169,66,11,619,278,275,553,55
2024-06-26,LR,Romania,2763,2156,68,13,607,269,270,539,55
2024-06-27,LR,Romania,2741,2078,73,15,663,296,294,590,58
2024-06-28,LR,Romania,2672,2014,64,9,658,299,295,594,55
2024-06-29,LR,Romania,2597,2054,32,3,543,258,253,511,29
2024-06-30,LR,Romania,2675,2096,40,5,579,264,275,539,35
2024-07-01,LR,Romania,2680,2039,63,6,641,290,288,578,57
2024-07-02,LR,Romania,2655,2023,63,9,632,289,280,569,54
2024-07-03,LR,Romania,2648,1972,71,7,676,295,310,605,64
2024-07-04,LR,Romania,2704,2032,77,10,672,296,299,595,67
2024-07-05,LR,Romania,2681,2032,72,9,649,286,291,577,63
2024-07-06,LR,Romania,2708,2142,40,9,566,265,261,526,31
2024-07-07,LR,Romania,2711,2102,51,7,609,275,283,558,44
2024-07-08,LR,Romania,2544,1943,42,8,601,281,278,559,34
2024-07-09,LR,Romania,2662,2018,68,9,644,294,282,576,59
2024-07-10,LR,Romania,2615,1973,70,11,642,279,293,572,59
2024-07-11,LR,Romania,2642,2001,60,4,641,295,286,581,56
2024-07-12,LR,Romania,2719,2089,67,10,630,278,285,563,57
2024-07-13,LR,Romania,2653,2085,40,5,568,270,258,528,35
2024-07-14,LR,Romania,2666,2061,43,3,605,276,286,562,40
2024-07-15,LR,Romania,2665,1985,66,8,680,309,305,614,58
2024-07-16,LR,Romania,2610,1997,65,11,613,276,272,548,54
2024-07-17,LR,Romania,2668,2040,56,6,628,280,292,572,50
2024-07-18,LR,Romania,2709,2072,59,7,637,291,287,578,52
2024-07-19,LR,Romania,2676,2094,65,5,582,264,253,517,60
2024-07-20,LR,Romania,2877,2311,43,5,566,264,259,523,38
2024-07-21,LR,Romania,2624,2061,38,2,563,255,270,525,36
2024-07-22,LR,Romania,2674,2020,63,7,654,298,293,591,56
2024-07-23,LR,Romania,2607,1973,75,15,634,280,279,559,60
2024-07-24,LR,Romania,2766,2129,63,6,637,288,286,574,57
2024-07-25,LR,Romania,2665,2016,75,9,649,287,287,574,66
2024-07-26,LR,Romania,2799,2173,64,13,626,284,278,562,51
2024-07-27,LR,Romania,2706,2149,28,8,557,267,262,529,20
2024-07-28,LR,Romania,2701,2126,34,4,575,267,274,541,30
2024-07-29,LR,Romania,2674,2015,62,11,659,296,301,597,51
2024-07-30,LR,Romania,2695,2064,61,5,631,282,288,570,56
2024-01-01,LY,Serbia & Montenegro,1715,1437,17,0,278,130,131,261,17
2024-01-02,LY,Serbia & Montenegro,1913,1662,19,0,251,112,120,232,19
2024-01-03,LY,Serbia & Montenegro,1886,1627,22,0,259,122,115,237,22
2024-01-04,LY,Serbia & Montenegro,1884,1639,20,0,245,114,111,225,20
2024-01-05,LY,Serbia & Montenegro,2013,1711,16,0,302,139,147,286,16
2024-01-06,LY,Serbia & Montenegro,2147,1894,20,0,253,119,114,233,20
2024-01-07,LY,Serbia & Montenegro,2088,1832,19,0,256,118,119,237,19
2024-01-08,LY,Serbia & Montenegro,1795,1515,18,3,280,130,132,262,15
2024-01-09,LY,Serbia & Montenegro,1606,1354,18,0,252,117,117,234,18
2024-01-10,LY,Serbia & Montenegro,1635,1403,20,0,232,109,103,212,20
2024-01-11,LY,Serbia & Montenegro,1647,1413,17,0,234,107,110,217,17
2024-01-12,LY,Serbia & Montenegro,1794,1505,16,0,289,136,137,273,16
2024-01-13,LY,Serbia & Montenegro,1825,1587,21,1,238,109,108,217,20
2024-01-14,LY,Serbia & Montenegro,1862,1618,18,0,244,112,114,226,18
2024-01-15,LY,Serbia & Montenegro,1641,1365,15,1,276,129,132,261,14
2024-01-16,LY,Serbia & Montenegro,1436,1210,19,1,226,102,105,207,18
2024-01-17,LY,Serbia & Montenegro,1477,1268,21,1,209,96,92,188,20
2024-01-18,LY,Serbia & Montenegro,1569,1347,15,1,222,108,99,207,14
2024-01-19,LY,Serbia & Montenegro,1712,1442,15,1,270,126,129,255,14
2024-01-20,LY,Serbia & Montenegro,1741,1520,19,1,221,101,101,202,18
2024-01-21,LY,Serbia & Montenegro,1800,1595,19,0,205,98,88,186,19
2024-01-22,LY,Serbia & Montenegro,1606,1317,16,1,289,131,142,273,15
2024-01-23,LY,Serbia & Montenegro,1394,1199,20,1,195,87,88,175,19
2024-01-24,LY,Serbia & Montenegro,1491,1298,22,2,193,85,86,171,20
2024-01-25,LY,Serbia & Montenegro,1480,1263,21,1,217,97,99,196,20
2024-01-26,LY,Serbia & Montenegro,1707,1432,16,2,275,128,131,259,14
2024-01-27,LY,Serbia & Montenegro,1729,1512,20,0,217,98,99,197,20
2024-01-28,LY,Serbia & Montenegro,1753,1507,18,0,246,113,115,228,18
2024-01-29,LY,Serbia & Montenegro,1541,1274,15,0,267,125,127,252,15
2024-01-30,LY,Serbia & Montenegro,1393,1187,23,4,206,93,90,183,19
2024-01-31,LY,Serbia & Montenegro,1518,1301,23,0,217,98,96,194,23
2024-02-01,LY,Serbia & Montenegro,1509,1286,18,2,223,104,101,205,16
2024-02-02,LY,Serbia & Montenegro,1749,1497,16,2,252,118,118,236,14
2024-02-03,LY,Serbia & Montenegro,1779,1563,26,3,216,95,95,190,23
2024-02-04,LY,Serbia & Montenegro,1773,1550,18,0,223,101,104,205,18
2024-02-05,LY,Serbia & Montenegro,1628,1383,15,0,245,115,115,230,15
2024-02-06,LY,Serbia & Montenegro,1407,1219,16,3,188,86,86,172,13
2024-02-07,LY,Serbia & Montenegro,1439,1242,20,1,197,89,88,177,19
2024-02-08,LY,Serbia & Montenegro,1592,1385,16,1,207,96,95,191,15
2024-02-09,LY,Serbia & Montenegro,1764,1504,15,2,260,123,122,245,13
2024-02-10,LY,Serbia & Montenegro,1925,1723,16,0,202,91,95,186,16
2024-02-11,LY,Serbia & Montenegro,1856,1637,16,0,219,104,99,203,16
2024-02-12,LY,Serbia & Montenegro,1640,1380,16,1,260,124,120,244,15
2024-02-13,LY,Serbia & Montenegro,1470,1284,16,0,186,80,90,170,16
2024-02-14,LY,Serbia & Montenegro,1576,1353,29,4,223,100,94,194,25
2024-02-15,LY,Serbia & Montenegro,1684,1473,21,1,211,95,95,190,20
2024-02-16,LY,Serbia & Montenegro,1765,1507,18,1,258,121,119,240,17
2024-02-17,LY,Serbia & Montenegro,1878,1657,22,1,221,102,97,199,21
2024-02-18,LY,Serbia & Montenegro,1884,1651,24,2,233,101,108,209,22
2024-02-19,LY,Serbia & Montenegro,1693,1421,23,3,272,126,123,249,20
2024-02-20,LY,Serbia & Montenegro,1499,1301,15,1,198,90,93,183,14
2024-02-21,LY,Serbia & Montenegro,1608,1405,21,2,203,91,91,182,19
2024-02-22,LY,Serbia & Montenegro,1621,1403,18,4,218,103,97,200,14
2024-02-23,LY,Serbia & Montenegro,1783,1525,20,3,258,117,121,238,17
2024-02-24,LY,Serbia & Montenegro,1837,1629,16,1,208,93,99,192,15
2024-02-25,LY,Serbia & Montenegro,1901,1677,17,1,224,105,102,207,16
2024-02-26,LY,Serbia & Montenegro,1603,1357,15,0,246,112,119,231,15
2024-02-27,LY,Serbia & Montenegro,1517,1322,10,0,195,90,95,185,10
2024-02-28,LY,Serbia & Montenegro,1584,1386,13,0,198,97,88,185,13
2024-02-29,LY,Serbia & Montenegro,1720,1505,18,1,215,96,101,197,17
2024-03-01,LY,Serbia & Montenegro,1802,1547,18,2,255,121,116,237,16
2024-03-02,LY,Serbia & Montenegro,1889,1672,17,0,217,98,102,200,17
2024-03-03,LY,Serbia & Montenegro,1882,1650,20,2,232,108,104,212,18
2024-03-04,LY,Serbia & Montenegro,1681,1424,18,1,257,118,121,239,17
2024-03-05,LY,Serbia & Montenegro,1564,1356,22,6,208,92,94,186,16
2024-03-06,LY,Serbia & Montenegro,1660,1449,23,3,211,95,93,188,20
2024-03-07,LY,Serbia & Montenegro,1616,1399,14,0,217,104,99,203,14
2024-03-08,LY,Serbia & Montenegro,1798,1558,16,0,240,111,113,224,16
2024-03-09,LY,Serbia & Montenegro,1880,1669,23,3,211,95,93,188,20
2024-03-10,LY,Serbia & Montenegro,1952,1726,27,7,226,97,102,199,20
2024-03-11,LY,Serbia & Montenegro,1730,1481,15,0,249,117,117,234,15
2024-03-12,LY,Serbia & Montenegro,1558,1357,22,6,201,88,91,179,16
2024-03-13,LY,Serbia & Montenegro,1617,1400,24,4,217,97,96,193,20
2024-03-14,LY,Serbia & Montenegro,1648,1418,16,0,230,106,108,214,16
2024-03-15,LY,Serbia & Montenegro,1904,1621,23,7,283,133,127,260,16
2024-03-16,LY,Serbia & Montenegro,1934,1704,24,5,230,101,105,206,19
2024-03-17,LY,Serbia & Montenegro,1960,1734,23,4,226,105,98,203,19
2024-03-18,LY,Serbia & Montenegro,1775,1501,20,4,274,123,131,254,16
2024-03-19,LY,Serbia & Montenegro,1693,1487,22,7,206,90,94,184,15
2024-03-20,LY,Serbia & Montenegro,1728,1510,25,4,218,99,94,193,21
2024-03-21,LY,Serbia & Montenegro,1688,1452,19,2,236,110,107,217,17
2024-03-22,LY,Serbia & Montenegro,1968,1702,20,6,266,121,125,246,14
2024-03-23,LY,Serbia & Montenegro,2119,1894,24,1,225,100,101,201,23
2024-03-24,LY,Serbia & Montenegro,2115,1884,19,1,231,106,106,212,18
2024-03-25,LY,Serbia & Montenegro,1913,1636,19,3,277,127,131,258,16
2024-03-26,LY,Serbia & Montenegro,1812,1595,21,4,217,97,99,196,17
2024-03-27,LY,Serbia & Montenegro,1817,1598,22,2,219,101,96,197,20
2024-03-28,LY,Serbia & Montenegro,1881,1652,18,0,229,108,103,211,18
2024-03-29,LY,Serbia & Montenegro,2138,1877,22,5,261,114,125,239,17
2024-03-30,LY,Serbia & Montenegro,2145,1936,19,0,209,93,97,190,19
2024-03-31,LY,Serbia & Montenegro,2458,2209,22,1,249,117,110,227,21
2024-04-01,LY,Serbia & Montenegro,2221,1925,23,1,296,135,138,273,22
2024-04-02,LY,Serbia & Montenegro,2154,1934,21,0,220,99,100,199,21
2024-04-03,LY,Serbia & Montenegro,2123,1895,21,1,228,105,102,207,20
2024-04-04,LY,Serbia & Montenegro,2177,1922,20,1,255,118,117,235,19
2024-04-05,LY,Serbia & Montenegro,2412,2107,24,1,305,142,139,281,23
2024-04-06,LY,Serbia & Montenegro,2642,2382,23,1,260,114,123,237,22
2024-04-07,LY,Serbia & Montenegro,2615,2345,23,0,270,127,120,247,23
2024-04-08,LY,Serbia & Montenegro,2294,1997,26,2,297,134,137,271,24
2024-04-09,LY,Serbia & Montenegro,2223,1978,24,2,245,108,113,221,22
2024-04-10,LY,Serbia & Montenegro,2250,2007,29,6,243,109,105,214,23
2024-04-11,LY,Serbia & Montenegro,2248,1972,22,6,276,128,126,254,16
2024-04-12,LY,Serbia & Montenegro,2449,2161,25,4,288,132,131,263,21
2024-04-13,LY,Serbia & Montenegro,2636,2385,24,1,251,112,115,227,23
2024-04-14,LY,Serbia & Montenegro,2557,2289,20,0,268,123,125,248,20
2024-04-15,LY,Serbia & Montenegro,2345,2022,22,3,323,150,151,301,19
2024-04-16,LY,Serbia & Montenegro,2172,1944,21,0,228,104,103,207,21
2024-04-17,LY,Serbia & Montenegro,2213,1972,22,1,241,110,109,219,21
2024-04-18,LY,Serbia & Montenegro,2309,2047,17,1,262,125,120,245,16
2024-04-19,LY,Serbia & Montenegro,2620,2309,26,4,311,143,142,285,22
2024-04-20,LY,Serbia & Montenegro,2787,2528,26,0,259,111,122,233,26
2024-04-21,LY,Serbia & Montenegro,2758,2486,23,0,272,127,122,249,23
2024-04-22,LY,Serbia & Montenegro,2405,2099,25,2,306,137,144,281,23
2024-04-23,LY,Serbia & Montenegro,2300,2056,26,3,244,107,111,218,23
2024-04-24,LY,Serbia & Montenegro,2418,2181,21,1,237,113,103,216,20
2024-04-25,LY,Serbia & Montenegro,2405,2123,28,6,282,126,128,254,22
2024-04-26,LY,Serbia & Montenegro,2650,2311,33,7,339,153,153,306,26
2024-04-27,LY,Serbia & Montenegro,2901,2629,27,1,272,119,126,245,26
2024-04-28,LY,Serbia & Montenegro,2740,2453,23,0,287,137,127,264,23
2024-04-29,LY,Serbia & Montenegro,2498,2173,24,2,325,150,151,301,22
2024-04-30,LY,Serbia & Montenegro,2539,2252,28,1,287,127,132,259,27
2024-05-01,LY,Serbia & Montenegro,2650,2395,26,0,255,117,112,229,26
2024-05-02,LY,Serbia & Montenegro,2517,2248,23,1,269,125,121,246,22
2024-05-03,LY,Serbia & Montenegro,2854,2532,25,1,322,149,148,297,24
2024-05-04,LY,Serbia & Montenegro,3074,2788,24,0,286,129,133,262,24
2024-05-05,LY,Serbia & Montenegro,3071,2772,23,0,299,139,137,276,23
2024-05-06,LY,Serbia & Montenegro,2778,2446,24,0,332,155,153,308,24
2024-05-07,LY,Serbia & Montenegro,2685,2435,22,0,250,111,117,228,22
2024-05-08,LY,Serbia & Montenegro,2770,2517,23,3,253,116,114,230,20
2024-05-09,LY,Serbia & Montenegro,2697,2410,27,3,287,132,128,260,24
2024-05-10,LY,Serbia & Montenegro,2890,2558,24,2,332,156,152,308,22
2024-05-11,LY,Serbia & Montenegro,3130,2855,23,0,275,123,129,252,23
2024-05-12,LY,Serbia & Montenegro,3092,2780,20,0,312,145,147,292,20
2024-05-13,LY,Serbia & Montenegro,2768,2415,30,5,353,160,163,323,25
2024-05-14,LY,Serbia & Montenegro,2717,2431,31,9,286,126,129,255,22
2024-05-15,LY,Serbia & Montenegro,2699,2426,26,5,273,125,122,247,21
2024-05-16,LY,Serbia & Montenegro,2621,2313,24,0,308,144,140,284,24
2024-05-17,LY,Serbia & Montenegro,3057,2714,25,0,343,159,159,318,25
2024-05-18,LY,Serbia & Montenegro,3295,3009,25,3,286,126,135,261,22
2024-05-19,LY,Serbia & Montenegro,3107,2789,25,0,318,149,144,293,25
2024-05-20,LY,Serbia & Montenegro,2960,2593,29,8,367,166,172,338,21
2024-05-21,LY,Serbia & Montenegro,2742,2481,25,1,261,120,116,236,24
2024-05-22,LY,Serbia & Montenegro,2836,2546,24,4,290,133,133,266,20
2024-05-23,LY,Serbia & Montenegro,2890,2580,25,2,310,146,139,285,23
2024-05-24,LY,Serbia & Montenegro,3137,2792,28,2,345,157,160,317,26
2024-05-25,LY,Serbia & Montenegro,3257,2959,28,1,298,129,141,270,27
2024-05-26,LY,Serbia & Montenegro,3213,2873,23,0,340,165,152,317,23
2024-05-27,LY,Serbia & Montenegro,3062,2700,27,6,362,167,168,335,21
2024-05-28,LY,Serbia & Montenegro,2838,2535,27,6,303,137,139,276,21
2024-05-29,LY,Serbia & Montenegro,2955,2655,23,3,300,141,136,277,20
2024-05-30,LY,Serbia & Montenegro,3000,2670,27,5,330,151,152,303,22
2024-05-31,LY,Serbia & Montenegro,3238,2885,27,2,353,166,160,326,25
2024-06-01,LY,Serbia & Montenegro,3517,3209,21,1,308,137,150,287,20
2024-06-02,LY,Serbia & Montenegro,3417,3067,26,2,350,167,157,324,24
2024-06-03,LY,Serbia & Montenegro,2958,2600,24,1,358,164,170,334,23
2024-06-04,LY,Serbia & Montenegro,3167,2868,27,2,299,136,136,272,25
2024-06-05,LY,Serbia & Montenegro,3054,2747,32,7,307,138,137,275,25
2024-06-06,LY,Serbia & Montenegro,3104,2769,34,8,335,151,150,301,26
2024-06-07,LY,Serbia & Montenegro,3343,2963,31,7,380,178,171,349,24
2024-06-08,LY,Serbia & Montenegro,3453,3122,26,1,331,147,158,305,25
2024-06-09,LY,Serbia & Montenegro,3495,3138,29,0,357,166,162,328,29
2024-06-10,LY,Serbia & Montenegro,3334,2946,27,5,388,179,182,361,22
2024-06-11,LY,Serbia & Montenegro,3043,2714,34,4,329,147,148,295,30
2024-06-12,LY,Serbia & Montenegro,3091,2767,28,5,324,150,146,296,23
2024-06-13,LY,Serbia & Montenegro,3107,2739,27,5,368,167,174,341,22
2024-06-14,LY,Serbia & Montenegro,3424,3031,30,6,393,183,180,363,24
2024-06-15,LY,Serbia & Montenegro,3740,3375,26,0,365,167,172,339,26
2024-06-16,LY,Serbia & Montenegro,3599,3235,28,2,364,171,165,336,26
2024-06-17,LY,Serbia & Montenegro,3291,2900,32,6,391,173,186,359,26
2024-06-18,LY,Serbia & Montenegro,3286,2943,33,5,343,157,153,310,28
2024-06-19,LY,Serbia & Montenegro,3429,3048,37,4,381,171,173,344,33
2024-06-20,LY,Serbia & Montenegro,3322,2936,30,3,386,183,173,356,27
2024-06-21,LY,Serbia & Montenegro,3510,3116,31,0,394,182,181,363,31
2024-06-22,LY,Serbia & Montenegro,3929,3582,25,1,347,160,162,322,24
2024-06-23,LY,Serbia & Montenegro,3906,3516,27,0,390,183,180,363,27
2024-06-24,LY,Serbia & Montenegro,3509,3106,35,4,403,179,189,368,31
2024-06-25,LY,Serbia & Montenegro,3422,3070,30,2,352,161,161,322,28
2024-06-26,LY,Serbia & Montenegro,3288,2926,33,0,362,166,163,329,33
2024-06-27,LY,Serbia & Montenegro,3282,2917,28,2,365,169,168,337,26
2024-06-28,LY,Serbia & Montenegro,3724,3307,33,3,417,191,193,384,30
2024-06-29,LY,Serbia & Montenegro,3996,3633,28,0,363,169,166,335,28
2024-06-30,LY,Serbia & Montenegro,3925,3553,30,0,372,171,171,342,30
2024-07-01,LY,Serbia & Montenegro,3456,3042,30,1,414,192,192,384,29
2024-07-02,LY,Serbia & Montenegro,3675,3297,29,0,378,172,177,349,29
2024-07-03,LY,Serbia & Montenegro,3852,3451,38,2,401,182,181,363,36
2024-07-04,LY,Serbia & Montenegro,3565,3170,30,1,395,184,181,365,29
2024-07-05,LY,Serbia & Montenegro,3916,3477,32,1,439,205,202,407,31
2024-07-06,LY,Serbia & Montenegro,4062,3663,36,3,399,178,185,363,33
2024-07-07,LY,Serbia & Montenegro,4011,3606,35,0,405,191,179,370,35
2024-07-08,LY,Serbia & Montenegro,3813,3389,33,2,424,193,198,391,31
2024-07-09,LY,Serbia & Montenegro,3753,3378,36,3,375,168,171,339,33
2024-07-10,LY,Serbia & Montenegro,3817,3408,39,1,409,188,182,370,38
2024-07-11,LY,Serbia & Montenegro,3784,3379,40,5,405,178,187,365,35
2024-07-12,LY,Serbia & Montenegro,3728,3323,36,4,405,185,184,369,32
2024-07-13,LY,Serbia & Montenegro,4143,3744,41,2,399,179,179,358,39
2024-07-14,LY,Serbia & Montenegro,4091,3682,33,0,409,189,187,376,33
2024-07-15,LY,Serbia & Montenegro,3888,3456,37,2,432,199,196,395,35
2024-07-16,LY,Serbia & Montenegro,3800,3419,34,2,381,173,174,347,32
2024-07-17,LY,Serbia & Montenegro,3923,3535,41,5,388,174,173,347,36
2024-07-18,LY,Serbia & Montenegro,3685,3276,28,1,409,191,190,381,27
2024-07-19,LY,Serbia & Montenegro,3459,3032,41,3,427,191,195,386,38
2024-07-20,LY,Serbia & Montenegro,3833,3456,33,0,377,170,174,344,33
2024-07-21,LY,Serbia & Montenegro,3897,3486,34,1,411,193,184,377,33
2024-07-22,LY,Serbia & Montenegro,3678,3254,31,1,424,189,204,393,30
2024-07-23,LY,Serbia & Montenegro,3868,3479,37,5,389,179,173,352,32
2024-07-24,LY,Serbia & Montenegro,3818,3422,41,1,396,176,179,355,40
2024-07-25,LY,Serbia & Montenegro,3726,3303,34,3,423,199,190,389,31
2024-07-26,LY,Serbia & Montenegro,3839,3409,36,2,430,196,198,394,34
2024-07-27,LY,Serbia & Montenegro,4167,3772,34,3,395,179,182,361,31
2024-07-28,LY,Serbia & Montenegro,4016,3613,35,2,403,183,185,368,33
2024-07-29,LY,Serbia & Montenegro,3771,3359,34,5,412,189,189,378,29
2024-07-30,LY,Serbia & Montenegro,3682,3311,30,2,371,171,170,341,28
2024-01-01,LZ,Slovakia,1056,1016,0,0,40,19,21,40,0
2024-01-02,LZ,Slovakia,1134,1076,4,0,58,29,25,54,4
2024-01-03,LZ,Slovakia,1169,1120,3,0,49,24,22,46,3
2024-01-04,LZ,Slovakia,1238,1179,7,2,59,25,27,52,5
2024-01-05,LZ,Slovakia,1283,1218,5,2,65,29,31,60,3
2024-01-06,LZ,Slovakia,1249,1207,1,0,42,22,19,41,1
2024-01-07,LZ,Slovakia,1280,1219,1,0,61,28,32,60,1
2024-01-08,LZ,Slovakia,1187,1132,1,1,55,27,27,54,0
2024-01-09,LZ,Slovakia,998,967,3,2,31,15,13,28,1
2024-01-10,LZ,Slovakia,1077,1033,4,1,44,19,21,40,3
2024-01-11,LZ,Slovakia,1097,1040,7,1,57,25,25,50,6
2024-01-12,LZ,Slovakia,1153,1090,6,1,63,29,28,57,5
2024-01-13,LZ,Slovakia,1152,1108,3,0,44,22,19,41,3
2024-01-14,LZ,Slovakia,1159,1115,1,0,44,22,21,43,1
2024-01-15,LZ,Slovakia,1139,1081,2,1,58,27,29,56,1
2024-01-16,LZ,Slovakia,1033,987,2,2,46,22,22,44,0
2024-01-17,LZ,Slovakia,1012,960,4,0,52,24,24,48,4
2024-01-18,LZ,Slovakia,1101,1043,4,0,58,27,27,54,4
2024-01-19,LZ,Slovakia,1174,1111,9,0,63,26,28,54,9
2024-01-20,LZ,Slovakia,1148,1091,5,1,57,27,25,52,4
2024-01-21,LZ,Slovakia,1103,1044,8,0,59,25,26,51,8
2024-01-22,LZ,Slovakia,1134,1058,9,1,76,34,33,67,8
2024-01-23,LZ,Slovakia,1029,979,4,0,50,22,24,46,4
2024-01-24,LZ,Slovakia,1023,963,2,0,60,28,30,58,2
2024-01-25,LZ,Slovakia,1138,1093,1,0,45,22,22,44,1
2024-01-26,LZ,Slovakia,1099,1049,2,1,50,27,21,48,1
2024-01-27,LZ,Slovakia,1158,1112,1,0,46,23,22,45,1
2024-01-28,LZ,Slovakia,1154,1105,2,0,49,23,24,47,2
2024-01-29,LZ,Slovakia,1072,1012,6,0,60,26,28,54,6
2024-01-30,LZ,Slovakia,1019,967,3,1,52,26,23,49,2
2024-01-31,LZ,Slovakia,997,949,3,1,48,21,24,45,2
2024-02-01,LZ,Slovakia,1012,940,5,0,72,31,36,67,5
2024-02-02,LZ,Slovakia,1217,1163,2,0,54,27,25,52,2
2024-02-03,LZ,Slovakia,1185,1139,4,3,46,22,20,42,1
2024-02-04,LZ,Slovakia,1183,1136,5,0,47,19,23,42,5
2024-02-05,LZ,Slovakia,1117,1064,2,0,53,24,27,51,2
2024-02-06,LZ,Slovakia,1015,970,5,1,45,20,20,40,4
2024-02-07,LZ,Slovakia,1039,981,7,1,58,25,26,51,6
2024-02-08,LZ,Slovakia,1141,1078,7,2,63,30,26,56,5
2024-02-09,LZ,Slovakia,1166,1097,6,4,69,34,29,63,2
2024-02-10,LZ,Slovakia,1182,1134,4,1,48,22,22,44,3
2024-02-11,LZ,Slovakia,1142,1096,0,0,46,22,24,46,0
2024-02-12,LZ,Slovakia,1098,1032,9,2,66,28,29,57,7
2024-02-13,LZ,Slovakia,1037,993,13,2,44,16,15,31,11
2024-02-14,LZ,Slovakia,985,926,9,0,59,26,24,50,9
2024-02-15,LZ,Slovakia,1101,1035,0,0,66,30,36,66,0
2024-02-16,LZ,Slovakia,1193,1110,9,4,83,37,37,74,5
2024-02-17,LZ,Slovakia,1120,1079,1,0,41,21,19,40,1
2024-02-18,LZ,Slovakia,1172,1120,1,1,52,24,27,51,0
2024-02-19,LZ,Slovakia,1114,1047,8,2,67,32,27,59,6
2024-02-20,LZ,Slovakia,1002,942,7,1,60,26,27,53,6
2024-02-21,LZ,Slovakia,1034,975,8,5,59,24,27,51,3
2024-02-22,LZ,Slovakia,1144,1078,11,5,66,29,26,55,6
2024-02-23,LZ,Slovakia,1180,1122,2,0,58,28,28,56,2
2024-02-24,LZ,Slovakia,1192,1135,4,1,57,28,25,53,3
2024-02-25,LZ,Slovakia,1220,1174,4,0,46,19,23,42,4
2024-02-26,LZ,Slovakia,1092,1029,8,2,63,28,27,55,6
2024-02-27,LZ,Slovakia,1055,990,10,3,65,26,29,55,7
2024-02-28,LZ,Slovakia,1048,989,14,1,59,23,22,45,13
2024-02-29,LZ,Slovakia,1132,1058,11,4,74,31,32,63,7
2024-03-01,LZ,Slovakia,1247,1168,10,0,79,36,33,69,10
2024-03-02,LZ,Slovakia,1276,1237,3,1,39,18,18,36,2
2024-03-03,LZ,Slovakia,1277,1239,0,0,38,20,18,38,0
2024-03-04,LZ,Slovakia,1156,1099,3,2,57,28,26,54,1
2024-03-05,LZ,Slovakia,1002,956,4,4,46,19,23,42,0
2024-03-06,LZ,Slovakia,1061,1011,5,2,50,22,23,45,3
2024-03-07,LZ,Slovakia,1169,1105,3,1,64,31,30,61,2
2024-03-08,LZ,Slovakia,1254,1210,0,0,44,23,21,44,0
2024-03-09,LZ,Slovakia,1267,1211,1,0,56,29,26,55,1
2024-03-10,LZ,Slovakia,1221,1173,2,0,48,21,25,46,2
2024-03-11,LZ,Slovakia,1126,1069,2,1,57,28,27,55,1
2024-03-12,LZ,Slovakia,1065,1018,5,1,47,21,21,42,4
2024-03-13,LZ,Slovakia,1066,1012,10,4,54,19,25,44,6
2024-03-14,LZ,Slovakia,1160,1080,13,7,80,34,33,67,6
2024-03-15,LZ,Slovakia,1246,1169,10,3,77,33,34,67,7
2024-03-16,LZ,Slovakia,1254,1207,1,1,47,25,21,46,0
2024-03-17,LZ,Slovakia,1279,1220,5,0,59,25,29,54,5
2024-03-18,LZ,Slovakia,1174,1112,2,1,62,28,32,60,1
2024-03-19,LZ,Slovakia,1093,1030,8,4,63,32,23,55,4
2024-03-20,LZ,Slovakia,1204,1136,11,3,68,26,31,57,8
2024-03-21,LZ,Slovakia,1197,1123,4,2,74,35,35,70,2
2024-03-22,LZ,Slovakia,1397,1313,2,1,84,42,40,82,1
2024-03-23,LZ,Slovakia,1346,1286,2,1,60,29,29,58,1
2024-03-24,LZ,Slovakia,1346,1292,2,0,54,24,28,52,2
2024-03-25,LZ,Slovakia,1263,1190,4,4,73,35,34,69,0
2024-03-26,LZ,Slovakia,1175,1126,7,3,49,23,19,42,4
2024-03-27,LZ,Slovakia,1281,1208,13,3,73,30,30,60,10
2024-03-28,LZ,Slovakia,1370,1300,3,2,70,34,33,67,1
2024-03-29,LZ,Slovakia,1366,1306,3,1,60,28,29,57,2
2024-03-30,LZ,Slovakia,1353,1315,1,0,38,19,18,37,1
2024-03-31,LZ,Slovakia,1482,1429,0,0,53,25,28,53,0
2024-04-01,LZ,Slovakia,1321,1272,2,1,49,24,23,47,1
2024-04-02,LZ,Slovakia,1432,1370,6,2,62,28,28,56,4
2024-04-03,LZ,Slovakia,1388,1325,8,5,63,28,27,55,3
2024-04-04,LZ,Slovakia,1375,1287,12,5,88,38,38,76,7
2024-04-05,LZ,Slovakia,1418,1339,12,4,79,32,35,67,8
2024-04-06,LZ,Slovakia,1520,1455,2,2,65,32,31,63,0
2024-04-07,LZ,Slovakia,1497,1427,4,3,70,30,36,66,1
2024-04-08,LZ,Slovakia,1408,1322,9,0,86,39,38,77,9
2024-04-09,LZ,Slovakia,1398,1301,14,3,97,42,41,83,11
2024-04-10,LZ,Slovakia,1296,1219,7,1,77,33,37,70,6
2024-04-11,LZ,Slovakia,1400,1307,11,4,93,39,43,82,7
2024-04-12,LZ,Slovakia,1377,1300,11,2,77,33,33,66,9
2024-04-13,LZ,Slovakia,1501,1440,5,3,61,31,25,56,2
2024-04-14,LZ,Slovakia,1442,1375,4,2,67,31,32,63,2
2024-04-15,LZ,Slovakia,1375,1309,8,2,66,30,28,58,6
2024-04-16,LZ,Slovakia,1394,1315,9,3,79,36,34,70,6
2024-04-17,LZ,Slovakia,1392,1305,14,5,87,35,38,73,9
2024-04-18,LZ,Slovakia,1438,1353,10,2,85,42,33,75,8
2024-04-19,LZ,Slovakia,1438,1373,4,2,65,29,32,61,2
2024-04-20,LZ,Slovakia,1504,1450,4,1,54,24,26,50,3
2024-04-21,LZ,Slovakia,1571,1505,3,2,66,33,30,63,1
2024-04-22,LZ,Slovakia,1366,1303,14,7,63,25,24,49,7
2024-04-23,LZ,Slovakia,1361,1277,16,6,84,33,35,68,10
2024-04-24,LZ,Slovakia,1442,1368,7,2,74,32,35,67,5
2024-04-25,LZ,Slovakia,1534,1442,12,6,92,38,42,80,6
2024-04-26,LZ,Slovakia,1626,1553,12,4,73,34,27,61,8
2024-04-27,LZ,Slovakia,1805,1755,3,1,50,25,22,47,2
2024-04-28,LZ,Slovakia,1777,1709,1,0,68,28,39,67,1
2024-04-29,LZ,Slovakia,1457,1395,6,3,62,30,26,56,3
2024-04-30,LZ,Slovakia,1510,1433,5,2,77,39,33,72,3
2024-05-01,LZ,Slovakia,1540,1465,3,2,75,38,34,72,1
2024-05-02,LZ,Slovakia,1568,1478,4,1,90,40,46,86,3
2024-05-03,LZ,Slovakia,1619,1549,4,2,70,32,34,66,2
2024-05-04,LZ,Slovakia,1805,1749,4,2,56,26,26,52,2
2024-05-05,LZ,Slovakia,1876,1809,2,1,67,31,34,65,1
2024-05-06,LZ,Slovakia,1558,1488,4,0,70,35,31,66,4
2024-05-07,LZ,Slovakia,1626,1553,3,1,73,35,35,70,2
2024-05-08,LZ,Slovakia,1612,1540,2,1,72,37,33,70,1
2024-05-09,LZ,Slovakia,1630,1545,12,3,85,38,35,73,9
2024-05-10,LZ,Slovakia,1621,1562,5,4,59,24,30,54,1
2024-05-11,LZ,Slovakia,1900,1845,1,0,55,27,27,54,1
2024-05-12,LZ,Slovakia,1900,1825,2,1,75,36,37,73,1
2024-05-13,LZ,Slovakia,1654,1576,11,3,78,35,32,67,8
2024-05-14,LZ,Slovakia,1616,1533,8,2,83,36,39,75,6
2024-05-15,LZ,Slovakia,1709,1608,9,5,101,45,47,92,4
2024-05-16,LZ,Slovakia,1766,1664,7,2,102,48,47,95,5
2024-05-17,LZ,Slovakia,1822,1757,2,1,65,31,32,63,1
2024-05-18,LZ,Slovakia,2013,1942,2,1,71,35,34,69,1
2024-05-19,LZ,Slovakia,2002,1923,2,2,79,35,42,77,0
2024-05-20,LZ,Slovakia,1626,1563,8,3,63,30,25,55,5
2024-05-21,LZ,Slovakia,1786,1701,6,3,85,42,37,79,3
2024-05-22,LZ,Slovakia,1616,1537,6,2,79,35,38,73,4
2024-05-23,LZ,Slovakia,1698,1611,8,2,87,40,39,79,6
2024-05-24,LZ,Slovakia,1835,1760,5,2,75,37,33,70,3
2024-05-25,LZ,Slovakia,2163,2115,0,0,48,24,24,48,0
2024-05-26,LZ,Slovakia,2103,2022,0,0,81,40,41,81,0
2024-05-27,LZ,Slovakia,1840,1758,6,1,82,37,39,76,5
2024-05-28,LZ,Slovakia,1793,1717,10,1,76,32,34,66,9
2024-05-29,LZ,Slovakia,1868,1784,12,1,84,35,37,72,11
2024-05-30,LZ,Slovakia,1850,1752,5,2,98,47,46,93,3
2024-05-31,LZ,Slovakia,1918,1852,5,1,66,32,29,61,4
2024-06-01,LZ,Slovakia,2173,2107,2,1,66,30,34,64,1
2024-06-02,LZ,Slovakia,2190,2091,4,1,99,45,50,95,3
2024-06-03,LZ,Slovakia,1951,1857,5,2,94,46,43,89,3
2024-06-04,LZ,Slovakia,1853,1742,6,1,111,49,56,105,5
2024-06-05,LZ,Slovakia,1992,1857,9,3,135,63,63,126,6
2024-06-06,LZ,Slovakia,1913,1777,6,2,136,64,66,130,4
2024-06-07,LZ,Slovakia,2026,1932,5,1,94,47,42,89,4
2024-06-08,LZ,Slovakia,2402,2312,1,0,90,47,42,89,1
2024-06-09,LZ,Slovakia,2255,2143,3,0,112,49,60,109,3
2024-06-10,LZ,Slovakia,1961,1862,4,3,99,51,44,95,1
2024-06-11,LZ,Slovakia,1971,1849,7,3,122,58,57,115,4
2024-06-12,LZ,Slovakia,1988,1842,10,5,146,66,70,136,5
2024-06-13,LZ,Slovakia,1998,1877,8,6,121,54,59,113,2
2024-06-14,LZ,Slovakia,2063,1930,13,5,133,61,59,120,8
2024-06-15,LZ,Slovakia,2213,2091,4,3,122,60,58,118,1
2024-06-16,LZ,Slovakia,2270,2147,7,2,123,58,58,116,5
2024-06-17,LZ,Slovakia,2007,1870,10,5,137,63,64,127,5
2024-06-18,LZ,Slovakia,2015,1868,7,3,147,67,73,140,4
2024-06-19,LZ,Slovakia,2162,1982,16,3,180,83,81,164,13
2024-06-20,LZ,Slovakia,2176,2038,11,1,138,61,66,127,10
2024-06-21,LZ,Slovakia,2342,2187,15,3,155,68,72,140,12
2024-06-22,LZ,Slovakia,2174,2068,2,0,106,52,52,104,2
2024-06-23,LZ,Slovakia,2222,2102,5,0,120,60,55,115,5
2024-06-24,LZ,Slovakia,2075,1955,4,1,120,61,55,116,3
2024-06-25,LZ,Slovakia,2156,2014,5,3,142,67,70,137,2
2024-06-26,LZ,Slovakia,1968,1802,6,1,166,82,78,160,5
2024-06-27,LZ,Slovakia,2003,1867,7,5,136,64,65,129,2
2024-06-28,LZ,Slovakia,2202,2065,1,1,137,67,69,136,0
2024-06-29,LZ,Slovakia,2221,2103,3,2,118,62,53,115,1
2024-06-30,LZ,Slovakia,2191,2049,1,0,142,68,73,141,1
2024-07-01,LZ,Slovakia,2112,1993,4,1,119,54,61,115,3
2024-07-02,LZ,Slovakia,2060,1918,5,1,142,69,68,137,4
2024-07-03,LZ,Slovakia,2215,2056,1,1,159,81,77,158,0
2024-07-04,LZ,Slovakia,2068,1937,1,0,131,64,66,130,1
2024-07-05,LZ,Slovakia,2201,2080,2,2,121,59,60,119,0
2024-07-06,LZ,Slovakia,2270,2153,1,0,117,60,56,116,1
2024-07-07,LZ,Slovakia,2280,2164,0,0,116,58,58,116,0
2024-07-08,LZ,Slovakia,2017,1913,2,1,104,54,48,102,1
2024-07-09,LZ,Slovakia,2060,1927,6,3,133,61,66,127,3
2024-07-10,LZ,Slovakia,2185,2029,2,0,156,78,76,154,2
2024-07-11,LZ,Slovakia,2229,2096,3,1,133,66,64,130,2
2024-07-12,LZ,Slovakia,2329,2196,2,1,133,62,69,131,1
2024-07-13,LZ,Slovakia,2382,2254,0,0,128,64,64,128,0
2024-07-14,LZ,Slovakia,2244,2125,0,0,119,60,59,119,0
2024-07-15,LZ,Slovakia,2163,2056,7,1,107,49,51,100,6
2024-07-16,LZ,Slovakia,2153,2005,9,3,148,72,67,139,6
2024-07-17,LZ,Slovakia,2185,2006,18,6,179,77,84,161,12
2024-07-18,LZ,Slovakia,2118,1987,9,2,131,63,59,122,7
2024-07-19,LZ,Slovakia,2288,2147,11,1,141,66,64,130,10
2024-07-20,LZ,Slovakia,2290,2171,2,0,119,60,57,117,2
2024-07-21,LZ,Slovakia,2290,2171,1,0,119,59,59,118,1
2024-07-22,LZ,Slovakia,2175,2060,10,2,115,52,53,105,8
2024-07-23,LZ,Slovakia,2177,2032,12,5,145,65,68,133,7
2024-07-24,LZ,Slovakia,2160,2004,5,2,156,77,74,151,3
2024-07-25,LZ,Slovakia,2186,2035,11,2,151,73,67,140,9
2024-07-26,LZ,Slovakia,2315,2180,1,1,135,65,69,134,0
2024-07-27,LZ,Slovakia,2239,2099,2,0,140,68,70,138,2
2024-07-28,LZ,Slovakia,2398,2267,3,1,131,64,64,128,2
2024-07-29,LZ,Slovakia,2092,1967,3,2,125,61,61,122,1
2024-07-30,LZ,Slovakia,2168,2025,14,6,143,62,67,129,8
2024-01-01,LJ,Slovenia,937,907,0,0,30,15,15,30,0
2024-01-02,LJ,Slovenia,963,920,1,1,43,21,21,42,0
2024-01-03,LJ,Slovenia,994,936,1,1,58,27,30,57,0
2024-01-04,LJ,Slovenia,1009,948,9,1,61,25,27,52,8
2024-01-05,LJ,Slovenia,1090,1034,0,0,56,28,28,56,0
2024-01-06,LJ,Slovenia,1125,1088,0,0,37,20,17,37,0
2024-01-07,LJ,Slovenia,1119,1077,0,0,42,20,22,42,0
2024-01-08,LJ,Slovenia,948,901,1,1,47,23,23,46,0
2024-01-09,LJ,Slovenia,804,758,1,1,46,23,22,45,0
2024-01-10,LJ,Slovenia,818,771,3,1,47,22,22,44,2
2024-01-11,LJ,Slovenia,827,764,3,0,63,30,30,60,3
2024-01-12,LJ,Slovenia,958,911,0,0,47,22,25,47,0
2024-01-13,LJ,Slovenia,1025,986,1,0,39,18,20,38,1
2024-01-14,LJ,Slovenia,1060,1013,1,1,47,22,24,46,0
2024-01-15,LJ,Slovenia,884,836,2,2,48,24,22,46,0
2024-01-16,LJ,Slovenia,787,733,2,1,54,27,25,52,1
2024-01-17,LJ,Slovenia,754,718,0,0,36,16,20,36,0
2024-01-18,LJ,Slovenia,834,778,1,0,56,30,25,55,1
2024-01-19,LJ,Slovenia,938,895,1,0,43,20,22,42,1
2024-01-20,LJ,Slovenia,924,874,0,0,50,25,25,50,0
2024-01-21,LJ,Slovenia,979,924,0,0,55,26,29,55,0
2024-01-22,LJ,Slovenia,795,746,5,1,49,23,21,44,4
2024-01-23,LJ,Slovenia,745,698,7,1,47,20,20,40,6
2024-01-24,LJ,Slovenia,787,729,6,1,58,27,25,52,5
2024-01-25,LJ,Slovenia,776,723,2,1,53,26,25,51,1
2024-01-26,LJ,Slovenia,947,881,3,3,66,27,36,63,0
2024-01-27,LJ,Slovenia,861,809,3,1,52,25,24,49,2
2024-01-28,LJ,Slovenia,927,866,3,2,61,30,28,58,1
2024-01-29,LJ,Slovenia,837,793,2,2,44,21,21,42,0
2024-01-30,LJ,Slovenia,734,673,8,1,61,29,24,53,7
2024-01-31,LJ,Slovenia,808,750,2,0,58,28,28,56,2
2024-02-01,LJ,Slovenia,780,717,4,1,63,29,30,59,3
2024-02-02,LJ,Slovenia,919,867,1,0,52,26,25,51,1
2024-02-03,LJ,Slovenia,924,878,5,1,46,20,21,41,4
2024-02-04,LJ,Slovenia,956,909,4,2,47,23,20,43,2
2024-02-05,LJ,Slovenia,898,838,12,2,60,22,26,48,10
2024-02-06,LJ,Slovenia,829,743,17,8,86,34,35,69,9
2024-02-07,LJ,Slovenia,778,717,7,5,61,29,25,54,2
2024-02-08,LJ,Slovenia,888,828,3,2,60,29,28,57,1
2024-02-09,LJ,Slovenia,1006,947,0,0,59,29,30,59,0
2024-02-10,LJ,Slovenia,1198,1157,0,0,41,20,21,41,0
2024-02-11,LJ,Slovenia,1065,1025,0,0,40,19,21,40,0
2024-02-12,LJ,Slovenia,898,839,1,1,59,31,27,58,0
2024-02-13,LJ,Slovenia,798,734,8,6,64,27,29,56,2
2024-02-14,LJ,Slovenia,883,815,8,5,68,30,30,60,3
2024-02-15,LJ,Slovenia,883,814,6,1,69,32,31,63,5
2024-02-16,LJ,Slovenia,1002,939,3,0,63,32,28,60,3
2024-02-17,LJ,Slovenia,973,935,0,0,38,18,20,38,0
2024-02-18,LJ,Slovenia,1066,1014,0,0,52,25,27,52,0
2024-02-19,LJ,Slovenia,925,873,4,2,52,26,22,48,2
2024-02-20,LJ,Slovenia,772,715,7,3,57,23,27,50,4
2024-02-21,LJ,Slovenia,892,831,4,2,61,29,28,57,2
2024-02-22,LJ,Slovenia,856,803,1,1,53,26,26,52,0
2024-02-23,LJ,Slovenia,960,900,2,2,60,30,28,58,0
2024-02-24,LJ,Slovenia,957,913,1,1,44,21,22,43,0
2024-02-25,LJ,Slovenia,992,938,2,2,54,23,29,52,0
2024-02-26,LJ,Slovenia,861,790,7,4,71,34,30,64,3
2024-02-27,LJ,Slovenia,820,762,7,5,58,26,25,51,2
2024-02-28,LJ,Slovenia,840,783,2,2,57,28,27,55,0
2024-02-29,LJ,Slovenia,908,846,3,2,62,29,30,59,1
2024-03-01,LJ,Slovenia,961,910,1,1,51,24,26,50,0
2024-03-02,LJ,Slovenia,952,923,1,1,29,14,14,28,0
2024-03-03,LJ,Slovenia,1009,967,0,0,42,20,22,42,0
2024-03-04,LJ,Slovenia,932,868,6,4,64,29,29,58,2
2024-03-05,LJ,Slovenia,836,768,5,3,68,33,30,63,2
2024-03-06,LJ,Slovenia,844,789,1,0,55,28,26,54,1
2024-03-07,LJ,Slovenia,774,722,3,1,52,23,26,49,2
2024-03-08,LJ,Slovenia,927,869,3,3,58,29,26,55,0
2024-03-09,LJ,Slovenia,967,937,0,0,30,14,16,30,0
2024-03-10,LJ,Slovenia,1076,1032,0,0,44,21,23,44,0
2024-03-11,LJ,Slovenia,936,879,3,0,57,27,27,54,3
2024-03-12,LJ,Slovenia,803,750,9,6,53,23,21,44,3
2024-03-13,LJ,Slovenia,893,810,8,0,83,35,40,75,8
2024-03-14,LJ,Slovenia,872,799,4,3,73,36,33,69,1
2024-03-15,LJ,Slovenia,1024,944,0,0,80,37,43,80,0
2024-03-16,LJ,Slovenia,1018,976,2,0,42,17,23,40,2
2024-03-17,LJ,Slovenia,1099,1022,2,0,77,42,33,75,2
2024-03-18,LJ,Slovenia,932,876,4,2,56,28,24,52,2
2024-03-19,LJ,Slovenia,911,856,2,1,55,26,27,53,1
2024-03-20,LJ,Slovenia,935,870,0,0,65,36,29,65,0
2024-03-21,LJ,Slovenia,922,849,0,0,73,33,40,73,0
2024-03-22,LJ,Slovenia,1129,1046,4,4,83,43,36,79,0
2024-03-23,LJ,Slovenia,1098,1054,0,0,44,21,23,44,0
2024-03-24,LJ,Slovenia,1087,1036,0,0,51,24,27,51,0
2024-03-25,LJ,Slovenia,1033,965,2,0,68,33,33,66,2
2024-03-26,LJ,Slovenia,1001,947,0,0,54,27,27,54,0
2024-03-27,LJ,Slovenia,1021,965,0,0,56,27,29,56,0
2024-03-28,LJ,Slovenia,1065,995,1,1,70,33,36,69,0
2024-03-29,LJ,Slovenia,1127,1060,0,0,67,34,33,67,0
2024-03-30,LJ,Slovenia,1162,1120,0,0,42,20,22,42,0
2024-03-31,LJ,Slovenia,1360,1316,1,0,44,23,20,43,1
2024-04-01,LJ,Slovenia,1218,1170,0,0,48,24,24,48,0
2024-04-02,LJ,Slovenia,1133,1067,3,0,66,32,31,63,3
2024-04-03,LJ,Slovenia,1239,1170,2,0,69,33,34,67,2
2024-04-04,LJ,Slovenia,1256,1182,4,0,74,35,35,70,4
2024-04-05,LJ,Slovenia,1332,1254,7,3,78,37,34,71,4
2024-04-06,LJ,Slovenia,1406,1357,2,2,49,23,24,47,0
2024-04-07,LJ,Slovenia,1409,1353,0,0,56,27,29,56,0
2024-04-08,LJ,Slovenia,1260,1178,5,1,82,40,37,77,4
2024-04-09,LJ,Slovenia,1228,1151,2,1,77,37,38,75,1
2024-04-10,LJ,Slovenia,1316,1252,9,0,64,29,26,55,9
2024-04-11,LJ,Slovenia,1247,1162,9,3,85,39,37,76,6
2024-04-12,LJ,Slovenia,1355,1276,6,1,79,36,37,73,5
2024-04-13,LJ,Slovenia,1416,1368,1,1,48,24,23,47,0
2024-04-14,LJ,Slovenia,1409,1347,0,0,62,28,34,62,0
2024-04-15,LJ,Slovenia,1278,1213,6,2,65,30,29,59,4
2024-04-16,LJ,Slovenia,1270,1207,1,1,63,30,32,62,0
2024-04-17,LJ,Slovenia,1215,1161,2,1,54,26,26,52,1
2024-04-18,LJ,Slovenia,1301,1234,0,0,67,35,32,67,0
2024-04-19,LJ,Slovenia,1458,1374,8,1,84,37,39,76,7
2024-04-20,LJ,Slovenia,1472,1417,1,1,55,27,27,54,0
2024-04-21,LJ,Slovenia,1430,1365,3,1,65,30,32,62,2
2024-04-22,LJ,Slovenia,1365,1288,8,4,77,35,34,69,4
2024-04-23,LJ,Slovenia,1341,1278,2,0,63,30,31,61,2
2024-04-24,LJ,Slovenia,1349,1293,2,0,56,27,27,54,2
2024-04-25,LJ,Slovenia,1414,1346,2,2,68,34,32,66,0
2024-04-26,LJ,Slovenia,1463,1377,11,5,86,38,37,75,6
2024-04-27,LJ,Slovenia,1562,1505,3,3,57,26,28,54,0
2024-04-28,LJ,Slovenia,1517,1449,7,0,68,29,32,61,7
2024-04-29,LJ,Slovenia,1465,1372,8,2,93,42,43,85,6
2024-04-30,LJ,Slovenia,1453,1363,6,5,90,44,40,84,1
2024-05-01,LJ,Slovenia,1453,1393,0,0,60,31,29,60,0
2024-05-02,LJ,Slovenia,1456,1392,1,1,64,31,32,63,0
2024-05-03,LJ,Slovenia,1617,1537,4,4,80,39,37,76,0
2024-05-04,LJ,Slovenia,1691,1631,2,2,60,28,30,58,0
2024-05-05,LJ,Slovenia,1728,1657,5,1,71,32,34,66,4
2024-05-06,LJ,Slovenia,1546,1465,4,0,81,35,42,77,4
2024-05-07,LJ,Slovenia,1614,1532,0,0,82,44,38,82,0
2024-05-08,LJ,Slovenia,1650,1571,1,1,79,39,39,78,0
2024-05-09,LJ,Slovenia,1691,1614,1,1,77,38,38,76,0
2024-05-10,LJ,Slovenia,1651,1566,3,2,85,40,42,82,1
2024-05-11,LJ,Slovenia,1733,1674,0,0,59,30,29,59,0
2024-05-12,LJ,Slovenia,1810,1746,0,0,64,32,32,64,0
2024-05-13,LJ,Slovenia,1589,1517,1,1,72,36,35,71,0
2024-05-14,LJ,Slovenia,1543,1473,2,1,70,35,33,68,1
2024-05-15,LJ,Slovenia,1592,1524,5,3,68,31,32,63,2
2024-05-16,LJ,Slovenia,1648,1580,2,0,68,35,31,66,2
2024-05-17,LJ,Slovenia,1796,1713,2,1,83,39,42,81,1
2024-05-18,LJ,Slovenia,1942,1871,5,2,71,32,34,66,3
2024-05-19,LJ,Slovenia,1873,1813,2,0,60,30,28,58,2
2024-05-20,LJ,Slovenia,1722,1645,2,0,77,39,36,75,2
2024-05-21,LJ,Slovenia,1541,1476,1,0,65,32,32,64,1
2024-05-22,LJ,Slovenia,1588,1515,1,0,73,37,35,72,1
2024-05-23,LJ,Slovenia,1745,1673,2,2,72,35,35,70,0
2024-05-24,LJ,Slovenia,1769,1683,2,0,86,41,43,84,2
2024-05-25,LJ,Slovenia,1898,1841,2,2,57,27,28,55,0
2024-05-26,LJ,Slovenia,1912,1856,1,0,56,26,29,55,1
2024-05-27,LJ,Slovenia,1732,1638,8,3,94,45,41,86,5
2024-05-28,LJ,Slovenia,1629,1545,7,4,84,39,38,77,3
2024-05-29,LJ,Slovenia,1729,1633,8,7,96,42,46,88,1
2024-05-30,LJ,Slovenia,1775,1693,3,2,82,41,38,79,1
2024-05-31,LJ,Slovenia,1794,1717,2,2,77,37,38,75,0
2024-06-01,LJ,Slovenia,2068,2012,0,0,56,29,27,56,0
2024-06-02,LJ,Slovenia,1972,1904,3,0,68,32,33,65,3
2024-06-03,LJ,Slovenia,1649,1582,1,0,67,34,32,66,1
2024-06-04,LJ,Slovenia,1719,1628,3,0,91,43,45,88,3
2024-06-05,LJ,Slovenia,1711,1620,4,4,91,42,45,87,0
2024-06-06,LJ,Slovenia,1802,1715,3,2,87,44,40,84,1
2024-06-07,LJ,Slovenia,1794,1714,6,3,80,35,39,74,3
2024-06-08,LJ,Slovenia,1915,1855,1,1,60,31,28,59,0
2024-06-09,LJ,Slovenia,1987,1923,4,0,64,30,30,60,4
2024-06-10,LJ,Slovenia,1816,1744,1,1,72,37,34,71,0
2024-06-11,LJ,Slovenia,1645,1575,1,1,70,35,34,69,0
2024-06-12,LJ,Slovenia,1672,1607,2,2,65,33,30,63,0
2024-06-13,LJ,Slovenia,1785,1699,4,4,86,42,40,82,0
2024-06-14,LJ,Slovenia,1902,1804,4,2,98,44,50,94,2
2024-06-15,LJ,Slovenia,2208,2144,1,1,64,33,30,63,0
2024-06-16,LJ,Slovenia,2057,1979,1,1,78,38,39,77,0
2024-06-17,LJ,Slovenia,1789,1711,4,1,78,38,36,74,3
2024-06-18,LJ,Slovenia,1815,1725,4,4,90,43,43,86,0
2024-06-19,LJ,Slovenia,1832,1741,10,3,91,41,40,81,7
2024-06-20,LJ,Slovenia,1965,1865,2,0,100,51,47,98,2
2024-06-21,LJ,Slovenia,1904,1807,9,2,97,44,44,88,7
2024-06-22,LJ,Slovenia,2161,2088,1,0,73,37,35,72,1
2024-06-23,LJ,Slovenia,2211,2136,0,0,75,37,38,75,0
2024-06-24,LJ,Slovenia,1873,1802,3,3,71,33,35,68,0
2024-06-25,LJ,Slovenia,1860,1780,0,0,80,42,38,80,0
2024-06-26,LJ,Slovenia,1789,1711,2,0,78,37,39,76,2
2024-06-27,LJ,Slovenia,1858,1766,2,2,92,45,45,90,0
2024-06-28,LJ,Slovenia,2098,2002,4,1,96,44,48,92,3
2024-06-29,LJ,Slovenia,2301,2227,2,0,74,34,38,72,2
2024-06-30,LJ,Slovenia,2162,2097,1,1,65,35,29,64,0
2024-07-01,LJ,Slovenia,1838,1764,0,0,74,39,35,74,0
2024-07-02,LJ,Slovenia,2015,1924,6,3,91,40,45,85,3
2024-07-03,LJ,Slovenia,2157,2076,0,0,81,40,41,81,0
2024-07-04,LJ,Slovenia,2101,2010,6,2,91,43,42,85,4
2024-07-05,LJ,Slovenia,2127,2029,6,2,98,48,44,92,4
2024-07-06,LJ,Slovenia,2257,2181,6,1,76,32,38,70,5
2024-07-07,LJ,Slovenia,2175,2107,1,1,68,32,35,67,0
2024-07-08,LJ,Slovenia,2109,2021,8,2,88,42,38,80,6
2024-07-09,LJ,Slovenia,2066,1964,7,7,102,48,47,95,0
2024-07-10,LJ,Slovenia,1886,1802,6,1,84,40,38,78,5
2024-07-11,LJ,Slovenia,2030,1946,5,3,84,38,41,79,2
2024-07-12,LJ,Slovenia,1980,1889,6,3,91,42,43,85,3
2024-07-13,LJ,Slovenia,2104,2031,0,0,73,35,38,73,0
2024-07-14,LJ,Slovenia,2245,2162,1,0,83,43,39,82,1
2024-07-15,LJ,Slovenia,2087,1998,7,4,89,41,41,82,3
2024-07-16,LJ,Slovenia,2166,2078,1,1,88,41,46,87,0
2024-07-17,LJ,Slovenia,1911,1848,1,1,63,31,31,62,0
2024-07-18,LJ,Slovenia,2045,1947,6,1,98,48,44,92,5
2024-07-19,LJ,Slovenia,1760,1687,2,1,73,36,35,71,1
2024-07-20,LJ,Slovenia,2228,2158,1,1,70,37,32,69,0
2024-07-21,LJ,Slovenia,2231,2149,1,1,82,40,41,81,0
2024-07-22,LJ,Slovenia,1988,1917,7,4,71,32,32,64,3
2024-07-23,LJ,Slovenia,2054,1961,7,4,93,43,43,86,3
2024-07-24,LJ,Slovenia,2033,1950,0,0,83,40,43,83,0
2024-07-25,LJ,Slovenia,2081,1980,5,3,101,49,47,96,2
2024-07-26,LJ,Slovenia,2171,2078,2,0,93,45,46,91,2
2024-07-27,LJ,Slovenia,2290,2220,0,0,70,37,33,70,0
2024-07-28,LJ,Slovenia,2052,1981,1,0,71,35,35,70,1
2024-07-29,LJ,Slovenia,2130,2044,1,0,86,41,44,85,1
2024-07-30,LJ,Slovenia,2094,2005,1,1,89,44,44,88,0
2024-01-01,LE,Spain,4951,1114,973,1,3837,1439,1425,2864,972
2024-01-02,LE,Spain,5197,1082,1056,14,4115,1551,1508,3059,1042
2024-01-03,LE,Spain,4981,987,1033,12,3994,1486,1475,2961,1021
2024-01-04,LE,Spain,5205,1072,1070,15,4133,1523,1540,3063,1055
2024-01-05,LE,Spain,5256,1162,1006,6,4094,1545,1543,3088,1000
2024-01-06,LE,Spain,5328,1238,898,7,4090,1605,1587,3192,891
2024-01-07,LE,Spain,5384,1101,1063,4,4283,1613,1607,3220,1059
2024-01-08,LE,Spain,4972,1087,1056,24,3885,1422,1407,2829,1032
2024-01-09,LE,Spain,4136,799,1015,26,3337,1163,1159,2322,989
2024-01-10,LE,Spain,3957,743,991,30,3214,1107,1116,2223,961
2024-01-11,LE,Spain,4223,754,1066,31,3469,1200,1203,2403,1035
2024-01-12,LE,Spain,4962,914,1231,35,4048,1411,1406,2817,1196
2024-01-13,LE,Spain,4635,927,931,24,3708,1387,1390,2777,907
2024-01-14,LE,Spain,4919,946,1081,19,3973,1451,1441,2892,1062
2024-01-15,LE,Spain,4591,872,1108,24,3719,1306,1305,2611,1084
2024-01-16,LE,Spain,3754,664,960,20,3090,1069,1061,2130,940
2024-01-17,LE,Spain,3633,566,997,28,3067,1038,1032,2070,969
2024-01-18,LE,Spain,4059,661,1063,35,3398,1164,1171,2335,1028
2024-01-19,LE,Spain,4791,857,1214,10,3934,1358,1362,2720,1204
2024-01-20,LE,Spain,4533,866,949,16,3667,1362,1356,2718,933
2024-01-21,LE,Spain,4766,872,1136,20,3894,1386,1372,2758,1116
2024-01-22,LE,Spain,4533,866,1118,25,3667,1271,1278,2549,1093
2024-01-23,LE,Spain,3761,622,1048,57,3139,1050,1041,2091,991
2024-01-24,LE,Spain,3832,613,1088,48,3219,1056,1075,2131,1040
2024-01-25,LE,Spain,4119,645,1109,47,3474,1181,1184,2365,1062
2024-01-26,LE,Spain,4847,845,1268,31,4002,1357,1377,2734,1237
2024-01-27,LE,Spain,4535,843,980,22,3692,1361,1351,2712,958
2024-01-28,LE,Spain,4835,880,1146,20,3955,1412,1397,2809,1126
2024-01-29,LE,Spain,4524,830,1148,40,3694,1273,1273,2546,1108
2024-01-30,LE,Spain,3804,617,1037,55,3187,1088,1062,2150,982
2024-01-31,LE,Spain,3817,615,1037,50,3202,1073,1092,2165,987
2024-02-01,LE,Spain,4231,677,1106,37,3554,1207,1241,2448,1069
2024-02-02,LE,Spain,4928,891,1277,25,4037,1383,1377,2760,1252
2024-02-03,LE,Spain,4704,900,1018,24,3804,1383,1403,2786,994
2024-02-04,LE,Spain,4943,885,1178,20,4058,1456,1424,2880,1158
2024-02-05,LE,Spain,4717,892,1176,30,3825,1342,1307,2649,1146
2024-02-06,LE,Spain,3952,692,1034,21,3260,1120,1106,2226,1013
2024-02-07,LE,Spain,3965,653,1083,34,3312,1105,1124,2229,1049
2024-02-08,LE,Spain,4443,742,1083,29,3701,1291,1327,2618,1054
2024-02-09,LE,Spain,5126,875,1273,14,4251,1486,1492,2978,1259
2024-02-10,LE,Spain,5144,989,1056,18,4155,1553,1546,3099,1038
2024-02-11,LE,Spain,5154,979,1139,10,4175,1523,1513,3036,1129
2024-02-12,LE,Spain,4929,927,1194,30,4002,1406,1402,2808,1164
2024-02-13,LE,Spain,4219,700,1164,44,3519,1181,1174,2355,1120
2024-02-14,LE,Spain,4363,734,1173,39,3629,1227,1229,2456,1134
2024-02-15,LE,Spain,4756,875,1152,38,3881,1356,1373,2729,1114
2024-02-16,LE,Spain,5395,1025,1310,35,4370,1529,1531,3060,1275
2024-02-17,LE,Spain,5253,1096,1052,26,4157,1551,1554,3105,1026
2024-02-18,LE,Spain,5390,1028,1178,24,4362,1596,1588,3184,1154
2024-02-19,LE,Spain,5062,1009,1196,38,4053,1435,1422,2857,1158
2024-02-20,LE,Spain,4329,812,1098,53,3517,1215,1204,2419,1045
2024-02-21,LE,Spain,4477,831,1143,50,3646,1250,1253,2503,1093
2024-02-22,LE,Spain,4778,900,1155,39,3878,1352,1371,2723,1116
2024-02-23,LE,Spain,5358,1049,1273,29,4309,1512,1524,3036,1244
2024-02-24,LE,Spain,5336,1118,1050,21,4218,1580,1588,3168,1029
2024-02-25,LE,Spain,5410,1040,1176,12,4370,1597,1597,3194,1164
2024-02-26,LE,Spain,5228,1063,1193,37,4165,1499,1473,2972,1156
2024-02-27,LE,Spain,4502,858,1143,55,3644,1255,1246,2501,1088
2024-02-28,LE,Spain,4544,813,1132,40,3731,1306,1293,2599,1092
2024-02-29,LE,Spain,4846,861,1201,54,3985,1392,1392,2784,1147
2024-03-01,LE,Spain,5502,1023,1340,38,4479,1558,1581,3139,1302
2024-03-02,LE,Spain,5343,1101,1074,12,4242,1585,1583,3168,1062
2024-03-03,LE,Spain,5481,1028,1232,14,4453,1619,1602,3221,1218
2024-03-04,LE,Spain,5268,1043,1235,26,4225,1501,1489,2990,1209
2024-03-05,LE,Spain,4543,838,1165,54,3705,1270,1270,2540,1111
2024-03-06,LE,Spain,4549,801,1161,54,3748,1285,1302,2587,1107
2024-03-07,LE,Spain,4790,855,1176,34,3935,1379,1380,2759,1142
2024-03-08,LE,Spain,5340,976,1318,28,4364,1523,1523,3046,1290
2024-03-09,LE,Spain,5384,1130,1088,12,4254,1576,1590,3166,1076
2024-03-10,LE,Spain,5473,1043,1216,17,4430,1609,1605,3214,1199
2024-03-11,LE,Spain,5193,975,1231,41,4218,1496,1491,2987,1190
2024-03-12,LE,Spain,4442,735,1148,58,3707,1296,1263,2559,1090
2024-03-13,LE,Spain,4506,762,1168,48,3744,1271,1305,2576,1120
2024-03-14,LE,Spain,4887,811,1254,45,4076,1409,1413,2822,1209
2024-03-15,LE,Spain,5522,945,1387,32,4577,1593,1597,3190,1355
2024-03-16,LE,Spain,5436,1044,1121,12,4392,1636,1635,3271,1109
2024-03-17,LE,Spain,5488,980,1233,21,4508,1639,1636,3275,1212
2024-03-18,LE,Spain,5355,985,1275,36,4370,1560,1535,3095,1239
2024-03-19,LE,Spain,4567,756,1137,41,3811,1338,1336,2674,1096
2024-03-20,LE,Spain,4586,760,1170,39,3826,1332,1324,2656,1131
2024-03-21,LE,Spain,4894,779,1237,30,4115,1415,1463,2878,1207
2024-03-22,LE,Spain,5747,985,1422,28,4762,1655,1685,3340,1394
2024-03-23,LE,Spain,5687,1038,1226,20,4649,1702,1721,3423,1206
2024-03-24,LE,Spain,5597,1000,1243,12,4597,1689,1665,3354,1231
2024-03-25,LE,Spain,5391,970,1231,27,4421,1603,1587,3190,1204
2024-03-26,LE,Spain,5004,863,1108,33,4141,1516,1517,3033,1075
2024-03-27,LE,Spain,5291,838,1331,32,4453,1558,1564,3122,1299
2024-03-28,LE,Spain,5478,892,1217,26,4586,1650,1719,3369,1191
2024-03-29,LE,Spain,5547,1035,1135,10,4512,1682,1695,3377,1125
2024-03-30,LE,Spain,5688,1030,1142,12,4658,1749,1767,3516,1130
2024-03-31,LE,Spain,6183,1062,1321,12,5121,1891,1909,3800,1309
2024-04-01,LE,Spain,6303,1075,1392,24,5228,1934,1902,3836,1368
2024-04-02,LE,Spain,6015,1039,1310,44,4976,1842,1824,3666,1266
2024-04-03,LE,Spain,5945,966,1358,43,4979,1817,1804,3621,1315
2024-04-04,LE,Spain,6158,1018,1394,59,5140,1873,1873,3746,1335
2024-04-05,LE,Spain,6351,1029,1469,42,5322,1915,1938,3853,1427
2024-04-06,LE,Spain,6517,1142,1219,26,5375,2081,2075,4156,1193
2024-04-07,LE,Spain,6521,1140,1370,28,5381,2023,1988,4011,1342
2024-04-08,LE,Spain,6159,1117,1347,42,5042,1850,1845,3695,1305
2024-04-09,LE,Spain,6098,1118,1309,26,4980,1832,1839,3671,1283
2024-04-10,LE,Spain,6025,1049,1338,48,4976,1833,1805,3638,1290
2024-04-11,LE,Spain,6299,1098,1405,45,5201,1886,1910,3796,1360
2024-04-12,LE,Spain,6415,1112,1469,43,5303,1910,1924,3834,1426
2024-04-13,LE,Spain,6462,1169,1190,28,5293,2054,2049,4103,1162
2024-04-14,LE,Spain,6398,1171,1300,24,5227,1976,1951,3927,1276
2024-04-15,LE,Spain,6216,1161,1355,30,5055,1855,1845,3700,1325
2024-04-16,LE,Spain,6042,1116,1310,34,4926,1813,1803,3616,1276
2024-04-17,LE,Spain,5959,1066,1318,39,4893,1794,1781,3575,1279
2024-04-18,LE,Spain,6278,1085,1400,45,5193,1881,1912,3793,1355
2024-04-19,LE,Spain,6372,1059,1459,37,5313,1912,1942,3854,1422
2024-04-20,LE,Spain,6402,1189,1140,15,5213,2039,2034,4073,1125
2024-04-21,LE,Spain,6348,1135,1299,17,5213,1967,1947,3914,1282
2024-04-22,LE,Spain,6212,1153,1333,25,5059,1866,1860,3726,1308
2024-04-23,LE,Spain,6060,1102,1307,34,4958,1823,1828,3651,1273
2024-04-24,LE,Spain,6109,1101,1358,31,5008,1819,1831,3650,1327
2024-04-25,LE,Spain,5746,835,1374,42,4911,1768,1769,3537,1332
2024-04-26,LE,Spain,6433,1152,1428,24,5281,1911,1942,3853,1404
2024-04-27,LE,Spain,6477,1161,1152,8,5316,2072,2092,4164,1144
2024-04-28,LE,Spain,6362,1146,1264,9,5216,1999,1953,3952,1255
2024-04-29,LE,Spain,6169,1112,1317,23,5057,1880,1860,3740,1294
2024-04-30,LE,Spain,6243,1134,1334,37,5109,1886,1889,3775,1297
2024-05-01,LE,Spain,6218,1167,1223,14,5051,1904,1924,3828,1209
2024-05-02,LE,Spain,6365,1217,1309,35,5148,1920,1919,3839,1274
2024-05-03,LE,Spain,6517,1162,1406,23,5355,1957,1992,3949,1383
2024-05-04,LE,Spain,6710,1203,1163,17,5507,2161,2183,4344,1146
2024-05-05,LE,Spain,6613,1176,1353,15,5437,2064,2020,4084,1338
2024-05-06,LE,Spain,6411,1145,1351,27,5266,1970,1945,3915,1324
2024-05-07,LE,Spain,6319,1136,1292,32,5183,1940,1951,3891,1260
2024-05-08,LE,Spain,6448,1138,1366,45,5310,1930,2014,3944,1321
2024-05-09,LE,Spain,6559,1143,1383,45,5416,2025,2008,4033,1338
2024-05-10,LE,Spain,6597,1122,1456,28,5475,2002,2017,4019,1428
2024-05-11,LE,Spain,6701,1240,1164,14,5461,2150,2147,4297,1150
2024-05-12,LE,Spain,6696,1190,1306,13,5506,2145,2055,4200,1293
2024-05-13,LE,Spain,6369,1096,1357,24,5273,1964,1952,3916,1333
2024-05-14,LE,Spain,6262,1121,1273,33,5141,1930,1938,3868,1240
2024-05-15,LE,Spain,6232,1096,1300,46,5136,1912,1924,3836,1254
2024-05-16,LE,Spain,6465,1143,1326,36,5322,1990,2006,3996,1290
2024-05-17,LE,Spain,6625,1097,1411,26,5528,2036,2081,4117,1385
2024-05-18,LE,Spain,6684,1176,1159,17,5508,2170,2179,4349,1142
2024-05-19,LE,Spain,6572,1139,1308,12,5433,2079,2046,4125,1296
2024-05-20,LE,Spain,6584,1184,1343,20,5400,2045,2012,4057,1323
2024-05-21,LE,Spain,6426,1168,1306,33,5258,1984,1968,3952,1273
2024-05-22,LE,Spain,6400,1147,1339,38,5253,1951,1963,3914,1301
2024-05-23,LE,Spain,6728,1195,1391,34,5533,2067,2075,4142,1357
2024-05-24,LE,Spain,6800,1152,1451,28,5648,2072,2125,4197,1423
2024-05-25,LE,Spain,6774,1141,1204,23,5633,2203,2226,4429,1181
2024-05-26,LE,Spain,6601,1082,1317,18,5519,2114,2088,4202,1299
2024-05-27,LE,Spain,6605,1141,1367,36,5464,2044,2053,4097,1331
2024-05-28,LE,Spain,6525,1120,1317,53,5405,2055,2033,4088,1264
2024-05-29,LE,Spain,6536,1117,1367,44,5419,2019,2033,4052,1323
2024-05-30,LE,Spain,6776,1232,1366,63,5544,2069,2109,4178,1303
2024-05-31,LE,Spain,6845,1116,1448,39,5729,2145,2136,4281,1409
2024-06-01,LE,Spain,6994,1218,1140,17,5776,2337,2299,4636,1123
2024-06-02,LE,Spain,7000,1162,1339,16,5838,2268,2231,4499,1323
2024-06-03,LE,Spain,6703,1191,1413,45,5512,2053,2046,4099,1368
2024-06-04,LE,Spain,6564,1139,1327,41,5425,2068,2030,4098,1286
2024-06-05,LE,Spain,6603,1145,1361,46,5458,2037,2060,4097,1315
2024-06-06,LE,Spain,6752,1175,1410,41,5577,2079,2088,4167,1369
2024-06-07,LE,Spain,6845,1134,1443,31,5711,2114,2154,4268,1412
2024-06-08,LE,Spain,6900,1228,1169,19,5672,2246,2257,4503,1150
2024-06-09,LE,Spain,6759,1150,1316,18,5609,2152,2141,4293,1298
2024-06-10,LE,Spain,6644,1145,1384,37,5499,2061,2054,4115,1347
2024-06-11,LE,Spain,6525,1144,1304,31,5381,2025,2052,4077,1273
2024-06-12,LE,Spain,6733,1157,1378,26,5576,2096,2102,4198,1352
2024-06-13,LE,Spain,6924,1217,1413,39,5707,2146,2148,4294,1374
2024-06-14,LE,Spain,7036,1131,1521,30,5905,2176,2208,4384,1491
2024-06-15,LE,Spain,7016,1226,1210,19,5790,2286,2294,4580,1191
2024-06-16,LE,Spain,6947,1198,1335,12,5749,2222,2192,4414,1323
2024-06-17,LE,Spain,6780,1163,1437,24,5617,2092,2088,4180,1413
2024-06-18,LE,Spain,6733,1173,1350,30,5560,2111,2099,4210,1320
2024-06-19,LE,Spain,6768,1137,1377,39,5631,2111,2143,4254,1338
2024-06-20,LE,Spain,7018,1226,1392,27,5792,2194,2206,4400,1365
2024-06-21,LE,Spain,7190,1157,1571,31,6033,2223,2239,4462,1540
2024-06-22,LE,Spain,7144,1252,1248,15,5892,2322,2322,4644,1233
2024-06-23,LE,Spain,7163,1278,1357,21,5885,2286,2242,4528,1336
2024-06-24,LE,Spain,6982,1242,1447,32,5740,2147,2146,4293,1415
2024-06-25,LE,Spain,6912,1238,1395,48,5674,2145,2134,4279,1347
2024-06-26,LE,Spain,6921,1190,1430,48,5731,2154,2147,4301,1382
2024-06-27,LE,Spain,7055,1259,1434,40,5796,2180,2182,4362,1394
2024-06-28,LE,Spain,7139,1184,1532,23,5955,2191,2232,4423,1509
2024-06-29,LE,Spain,7065,1223,1226,10,5842,2300,2316,4616,1216
2024-06-30,LE,Spain,7246,1285,1375,16,5961,2311,2275,4586,1359
2024-07-01,LE,Spain,7083,1208,1430,30,5875,2228,2217,4445,1400
2024-07-02,LE,Spain,7100,1276,1408,38,5824,2216,2200,4416,1370
2024-07-03,LE,Spain,7150,1264,1451,50,5886,2203,2232,4435,1401
2024-07-04,LE,Spain,7307,1335,1484,42,5972,2239,2249,4488,1442
2024-07-05,LE,Spain,7314,1245,1538,26,6069,2269,2262,4531,1512
2024-07-06,LE,Spain,7376,1299,1285,15,6077,2390,2402,4792,1270
2024-07-07,LE,Spain,7340,1285,1391,19,6055,2348,2316,4664,1372
2024-07-08,LE,Spain,7177,1250,1504,39,5927,2209,2214,4423,1465
2024-07-09,LE,Spain,7098,1248,1431,53,5850,2220,2199,4419,1378
2024-07-10,LE,Spain,7116,1206,1485,49,5910,2201,2224,4425,1436
2024-07-11,LE,Spain,7298,1287,1456,50,6011,2282,2273,4555,1406
2024-07-12,LE,Spain,7193,1233,1470,28,5960,2229,2261,4490,1442
2024-07-13,LE,Spain,7380,1292,1269,15,6088,2400,2419,4819,1254
2024-07-14,LE,Spain,7349,1279,1404,20,6070,2362,2304,4666,1384
2024-07-15,LE,Spain,7198,1257,1473,33,5941,2224,2244,4468,1440
2024-07-16,LE,Spain,7083,1265,1371,34,5818,2231,2216,4447,1337
2024-07-17,LE,Spain,7160,1218,1429,41,5942,2251,2262,4513,1388
2024-07-18,LE,Spain,7281,1268,1468,46,6013,2282,2263,4545,1422
2024-07-19,LE,Spain,6774,1083,1430,28,5691,2106,2155,4261,1402
2024-07-20,LE,Spain,7418,1311,1298,25,6107,2396,2413,4809,1273
2024-07-21,LE,Spain,7236,1287,1348,10,5949,2314,2287,4601,1338
2024-07-22,LE,Spain,7277,1296,1506,45,5981,2243,2232,4475,1461
2024-07-23,LE,Spain,7153,1299,1438,59,5854,2222,2194,4416,1379
2024-07-24,LE,Spain,7537,1636,1401,35,5901,2237,2263,4500,1366
2024-07-25,LE,Spain,7775,1777,1459,35,5998,2293,2246,4539,1424
2024-07-26,LE,Spain,7563,1557,1542,27,6006,2221,2243,4464,1515
2024-07-27,LE,Spain,7792,1661,1264,16,6131,2429,2438,4867,1248
2024-07-28,LE,Spain,7787,1717,1394,14,6070,2358,2318,4676,1380
2024-07-29,LE,Spain,7634,1707,1436,25,5927,2242,2249,4491,1411
2024-07-30,LE,Spain,7506,1661,1418,46,5845,2216,2211,4427,1372
2024-01-01,ES,Sweden,1285,761,90,2,524,214,220,434,88
2024-01-02,ES,Sweden,1463,787,206,3,676,234,236,470,203
2024-01-03,ES,Sweden,1488,812,195,5,676,236,245,481,190
2024-01-04,ES,Sweden,1549,796,234,5,753,258,261,519,229
2024-01-05,ES,Sweden,1551,795,197,13,756,281,278,559,184
2024-01-06,ES,Sweden,1275,761,70,5,514,221,223,444,65
2024-01-07,ES,Sweden,1642,901,212,5,741,262,267,529,207
2024-01-08,ES,Sweden,1583,760,244,21,823,295,284,579,223
2024-01-09,ES,Sweden,1325,631,242,15,694,225,227,452,227
2024-01-10,ES,Sweden,1396,704,255,13,692,218,219,437,242
2024-01-11,ES,Sweden,1422,697,248,14,725,237,240,477,234
2024-01-12,ES,Sweden,1631,840,236,9,791,281,274,555,227
2024-01-13,ES,Sweden,1179,731,71,2,448,190,187,377,69
2024-01-14,ES,Sweden,1553,869,193,5,684,242,249,491,188
2024-01-15,ES,Sweden,1545,767,254,5,778,265,259,524,249
2024-01-16,ES,Sweden,1338,656,261,7,682,209,212,421,254
2024-01-17,ES,Sweden,1355,696,249,4,659,200,210,410,245
2024-01-18,ES,Sweden,1545,764,292,13,781,248,241,489,279
2024-01-19,ES,Sweden,1711,875,284,5,836,275,277,552,279
2024-01-20,ES,Sweden,1245,770,83,8,475,197,195,392,75
2024-01-21,ES,Sweden,1547,888,192,1,659,231,236,467,191
2024-01-22,ES,Sweden,1598,818,264,13,780,257,259,516,251
2024-01-23,ES,Sweden,1440,704,276,4,736,230,230,460,272
2024-01-24,ES,Sweden,1519,776,284,7,743,230,229,459,277
2024-01-25,ES,Sweden,1620,792,318,15,828,257,253,510,303
2024-01-26,ES,Sweden,1735,891,270,1,844,287,287,574,269
2024-01-27,ES,Sweden,1216,765,68,0,451,190,193,383,68
2024-01-28,ES,Sweden,1555,863,201,8,692,240,251,491,193
2024-01-29,ES,Sweden,1666,808,293,14,858,286,279,565,279
2024-01-30,ES,Sweden,1378,652,272,10,726,226,228,454,262
2024-01-31,ES,Sweden,1545,766,309,13,779,237,233,470,296
2024-02-01,ES,Sweden,1428,655,291,9,773,242,240,482,282
2024-02-02,ES,Sweden,1628,784,289,11,844,277,278,555,278
2024-02-03,ES,Sweden,1285,763,93,2,522,215,214,429,91
2024-02-04,ES,Sweden,1620,910,221,2,710,240,249,489,219
2024-02-05,ES,Sweden,1718,835,304,9,883,293,286,579,295
2024-02-06,ES,Sweden,1444,701,281,9,743,234,228,462,272
2024-02-07,ES,Sweden,1483,717,327,12,766,213,226,439,315
2024-02-08,ES,Sweden,1629,760,347,5,869,265,257,522,342
2024-02-09,ES,Sweden,1703,790,317,13,913,299,297,596,304
2024-02-10,ES,Sweden,1245,730,82,2,515,214,219,433,80
2024-02-11,ES,Sweden,1546,809,221,4,737,253,263,516,217
2024-02-12,ES,Sweden,1620,775,281,4,845,287,277,564,277
2024-02-13,ES,Sweden,1466,732,286,14,734,223,225,448,272
2024-02-14,ES,Sweden,1580,785,313,15,795,238,244,482,298
2024-02-15,ES,Sweden,1689,852,320,8,837,262,255,517,312
2024-02-16,ES,Sweden,1818,932,293,6,886,298,295,593,287
2024-02-17,ES,Sweden,1294,744,96,5,550,231,223,454,91
2024-02-18,ES,Sweden,1726,969,215,8,757,269,273,542,207
2024-02-19,ES,Sweden,1731,847,292,8,884,293,299,592,284
2024-02-20,ES,Sweden,1455,696,296,20,759,230,233,463,276
2024-02-21,ES,Sweden,1621,828,284,9,793,256,253,509,275
2024-02-22,ES,Sweden,1720,854,312,15,866,273,281,554,297
2024-02-23,ES,Sweden,1867,946,286,5,921,319,316,635,281
2024-02-24,ES,Sweden,1451,839,97,3,612,266,249,515,94
2024-02-25,ES,Sweden,1742,973,220,2,769,273,276,549,218
2024-02-26,ES,Sweden,1692,820,276,9,872,297,299,596,267
2024-02-27,ES,Sweden,1489,743,264,9,746,239,243,482,255
2024-02-28,ES,Sweden,1609,841,273,8,768,247,248,495,265
2024-02-29,ES,Sweden,1688,847,312,13,841,268,261,529,299
2024-03-01,ES,Sweden,1886,963,297,4,923,311,315,626,293
2024-03-02,ES,Sweden,1403,811,84,1,592,250,258,508,83
2024-03-03,ES,Sweden,1639,843,238,4,796,280,278,558,234
2024-03-04,ES,Sweden,1761,822,321,18,939,311,307,618,303
2024-03-05,ES,Sweden,1545,710,318,10,835,255,262,517,308
2024-03-06,ES,Sweden,1656,761,341,17,895,281,273,554,324
2024-03-07,ES,Sweden,1673,752,357,18,921,282,282,564,339
2024-03-08,ES,Sweden,1822,890,327,16,932,304,301,605,311
2024-03-09,ES,Sweden,1283,732,100,6,551,226,225,451,94
2024-03-10,ES,Sweden,1623,863,219,8,760,272,269,541,211
2024-03-11,ES,Sweden,1744,830,302,11,914,308,304,612,291
2024-03-12,ES,Sweden,1537,718,320,12,819,244,255,499,308
2024-03-13,ES,Sweden,1674,815,332,17,859,260,267,527,315
2024-03-14,ES,Sweden,1816,865,373,22,951,292,286,578,351
2024-03-15,ES,Sweden,1916,935,329,12,981,327,325,652,317
2024-03-16,ES,Sweden,1374,784,103,3,590,242,245,487,100
2024-03-17,ES,Sweden,1682,899,234,4,783,276,273,549,230
2024-03-18,ES,Sweden,1826,875,329,17,951,310,312,622,312
2024-03-19,ES,Sweden,1639,771,334,19,868,269,265,534,315
2024-03-20,ES,Sweden,1740,867,341,15,873,262,270,532,326
2024-03-21,ES,Sweden,1842,863,375,24,979,305,299,604,351
2024-03-22,ES,Sweden,1931,963,326,15,968,317,325,642,311
2024-03-23,ES,Sweden,1373,815,98,4,558,234,226,460,94
2024-03-24,ES,Sweden,1687,948,235,10,739,248,256,504,225
2024-03-25,ES,Sweden,1773,902,288,9,871,286,297,583,279
2024-03-26,ES,Sweden,1597,783,300,12,814,261,253,514,288
2024-03-27,ES,Sweden,1689,789,327,26,900,286,287,573,301
2024-03-28,ES,Sweden,1796,895,290,8,901,311,300,611,282
2024-03-29,ES,Sweden,1550,878,126,5,672,273,273,546,121
2024-03-30,ES,Sweden,1222,725,60,2,497,220,217,437,58
2024-03-31,ES,Sweden,1567,880,136,5,687,275,276,551,131
2024-04-01,ES,Sweden,1678,904,188,11,774,294,292,586,177
2024-04-02,ES,Sweden,1753,900,245,10,853,306,302,608,235
2024-04-03,ES,Sweden,1837,944,264,9,893,312,317,629,255
2024-04-04,ES,Sweden,1867,978,279,17,889,306,304,610,262
2024-04-05,ES,Sweden,1940,1018,264,16,922,327,331,658,248
2024-04-06,ES,Sweden,1430,836,80,5,594,258,256,514,75
2024-04-07,ES,Sweden,1796,964,195,6,832,311,326,637,189
2024-04-08,ES,Sweden,1934,960,297,14,974,342,335,677,283
2024-04-09,ES,Sweden,1908,938,345,20,970,316,309,625,325
2024-04-10,ES,Sweden,1981,985,326,18,996,332,338,670,308
2024-04-11,ES,Sweden,1978,973,354,19,1005,329,322,651,335
2024-04-12,ES,Sweden,2008,1021,331,15,987,327,329,656,316
2024-04-13,ES,Sweden,1416,851,83,8,565,243,239,482,75
2024-04-14,ES,Sweden,1809,1015,201,1,794,293,300,593,200
2024-04-15,ES,Sweden,1946,981,309,13,965,336,320,656,296
2024-04-16,ES,Sweden,1887,918,337,13,969,314,318,632,324
2024-04-17,ES,Sweden,1919,915,337,22,1004,336,331,667,315
2024-04-18,ES,Sweden,1936,938,327,12,998,332,339,671,315
2024-04-19,ES,Sweden,1907,923,312,9,984,334,338,672,303
2024-04-20,ES,Sweden,1383,802,91,5,581,245,245,490,86
2024-04-21,ES,Sweden,1775,958,214,7,817,299,304,603,207
2024-04-22,ES,Sweden,1909,921,317,12,988,344,327,671,305
2024-04-23,ES,Sweden,1920,953,340,17,967,309,318,627,323
2024-04-24,ES,Sweden,2052,1021,357,20,1031,339,335,674,337
2024-04-25,ES,Sweden,1939,955,348,16,984,318,318,636,332
2024-04-26,ES,Sweden,1983,1027,307,13,956,321,328,649,294
2024-04-27,ES,Sweden,1484,913,90,3,571,239,242,481,87
2024-04-28,ES,Sweden,1829,1018,199,5,811,307,305,612,194
2024-04-29,ES,Sweden,1902,976,275,8,926,327,324,651,267
2024-04-30,ES,Sweden,1748,885,246,12,863,305,312,617,234
2024-05-01,ES,Sweden,1643,895,151,10,748,299,298,597,141
2024-05-02,ES,Sweden,1834,896,284,19,938,324,330,654,265
2024-05-03,ES,Sweden,1867,923,262,15,944,341,341,682,247
2024-05-04,ES,Sweden,1503,912,91,5,591,252,248,500,86
2024-05-05,ES,Sweden,1811,977,202,7,834,313,319,632,195
2024-05-06,ES,Sweden,1994,1024,288,16,970,344,338,682,272
2024-05-07,ES,Sweden,1952,970,302,17,982,338,342,680,285
2024-05-08,ES,Sweden,2045,1033,298,18,1012,361,353,714,280
2024-05-09,ES,Sweden,1744,982,161,7,762,298,303,601,154
2024-05-10,ES,Sweden,1719,892,196,10,827,313,318,631,186
2024-05-11,ES,Sweden,1504,897,72,9,607,268,267,535,63
2024-05-12,ES,Sweden,1882,977,208,4,905,349,348,697,204
2024-05-13,ES,Sweden,2062,987,323,11,1075,371,381,752,312
2024-05-14,ES,Sweden,1970,928,342,8,1042,356,344,700,334
2024-05-15,ES,Sweden,2032,970,337,10,1062,363,362,725,327
2024-05-16,ES,Sweden,2063,997,337,10,1066,372,357,729,327
2024-05-17,ES,Sweden,2042,994,316,8,1048,359,373,732,308
2024-05-18,ES,Sweden,1571,909,91,6,662,286,285,571,85
2024-05-19,ES,Sweden,1897,983,227,10,914,338,349,687,217
2024-05-20,ES,Sweden,2017,961,352,19,1056,360,344,704,333
2024-05-21,ES,Sweden,1948,918,347,21,1030,337,346,683,326
2024-05-22,ES,Sweden,2058,978,346,16,1080,369,365,734,330
2024-05-23,ES,Sweden,2086,1011,344,8,1075,370,361,731,336
2024-05-24,ES,Sweden,2039,979,321,9,1060,363,376,739,312
2024-05-25,ES,Sweden,1567,926,84,6,641,279,278,557,78
2024-05-26,ES,Sweden,1861,977,206,3,884,338,340,678,203
2024-05-27,ES,Sweden,2106,1065,314,10,1041,372,355,727,304
2024-05-28,ES,Sweden,1984,982,335,16,1002,327,340,667,319
2024-05-29,ES,Sweden,2191,1089,363,19,1102,370,369,739,344
2024-05-30,ES,Sweden,2131,1055,351,12,1076,359,366,725,339
2024-05-31,ES,Sweden,2053,965,329,18,1088,374,385,759,311
2024-06-01,ES,Sweden,1600,932,85,1,668,293,290,583,84
2024-06-02,ES,Sweden,1952,1010,200,5,942,368,374,742,195
2024-06-03,ES,Sweden,2136,1078,303,14,1058,388,367,755,289
2024-06-04,ES,Sweden,2051,1031,305,13,1020,351,364,715,292
2024-06-05,ES,Sweden,2149,1093,287,10,1056,388,381,769,277
2024-06-06,ES,Sweden,1980,1124,169,2,856,343,344,687,167
2024-06-07,ES,Sweden,2042,1107,222,7,935,349,364,713,215
2024-06-08,ES,Sweden,1679,1003,96,3,676,291,289,580,93
2024-06-09,ES,Sweden,2105,1157,215,6,948,362,371,733,209
2024-06-10,ES,Sweden,2152,1080,333,13,1072,371,368,739,320
2024-06-11,ES,Sweden,2076,1042,319,16,1034,356,359,715,303
2024-06-12,ES,Sweden,2288,1165,332,14,1123,394,397,791,318
2024-06-13,ES,Sweden,2267,1158,343,10,1109,386,380,766,333
2024-06-14,ES,Sweden,2263,1165,309,12,1098,392,397,789,297
2024-06-15,ES,Sweden,1791,1069,84,6,722,322,316,638,78
2024-06-16,ES,Sweden,2049,1122,196,3,927,365,366,731,193
2024-06-17,ES,Sweden,2197,1124,299,8,1073,388,386,774,291
2024-06-18,ES,Sweden,2076,1050,297,19,1026,367,362,729,278
2024-06-19,ES,Sweden,2249,1126,332,18,1123,393,398,791,314
2024-06-20,ES,Sweden,2180,1123,275,11,1057,392,390,782,264
2024-06-21,ES,Sweden,1819,1086,75,1,733,330,328,658,74
2024-06-22,ES,Sweden,1718,1091,55,0,627,280,292,572,55
2024-06-23,ES,Sweden,2022,1075,197,2,947,371,379,750,195
2024-06-24,ES,Sweden,2159,1081,302,7,1078,393,383,776,295
2024-06-25,ES,Sweden,2160,1070,329,15,1090,383,378,761,314
2024-06-26,ES,Sweden,2141,1067,311,7,1074,381,382,763,304
2024-06-27,ES,Sweden,2117,1082,300,13,1035,368,367,735,287
2024-06-28,ES,Sweden,2234,1205,280,8,1029,374,375,749,272
2024-06-29,ES,Sweden,1807,1094,97,0,713,309,307,616,97
2024-06-30,ES,Sweden,1940,1061,189,3,879,343,347,690,186
2024-07-01,ES,Sweden,2080,1147,212,12,933,364,357,721,200
2024-07-02,ES,Sweden,1954,1068,192,11,886,342,352,694,181
2024-07-03,ES,Sweden,2123,1179,219,7,944,363,362,725,212
2024-07-04,ES,Sweden,2112,1182,205,3,930,361,364,725,202
2024-07-05,ES,Sweden,2101,1168,201,8,933,368,364,732,193
2024-07-06,ES,Sweden,1791,1119,72,5,672,297,303,600,67
2024-07-07,ES,Sweden,2021,1165,152,5,856,354,350,704,147
2024-07-08,ES,Sweden,2034,1113,210,8,921,355,356,711,202
2024-07-09,ES,Sweden,1891,1000,192,11,891,350,349,699,181
2024-07-10,ES,Sweden,2050,1120,209,7,930,360,361,721,202
2024-07-11,ES,Sweden,2148,1198,230,13,950,360,360,720,217
2024-07-12,ES,Sweden,1990,1076,194,11,914,356,364,720,183
2024-07-13,ES,Sweden,1786,1068,90,2,718,315,313,628,88
2024-07-14,ES,Sweden,2025,1174,153,4,851,349,349,698,149
2024-07-15,ES,Sweden,2107,1175,204,10,932,369,359,728,194
2024-07-16,ES,Sweden,1864,1005,180,9,859,341,338,679,171
2024-07-17,ES,Sweden,2120,1200,196,11,920,368,356,724,185
2024-07-18,ES,Sweden,2023,1139,205,9,884,332,347,679,196
2024-07-19,ES,Sweden,1931,1059,183,6,872,345,344,689,177
2024-07-20,ES,Sweden,1723,1016,77,4,707,315,315,630,73
2024-07-21,ES,Sweden,2014,1158,140,2,856,353,363,716,138
2024-07-22,ES,Sweden,2010,1146,160,1,864,358,346,704,159
2024-07-23,ES,Sweden,1966,1108,167,4,858,342,349,691,163
2024-07-24,ES,Sweden,2049,1138,183,4,911,367,361,728,179
2024-07-25,ES,Sweden,2040,1151,181,10,889,352,356,708,171
2024-07-26,ES,Sweden,2001,1153,146,5,848,349,353,702,141
2024-07-27,ES,Sweden,1747,1072,73,3,675,303,299,602,70
2024-07-28,ES,Sweden,1937,1131,128,2,806,339,339,678,126
2024-07-29,ES,Sweden,1991,1105,179,7,886,357,350,707,172
2024-07-30,ES,Sweden,1868,993,183,7,875,343,349,692,176
2024-01-01,LS,Switzerland,2512,1418,24,0,1094,538,532,1070,24
2024-01-02,LS,Switzerland,2699,1481,47,2,1218,581,590,1171,45
2024-01-03,LS,Switzerland,2639,1488,49,4,1151,549,553,1102,45
2024-01-04,LS,Switzerland,2707,1499,45,5,1208,584,579,1163,40
2024-01-05,LS,Switzerland,2840,1557,37,1,1283,628,618,1246,36
2024-01-06,LS,Switzerland,2853,1517,34,1,1336,647,655,1302,33
2024-01-07,LS,Switzerland,2987,1602,35,0,1385,678,672,1350,35
2024-01-08,LS,Switzerland,2609,1436,46,1,1173,564,563,1127,45
2024-01-09,LS,Switzerland,2104,1146,30,0,958,466,462,928,30
2024-01-10,LS,Switzerland,2194,1190,50,0,1004,482,472,954,50
2024-01-11,LS,Switzerland,2257,1205,54,4,1052,490,508,998,50
2024-01-12,LS,Switzerland,2562,1313,61,2,1249,592,596,1188,59
2024-01-13,LS,Switzerland,2352,1228,34,2,1124,543,547,1090,32
2024-01-14,LS,Switzerland,2639,1315,39,2,1324,640,645,1285,37
2024-01-15,LS,Switzerland,2402,1129,60,1,1273,587,626,1213,59
2024-01-16,LS,Switzerland,2011,1003,65,8,1008,472,471,943,57
2024-01-17,LS,Switzerland,1843,902,36,0,941,456,449,905,36
2024-01-18,LS,Switzerland,2241,1087,41,1,1154,563,550,1113,40
2024-01-19,LS,Switzerland,2633,1285,56,4,1348,664,628,1292,52
2024-01-20,LS,Switzerland,2347,1233,33,2,1114,530,551,1081,31
2024-01-21,LS,Switzerland,2534,1286,46,2,1248,615,587,1202,44
2024-01-22,LS,Switzerland,2366,1252,44,1,1114,536,534,1070,43
2024-01-23,LS,Switzerland,1965,1031,56,3,934,438,440,878,53
2024-01-24,LS,Switzerland,2207,1199,49,2,1008,483,476,959,47
2024-01-25,LS,Switzerland,2352,1228,47,1,1124,536,541,1077,46
2024-01-26,LS,Switzerland,2709,1466,53,2,1243,582,608,1190,51
2024-01-27,LS,Switzerland,2478,1320,62,4,1158,543,553,1096,58
2024-01-28,LS,Switzerland,2654,1378,42,4,1276,629,605,1234,38
2024-01-29,LS,Switzerland,2507,1359,67,3,1148,545,536,1081,64
2024-01-30,LS,Switzerland,2048,1116,55,4,932,436,441,877,51
2024-01-31,LS,Switzerland,2170,1128,63,4,1042,496,483,979,59
2024-02-01,LS,Switzerland,2284,1185,43,3,1099,523,533,1056,40
2024-02-02,LS,Switzerland,2777,1512,63,7,1265,591,611,1202,56
2024-02-03,LS,Switzerland,2625,1443,44,2,1182,566,572,1138,42
2024-02-04,LS,Switzerland,2782,1497,43,1,1285,636,606,1242,42
2024-02-05,LS,Switzerland,2589,1394,51,2,1195,581,563,1144,49
2024-02-06,LS,Switzerland,2192,1182,43,5,1010,485,482,967,38
2024-02-07,LS,Switzerland,2113,1056,48,3,1057,496,513,1009,45
2024-02-08,LS,Switzerland,2501,1296,44,3,1205,585,576,1161,41
2024-02-09,LS,Switzerland,2786,1454,43,0,1332,653,636,1289,43
2024-02-10,LS,Switzerland,2805,1420,40,0,1385,655,690,1345,40
2024-02-11,LS,Switzerland,2716,1408,40,2,1308,620,648,1268,38
2024-02-12,LS,Switzerland,2539,1350,56,3,1189,578,555,1133,53
2024-02-13,LS,Switzerland,2237,1172,70,2,1065,494,501,995,68
2024-02-14,LS,Switzerland,2363,1235,53,3,1128,534,541,1075,50
2024-02-15,LS,Switzerland,2672,1398,57,4,1274,594,623,1217,53
2024-02-16,LS,Switzerland,2993,1596,51,3,1397,694,652,1346,48
2024-02-17,LS,Switzerland,3021,1547,56,1,1474,714,704,1418,55
2024-02-18,LS,Switzerland,3056,1489,55,2,1567,764,748,1512,53
2024-02-19,LS,Switzerland,2684,1449,48,5,1235,593,594,1187,43
2024-02-20,LS,Switzerland,2199,1115,56,3,1084,508,520,1028,53
2024-02-21,LS,Switzerland,2395,1235,70,2,1160,547,543,1090,68
2024-02-22,LS,Switzerland,2463,1224,44,3,1239,594,601,1195,41
2024-02-23,LS,Switzerland,2816,1478,54,4,1338,639,645,1284,50
2024-02-24,LS,Switzerland,2844,1491,42,0,1353,660,651,1311,42
2024-02-25,LS,Switzerland,2898,1490,55,2,1408,681,672,1353,53
2024-02-26,LS,Switzerland,2720,1442,39,3,1278,621,618,1239,36
2024-02-27,LS,Switzerland,2225,1159,33,0,1066,516,517,1033,33
2024-02-28,LS,Switzerland,2431,1277,43,3,1154,553,558,1111,40
2024-02-29,LS,Switzerland,2680,1370,60,0,1310,627,623,1250,60
2024-03-01,LS,Switzerland,2824,1529,29,0,1295,633,633,1266,29
2024-03-02,LS,Switzerland,2755,1466,33,0,1289,636,620,1256,33
2024-03-03,LS,Switzerland,2844,1495,34,0,1349,656,659,1315,34
2024-03-04,LS,Switzerland,2763,1480,36,0,1283,627,620,1247,36
2024-03-05,LS,Switzerland,2359,1286,45,3,1073,509,519,1028,42
2024-03-06,LS,Switzerland,2472,1339,39,2,1133,548,546,1094,37
2024-03-07,LS,Switzerland,2651,1327,61,4,1324,633,630,1263,57
2024-03-08,LS,Switzerland,2865,1448,67,4,1417,668,682,1350,63
2024-03-09,LS,Switzerland,2703,1435,32,0,1268,620,616,1236,32
2024-03-10,LS,Switzerland,2817,1520,31,3,1297,642,624,1266,28
2024-03-11,LS,Switzerland,2868,1564,50,6,1304,633,621,1254,44
2024-03-12,LS,Switzerland,2399,1280,51,4,1119,528,540,1068,47
2024-03-13,LS,Switzerland,2481,1314,46,4,1167,567,554,1121,42
2024-03-14,LS,Switzerland,2717,1420,57,5,1297,618,622,1240,52
2024-03-15,LS,Switzerland,3089,1671,61,5,1418,664,693,1357,56
2024-03-16,LS,Switzerland,2738,1533,31,1,1205,588,586,1174,30
2024-03-17,LS,Switzerland,2916,1593,39,2,1323,650,634,1284,37
2024-03-18,LS,Switzerland,2841,1595,38,0,1246,601,607,1208,38
2024-03-19,LS,Switzerland,2547,1389,62,5,1158,547,549,1096,57
2024-03-20,LS,Switzerland,2585,1402,50,2,1183,563,570,1133,48
2024-03-21,LS,Switzerland,2879,1573,67,4,1306,621,618,1239,63
2024-03-22,LS,Switzerland,3214,1787,73,2,1427,679,675,1354,71
2024-03-23,LS,Switzerland,2922,1712,26,1,1210,595,589,1184,25
2024-03-24,LS,Switzerland,2984,1744,23,0,1240,610,607,1217,23
2024-03-25,LS,Switzerland,2962,1697,56,3,1265,604,605,1209,53
2024-03-26,LS,Switzerland,2708,1554,62,0,1154,547,545,1092,62
2024-03-27,LS,Switzerland,2766,1601,30,1,1165,567,568,1135,29
2024-03-28,LS,Switzerland,2967,1639,46,3,1328,659,623,1282,43
2024-03-29,LS,Switzerland,3100,1801,25,0,1299,649,625,1274,25
2024-03-30,LS,Switzerland,2922,1708,28,4,1214,588,598,1186,24
2024-03-31,LS,Switzerland,3075,1899,19,0,1176,574,583,1157,19
2024-04-01,LS,Switzerland,3294,1976,36,1,1318,639,643,1282,35
2024-04-02,LS,Switzerland,3127,1837,54,3,1290,615,621,1236,51
2024-04-03,LS,Switzerland,3117,1935,44,1,1182,570,568,1138,43
2024-04-04,LS,Switzerland,3252,1967,45,1,1285,622,618,1240,44
2024-04-05,LS,Switzerland,3351,2021,52,1,1330,647,631,1278,51
2024-04-06,LS,Switzerland,3358,2104,30,0,1254,608,616,1224,30
2024-04-07,LS,Switzerland,3527,2200,25,3,1327,642,660,1302,22
2024-04-08,LS,Switzerland,3336,2024,47,0,1312,641,624,1265,47
2024-04-09,LS,Switzerland,3059,1848,45,2,1211,572,594,1166,43
2024-04-10,LS,Switzerland,3223,1919,36,1,1304,639,629,1268,35
2024-04-11,LS,Switzerland,3405,2034,70,4,1371,655,646,1301,66
2024-04-12,LS,Switzerland,3450,2075,44,3,1375,667,664,1331,41
2024-04-13,LS,Switzerland,3352,2074,40,2,1278,630,608,1238,38
2024-04-14,LS,Switzerland,3553,2192,33,0,1361,649,679,1328,33
2024-04-15,LS,Switzerland,3371,2082,37,3,1289,626,626,1252,34
2024-04-16,LS,Switzerland,3121,1905,35,1,1216,588,593,1181,34
2024-04-17,LS,Switzerland,3335,2088,38,2,1247,603,606,1209,36
2024-04-18,LS,Switzerland,3332,2051,32,4,1281,624,625,1249,28
2024-04-19,LS,Switzerland,3563,2181,49,1,1382,673,660,1333,48
2024-04-20,LS,Switzerland,3266,2125,23,1,1141,569,549,1118,22
2024-04-21,LS,Switzerland,3437,2153,21,1,1284,620,643,1263,20
2024-04-22,LS,Switzerland,3411,2096,41,1,1315,641,633,1274,40
2024-04-23,LS,Switzerland,3189,1953,48,0,1236,602,586,1188,48
2024-04-24,LS,Switzerland,3312,2039,43,5,1273,621,609,1230,38
2024-04-25,LS,Switzerland,2819,1592,55,2,1227,586,586,1172,53
2024-04-26,LS,Switzerland,3456,2069,51,3,1387,672,664,1336,48
2024-04-27,LS,Switzerland,3277,2104,34,1,1173,579,560,1139,33
2024-04-28,LS,Switzerland,3341,2096,24,1,1245,595,626,1221,23
2024-04-29,LS,Switzerland,3413,2092,48,0,1321,642,631,1273,48
2024-04-30,LS,Switzerland,3167,1916,55,4,1251,591,605,1196,51
2024-05-01,LS,Switzerland,3211,1955,73,4,1256,594,589,1183,69
2024-05-02,LS,Switzerland,3312,2081,45,2,1231,592,594,1186,43
2024-05-03,LS,Switzerland,3492,2158,40,1,1334,644,650,1294,39
2024-05-04,LS,Switzerland,3421,2252,29,0,1169,576,564,1140,29
2024-05-05,LS,Switzerland,3584,2276,29,2,1308,627,652,1279,27
2024-05-06,LS,Switzerland,3591,2260,36,0,1331,655,640,1295,36
2024-05-07,LS,Switzerland,3381,2128,42,3,1253,605,606,1211,39
2024-05-08,LS,Switzerland,3750,2289,63,3,1461,716,682,1398,60
2024-05-09,LS,Switzerland,3513,2229,33,0,1284,645,606,1251,33
2024-05-10,LS,Switzerland,3507,2202,39,1,1305,628,638,1266,38
2024-05-11,LS,Switzerland,3498,2347,31,1,1151,556,564,1120,30
2024-05-12,LS,Switzerland,3913,2441,27,2,1472,695,750,1445,25
2024-05-13,LS,Switzerland,3623,2239,45,2,1384,673,666,1339,43
2024-05-14,LS,Switzerland,3302,2007,52,0,1295,624,619,1243,52
2024-05-15,LS,Switzerland,3459,2134,48,1,1325,633,644,1277,47
2024-05-16,LS,Switzerland,3549,2182,49,1,1367,669,649,1318,48
2024-05-17,LS,Switzerland,3869,2393,53,5,1476,726,697,1423,48
2024-05-18,LS,Switzerland,3493,2305,42,2,1188,592,554,1146,40
2024-05-19,LS,Switzerland,3634,2375,23,2,1259,611,625,1236,21
2024-05-20,LS,Switzerland,3676,2282,31,0,1394,646,717,1363,31
2024-05-21,LS,Switzerland,3491,2173,38,1,1318,648,632,1280,37
2024-05-22,LS,Switzerland,3674,2319,55,1,1355,654,646,1300,54
2024-05-23,LS,Switzerland,3734,2312,66,5,1422,675,681,1356,61
2024-05-24,LS,Switzerland,3886,2418,49,1,1468,721,698,1419,48
2024-05-25,LS,Switzerland,3469,2259,29,1,1210,587,594,1181,28
2024-05-26,LS,Switzerland,3796,2403,45,3,1393,654,694,1348,42
2024-05-27,LS,Switzerland,3904,2470,52,2,1434,689,693,1382,50
2024-05-28,LS,Switzerland,3627,2211,64,4,1416,678,674,1352,60
2024-05-29,LS,Switzerland,3724,2304,52,1,1420,690,678,1368,51
2024-05-30,LS,Switzerland,3707,2344,35,3,1363,681,647,1328,32
2024-05-31,LS,Switzerland,3870,2465,40,4,1405,693,672,1365,36
2024-06-01,LS,Switzerland,3697,2458,28,1,1239,607,604,1211,27
2024-06-02,LS,Switzerland,3920,2533,30,0,1387,670,687,1357,30
2024-06-03,LS,Switzerland,3791,2412,36,2,1379,672,671,1343,34
2024-06-04,LS,Switzerland,3692,2346,71,7,1346,629,646,1275,64
2024-06-05,LS,Switzerland,3784,2381,60,2,1403,671,672,1343,58
2024-06-06,LS,Switzerland,3706,2297,54,1,1409,671,684,1355,53
2024-06-07,LS,Switzerland,3927,2458,60,4,1469,721,688,1409,56
2024-06-08,LS,Switzerland,3706,2473,36,3,1233,602,595,1197,33
2024-06-09,LS,Switzerland,3705,2449,18,2,1256,616,622,1238,16
2024-06-10,LS,Switzerland,4055,2600,68,0,1455,681,706,1387,68
2024-06-11,LS,Switzerland,3700,2379,52,2,1321,643,626,1269,50
2024-06-12,LS,Switzerland,3930,2473,80,2,1457,688,689,1377,78
2024-06-13,LS,Switzerland,3990,2551,60,3,1439,696,683,1379,57
2024-06-14,LS,Switzerland,4007,2511,39,4,1496,739,718,1457,35
2024-06-15,LS,Switzerland,3695,2439,22,3,1256,605,629,1234,19
2024-06-16,LS,Switzerland,3885,2459,27,2,1426,707,692,1399,25
2024-06-17,LS,Switzerland,3880,2471,38,2,1409,676,695,1371,36
2024-06-18,LS,Switzerland,3760,2356,56,5,1404,667,681,1348,51
2024-06-19,LS,Switzerland,3979,2501,61,5,1478,707,710,1417,56
2024-06-20,LS,Switzerland,3829,2381,63,2,1448,701,684,1385,61
2024-06-21,LS,Switzerland,3876,2476,46,2,1400,690,664,1354,44
2024-06-22,LS,Switzerland,3851,2588,33,1,1263,614,616,1230,32
2024-06-23,LS,Switzerland,3911,2501,34,0,1410,682,694,1376,34
2024-06-24,LS,Switzerland,3911,2442,60,1,1469,698,711,1409,59
2024-06-25,LS,Switzerland,3523,2239,51,2,1284,622,611,1233,49
2024-06-26,LS,Switzerland,3522,2216,52,3,1306,633,621,1254,49
2024-06-27,LS,Switzerland,3924,2496,62,2,1428,677,689,1366,60
2024-06-28,LS,Switzerland,4070,2541,57,2,1529,745,727,1472,55
2024-06-29,LS,Switzerland,3482,2217,28,1,1265,628,609,1237,27
2024-06-30,LS,Switzerland,4125,2655,29,0,1470,711,730,1441,29
2024-07-01,LS,Switzerland,4077,2627,57,6,1450,696,697,1393,51
2024-07-02,LS,Switzerland,3939,2521,72,3,1418,672,674,1346,69
2024-07-03,LS,Switzerland,3789,2390,56,4,1399,676,667,1343,52
2024-07-04,LS,Switzerland,3857,2431,56,3,1426,685,685,1370,53
2024-07-05,LS,Switzerland,4071,2551,47,5,1520,738,735,1473,42
2024-07-06,LS,Switzerland,3860,2574,31,1,1286,637,618,1255,30
2024-07-07,LS,Switzerland,4059,2612,26,0,1447,698,723,1421,26
2024-07-08,LS,Switzerland,3970,2509,45,0,1461,703,713,1416,45
2024-07-09,LS,Switzerland,3828,2453,55,6,1375,657,663,1320,49
2024-07-10,LS,Switzerland,3996,2609,48,4,1387,683,656,1339,44
2024-07-11,LS,Switzerland,3961,2521,59,7,1440,691,690,1381,52
2024-07-12,LS,Switzerland,3821,2433,35,0,1388,690,663,1353,35
2024-07-13,LS,Switzerland,4034,2698,40,4,1336,657,639,1296,36
2024-07-14,LS,Switzerland,4029,2583,36,2,1446,695,715,1410,34
2024-07-15,LS,Switzerland,3991,2518,50,2,1473,697,726,1423,48
2024-07-16,LS,Switzerland,3834,2467,35,1,1367,668,664,1332,34
2024-07-17,LS,Switzerland,4100,2675,55,2,1425,693,677,1370,53
2024-07-18,LS,Switzerland,3916,2494,54,2,1422,679,689,1368,52
2024-07-19,LS,Switzerland,3738,2407,58,3,1331,647,626,1273,55
2024-07-20,LS,Switzerland,4013,2639,43,3,1374,665,666,1331,40
2024-07-21,LS,Switzerland,4054,2696,28,1,1358,655,675,1330,27
2024-07-22,LS,Switzerland,4022,2553,64,6,1469,701,704,1405,58
2024-07-23,LS,Switzerland,3895,2558,42,1,1337,649,646,1295,41
2024-07-24,LS,Switzerland,3970,2566,66,3,1404,671,667,1338,63
2024-07-25,LS,Switzerland,4000,2594,40,1,1406,680,686,1366,39
2024-07-26,LS,Switzerland,4094,2653,58,6,1441,702,681,1383,52
2024-07-27,LS,Switzerland,4063,2694,45,5,1369,651,673,1324,40
2024-07-28,LS,Switzerland,4185,2731,35,1,1454,714,705,1419,34
2024-07-29,LS,Switzerland,3990,2530,48,1,1460,695,717,1412,47
2024-07-30,LS,Switzerland,3829,2477,46,0,1352,668,638,1306,46
2024-01-01,LT,Türkiye,3619,1274,750,0,2345,799,796,1595,750
2024-01-02,LT,Türkiye,3863,1363,730,4,2500,889,881,1770,726
2024-01-03,LT,Türkiye,3876,1403,754,4,2473,856,863,1719,750
2024-01-04,LT,Türkiye,3876,1459,714,4,2417,860,843,1703,710
2024-01-05,LT,Türkiye,4104,1462,794,4,2642,936,912,1848,790
2024-01-06,LT,Türkiye,4133,1469,748,7,2664,948,968,1916,741
2024-01-07,LT,Türkiye,4148,1486,762,4,2662,948,952,1900,758
2024-01-08,LT,Türkiye,3807,1344,757,4,2463,847,859,1706,753
2024-01-09,LT,Türkiye,3674,1352,693,4,2322,809,820,1629,689
2024-01-10,LT,Türkiye,3720,1381,717,7,2339,814,808,1622,710
2024-01-11,LT,Türkiye,3769,1414,737,9,2355,808,810,1618,728
2024-01-12,LT,Türkiye,3830,1425,756,3,2405,833,816,1649,753
2024-01-13,LT,Türkiye,3860,1414,743,2,2446,850,853,1703,741
2024-01-14,LT,Türkiye,3918,1463,764,1,2455,850,841,1691,763
2024-01-15,LT,Türkiye,3611,1305,759,3,2306,763,784,1547,756
2024-01-16,LT,Türkiye,3504,1309,704,4,2195,747,744,1491,700
2024-01-17,LT,Türkiye,3565,1291,759,5,2274,758,757,1515,754
2024-01-18,LT,Türkiye,3723,1369,771,3,2354,797,786,1583,768
2024-01-19,LT,Türkiye,3907,1380,851,3,2527,846,830,1676,848
2024-01-20,LT,Türkiye,3955,1372,832,5,2583,863,888,1751,827
2024-01-21,LT,Türkiye,4029,1483,841,1,2546,855,850,1705,840
2024-01-22,LT,Türkiye,3683,1301,817,4,2382,780,785,1565,813
2024-01-23,LT,Türkiye,3548,1292,759,3,2256,745,752,1497,756
2024-01-24,LT,Türkiye,3698,1371,787,2,2327,775,765,1540,785
2024-01-25,LT,Türkiye,3790,1405,830,3,2385,774,781,1555,827
2024-01-26,LT,Türkiye,3782,1351,853,8,2431,788,790,1578,845
2024-01-27,LT,Türkiye,3780,1350,813,3,2430,808,809,1617,810
2024-01-28,LT,Türkiye,3991,1460,854,3,2531,844,833,1677,851
2024-01-29,LT,Türkiye,3574,1249,807,3,2325,752,766,1518,804
2024-01-30,LT,Türkiye,3596,1330,741,1,2266,761,764,1525,740
2024-01-31,LT,Türkiye,3705,1349,798,5,2356,774,784,1558,793
2024-02-01,LT,Türkiye,3693,1318,842,7,2375,778,755,1533,835
2024-02-02,LT,Türkiye,3959,1395,898,4,2564,842,824,1666,894
2024-02-03,LT,Türkiye,3964,1400,856,2,2564,841,867,1708,854
2024-02-04,LT,Türkiye,4032,1419,889,4,2613,863,861,1724,885
2024-02-05,LT,Türkiye,3711,1304,843,2,2407,768,796,1564,841
2024-02-06,LT,Türkiye,3557,1241,796,1,2316,761,759,1520,795
2024-02-07,LT,Türkiye,3633,1288,816,4,2345,764,765,1529,812
2024-02-08,LT,Türkiye,3811,1412,838,2,2399,787,774,1561,836
2024-02-09,LT,Türkiye,3932,1408,871,7,2524,836,817,1653,864
2024-02-10,LT,Türkiye,3932,1432,810,1,2500,831,859,1690,809
2024-02-11,LT,Türkiye,4030,1434,849,2,2596,875,872,1747,847
2024-02-12,LT,Türkiye,3606,1276,812,7,2330,752,766,1518,805
2024-02-13,LT,Türkiye,3531,1275,755,3,2256,751,750,1501,752
2024-02-14,LT,Türkiye,3641,1327,788,4,2314,755,771,1526,784
2024-02-15,LT,Türkiye,3824,1399,829,2,2425,809,787,1596,827
2024-02-16,LT,Türkiye,3908,1393,857,5,2515,837,821,1658,852
2024-02-17,LT,Türkiye,3970,1412,824,2,2558,859,875,1734,822
2024-02-18,LT,Türkiye,4140,1527,839,0,2613,899,875,1774,839
2024-02-19,LT,Türkiye,3674,1299,805,1,2375,761,809,1570,804
2024-02-20,LT,Türkiye,3655,1354,752,3,2301,785,764,1549,749
2024-02-21,LT,Türkiye,3714,1365,777,3,2349,795,777,1572,774
2024-02-22,LT,Türkiye,3826,1392,806,2,2434,812,816,1628,804
2024-02-23,LT,Türkiye,3935,1444,822,2,2491,847,822,1669,820
2024-02-24,LT,Türkiye,3943,1457,778,3,2486,837,871,1708,775
2024-02-25,LT,Türkiye,4146,1540,815,1,2606,905,886,1791,814
2024-02-26,LT,Türkiye,3694,1317,795,3,2377,782,800,1582,792
2024-02-27,LT,Türkiye,3664,1395,744,3,2269,762,763,1525,741
2024-02-28,LT,Türkiye,3749,1423,787,4,2326,775,764,1539,783
2024-02-29,LT,Türkiye,3919,1503,789,4,2416,806,821,1627,785
2024-03-01,LT,Türkiye,4015,1447,846,4,2568,866,856,1722,842
2024-03-02,LT,Türkiye,4056,1514,793,1,2542,874,875,1749,792
2024-03-03,LT,Türkiye,4181,1589,837,1,2592,885,870,1755,836
2024-03-04,LT,Türkiye,3749,1334,803,1,2415,795,817,1612,802
2024-03-05,LT,Türkiye,3690,1371,760,2,2319,786,773,1559,758
2024-03-06,LT,Türkiye,3790,1426,793,2,2364,788,783,1571,791
2024-03-07,LT,Türkiye,3871,1438,801,0,2433,829,803,1632,801
2024-03-08,LT,Türkiye,3934,1405,819,2,2529,847,863,1710,817
2024-03-09,LT,Türkiye,3953,1434,783,1,2519,866,870,1736,782
2024-03-10,LT,Türkiye,4132,1549,810,1,2583,886,887,1773,809
2024-03-11,LT,Türkiye,3678,1374,742,1,2304,773,789,1562,741
2024-03-12,LT,Türkiye,3500,1368,666,4,2132,732,734,1466,662
2024-03-13,LT,Türkiye,3618,1403,716,3,2215,744,755,1499,713
2024-03-14,LT,Türkiye,3715,1477,731,1,2238,763,744,1507,730
2024-03-15,LT,Türkiye,3908,1458,769,1,2450,845,836,1681,768
2024-03-16,LT,Türkiye,3941,1505,737,5,2436,843,856,1699,732
2024-03-17,LT,Türkiye,4072,1571,754,1,2501,887,860,1747,753
2024-03-18,LT,Türkiye,3737,1399,751,2,2338,787,800,1587,749
2024-03-19,LT,Türkiye,3576,1358,659,5,2218,774,785,1559,654
2024-03-20,LT,Türkiye,3749,1446,719,2,2303,796,788,1584,717
2024-03-21,LT,Türkiye,3856,1473,753,2,2383,822,808,1630,751
2024-03-22,LT,Türkiye,4011,1439,763,2,2572,906,903,1809,761
2024-03-23,LT,Türkiye,4097,1539,713,3,2558,913,932,1845,710
2024-03-24,LT,Türkiye,4146,1501,785,3,2645,932,928,1860,782
2024-03-25,LT,Türkiye,3874,1407,772,5,2467,841,854,1695,767
2024-03-26,LT,Türkiye,3822,1387,713,2,2435,859,863,1722,711
2024-03-27,LT,Türkiye,3973,1505,738,4,2468,864,866,1730,734
2024-03-28,LT,Türkiye,4116,1560,770,6,2556,906,880,1786,764
2024-03-29,LT,Türkiye,4270,1522,824,5,2748,970,954,1924,819
2024-03-30,LT,Türkiye,4261,1565,768,1,2696,955,973,1928,767
2024-03-31,LT,Türkiye,4410,1558,816,2,2852,1021,1015,2036,814
2024-04-01,LT,Türkiye,4291,1455,913,2,2836,959,964,1923,911
2024-04-02,LT,Türkiye,4233,1508,903,7,2725,904,918,1822,896
2024-04-03,LT,Türkiye,4253,1518,897,2,2735,917,921,1838,895
2024-04-04,LT,Türkiye,4383,1572,917,4,2811,955,939,1894,913
2024-04-05,LT,Türkiye,4509,1472,952,4,3037,1048,1037,2085,948
2024-04-06,LT,Türkiye,4684,1604,960,6,3080,1057,1063,2120,954
2024-04-07,LT,Türkiye,4588,1569,904,1,3019,1061,1054,2115,903
2024-04-08,LT,Türkiye,4277,1471,912,1,2806,947,947,1894,911
2024-04-09,LT,Türkiye,4214,1467,868,2,2747,939,940,1879,866
2024-04-10,LT,Türkiye,4292,1549,861,2,2743,938,944,1882,859
2024-04-11,LT,Türkiye,4354,1546,890,3,2808,959,959,1918,887
2024-04-12,LT,Türkiye,4469,1527,894,0,2942,1038,1010,2048,894
2024-04-13,LT,Türkiye,4607,1541,961,15,3066,1016,1089,2105,946
2024-04-14,LT,Türkiye,4410,1248,999,1,3162,1098,1065,2163,998
2024-04-15,LT,Türkiye,4291,1376,948,3,2915,980,987,1967,945
2024-04-16,LT,Türkiye,4257,1425,886,3,2832,969,977,1946,883
2024-04-17,LT,Türkiye,4161,1360,888,3,2801,953,960,1913,885
2024-04-18,LT,Türkiye,4371,1486,891,7,2885,1005,989,1994,884
2024-04-19,LT,Türkiye,4392,1374,909,9,3018,1056,1053,2109,900
2024-04-20,LT,Türkiye,4478,1448,866,5,3030,1078,1086,2164,861
2024-04-21,LT,Türkiye,4572,1531,872,6,3041,1087,1082,2169,866
2024-04-22,LT,Türkiye,4218,1358,909,3,2860,979,972,1951,906
2024-04-23,LT,Türkiye,4136,1342,869,5,2794,960,965,1925,864
2024-04-24,LT,Türkiye,4369,1500,880,3,2869,987,1002,1989,877
2024-04-25,LT,Türkiye,4479,1512,868,6,2967,1058,1041,2099,862
2024-04-26,LT,Türkiye,4728,1502,898,3,3226,1176,1152,2328,895
2024-04-27,LT,Türkiye,4924,1586,873,1,3338,1227,1238,2465,872
2024-04-28,LT,Türkiye,4871,1578,847,7,3293,1226,1220,2446,840
2024-04-29,LT,Türkiye,4462,1421,901,2,3041,1065,1075,2140,899
2024-04-30,LT,Türkiye,4558,1535,864,10,3023,1075,1084,2159,854
2024-05-01,LT,Türkiye,4703,1564,898,6,3139,1125,1116,2241,892
2024-05-02,LT,Türkiye,4619,1486,891,4,3133,1121,1121,2242,887
2024-05-03,LT,Türkiye,4805,1482,886,0,3323,1219,1218,2437,886
2024-05-04,LT,Türkiye,4978,1594,893,9,3384,1246,1245,2491,884
2024-05-05,LT,Türkiye,4958,1611,873,2,3347,1233,1241,2474,871
2024-05-06,LT,Türkiye,4577,1475,907,4,3102,1102,1093,2195,903
2024-05-07,LT,Türkiye,4544,1521,856,0,3023,1070,1097,2167,856
2024-05-08,LT,Türkiye,4717,1537,881,2,3180,1155,1144,2299,879
2024-05-09,LT,Türkiye,4755,1560,873,3,3195,1161,1161,2322,870
2024-05-10,LT,Türkiye,4871,1523,866,3,3348,1244,1238,2482,863
2024-05-11,LT,Türkiye,5073,1646,868,1,3427,1274,1285,2559,867
2024-05-12,LT,Türkiye,5037,1608,902,5,3429,1258,1269,2527,897
2024-05-13,LT,Türkiye,4633,1504,873,3,3129,1134,1122,2256,870
2024-05-14,LT,Türkiye,4595,1555,841,1,3040,1090,1109,2199,840
2024-05-15,LT,Türkiye,4763,1578,893,2,3185,1151,1141,2292,891
2024-05-16,LT,Türkiye,4791,1575,891,6,3216,1172,1153,2325,885
2024-05-17,LT,Türkiye,4925,1501,886,6,3424,1272,1266,2538,880
2024-05-18,LT,Türkiye,5197,1688,862,3,3509,1327,1320,2647,859
2024-05-19,LT,Türkiye,5095,1617,858,2,3478,1297,1323,2620,856
2024-05-20,LT,Türkiye,4750,1512,895,3,3238,1173,1170,2343,892
2024-05-21,LT,Türkiye,4646,1508,854,3,3138,1128,1156,2284,851
2024-05-22,LT,Türkiye,4806,1582,861,3,3224,1187,1176,2363,858
2024-05-23,LT,Türkiye,4905,1565,878,2,3340,1245,1217,2462,876
2024-05-24,LT,Türkiye,4932,1452,918,2,3480,1283,1279,2562,916
2024-05-25,LT,Türkiye,5263,1678,901,3,3585,1333,1351,2684,898
2024-05-26,LT,Türkiye,5185,1638,892,2,3547,1320,1335,2655,890
2024-05-27,LT,Türkiye,4866,1534,897,1,3332,1210,1225,2435,896
2024-05-28,LT,Türkiye,4775,1518,870,5,3257,1195,1192,2387,865
2024-05-29,LT,Türkiye,5030,1619,881,2,3411,1265,1265,2530,879
2024-05-30,LT,Türkiye,5077,1570,932,1,3507,1293,1282,2575,931
2024-05-31,LT,Türkiye,5185,1522,937,3,3663,1370,1356,2726,934
2024-06-01,LT,Türkiye,5452,1656,896,2,3796,1452,1448,2900,894
2024-06-02,LT,Türkiye,5456,1701,906,1,3755,1424,1425,2849,905
2024-06-03,LT,Türkiye,5098,1582,900,1,3516,1314,1302,2616,899
2024-06-04,LT,Türkiye,4991,1612,871,6,3379,1253,1255,2508,865
2024-06-05,LT,Türkiye,5182,1633,881,0,3549,1323,1345,2668,881
2024-06-06,LT,Türkiye,5199,1649,907,5,3550,1327,1316,2643,902
2024-06-07,LT,Türkiye,5269,1557,962,6,3712,1378,1372,2750,956
2024-06-08,LT,Türkiye,5538,1710,933,1,3828,1441,1454,2895,932
2024-06-09,LT,Türkiye,5450,1691,905,0,3759,1428,1426,2854,905
2024-06-10,LT,Türkiye,5280,1626,961,3,3654,1352,1341,2693,958
2024-06-11,LT,Türkiye,5138,1571,923,2,3567,1310,1334,2644,921
2024-06-12,LT,Türkiye,5352,1617,971,6,3735,1396,1368,2764,965
2024-06-13,LT,Türkiye,5415,1629,1003,1,3786,1393,1390,2783,1002
2024-06-14,LT,Türkiye,5682,1662,1098,3,4020,1449,1473,2922,1095
2024-06-15,LT,Türkiye,6025,1798,1136,0,4227,1540,1551,3091,1136
2024-06-16,LT,Türkiye,5659,1740,1002,3,3919,1463,1454,2917,999
2024-06-17,LT,Türkiye,5367,1666,975,1,3701,1376,1350,2726,974
2024-06-18,LT,Türkiye,5226,1634,927,1,3592,1332,1333,2665,926
2024-06-19,LT,Türkiye,5588,1767,954,3,3821,1430,1437,2867,951
2024-06-20,LT,Türkiye,5599,1709,978,2,3890,1461,1451,2912,976
2024-06-21,LT,Türkiye,5569,1594,983,1,3975,1496,1496,2992,982
2024-06-22,LT,Türkiye,5904,1727,1035,4,4177,1563,1579,3142,1031
2024-06-23,LT,Türkiye,5869,1768,1038,1,4101,1539,1524,3063,1037
2024-06-24,LT,Türkiye,5609,1685,993,4,3924,1464,1467,2931,989
2024-06-25,LT,Türkiye,5397,1645,949,3,3752,1400,1403,2803,946
2024-06-26,LT,Türkiye,5465,1650,936,4,3815,1436,1443,2879,932
2024-06-27,LT,Türkiye,5596,1655,968,5,3941,1483,1490,2973,963
2024-06-28,LT,Türkiye,5753,1665,1024,4,4088,1534,1530,3064,1020
2024-06-29,LT,Türkiye,5870,1774,965,1,4096,1565,1566,3131,964
2024-06-30,LT,Türkiye,5868,1802,965,2,4066,1557,1544,3101,963
2024-07-01,LT,Türkiye,5744,1700,1007,1,4044,1511,1526,3037,1006
2024-07-02,LT,Türkiye,5494,1662,937,5,3832,1454,1441,2895,932
2024-07-03,LT,Türkiye,5777,1771,926,4,4006,1535,1545,3080,922
2024-07-04,LT,Türkiye,5724,1775,948,3,3949,1506,1495,3001,945
2024-07-05,LT,Türkiye,5736,1667,970,4,4069,1543,1556,3099,966
2024-07-06,LT,Türkiye,5921,1813,917,2,4108,1595,1596,3191,915
2024-07-07,LT,Türkiye,5897,1828,899,1,4069,1576,1594,3170,898
2024-07-08,LT,Türkiye,5638,1717,941,4,3921,1498,1482,2980,937
2024-07-09,LT,Türkiye,5513,1737,903,3,3776,1432,1441,2873,900
2024-07-10,LT,Türkiye,5656,1777,895,2,3879,1490,1494,2984,893
2024-07-11,LT,Türkiye,5696,1779,921,2,3917,1511,1485,2996,919
2024-07-12,LT,Türkiye,5726,1696,971,2,4030,1525,1534,3059,969
2024-07-13,LT,Türkiye,5901,1815,900,0,4086,1583,1603,3186,900
2024-07-14,LT,Türkiye,5866,1813,905,2,4053,1585,1563,3148,903
2024-07-15,LT,Türkiye,5724,1739,980,1,3985,1499,1506,3005,979
2024-07-16,LT,Türkiye,5563,1759,903,5,3804,1449,1452,2901,898
2024-07-17,LT,Türkiye,5709,1765,940,3,3944,1496,1508,3004,937
2024-07-18,LT,Türkiye,5635,1714,942,4,3921,1490,1489,2979,938
2024-07-19,LT,Türkiye,5481,1581,953,1,3900,1463,1484,2947,952
2024-07-20,LT,Türkiye,5828,1728,934,2,4100,1572,1594,3166,932
2024-07-21,LT,Türkiye,5803,1745,906,1,4058,1602,1550,3152,905
2024-07-22,LT,Türkiye,5652,1710,959,3,3942,1478,1505,2983,956
2024-07-23,LT,Türkiye,5472,1648,900,2,3824,1463,1461,2924,898
2024-07-24,LT,Türkiye,5718,1762,906,2,3956,1528,1522,3050,904
2024-07-25,LT,Türkiye,5707,1760,911,2,3947,1516,1520,3036,909
2024-07-26,LT,Türkiye,5718,1703,915,6,4015,1554,1546,3100,909
2024-07-27,LT,Türkiye,5879,1777,910,0,4102,1593,1599,3192,910
2024-07-28,LT,Türkiye,5815,1826,891,2,3989,1551,1547,3098,889
2024-07-29,LT,Türkiye,5601,1688,929,1,3913,1484,1500,2984,928
2024-07-30,LT,Türkiye,5568,1712,902,3,3856,1487,1467,2954,899
2024-01-01,UK,Ukraine,1,1,0,0,0,0,0,0,0
2024-01-02,UK,Ukraine,4,4,0,0,0,0,0,0,0
2024-01-03,UK,Ukraine,4,4,0,0,0,0,0,0,0
2024-01-04,UK,Ukraine,6,5,0,0,1,0,1,1,0
2024-01-05,UK,Ukraine,3,3,0,0,0,0,0,0,0
2024-01-06,UK,Ukraine,6,6,0,0,0,0,0,0,0
2024-01-07,UK,Ukraine,1,1,0,0,0,0,0,0,0
2024-01-08,UK,Ukraine,3,3,0,0,0,0,0,0,0
2024-01-09,UK,Ukraine,3,3,0,0,0,0,0,0,0
2024-01-10,UK,Ukraine,3,3,0,0,0,0,0,0,0
2024-01-11,UK,Ukraine,0,0,0,0,0,0,0,0,0
2024-01-12,UK,Ukraine,5,5,0,0,0,0,0,0,0
2024-01-13,UK,Ukraine,4,3,0,0,1,0,1,1,0
2024-01-14,UK,Ukraine,3,3,0,0,0,0,0,0,0
2024-01-15,UK,Ukraine,3,3,0,0,0,0,0,0,0
2024-01-16,UK,Ukraine,4,4,0,0,0,0,0,0,0
2024-01-17,UK,Ukraine,2,2,0,0,0,0,0,0,0
2024-01-18,UK,Ukraine,2,2,0,0,0,0,0,0,0
2024-01-19,UK,Ukraine,5,5,0,0,0,0,0,0,0
2024-01-20,UK,Ukraine,4,4,0,0,0,0,0,0,0
2024-01-21,UK,Ukraine,3,3,0,0,0,0,0,0,0
2024-01-22,UK,Ukraine,4,4,0,0,0,0,0,0,0
2024-01-23,UK,Ukraine,3,3,0,0,0,0,0,0,0
2024-01-24,UK,Ukraine,3,3,0,0,0,0,0,0,0
2024-01-25,UK,Ukraine,2,2,0,0,0,0,0,0,0
2024-01-26,UK,Ukraine,4,4,0,0,0,0,0,0,0
2024-01-27,UK,Ukraine,1,1,0,0,0,0,0,0,0
2024-01-28,UK,Ukraine,2,2,0,0,0,0,0,0,0
2024-01-29,UK,Ukraine,3,3,0,0,0,0,0,0,0
2024-01-30,UK,Ukraine,2,2,0,0,0,0,0,0,0
2024-01-31,UK,Ukraine,1,1,0,0,0,0,0,0,0
2024-02-01,UK,Ukraine,2,2,0,0,0,0,0,0,0
2024-02-02,UK,Ukraine,5,5,0,0,0,0,0,0,0
2024-02-03,UK,Ukraine,3,3,0,0,0,0,0,0,0
2024-02-04,UK,Ukraine,2,2,0,0,0,0,0,0,0
2024-02-05,UK,Ukraine,1,1,0,0,0,0,0,0,0
2024-02-06,UK,Ukraine,2,2,0,0,0,0,0,0,0
2024-02-07,UK,Ukraine,2,2,0,0,0,0,0,0,0
2024-02-08,UK,Ukraine,5,4,0,0,1,1,0,1,0
2024-02-09,UK,Ukraine,2,1,0,0,1,0,1,1,0
2024-02-10,UK,Ukraine,2,2,0,0,0,0,0,0,0
2024-02-11,UK,Ukraine,3,3,0,0,0,0,0,0,0
2024-02-12,UK,Ukraine,0,0,0,0,0,0,0,0,0
2024-02-13,UK,Ukraine,3,3,0,0,0,0,0,0,0
2024-02-14,UK,Ukraine,4,4,0,0,0,0,0,0,0
2024-02-15,UK,Ukraine,3,3,0,0,0,0,0,0,0
2024-02-16,UK,Ukraine,3,3,0,0,0,0,0,0,0
2024-02-17,UK,Ukraine,2,2,0,0,0,0,0,0,0
2024-02-18,UK,Ukraine,4,4,0,0,0,0,0,0,0
2024-02-19,UK,Ukraine,0,0,0,0,0,0,0,0,0
2024-02-20,UK,Ukraine,3,3,0,0,0,0,0,0,0
2024-02-21,UK,Ukraine,0,0,0,0,0,0,0,0,0
2024-02-22,UK,Ukraine,1,1,0,0,0,0,0,0,0
2024-02-23,UK,Ukraine,0,0,0,0,0,0,0,0,0
2024-02-24,UK,Ukraine,2,2,0,0,0,0,0,0,0
2024-02-25,UK,Ukraine,1,1,0,0,0,0,0,0,0
2024-02-26,UK,Ukraine,4,4,0,0,0,0,0,0,0
2024-02-27,UK,Ukraine,3,3,0,0,0,0,0,0,0
2024-02-28,UK,Ukraine,3,2,0,0,1,1,0,1,0
2024-02-29,UK,Ukraine,2,2,0,0,0,0,0,0,0
2024-03-01,UK,Ukraine,1,1,0,0,0,0,0,0,0
2024-03-02,UK,Ukraine,3,3,0,0,0,0,0,0,0
2024-03-03,UK,Ukraine,4,4,0,0,0,0,0,0,0
2024-03-04,UK,Ukraine,2,1,0,0,1,0,1,1,0
2024-03-05,UK,Ukraine,4,4,0,0,0,0,0,0,0
2024-03-06,UK,Ukraine,2,2,0,0,0,0,0,0,0
2024-03-07,UK,Ukraine,6,5,0,0,1,1,0,1,0
2024-03-08,UK,Ukraine,4,4,0,0,0,0,0,0,0
2024-03-09,UK,Ukraine,1,1,0,0,0,0,0,0,0
2024-03-10,UK,Ukraine,2,2,0,0,0,0,0,0,0
2024-03-11,UK,Ukraine,1,1,0,0,0,0,0,0,0
2024-03-12,UK,Ukraine,3,3,0,0,0,0,0,0,0
2024-03-13,UK,Ukraine,1,0,0,0,1,0,1,1,0
2024-03-14,UK,Ukraine,2,2,0,0,0,0,0,0,0
2024-03-15,UK,Ukraine,1,1,0,0,0,0,0,0,0
2024-03-16,UK,Ukraine,2,2,0,0,0,0,0,0,0
2024-03-17,UK,Ukraine,1,1,0,0,0,0,0,0,0
2024-03-18,UK,Ukraine,0,0,0,0,0,0,0,0,0
2024-03-19,UK,Ukraine,1,1,0,0,0,0,0,0,0
2024-03-20,UK,Ukraine,4,4,0,0,0,0,0,0,0
2024-03-21,UK,Ukraine,1,1,0,0,0,0,0,0,0
2024-03-22,UK,Ukraine,1,1,0,0,0,0,0,0,0
2024-03-23,UK,Ukraine,4,3,0,0,1,1,0,1,0
2024-03-24,UK,Ukraine,0,0,0,0,0,0,0,0,0
2024-03-25,UK,Ukraine,3,3,0,0,0,0,0,0,0
2024-03-26,UK,Ukraine,3,2,0,0,1,0,1,1,0
2024-03-27,UK,Ukraine,3,3,0,0,0,0,0,0,0
2024-03-28,UK,Ukraine,0,0,0,0,0,0,0,0,0
2024-03-29,UK,Ukraine,6,6,0,0,0,0,0,0,0
2024-03-30,UK,Ukraine,3,3,0,0,0,0,0,0,0
2024-03-31,UK,Ukraine,4,4,0,0,0,0,0,0,0
2024-04-01,UK,Ukraine,1,1,0,0,0,0,0,0,0
2024-04-02,UK,Ukraine,0,0,0,0,0,0,0,0,0
2024-04-03,UK,Ukraine,3,3,0,0,0,0,0,0,0
2024-04-04,UK,Ukraine,0,0,0,0,0,0,0,0,0
2024-04-05,UK,Ukraine,1,1,0,0,0,0,0,0,0
2024-04-06,UK,Ukraine,3,3,0,0,0,0,0,0,0
2024-04-07,UK,Ukraine,0,0,0,0,0,0,0,0,0
2024-04-08,UK,Ukraine,1,1,0,0,0,0,0,0,0
2024-04-09,UK,Ukraine,3,3,0,0,0,0,0,0,0
2024-04-10,UK,Ukraine,4,3,0,0,1,1,0,1,0
2024-04-11,UK,Ukraine,2,2,0,0,0,0,0,0,0
2024-04-12,UK,Ukraine,3,3,0,0,0,0,0,0,0
2024-04-13,UK,Ukraine,8,8,0,0,0,0,0,0,0
2024-04-14,UK,Ukraine,3,3,0,0,0,0,0,0,0
2024-04-15,UK,Ukraine,6,5,0,0,1,0,1,1,0
2024-04-16,UK,Ukraine,1,1,0,0,0,0,0,0,0
2024-04-17,UK,Ukraine,0,0,0,0,0,0,0,0,0
2024-04-18,UK,Ukraine,5,5,0,0,0,0,0,0,0
2024-04-19,UK,Ukraine,5,5,0,0,0,0,0,0,0
2024-04-20,UK,Ukraine,0,0,0,0,0,0,0,0,0
2024-04-21,UK,Ukraine,6,6,0,0,0,0,0,0,0
2024-04-22,UK,Ukraine,4,4,0,0,0,0,0,0,0
2024-04-23,UK,Ukraine,5,5,0,0,0,0,0,0,0
2024-04-24,UK,Ukraine,2,2,0,0,0,0,0,0,0
2024-04-25,UK,Ukraine,3,3,0,0,0,0,0,0,0
2024-04-26,UK,Ukraine,3,3,0,0,0,0,0,0,0
2024-04-27,UK,Ukraine,2,2,0,0,0,0,0,0,0
2024-04-28,UK,Ukraine,3,3,0,0,0,0,0,0,0
2024-04-29,UK,Ukraine,3,2,0,0,1,1,0,1,0
2024-04-30,UK,Ukraine,1,1,0,0,0,0,0,0,0
2024-05-01,UK,Ukraine,1,1,0,0,0,0,0,0,0
2024-05-02,UK,Ukraine,3,3,0,0,0,0,0,0,0
2024-05-03,UK,Ukraine,4,4,0,0,0,0,0,0,0
2024-05-04,UK,Ukraine,0,0,0,0,0,0,0,0,0
2024-05-05,UK,Ukraine,3,3,0,0,0,0,0,0,0
2024-05-06,UK,Ukraine,2,2,0,0,0,0,0,0,0
2024-05-07,UK,Ukraine,5,5,0,0,0,0,0,0,0
2024-05-08,UK,Ukraine,3,1,0,0,2,1,1,2,0
2024-05-09,UK,Ukraine,2,2,0,0,0,0,0,0,0
2024-05-10,UK,Ukraine,2,2,0,0,0,0,0,0,0
2024-05-11,UK,Ukraine,0,0,0,0,0,0,0,0,0
2024-05-12,UK,Ukraine,6,4,0,0,2,1,1,2,0
2024-05-13,UK,Ukraine,2,1,0,0,1,0,1,1,0
2024-05-14,UK,Ukraine,1,1,0,0,0,0,0,0,0
2024-05-15,UK,Ukraine,3,1,0,0,2,1,1,2,0
2024-05-16,UK,Ukraine,3,3,0,0,0,0,0,0,0
2024-05-17,UK,Ukraine,1,1,0,0,0,0,0,0,0
2024-05-18,UK,Ukraine,2,2,0,0,0,0,0,0,0
2024-05-19,UK,Ukraine,2,2,0,0,0,0,0,0,0
2024-05-20,UK,Ukraine,0,0,0,0,0,0,0,0,0
2024-05-21,UK,Ukraine,3,3,0,0,0,0,0,0,0
2024-05-22,UK,Ukraine,2,2,0,0,0,0,0,0,0
2024-05-23,UK,Ukraine,6,6,0,0,0,0,0,0,0
2024-05-24,UK,Ukraine,5,5,0,0,0,0,0,0,0
2024-05-25,UK,Ukraine,1,1,0,0,0,0,0,0,0
2024-05-26,UK,Ukraine,1,1,0,0,0,0,0,0,0
2024-05-27,UK,Ukraine,1,1,0,0,0,0,0,0,0
2024-05-28,UK,Ukraine,2,2,0,0,0,0,0,0,0
2024-05-29,UK,Ukraine,2,2,0,0,0,0,0,0,0
2024-05-30,UK,Ukraine,1,1,0,0,0,0,0,0,0
2024-05-31,UK,Ukraine,2,2,0,0,0,0,0,0,0
2024-06-01,UK,Ukraine,2,2,0,0,0,0,0,0,0
2024-06-02,UK,Ukraine,3,3,0,0,0,0,0,0,0
2024-06-03,UK,Ukraine,1,1,0,0,0,0,0,0,0
2024-06-04,UK,Ukraine,1,1,0,0,0,0,0,0,0
2024-06-05,UK,Ukraine,0,0,0,0,0,0,0,0,0
2024-06-06,UK,Ukraine,3,3,0,0,0,0,0,0,0
2024-06-07,UK,Ukraine,2,1,0,0,1,1,0,1,0
2024-06-08,UK,Ukraine,5,3,0,0,2,0,2,2,0
2024-06-09,UK,Ukraine,1,1,0,0,0,0,0,0,0
2024-06-10,UK,Ukraine,3,3,0,0,0,0,0,0,0
2024-06-11,UK,Ukraine,3,3,0,0,0,0,0,0,0
2024-06-12,UK,Ukraine,4,4,0,0,0,0,0,0,0
2024-06-13,UK,Ukraine,5,4,0,0,1,0,1,1,0
2024-06-14,UK,Ukraine,6,6,0,0,0,0,0,0,0
2024-06-15,UK,Ukraine,3,3,0,0,0,0,0,0,0
2024-06-16,UK,Ukraine,2,2,0,0,0,0,0,0,0
2024-06-17,UK,Ukraine,1,1,0,0,0,0,0,0,0
2024-06-18,UK,Ukraine,3,3,0,0,0,0,0,0,0
2024-06-19,UK,Ukraine,2,2,0,0,0,0,0,0,0
2024-06-20,UK,Ukraine,1,1,0,0,0,0,0,0,0
2024-06-21,UK,Ukraine,3,3,0,0,0,0,0,0,0
2024-06-22,UK,Ukraine,3,3,0,0,0,0,0,0,0
2024-06-23,UK,Ukraine,3,3,0,0,0,0,0,0,0
2024-06-24,UK,Ukraine,1,1,0,0,0,0,0,0,0
2024-06-25,UK,Ukraine,1,0,0,0,1,1,0,1,0
2024-06-26,UK,Ukraine,2,2,0,0,0,0,0,0,0
2024-06-27,UK,Ukraine,5,5,0,0,0,0,0,0,0
2024-06-28,UK,Ukraine,9,8,0,0,1,0,1,1,0
2024-06-29,UK,Ukraine,0,0,0,0,0,0,0,0,0
2024-06-30,UK,Ukraine,3,3,0,0,0,0,0,0,0
2024-07-01,UK,Ukraine,2,2,0,0,0,0,0,0,0
2024-07-02,UK,Ukraine,2,2,0,0,0,0,0,0,0
2024-07-03,UK,Ukraine,4,3,0,0,1,0,1,1,0
2024-07-04,UK,Ukraine,6,5,0,0,1,1,0,1,0
2024-07-05,UK,Ukraine,5,5,0,0,0,0,0,0,0
2024-07-06,UK,Ukraine,1,1,0,0,0,0,0,0,0
2024-07-07,UK,Ukraine,2,2,0,0,0,0,0,0,0
2024-07-08,UK,Ukraine,2,1,0,0,1,1,0,1,0
2024-07-09,UK,Ukraine,3,3,0,0,0,0,0,0,0
2024-07-10,UK,Ukraine,0,0,0,0,0,0,0,0,0
2024-07-11,UK,Ukraine,2,2,0,0,0,0,0,0,0
2024-07-12,UK,Ukraine,2,2,0,0,0,0,0,0,0
2024-07-13,UK,Ukraine,1,1,0,0,0,0,0,0,0
2024-07-14,UK,Ukraine,2,0,0,0,2,1,1,2,0
2024-07-15,UK,Ukraine,1,0,0,0,1,0,1,1,0
2024-07-16,UK,Ukraine,3,3,0,0,0,0,0,0,0
2024-07-17,UK,Ukraine,4,4,0,0,0,0,0,0,0
2024-07-18,UK,Ukraine,3,3,0,0,0,0,0,0,0
2024-07-19,UK,Ukraine,3,3,0,0,0,0,0,0,0
2024-07-20,UK,Ukraine,2,1,0,0,1,0,1,1,0
2024-07-21,UK,Ukraine,0,0,0,0,0,0,0,0,0
2024-07-22,UK,Ukraine,2,2,0,0,0,0,0,0,0
2024-07-23,UK,Ukraine,2,2,0,0,0,0,0,0,0
2024-07-24,UK,Ukraine,2,2,0,0,0,0,0,0,0
2024-07-25,UK,Ukraine,3,2,0,0,1,1,0,1,0
2024-07-26,UK,Ukraine,7,7,0,0,0,0,0,0,0
2024-07-27,UK,Ukraine,1,1,0,0,0,0,0,0,0
2024-07-28,UK,Ukraine,1,1,0,0,0,0,0,0,0
2024-07-29,UK,Ukraine,2,2,0,0,0,0,0,0,0
2024-07-30,UK,Ukraine,2,2,0,0,0,0,0,0,0
2024-01-01,EG,United Kingdom,5460,1228,441,0,4232,1894,1897,3791,441
2024-01-02,EG,United Kingdom,6005,1312,662,6,4693,1993,2038,4031,656
2024-01-03,EG,United Kingdom,6066,1365,782,11,4701,1943,1976,3919,771
2024-01-04,EG,United Kingdom,6289,1368,784,15,4921,2062,2075,4137,769
2024-01-05,EG,United Kingdom,6586,1446,822,9,5140,2162,2156,4318,813
2024-01-06,EG,United Kingdom,6073,1428,502,7,4645,2065,2078,4143,495
2024-01-07,EG,United Kingdom,6322,1409,591,3,4913,2155,2167,4322,588
2024-01-08,EG,United Kingdom,6021,1357,742,17,4664,1957,1965,3922,725
2024-01-09,EG,United Kingdom,4989,1204,723,12,3785,1534,1528,3062,711
2024-01-10,EG,United Kingdom,4973,1176,713,13,3797,1536,1548,3084,700
2024-01-11,EG,United Kingdom,5463,1268,789,16,4195,1720,1686,3406,773
2024-01-12,EG,United Kingdom,6107,1294,869,14,4813,1959,1985,3944,855
2024-01-13,EG,United Kingdom,5421,1306,481,7,4115,1819,1815,3634,474
2024-01-14,EG,United Kingdom,5859,1288,620,6,4571,1971,1980,3951,614
2024-01-15,EG,United Kingdom,5639,1208,713,12,4431,1876,1842,3718,701
2024-01-16,EG,United Kingdom,4635,1040,633,16,3595,1476,1486,2962,617
2024-01-17,EG,United Kingdom,4496,971,656,20,3525,1418,1451,2869,636
2024-01-18,EG,United Kingdom,5191,1086,699,11,4105,1704,1702,3406,688
2024-01-19,EG,United Kingdom,6120,1333,823,22,4787,1982,1982,3964,801
2024-01-20,EG,United Kingdom,5312,1268,463,9,4044,1803,1778,3581,454
2024-01-21,EG,United Kingdom,5152,1148,436,13,4004,1805,1763,3568,423
2024-01-22,EG,United Kingdom,5698,1159,772,12,4539,1858,1909,3767,760
2024-01-23,EG,United Kingdom,4625,1035,633,13,3590,1476,1481,2957,620
2024-01-24,EG,United Kingdom,4685,1025,661,7,3660,1497,1502,2999,654
2024-01-25,EG,United Kingdom,5381,1148,787,16,4233,1716,1730,3446,771
2024-01-26,EG,United Kingdom,6035,1194,840,11,4841,2005,1996,4001,829
2024-01-27,EG,United Kingdom,5305,1274,475,12,4031,1790,1766,3556,463
2024-01-28,EG,United Kingdom,5818,1291,586,5,4527,1957,1984,3941,581
2024-01-29,EG,United Kingdom,5802,1227,798,18,4575,1893,1884,3777,780
2024-01-30,EG,United Kingdom,4869,1076,711,19,3793,1545,1537,3082,692
2024-01-31,EG,United Kingdom,4864,1091,655,8,3773,1554,1564,3118,647
2024-02-01,EG,United Kingdom,5454,1138,790,21,4316,1775,1751,3526,769
2024-02-02,EG,United Kingdom,6165,1280,787,14,4885,2060,2038,4098,773
2024-02-03,EG,United Kingdom,5457,1262,500,10,4195,1849,1846,3695,490
2024-02-04,EG,United Kingdom,6031,1308,652,4,4723,2017,2054,4071,648
2024-02-05,EG,United Kingdom,6095,1266,860,9,4829,1988,1981,3969,851
2024-02-06,EG,United Kingdom,5100,1140,721,20,3960,1612,1627,3239,701
2024-02-07,EG,United Kingdom,5028,1077,720,27,3951,1623,1608,3231,693
2024-02-08,EG,United Kingdom,5711,1137,766,15,4574,1906,1902,3808,751
2024-02-09,EG,United Kingdom,6821,1347,905,10,5474,2258,2311,4569,895
2024-02-10,EG,United Kingdom,6198,1358,519,7,4840,2196,2125,4321,512
2024-02-11,EG,United Kingdom,6314,1275,648,10,5039,2209,2182,4391,638
2024-02-12,EG,United Kingdom,6177,1195,854,13,4982,2056,2072,4128,841
2024-02-13,EG,United Kingdom,5267,1073,772,15,4194,1707,1715,3422,757
2024-02-14,EG,United Kingdom,5365,1118,791,14,4247,1725,1731,3456,777
2024-02-15,EG,United Kingdom,5969,1196,822,28,4773,1982,1969,3951,794
2024-02-16,EG,United Kingdom,6641,1348,897,10,5293,2194,2202,4396,887
2024-02-17,EG,United Kingdom,6291,1392,563,13,4899,2142,2194,4336,550
2024-02-18,EG,United Kingdom,6616,1338,682,13,5278,2264,2332,4596,669
2024-02-19,EG,United Kingdom,6385,1296,898,11,5089,2114,2077,4191,887
2024-02-20,EG,United Kingdom,5254,1095,738,16,4159,1715,1706,3421,722
2024-02-21,EG,United Kingdom,5336,1141,736,10,4195,1738,1721,3459,726
2024-02-22,EG,United Kingdom,5965,1190,820,8,4775,1989,1966,3955,812
2024-02-23,EG,United Kingdom,6490,1255,897,13,5235,2188,2150,4338,884
2024-02-24,EG,United Kingdom,5894,1319,549,6,4575,2010,2016,4026,543
2024-02-25,EG,United Kingdom,6328,1347,686,10,4981,2120,2175,4295,676
2024-02-26,EG,United Kingdom,6385,1356,781,11,5029,2124,2124,4248,770
2024-02-27,EG,United Kingdom,5419,1159,782,19,4260,1745,1733,3478,763
2024-02-28,EG,United Kingdom,5494,1201,784,21,4293,1753,1756,3509,763
2024-02-29,EG,United Kingdom,6115,1225,879,25,4890,2003,2008,4011,854
2024-03-01,EG,United Kingdom,6654,1346,898,12,5308,2228,2182,4410,886
2024-03-02,EG,United Kingdom,5974,1409,518,6,4565,2020,2027,4047,512
2024-03-03,EG,United Kingdom,6295,1321,681,4,4974,2138,2155,4293,677
2024-03-04,EG,United Kingdom,6376,1237,873,16,5139,2136,2130,4266,857
2024-03-05,EG,United Kingdom,5535,1216,801,18,4319,1756,1762,3518,783
2024-03-06,EG,United Kingdom,5565,1236,820,27,4329,1751,1758,3509,793
2024-03-07,EG,United Kingdom,6138,1248,907,19,4890,1998,1985,3983,888
2024-03-08,EG,United Kingdom,6723,1310,943,7,5413,2227,2243,4470,936
2024-03-09,EG,United Kingdom,5980,1352,531,4,4628,2033,2064,4097,527
2024-03-10,EG,United Kingdom,6482,1380,713,3,5102,2202,2187,4389,710
2024-03-11,EG,United Kingdom,6719,1397,914,13,5322,2207,2201,4408,901
2024-03-12,EG,United Kingdom,5560,1202,812,18,4358,1771,1775,3546,794
2024-03-13,EG,United Kingdom,5671,1257,818,10,4414,1800,1796,3596,808
2024-03-14,EG,United Kingdom,6236,1343,859,17,4893,2020,2014,4034,842
2024-03-15,EG,United Kingdom,6891,1403,921,15,5488,2294,2273,4567,906
2024-03-16,EG,United Kingdom,6155,1437,574,12,4718,2073,2071,4144,562
2024-03-17,EG,United Kingdom,6523,1433,681,7,5090,2186,2223,4409,674
2024-03-18,EG,United Kingdom,6598,1348,925,24,5250,2161,2164,4325,901
2024-03-19,EG,United Kingdom,5723,1316,809,22,4407,1790,1808,3598,787
2024-03-20,EG,United Kingdom,5768,1293,831,22,4475,1828,1816,3644,809
2024-03-21,EG,United Kingdom,6347,1432,838,17,4915,2054,2023,4077,821
2024-03-22,EG,United Kingdom,6845,1399,906,13,5446,2276,2264,4540,893
2024-03-23,EG,United Kingdom,6091,1404,522,6,4687,2090,2075,4165,516
2024-03-24,EG,United Kingdom,6435,1422,682,8,5013,2168,2163,4331,674
2024-03-25,EG,United Kingdom,6622,1407,906,7,5215,2163,2146,4309,899
2024-03-26,EG,United Kingdom,6075,1377,838,16,4698,1920,1940,3860,822
2024-03-27,EG,United Kingdom,6059,1335,800,12,4724,1951,1973,3924,788
2024-03-28,EG,United Kingdom,6659,1495,812,5,5164,2191,2161,4352,807
2024-03-29,EG,United Kingdom,6961,1428,859,12,5533,2349,2325,4674,847
2024-03-30,EG,United Kingdom,6145,1380,548,10,4765,2105,2112,4217,538
2024-03-31,EG,United Kingdom,6722,1507,676,5,5215,2273,2266,4539,671
2024-04-01,EG,United Kingdom,6909,1511,805,9,5398,2289,2304,4593,796
2024-04-02,EG,United Kingdom,6876,1526,867,18,5350,2230,2253,4483,849
2024-04-03,EG,United Kingdom,6867,1543,833,6,5324,2253,2238,4491,827
2024-04-04,EG,United Kingdom,7195,1538,927,17,5657,2358,2372,4730,910
2024-04-05,EG,United Kingdom,7170,1555,884,9,5615,2366,2365,4731,875
2024-04-06,EG,United Kingdom,6462,1542,465,14,4920,2223,2232,4455,451
2024-04-07,EG,United Kingdom,7096,1654,671,8,5442,2367,2404,4771,663
2024-04-08,EG,United Kingdom,7240,1562,900,16,5678,2405,2373,4778,884
2024-04-09,EG,United Kingdom,6842,1509,841,15,5333,2242,2250,4492,826
2024-04-10,EG,United Kingdom,7009,1565,861,17,5444,2294,2289,4583,844
2024-04-11,EG,United Kingdom,7238,1562,913,13,5676,2373,2390,4763,900
2024-04-12,EG,United Kingdom,7357,1602,917,16,5755,2421,2417,4838,901
2024-04-13,EG,United Kingdom,6619,1517,584,11,5102,2261,2257,4518,573
2024-04-14,EG,United Kingdom,6993,1532,714,6,5461,2353,2394,4747,708
2024-04-15,EG,United Kingdom,7087,1539,864,8,5548,2333,2351,4684,856
2024-04-16,EG,United Kingdom,6966,1518,873,19,5448,2294,2281,4575,854
2024-04-17,EG,United Kingdom,7068,1538,919,18,5530,2299,2312,4611,901
2024-04-18,EG,United Kingdom,7370,1589,912,13,5781,2437,2432,4869,899
2024-04-19,EG,United Kingdom,7427,1631,949,14,5796,2426,2421,4847,935
2024-04-20,EG,United Kingdom,6525,1520,581,6,5005,2214,2210,4424,575
2024-04-21,EG,United Kingdom,6918,1561,731,5,5357,2307,2319,4626,726
2024-04-22,EG,United Kingdom,7272,1595,898,7,5677,2392,2387,4779,891
2024-04-23,EG,United Kingdom,6979,1562,883,21,5417,2280,2254,4534,862
2024-04-24,EG,United Kingdom,7109,1568,900,17,5541,2306,2335,4641,883
2024-04-25,EG,United Kingdom,7106,1561,949,16,5545,2310,2286,4596,933
2024-04-26,EG,United Kingdom,7377,1570,949,16,5807,2432,2426,4858,933
2024-04-27,EG,United Kingdom,6490,1499,571,13,4991,2214,2206,4420,558
2024-04-28,EG,United Kingdom,6912,1564,705,9,5348,2310,2333,4643,696
2024-04-29,EG,United Kingdom,7228,1580,904,12,5648,2370,2374,4744,892
2024-04-30,EG,United Kingdom,7038,1549,893,27,5489,2287,2309,4596,866
2024-05-01,EG,United Kingdom,7245,1542,879,27,5703,2407,2417,4824,852
2024-05-02,EG,United Kingdom,7570,1585,964,23,5985,2524,2497,5021,941
2024-05-03,EG,United Kingdom,7815,1658,984,9,6157,2602,2571,5173,975
2024-05-04,EG,United Kingdom,6937,1598,597,5,5339,2376,2366,4742,592
2024-05-05,EG,United Kingdom,7238,1596,719,16,5642,2472,2451,4923,703
2024-05-06,EG,United Kingdom,7588,1698,824,8,5890,2493,2573,5066,816
2024-05-07,EG,United Kingdom,7566,1675,942,20,5891,2474,2475,4949,922
2024-05-08,EG,United Kingdom,7551,1735,893,17,5816,2448,2475,4923,876
2024-05-09,EG,United Kingdom,7767,1690,969,26,6077,2562,2546,5108,943
2024-05-10,EG,United Kingdom,7767,1683,975,17,6084,2567,2542,5109,958
2024-05-11,EG,United Kingdom,7074,1651,644,8,5423,2395,2384,4779,636
2024-05-12,EG,United Kingdom,7531,1748,771,10,5783,2505,2507,5012,761
2024-05-13,EG,United Kingdom,7774,1706,931,8,6068,2556,2581,5137,923
2024-05-14,EG,United Kingdom,7587,1710,917,17,5877,2478,2482,4960,900
2024-05-15,EG,United Kingdom,7663,1752,930,26,5911,2488,2493,4981,904
2024-05-16,EG,United Kingdom,7878,1747,944,17,6131,2603,2584,5187,927
2024-05-17,EG,United Kingdom,7898,1719,977,20,6179,2605,2597,5202,957
2024-05-18,EG,United Kingdom,7107,1700,592,12,5407,2398,2417,4815,580
2024-05-19,EG,United Kingdom,7561,1735,764,12,5826,2500,2562,5062,752
2024-05-20,EG,United Kingdom,7819,1736,962,10,6083,2571,2550,5121,952
2024-05-21,EG,United Kingdom,7623,1709,931,21,5914,2492,2491,4983,910
2024-05-22,EG,United Kingdom,7814,1835,891,23,5979,2543,2545,5088,868
2024-05-23,EG,United Kingdom,8161,1749,925,24,6412,2738,2749,5487,901
2024-05-24,EG,United Kingdom,8333,1769,960,22,6564,2826,2778,5604,938
2024-05-25,EG,United Kingdom,7552,1665,643,14,5887,2645,2599,5244,629
2024-05-26,EG,United Kingdom,7641,1732,694,14,5909,2617,2598,5215,680
2024-05-27,EG,United Kingdom,7946,1791,813,13,6155,2645,2697,5342,800
2024-05-28,EG,United Kingdom,7765,1702,855,17,6063,2593,2615,5208,838
2024-05-29,EG,United Kingdom,7880,1727,912,21,6153,2620,2621,5241,891
2024-05-30,EG,United Kingdom,8113,1771,954,17,6342,2691,2697,5388,937
2024-05-31,EG,United Kingdom,8309,1771,985,20,6538,2744,2809,5553,965
2024-06-01,EG,United Kingdom,7806,1745,629,9,6061,2637,2795,5432,620
2024-06-02,EG,United Kingdom,8285,1828,738,13,6457,2943,2776,5719,725
2024-06-03,EG,United Kingdom,8351,1890,967,27,6461,2744,2750,5494,940
2024-06-04,EG,United Kingdom,8070,1866,913,26,6204,2657,2634,5291,887
2024-06-05,EG,United Kingdom,8091,1787,958,32,6304,2691,2655,5346,926
2024-06-06,EG,United Kingdom,8253,1836,969,28,6417,2710,2738,5448,941
2024-06-07,EG,United Kingdom,8366,1893,972,15,6473,2753,2748,5501,957
2024-06-08,EG,United Kingdom,7500,1769,604,13,5731,2567,2560,5127,591
2024-06-09,EG,United Kingdom,7897,1845,759,10,6052,2649,2644,5293,749
2024-06-10,EG,United Kingdom,8322,1907,958,15,6415,2729,2728,5457,943
2024-06-11,EG,United Kingdom,7992,1815,914,25,6177,2636,2627,5263,889
2024-06-12,EG,United Kingdom,8135,1828,952,21,6307,2662,2693,5355,931
2024-06-13,EG,United Kingdom,8358,1862,958,20,6496,2768,2770,5538,938
2024-06-14,EG,United Kingdom,8388,1840,978,11,6548,2800,2770,5570,967
2024-06-15,EG,United Kingdom,7620,1812,569,10,5808,2620,2619,5239,559
2024-06-16,EG,United Kingdom,7966,1800,739,6,6166,2695,2732,5427,733
2024-06-17,EG,United Kingdom,8321,1884,932,22,6437,2746,2759,5505,910
2024-06-18,EG,United Kingdom,8074,1875,896,23,6199,2654,2649,5303,873
2024-06-19,EG,United Kingdom,8351,1987,921,20,6364,2720,2723,5443,901
2024-06-20,EG,United Kingdom,8390,1912,949,19,6478,2766,2763,5529,930
2024-06-21,EG,United Kingdom,8384,1879,957,16,6505,2765,2783,5548,941
2024-06-22,EG,United Kingdom,7686,1849,620,9,5837,2627,2590,5217,611
2024-06-23,EG,United Kingdom,8030,1959,768,9,6071,2661,2642,5303,759
2024-06-24,EG,United Kingdom,8323,1883,904,24,6440,2777,2759,5536,880
2024-06-25,EG,United Kingdom,8157,1901,899,21,6256,2669,2688,5357,878
2024-06-26,EG,United Kingdom,7999,1772,890,18,6227,2670,2667,5337,872
2024-06-27,EG,United Kingdom,8285,1919,914,19,6366,2727,2725,5452,895
2024-06-28,EG,United Kingdom,8254,1905,970,9,6349,2703,2676,5379,961
2024-06-29,EG,United Kingdom,7553,1774,600,9,5779,2581,2598,5179,591
2024-06-30,EG,United Kingdom,8078,1933,723,4,6145,2698,2724,5422,719
2024-07-01,EG,United Kingdom,8216,1842,880,11,6374,2745,2749,5494,869
2024-07-02,EG,United Kingdom,8118,1846,924,19,6272,2673,2675,5348,905
2024-07-03,EG,United Kingdom,8069,1810,894,10,6259,2675,2690,5365,884
2024-07-04,EG,United Kingdom,8194,1744,933,15,6450,2759,2758,5517,918
2024-07-05,EG,United Kingdom,8328,1786,969,11,6542,2797,2776,5573,958
2024-07-06,EG,United Kingdom,7656,1809,597,9,5847,2636,2614,5250,588
2024-07-07,EG,United Kingdom,8025,1898,711,7,6127,2686,2730,5416,704
2024-07-08,EG,United Kingdom,8297,1870,888,16,6427,2767,2772,5539,872
2024-07-09,EG,United Kingdom,8054,1822,894,17,6232,2678,2660,5338,877
2024-07-10,EG,United Kingdom,8111,1822,883,17,6289,2697,2709,5406,866
2024-07-11,EG,United Kingdom,8485,1913,956,17,6572,2799,2817,5616,939
2024-07-12,EG,United Kingdom,8444,1969,959,10,6475,2750,2766,5516,949
2024-07-13,EG,United Kingdom,7876,1832,614,12,6044,2723,2707,5430,602
2024-07-14,EG,United Kingdom,8153,1865,755,11,6288,2779,2754,5533,744
2024-07-15,EG,United Kingdom,8586,1974,909,18,6612,2848,2855,5703,891
2024-07-16,EG,United Kingdom,8219,1969,899,27,6250,2686,2665,5351,872
2024-07-17,EG,United Kingdom,8289,1861,941,21,6428,2725,2762,5487,920
2024-07-18,EG,United Kingdom,8512,1940,989,25,6572,2777,2806,5583,964
2024-07-19,EG,United Kingdom,7916,1784,933,23,6132,2618,2581,5199,910
2024-07-20,EG,United Kingdom,7693,1788,597,5,5905,2654,2654,5308,592
2024-07-21,EG,United Kingdom,7938,1834,730,9,6104,2659,2715,5374,721
2024-07-22,EG,United Kingdom,8291,1766,925,21,6525,2817,2783,5600,904
2024-07-23,EG,United Kingdom,8190,1902,908,21,6288,2696,2684,5380,887
2024-07-24,EG,United Kingdom,8250,1879,927,17,6371,2725,2719,5444,910
2024-07-25,EG,United Kingdom,8377,1925,906,20,6452,2784,2762,5546,886
2024-07-26,EG,United Kingdom,8487,1959,981,16,6528,2779,2768,5547,965
2024-07-27,EG,United Kingdom,7709,1782,599,11,5927,2674,2654,5328,588
2024-07-28,EG,United Kingdom,8156,1930,761,14,6226,2718,2747,5465,747
2024-07-29,EG,United Kingdom,8321,1942,895,24,6379,2757,2727,5484,871
2024-07-30,EG,United Kingdom,8176,1976,884,21,6200,2659,2657,5316,863
