entry_date,country_icao_code,country_name,flt_daio,flt_o,flt_i,flt_c,flt_dai,flt_d,flt_a,flt_da,flt_i_excl_c
2024-01-01,LA,Albania,584,436,0,0,148,73,75,148,0
2024-01-02,LA,Albania,629,454,0,0,175,88,87,175,0
2024-01-03,LA,Albania,666,493,0,0,173,86,87,173,0
2024-01-04,LA,Albania,25,-147,0,0,172,87,85,172,0
2024-01-05,LA,Albania,710,535,0,0,175,88,87,175,0
2024-01-06,LA,Albania,791,631,0,0,160,79,81,160,0
2024-01-07,LA,Albania,732,567,0,0,165,84,81,165,0
2024-01-08,LA,Albania,602,441,0,0,161,79,82,161,0
2024-01-09,LA,Albania,531,359,0,0,172,87,85,172,0
2024-01-10,LA,Albania,543,378,0,0,165,82,83,165,0
2024-01-11,LA,Albania,537,374,1,1,163,81,81,162,0
2024-01-12,LA,Albania,580,432,0,0,148,75,73,148,0
2024-01-13,LA,Albania,667,505,0,0,162,81,81,162,0
2024-01-14,LA,Albania,650,500,0,0,150,76,74,150,0
2024-01-15,LA,Albania,537,392,0,0,145,72,73,145,0
2024-01-16,LA,Albania,515,364,0,0,151,75,76,151,0
2024-01-17,LA,Albania,528,385,0,0,143,72,71,143,0
2024-01-18,LA,Albania,491,333,0,0,158,79,79,158,0
2024-01-19,LA,Albania,568,429,0,0,139,70,69,139,0
2024-01-20,LA,Albania,582,434,0,0,148,72,76,148,0
2024-01-21,LA,Albania,602,460,0,0,142,72,70,142,0
2024-01-22,LA,Albania,516,374,0,0,142,71,71,142,0
2024-01-23,LA,Albania,442,315,0,0,127,64,63,127,0
2024-01-24,LA,Albania,494,359,0,0,135,68,67,135,0
2024-01-25,LA,Albania,486,335,0,0,151,75,76,151,0
2024-01-26,LA,Albania,591,445,0,0,146,75,71,146,0
2024-01-27,LA,Albania,614,477,0,0,137,68,69,137,0
2024-01-28,LA,Albania,556,422,1,1,134,65,68,133,0
2024-01-29,LA,Albania,470,331,0,0,139,71,68,139,0
2024-01-30,LA,Albania,481,327,0,0,154,76,78,154,0
2024-01-31,LA,Albania,535,401,0,0,134,66,68,134,0
2024-02-01,LA,Albania,508,359,0,0,149,75,74,149,0
2024-02-02,LA,Albania,543,401,0,0,142,72,70,142,0
2024-02-03,LA,Albania,622,478,0,0,144,71,73,144,0
2024-02-04,LA,Albania,619,485,0,0,134,68,66,134,0
2024-01-01,UD,Armenia,156,54,0,0,102,52,50,102,0
2024-01-02,UD,Armenia,178,77,0,0,101,48,53,101,0
2024-01-03,UD,Armenia,174,63,0,0,111,55,56,111,0
2024-01-04,UD,Armenia,11,-100,0,0,111,56,55,111,0
2024-01-05,UD,Armenia,188,78,0,0,110,55,55,110,0
2024-01-06,UD,Armenia,209,80,0,0,129,63,66,129,0
2024-01-07,UD,Armenia,196,83,0,0,113,58,55,113,0
2024-01-08,UD,Armenia,200,75,0,0,125,63,62,125,0
2024-01-09,UD,Armenia,192,87,0,0,105,52,53,105,0
2024-01-10,UD,Armenia,187,77,0,0,110,54,56,110,0
2024-01-11,UD,Armenia,185,83,1,1,102,51,50,101,0
2024-01-12,UD,Armenia,177,79,0,0,98,48,50,98,0
2024-01-13,UD,Armenia,176,66,0,0,110,56,54,110,0
2024-01-14,UD,Armenia,170,67,0,0,103,51,52,103,0
2024-01-15,UD,Armenia,144,62,0,0,82,40,42,82,0
2024-01-16,UD,Armenia,153,68,0,0,85,41,44,85,0
2024-01-17,UD,Armenia,151,69,0,0,82,40,42,82,0
2024-01-18,UD,Armenia,153,64,0,0,89,48,41,89,0
2024-01-19,UD,Armenia,160,78,0,0,82,41,41,82,0
2024-01-20,UD,Armenia,152,58,0,0,94,47,47,94,0
2024-01-21,UD,Armenia,163,70,0,0,93,46,47,93,0
2024-01-22,UD,Armenia,142,67,0,0,75,38,37,75,0
2024-01-23,UD,Armenia,139,69,0,0,70,34,36,70,0
2024-01-24,UD,Armenia,145,63,0,0,82,40,42,82,0
2024-01-25,UD,Armenia,159,76,0,0,83,43,40,83,0
2024-01-26,UD,Armenia,167,74,0,0,93,47,46,93,0
2024-01-27,UD,Armenia,161,67,0,0,94,48,46,94,0
2024-01-28,UD,Armenia,167,69,0,0,98,48,50,98,0
2024-01-29,UD,Armenia,142,67,0,0,75,37,38,75,0
2024-01-30,UD,Armenia,144,75,0,0,69,34,35,69,0
2024-01-31,UD,Armenia,160,74,0,0,86,42,44,86,0
2024-02-01,UD,Armenia,155,75,0,0,80,42,38,80,0
2024-02-02,UD,Armenia,160,78,0,0,82,41,41,82,0
2024-02-03,UD,Armenia,170,81,0,0,89,47,42,89,0
2024-02-04,UD,Armenia,168,76,0,0,92,44,48,92,0
2024-01-01,LO,Austria,2922,2310,12,0,612,301,299,600,12
2024-01-02,LO,Austria,3119,2405,19,2,714,353,342,695,17
2024-01-03,LO,Austria,3145,2424,19,0,721,354,348,702,19
2024-01-04,LO,Austria,131,-580,13,2,711,348,350,698,11
2024-01-05,LO,Austria,3540,2690,39,0,850,410,401,811,39
2024-01-06,LO,Austria,3486,2693,18,1,793,389,386,775,17
2024-01-07,LO,Austria,3448,2712,13,0,736,363,360,723,13
2024-01-08,LO,Austria,3213,2509,21,1,704,336,347,683,20
2024-01-09,LO,Austria,2765,2165,29,1,600,283,288,571,28
2024-01-10,LO,Austria,2833,2149,39,3,684,326,319,645,36
2024-01-11,LO,Austria,2914,2239,44,2,675,310,321,631,42
2024-01-12,LO,Austria,3372,2613,21,1,759,366,372,738,20
2024-01-13,LO,Austria,3220,2485,18,1,735,360,357,717,17
2024-01-14,LO,Austria,3346,2608,31,1,738,359,348,707,30
2024-01-15,LO,Austria,3130,2406,24,1,724,351,349,700,23
2024-01-16,LO,Austria,2608,2022,20,2,586,276,290,566,18
2024-01-17,LO,Austria,2563,1910,27,1,653,317,309,626,26
2024-01-18,LO,Austria,2891,2221,25,3,670,318,327,645,22
2024-01-19,LO,Austria,3274,2464,20,0,810,397,393,790,20
2024-01-20,LO,Austria,3153,2380,25,1,773,373,375,748,24
2024-01-21,LO,Austria,3157,2392,23,0,765,379,363,742,23
2024-01-22,LO,Austria,2990,2240,48,1,750,351,351,702,47
2024-01-23,LO,Austria,2464,1874,24,1,590,281,285,566,23
2024-01-24,LO,Austria,2610,1948,26,1,662,317,319,636,25
2024-01-25,LO,Austria,2743,2044,23,0,699,333,343,676,23
2024-01-26,LO,Austria,3192,2394,24,2,798,391,383,774,22
2024-01-27,LO,Austria,3045,2221,24,3,824,384,416,800,21
2024-01-28,LO,Austria,3139,2372,16,0,767,380,371,751,16
2024-01-29,LO,Austria,2940,2193,37,1,747,361,349,710,36
2024-01-30,LO,Austria,2519,1932,34,1,587,274,279,553,33
2024-01-31,LO,Austria,2743,2060,24,2,683,328,331,659,22
2024-02-01,LO,Austria,2736,2080,29,5,656,316,311,627,24
2024-02-02,LO,Austria,3121,2322,30,0,799,385,384,769,30
2024-02-03,LO,Austria,3051,2229,28,0,822,390,404,794,28
2024-02-04,LO,Austria,3110,2372,16,1,738,372,350,722,15
2024-01-01,EB,Belgium and Luxembourg,2575,1811,1,1,764,386,377,763,0
2024-01-02,EB,Belgium and Luxembourg,2819,1947,5,2,872,429,438,867,3
2024-01-03,EB,Belgium and Luxembourg,2822,1910,5,3,912,451,456,907,2
2024-01-04,EB,Belgium and Luxembourg,128,-822,12,7,950,477,461,938,5
2024-01-05,EB,Belgium and Luxembourg,2988,2024,7,3,964,484,473,957,4
2024-01-06,EB,Belgium and Luxembourg,2944,2126,3,0,818,404,411,815,3
2024-01-07,EB,Belgium and Luxembourg,3020,2101,5,1,919,455,459,914,4
2024-01-08,EB,Belgium and Luxembourg,2728,1833,6,2,895,432,457,889,4
2024-01-09,EB,Belgium and Luxembourg,2472,1639,14,9,833,409,410,819,5
2024-01-10,EB,Belgium and Luxembourg,2456,1598,24,15,858,420,414,834,9
2024-01-11,EB,Belgium and Luxembourg,2679,1810,15,10,869,429,425,854,5
2024-01-12,EB,Belgium and Luxembourg,2952,2035,7,3,917,467,443,910,4
2024-01-13,EB,Belgium and Luxembourg,2706,2066,7,1,640,307,326,633,6
2024-01-14,EB,Belgium and Luxembourg,2954,2117,5,0,837,417,415,832,5
2024-01-15,EB,Belgium and Luxembourg,2625,1770,15,4,855,401,439,840,11
2024-01-16,EB,Belgium and Luxembourg,2353,1512,23,8,841,404,414,818,15
2024-01-17,EB,Belgium and Luxembourg,2209,1484,10,4,725,355,360,715,6
2024-01-18,EB,Belgium and Luxembourg,2555,1646,11,4,909,468,430,898,7
2024-01-19,EB,Belgium and Luxembourg,2773,1826,13,9,947,478,456,934,4
2024-01-20,EB,Belgium and Luxembourg,2517,1826,8,2,691,332,351,683,6
2024-01-21,EB,Belgium and Luxembourg,2726,1870,8,0,856,418,430,848,8
2024-01-22,EB,Belgium and Luxembourg,2524,1663,6,2,861,426,429,855,4
2024-01-23,EB,Belgium and Luxembourg,2361,1499,14,8,862,421,427,848,6
2024-01-24,EB,Belgium and Luxembourg,2423,1566,15,8,857,428,414,842,7
2024-01-25,EB,Belgium and Luxembourg,2551,1639,11,6,912,455,446,901,5
2024-01-26,EB,Belgium and Luxembourg,2818,1893,9,5,925,470,446,916,4
2024-01-27,EB,Belgium and Luxembourg,2710,1984,10,4,726,353,363,716,6
2024-01-28,EB,Belgium and Luxembourg,2923,2035,16,4,888,431,441,872,12
2024-01-29,EB,Belgium and Luxembourg,2758,1850,18,10,908,431,459,890,8
2024-01-30,EB,Belgium and Luxembourg,2406,1568,9,6,838,417,412,829,3
2024-01-31,EB,Belgium and Luxembourg,2616,1696,22,7,920,438,460,898,15
2024-02-01,EB,Belgium and Luxembourg,2622,1675,26,11,947,471,450,921,15
2024-02-02,EB,Belgium and Luxembourg,2840,1907,18,10,933,474,441,915,8
2024-02-03,EB,Belgium and Luxembourg,2723,1977,13,5,746,364,369,733,8
2024-02-04,EB,Belgium and Luxembourg,2941,2089,5,3,852,421,426,847,2
2024-01-01,LQ,Bosnia-Herzegovina,961,924,0,0,37,17,20,37,0
2024-01-02,LQ,Bosnia-Herzegovina,1071,1028,0,0,43,22,21,43,0
2024-01-03,LQ,Bosnia-Herzegovina,1034,990,0,0,44,22,22,44,0
2024-01-04,LQ,Bosnia-Herzegovina,39,-10,0,0,49,23,26,49,0
2024-01-05,LQ,Bosnia-Herzegovina,1086,1032,0,0,54,28,26,54,0
2024-01-06,LQ,Bosnia-Herzegovina,1202,1172,0,0,30,15,15,30,0
2024-01-07,LQ,Bosnia-Herzegovina,1162,1124,0,0,38,19,19,38,0
2024-01-08,LQ,Bosnia-Herzegovina,1015,961,0,0,54,27,27,54,0
2024-01-09,LQ,Bosnia-Herzegovina,893,847,0,0,46,23,23,46,0
2024-01-10,LQ,Bosnia-Herzegovina,882,843,1,1,39,20,18,38,0
2024-01-11,LQ,Bosnia-Herzegovina,896,853,1,1,43,20,22,42,0
2024-01-12,LQ,Bosnia-Herzegovina,1013,960,0,0,53,27,26,53,0
2024-01-13,LQ,Bosnia-Herzegovina,1051,1020,1,1,31,15,15,30,0
2024-01-14,LQ,Bosnia-Herzegovina,1061,1025,0,0,36,18,18,36,0
2024-01-15,LQ,Bosnia-Herzegovina,919,878,0,0,41,20,21,41,0
2024-01-16,LQ,Bosnia-Herzegovina,834,793,0,0,41,21,20,41,0
2024-01-17,LQ,Bosnia-Herzegovina,847,807,2,0,40,19,19,38,2
2024-01-18,LQ,Bosnia-Herzegovina,849,814,0,0,35,17,18,35,0
2024-01-19,LQ,Bosnia-Herzegovina,933,882,0,0,51,26,25,51,0
2024-01-20,LQ,Bosnia-Herzegovina,958,928,0,0,30,15,15,30,0
2024-01-21,LQ,Bosnia-Herzegovina,1010,972,0,0,38,18,20,38,0
2024-01-22,LQ,Bosnia-Herzegovina,877,836,0,0,41,20,21,41,0
2024-01-23,LQ,Bosnia-Herzegovina,767,728,0,0,39,20,19,39,0
2024-01-24,LQ,Bosnia-Herzegovina,882,840,0,0,42,22,20,42,0
2024-01-25,LQ,Bosnia-Herzegovina,831,797,0,0,34,17,17,34,0
2024-01-26,LQ,Bosnia-Herzegovina,956,899,1,0,57,29,27,56,1
2024-01-27,LQ,Bosnia-Herzegovina,941,902,3,0,39,18,18,36,3
2024-01-28,LQ,Bosnia-Herzegovina,977,939,1,0,38,17,20,37,1
2024-01-29,LQ,Bosnia-Herzegovina,890,840,1,1,50,25,24,49,0
2024-01-30,LQ,Bosnia-Herzegovina,778,741,0,0,37,18,19,37,0
2024-01-31,LQ,Bosnia-Herzegovina,886,845,0,0,41,22,19,41,0
2024-02-01,LQ,Bosnia-Herzegovina,860,822,0,0,38,17,21,38,0
2024-02-02,LQ,Bosnia-Herzegovina,1000,947,0,0,53,28,25,53,0
2024-02-03,LQ,Bosnia-Herzegovina,999,969,0,0,30,15,15,30,0
2024-02-04,LQ,Bosnia-Herzegovina,1014,977,0,0,37,18,19,37,0
2024-01-01,LB,Bulgaria,2007,1864,4,0,143,70,69,139,4
2024-01-02,LB,Bulgaria,2302,2034,8,1,268,123,137,260,7
2024-01-03,LB,Bulgaria,2326,2103,9,2,223,104,110,214,7
2024-01-04,LB,Bulgaria,246,55,8,2,191,94,89,183,6
2024-01-05,LB,Bulgaria,2387,2172,7,0,215,106,102,208,7
2024-01-06,LB,Bulgaria,2497,2280,2,0,217,107,108,215,2
2024-01-07,LB,Bulgaria,2458,2265,6,0,193,93,94,187,6
2024-01-08,LB,Bulgaria,2227,2043,8,0,184,85,91,176,8
2024-01-09,LB,Bulgaria,2162,1995,11,0,167,81,75,156,11
2024-01-10,LB,Bulgaria,2204,2042,8,0,162,74,80,154,8
2024-01-11,LB,Bulgaria,2207,2036,7,0,171,83,81,164,7
2024-01-12,LB,Bulgaria,2250,2059,7,1,191,91,93,184,6
2024-01-13,LB,Bulgaria,2279,2086,4,0,193,95,94,189,4
2024-01-14,LB,Bulgaria,2268,2086,4,0,182,86,92,178,4
2024-01-15,LB,Bulgaria,2069,1900,12,1,169,80,77,157,11
2024-01-16,LB,Bulgaria,1973,1823,8,2,150,71,71,142,6
2024-01-17,LB,Bulgaria,1986,1821,13,2,165,78,74,152,11
2024-01-18,LB,Bulgaria,2171,2016,9,0,155,70,76,146,9
2024-01-19,LB,Bulgaria,2252,2070,8,2,182,89,85,174,6
2024-01-20,LB,Bulgaria,2304,2119,2,0,185,89,94,183,2
2024-01-21,LB,Bulgaria,2283,2103,6,1,180,89,85,174,5
2024-01-22,LB,Bulgaria,2082,1912,14,4,170,77,79,156,10
2024-01-23,LB,Bulgaria,2013,1849,12,3,164,77,75,152,9
2024-01-24,LB,Bulgaria,2068,1895,11,2,173,81,81,162,9
2024-01-25,LB,Bulgaria,2147,1991,9,3,156,74,73,147,6
2024-01-26,LB,Bulgaria,2137,1943,7,0,194,95,92,187,7
2024-01-27,LB,Bulgaria,2244,2043,3,0,201,100,98,198,3
2024-01-28,LB,Bulgaria,2273,2090,5,0,183,88,90,178,5
2024-01-29,LB,Bulgaria,1993,1836,8,2,157,73,76,149,6
2024-01-30,LB,Bulgaria,2001,1843,10,0,158,74,74,148,10
2024-01-31,LB,Bulgaria,2000,1838,12,2,162,76,74,150,10
2024-02-01,LB,Bulgaria,1987,1825,9,1,162,78,75,153,8
2024-02-02,LB,Bulgaria,2225,2039,6,0,186,90,90,180,6
2024-02-03,LB,Bulgaria,2272,2079,2,0,193,99,92,191,2
2024-02-04,LB,Bulgaria,2286,2104,5,0,182,86,91,177,5
2024-01-01,LD,Croatia,1519,1389,25,0,130,54,51,105,25
2024-01-02,LD,Croatia,1721,1566,26,1,155,66,63,129,25
2024-01-03,LD,Croatia,1643,1506,19,0,137,59,59,118,19
2024-01-04,LD,Croatia,61,-92,23,0,153,66,64,130,23
2024-01-05,LD,Croatia,1768,1600,26,0,168,69,73,142,26
2024-01-06,LD,Croatia,1869,1727,14,0,142,66,62,128,14
2024-01-07,LD,Croatia,1871,1730,17,0,141,62,62,124,17
2024-01-08,LD,Croatia,1608,1452,24,0,156,64,68,132,24
2024-01-09,LD,Croatia,1391,1262,26,0,129,52,51,103,26
2024-01-10,LD,Croatia,1408,1292,18,1,116,49,49,98,17
2024-01-11,LD,Croatia,1413,1285,21,0,128,52,55,107,21
2024-01-12,LD,Croatia,1591,1433,25,0,158,67,66,133,25
2024-01-13,LD,Croatia,1638,1513,15,0,125,55,55,110,15
2024-01-14,LD,Croatia,1704,1572,17,1,132,58,57,115,16
2024-01-15,LD,Croatia,1481,1332,27,0,149,61,61,122,27
2024-01-16,LD,Croatia,1275,1159,23,2,116,47,46,93,21
2024-01-17,LD,Croatia,1285,1170,18,0,115,49,48,97,18
2024-01-18,LD,Croatia,1355,1232,21,0,123,50,52,102,21
2024-01-19,LD,Croatia,1511,1364,25,0,147,59,63,122,25
2024-01-20,LD,Croatia,1552,1429,14,1,123,55,54,109,13
2024-01-21,LD,Croatia,1619,1482,20,1,137,60,57,117,19
2024-01-22,LD,Croatia,1425,1263,29,1,162,66,67,133,28
2024-01-23,LD,Croatia,1257,1127,24,2,130,50,56,106,22
2024-01-24,LD,Croatia,1341,1218,18,0,123,53,52,105,18
2024-01-25,LD,Croatia,1320,1198,24,1,122,50,48,98,23
2024-01-26,LD,Croatia,1543,1387,25,0,156,65,66,131,25
2024-01-27,LD,Croatia,1511,1387,18,0,124,53,53,106,18
2024-01-28,LD,Croatia,1600,1454,22,0,146,64,60,124,22
2024-01-29,LD,Croatia,1428,1259,31,1,169,65,73,138,30
2024-01-30,LD,Croatia,1246,1110,30,1,136,52,54,106,29
2024-01-31,LD,Croatia,1409,1274,20,0,135,60,55,115,20
2024-02-01,LD,Croatia,1360,1224,21,1,136,59,56,115,20
2024-02-02,LD,Croatia,1562,1405,31,3,157,62,64,126,28
2024-02-03,LD,Croatia,1560,1443,13,0,117,54,50,104,13
2024-02-04,LD,Croatia,1607,1474,17,0,133,57,59,116,17
2024-01-01,LC,Cyprus,705,543,5,5,162,80,77,157,0
2024-01-02,LC,Cyprus,738,578,7,7,160,76,77,153,0
2024-01-03,LC,Cyprus,718,533,8,8,185,85,92,177,0
2024-01-04,LC,Cyprus,52,-130,3,3,182,91,88,179,0
2024-01-05,LC,Cyprus,780,592,6,6,188,92,90,182,0
2024-01-06,LC,Cyprus,790,603,1,1,187,89,97,186,0
2024-01-07,LC,Cyprus,866,673,5,5,193,90,98,188,0
2024-01-08,LC,Cyprus,749,561,6,6,188,93,89,182,0
2024-01-09,LC,Cyprus,694,560,6,6,134,62,66,128,0
2024-01-10,LC,Cyprus,702,534,7,7,168,80,81,161,0
2024-01-11,LC,Cyprus,815,650,7,7,165,78,80,158,0
2024-01-12,LC,Cyprus,679,495,4,3,184,94,86,180,1
2024-01-13,LC,Cyprus,667,512,2,2,155,75,78,153,0
2024-01-14,LC,Cyprus,741,554,7,7,187,91,89,180,0
2024-01-15,LC,Cyprus,686,506,10,10,180,86,84,170,0
2024-01-16,LC,Cyprus,612,495,9,9,117,55,53,108,0
2024-01-17,LC,Cyprus,700,537,8,8,163,76,79,155,0
2024-01-18,LC,Cyprus,737,585,9,9,152,71,72,143,0
2024-01-19,LC,Cyprus,748,566,7,7,182,90,85,175,0
2024-01-20,LC,Cyprus,721,575,2,2,146,68,76,144,0
2024-01-21,LC,Cyprus,818,622,8,8,196,92,96,188,0
2024-01-22,LC,Cyprus,712,536,5,5,176,89,82,171,0
2024-01-23,LC,Cyprus,623,513,4,4,110,51,55,106,0
2024-01-24,LC,Cyprus,694,532,7,7,162,81,74,155,0
2024-01-25,LC,Cyprus,782,635,6,6,147,71,70,141,0
2024-01-26,LC,Cyprus,687,520,4,4,167,84,79,163,0
2024-01-27,LC,Cyprus,722,587,0,0,135,66,69,135,0
2024-01-28,LC,Cyprus,788,620,4,4,168,82,82,164,0
2024-01-29,LC,Cyprus,700,539,4,4,161,78,79,157,0
2024-01-30,LC,Cyprus,691,570,6,5,121,58,57,115,1
2024-01-31,LC,Cyprus,736,590,4,2,146,71,71,142,2
2024-02-01,LC,Cyprus,809,662,6,6,147,69,72,141,0
2024-02-02,LC,Cyprus,763,580,5,5,183,90,88,178,0
2024-02-03,LC,Cyprus,708,560,5,4,148,69,74,143,1
2024-02-04,LC,Cyprus,797,615,2,1,182,94,86,180,1
2024-01-01,LK,Czech Republic,1530,1248,0,0,282,137,145,282,0
2024-01-02,LK,Czech Republic,1629,1322,2,0,307,156,149,305,2
2024-01-03,LK,Czech Republic,1754,1423,7,3,331,160,164,324,4
2024-01-04,LK,Czech Republic,94,-232,4,0,326,159,163,322,4
2024-01-05,LK,Czech Republic,1919,1547,18,3,372,180,174,354,15
2024-01-06,LK,Czech Republic,1742,1501,6,0,241,110,125,235,6
2024-01-07,LK,Czech Republic,1820,1491,5,2,329,160,164,324,3
2024-01-08,LK,Czech Republic,1811,1484,13,3,327,155,159,314,10
2024-01-09,LK,Czech Republic,1448,1213,12,9,235,111,112,223,3
2024-01-10,LK,Czech Republic,1618,1337,19,7,281,131,131,262,12
2024-01-11,LK,Czech Republic,1586,1273,17,6,313,153,143,296,11
2024-01-12,LK,Czech Republic,1727,1398,14,4,329,159,156,315,10
2024-01-13,LK,Czech Republic,1494,1286,3,1,208,104,101,205,2
2024-01-14,LK,Czech Republic,1636,1338,10,3,298,137,151,288,7
2024-01-15,LK,Czech Republic,1659,1354,7,2,305,147,151,298,5
2024-01-16,LK,Czech Republic,1355,1123,11,5,232,114,107,221,6
2024-01-17,LK,Czech Republic,1339,1102,7,4,237,115,115,230,3
2024-01-18,LK,Czech Republic,1492,1230,3,0,262,129,130,259,3
2024-01-19,LK,Czech Republic,1724,1394,17,8,330,156,157,313,9
2024-01-20,LK,Czech Republic,1563,1353,12,6,210,104,94,198,6
2024-01-21,LK,Czech Republic,1579,1277,11,8,302,141,150,291,3
2024-01-22,LK,Czech Republic,1639,1318,9,4,321,152,160,312,5
2024-01-23,LK,Czech Republic,1343,1119,5,2,224,111,108,219,3
2024-01-24,LK,Czech Republic,1428,1168,5,1,260,129,126,255,4
2024-01-25,LK,Czech Republic,1502,1215,4,2,287,144,139,283,2
2024-01-26,LK,Czech Republic,1692,1358,11,4,334,160,163,323,7
2024-01-27,LK,Czech Republic,1533,1313,8,5,220,105,107,212,3
2024-01-28,LK,Czech Republic,1605,1292,16,9,313,141,156,297,7
2024-01-29,LK,Czech Republic,1542,1243,7,3,299,146,146,292,4
2024-01-30,LK,Czech Republic,1401,1128,14,7,273,129,130,259,7
2024-01-31,LK,Czech Republic,1445,1184,9,2,261,124,128,252,7
2024-02-01,LK,Czech Republic,1411,1108,10,2,303,154,139,293,8
2024-02-02,LK,Czech Republic,1723,1379,12,4,344,171,161,332,8
2024-02-03,LK,Czech Republic,1558,1317,8,1,241,115,118,233,7
2024-02-04,LK,Czech Republic,1605,1306,1,0,299,144,154,298,1
2024-01-01,EK,Denmark,1283,704,54,0,579,265,260,525,54
2024-01-02,EK,Denmark,1313,670,89,3,643,276,278,554,86
2024-01-03,EK,Denmark,1313,690,48,0,623,289,286,575,48
2024-01-04,EK,Denmark,47,-578,62,3,625,282,281,563,59
2024-01-05,EK,Denmark,1414,704,66,9,710,321,323,644,57
2024-01-06,EK,Denmark,1246,703,36,1,543,253,254,507,35
2024-01-07,EK,Denmark,1415,766,46,0,649,304,299,603,46
2024-01-08,EK,Denmark,1372,643,83,12,729,324,322,646,71
2024-01-09,EK,Denmark,1085,526,63,6,559,250,246,496,57
2024-01-10,EK,Denmark,1165,553,66,4,612,273,273,546,62
2024-01-11,EK,Denmark,1260,609,96,10,651,276,279,555,86
2024-01-12,EK,Denmark,1412,680,105,6,732,311,316,627,99
2024-01-13,EK,Denmark,1142,637,40,2,505,230,235,465,38
2024-01-14,EK,Denmark,1337,705,58,5,632,285,289,574,53
2024-01-15,EK,Denmark,1284,606,74,8,678,311,293,604,66
2024-01-16,EK,Denmark,1074,525,74,14,549,233,242,475,60
2024-01-17,EK,Denmark,1069,497,75,7,572,247,250,497,68
2024-01-18,EK,Denmark,1245,613,101,18,632,263,268,531,83
2024-01-19,EK,Denmark,1440,692,92,7,748,328,328,656,85
2024-01-20,EK,Denmark,1169,647,35,1,522,240,247,487,34
2024-01-21,EK,Denmark,1321,693,57,5,628,287,284,571,52
2024-01-22,EK,Denmark,1357,646,92,5,711,314,305,619,87
2024-01-23,EK,Denmark,1160,559,87,11,601,255,259,514,76
2024-01-24,EK,Denmark,1204,595,78,6,609,265,266,531,72
2024-01-25,EK,Denmark,1332,633,118,18,699,293,288,581,100
2024-01-26,EK,Denmark,1444,703,92,1,741,318,331,649,91
2024-01-27,EK,Denmark,1152,622,33,6,530,248,249,497,27
2024-01-28,EK,Denmark,1378,737,60,3,641,288,293,581,57
2024-01-29,EK,Denmark,1432,669,107,16,763,335,321,656,91
2024-01-30,EK,Denmark,1186,549,105,11,637,265,267,532,94
2024-01-31,EK,Denmark,1286,599,121,13,687,286,280,566,108
2024-02-01,EK,Denmark,1240,562,104,8,678,286,288,574,96
2024-02-02,EK,Denmark,1464,680,101,8,784,338,345,683,93
2024-02-03,EK,Denmark,1216,658,34,3,558,258,266,524,31
2024-02-04,EK,Denmark,1397,735,53,0,662,307,302,609,53
2024-01-01,EE,Estonia,345,253,9,1,92,41,42,83,8
2024-01-02,EE,Estonia,363,275,10,2,88,40,38,78,8
2024-01-03,EE,Estonia,379,283,11,3,96,40,45,85,8
2024-01-04,EE,Estonia,19,-72,9,1,91,39,43,82,8
2024-01-05,EE,Estonia,410,316,12,4,94,42,40,82,8
2024-01-06,EE,Estonia,386,312,5,1,74,34,35,69,4
2024-01-07,EE,Estonia,405,308,5,1,97,48,44,92,4
2024-01-08,EE,Estonia,408,300,8,0,108,51,49,100,8
2024-01-09,EE,Estonia,347,261,10,2,86,38,38,76,8
2024-01-10,EE,Estonia,342,251,9,1,91,40,42,82,8
2024-01-11,EE,Estonia,351,265,9,1,86,41,36,77,8
2024-01-12,EE,Estonia,352,259,6,2,93,41,46,87,4
2024-01-13,EE,Estonia,359,286,6,2,73,33,34,67,4
2024-01-14,EE,Estonia,356,267,5,1,89,43,41,84,4
2024-01-15,EE,Estonia,344,248,8,2,96,45,43,88,6
2024-01-16,EE,Estonia,285,208,10,2,77,34,33,67,8
2024-01-17,EE,Estonia,311,231,11,3,80,34,35,69,8
2024-01-18,EE,Estonia,326,242,7,0,84,37,40,77,7
2024-01-19,EE,Estonia,355,258,7,1,97,44,46,90,6
2024-01-20,EE,Estonia,333,261,5,1,72,34,33,67,4
2024-01-21,EE,Estonia,370,279,5,1,91,43,43,86,4
2024-01-22,EE,Estonia,340,261,5,1,79,39,35,74,4
2024-01-23,EE,Estonia,315,230,9,1,85,36,40,76,8
2024-01-24,EE,Estonia,328,240,10,2,88,38,40,78,8
2024-01-25,EE,Estonia,358,268,10,2,90,39,41,80,8
2024-01-26,EE,Estonia,382,286,9,1,96,44,43,87,8
2024-01-27,EE,Estonia,342,275,6,2,67,32,29,61,4
2024-01-28,EE,Estonia,353,267,5,1,86,39,42,81,4
2024-01-29,EE,Estonia,372,273,11,3,99,46,42,88,8
2024-01-30,EE,Estonia,302,228,10,2,74,32,32,64,8
2024-01-31,EE,Estonia,325,243,9,1,82,37,36,73,8
2024-02-01,EE,Estonia,270,193,10,2,77,31,36,67,8
2024-02-02,EE,Estonia,286,198,15,5,88,37,36,73,10
2024-02-03,EE,Estonia,338,268,7,3,70,32,31,63,4
2024-02-04,EE,Estonia,357,269,6,2,88,41,41,82,4
2024-01-01,EF,Finland,527,149,80,0,378,147,151,298,80
2024-01-02,EF,Finland,661,175,97,2,486,200,189,389,95
2024-01-03,EF,Finland,638,191,86,0,447,179,182,361,86
2024-01-04,EF,Finland,33,-404,93,1,437,172,172,344,92
2024-01-05,EF,Finland,642,193,107,2,449,172,170,342,105
2024-01-06,EF,Finland,621,169,78,0,452,187,187,374,78
2024-01-07,EF,Finland,693,193,86,0,500,201,213,414,86
2024-01-08,EF,Finland,641,165,124,3,476,178,174,352,121
2024-01-09,EF,Finland,594,141,116,2,453,172,165,337,114
2024-01-10,EF,Finland,603,153,115,0,450,165,170,335,115
2024-01-11,EF,Finland,605,141,123,2,464,171,170,341,121
2024-01-12,EF,Finland,585,147,105,0,438,168,165,333,105
2024-01-13,EF,Finland,534,108,68,1,426,180,178,358,67
2024-01-14,EF,Finland,599,151,82,0,448,180,186,366,82
2024-01-15,EF,Finland,594,140,116,1,454,165,173,338,115
2024-01-16,EF,Finland,543,125,99,2,418,166,153,319,97
2024-01-17,EF,Finland,580,143,107,2,437,164,166,330,105
2024-01-18,EF,Finland,591,130,125,0,461,166,170,336,125
2024-01-19,EF,Finland,603,150,118,0,453,168,167,335,118
2024-01-20,EF,Finland,573,128,81,1,445,184,180,364,80
2024-01-21,EF,Finland,618,164,86,0,454,179,189,368,86
2024-01-22,EF,Finland,558,129,118,2,429,152,159,311,116
2024-01-23,EF,Finland,590,139,108,3,451,178,165,343,105
2024-01-24,EF,Finland,597,138,114,1,459,175,170,345,113
2024-01-25,EF,Finland,632,155,135,1,477,171,171,342,134
2024-01-26,EF,Finland,634,156,131,2,478,170,177,347,129
2024-01-27,EF,Finland,570,123,80,0,447,186,181,367,80
2024-01-28,EF,Finland,594,142,89,0,452,178,185,363,89
2024-01-29,EF,Finland,582,140,105,1,442,171,166,337,104
2024-01-30,EF,Finland,552,121,115,1,431,157,159,316,114
2024-01-31,EF,Finland,628,146,117,2,482,187,178,365,115
2024-02-01,EF,Finland,320,135,32,0,185,69,84,153,32
2024-02-02,EF,Finland,325,138,30,0,187,82,75,157,30
2024-02-03,EF,Finland,552,109,78,1,443,183,182,365,77
2024-02-04,EF,Finland,627,153,88,1,474,192,194,386,87
2024-01-01,LF,France,7333,4123,460,1,3210,1382,1368,2750,459
2024-01-02,LF,France,7895,4410,610,6,3485,1425,1450,2875,604
2024-01-03,LF,France,7680,4223,618,28,3457,1415,1424,2839,590
2024-01-04,LF,France,230,-3336,721,24,3566,1425,1420,2845,697
2024-01-05,LF,France,8410,4583,778,11,3827,1519,1530,3049,767
2024-01-06,LF,France,8126,4761,441,8,3365,1472,1452,2924,433
2024-01-07,LF,France,8382,4760,583,24,3622,1523,1516,3039,559
2024-01-08,LF,France,7675,4115,793,28,3560,1372,1395,2767,765
2024-01-09,LF,France,6050,3332,694,24,2718,1009,1015,2024,670
2024-01-10,LF,France,6118,3314,715,26,2804,1046,1043,2089,689
2024-01-11,LF,France,6452,3491,792,31,2961,1067,1102,2169,761
2024-01-12,LF,France,7503,4159,842,26,3344,1267,1235,2502,816
2024-01-13,LF,France,6832,4141,394,17,2691,1148,1149,2297,377
2024-01-14,LF,France,7304,4346,486,7,2958,1233,1239,2472,479
2024-01-15,LF,France,6862,3780,784,31,3082,1140,1158,2298,753
2024-01-16,LF,France,5831,3036,823,39,2795,989,983,1972,784
2024-01-17,LF,France,5569,2946,702,33,2623,960,961,1921,669
2024-01-18,LF,France,6298,3413,803,31,2885,1046,1036,2082,772
2024-01-19,LF,France,7479,4129,861,32,3350,1239,1250,2489,829
2024-01-20,LF,France,6698,4064,408,8,2634,1122,1104,2226,400
2024-01-21,LF,France,7020,4080,481,9,2940,1216,1243,2459,472
2024-01-22,LF,France,6943,3804,836,35,3139,1152,1151,2303,801
2024-01-23,LF,France,5753,2997,827,48,2756,957,972,1929,779
2024-01-24,LF,France,6114,3162,927,45,2952,1018,1007,2025,882
2024-01-25,LF,France,6558,3504,864,44,3054,1102,1088,2190,820
2024-01-26,LF,France,7400,4087,878,29,3313,1219,1216,2435,849
2024-01-27,LF,France,6799,4117,440,20,2682,1127,1115,2242,420
2024-01-28,LF,France,7272,4297,518,18,2975,1235,1222,2457,500
2024-01-29,LF,France,6931,3748,870,33,3183,1149,1164,2313,837
2024-01-30,LF,France,5900,3025,894,51,2875,988,993,1981,843
2024-01-31,LF,France,6231,3269,897,51,2962,1020,1045,2065,846
2024-02-01,LF,France,6711,3590,919,52,3121,1105,1097,2202,867
2024-02-02,LF,France,7581,4208,884,37,3373,1232,1257,2489,847
2024-02-03,LF,France,7058,4292,423,16,2766,1179,1164,2343,407
2024-02-04,LF,France,7488,4456,509,12,3032,1278,1245,2523,497
2024-01-01,UG,Georgia,518,395,0,0,123,58,65,123,0
2024-01-02,UG,Georgia,614,462,0,0,152,76,76,152,0
2024-01-03,UG,Georgia,590,453,2,0,137,68,67,135,2
2024-01-04,UG,Georgia,94,-46,0,0,140,69,71,140,0
2024-01-05,UG,Georgia,641,487,3,0,154,76,75,151,3
2024-01-06,UG,Georgia,616,476,0,0,140,71,69,140,0
2024-01-07,UG,Georgia,628,476,2,0,152,74,76,150,2
2024-01-08,UG,Georgia,602,461,0,0,141,73,68,141,0
2024-01-09,UG,Georgia,609,463,0,0,146,72,74,146,0
2024-01-10,UG,Georgia,588,452,3,0,136,66,67,133,3
2024-01-11,UG,Georgia,599,458,3,0,141,70,68,138,3
2024-01-12,UG,Georgia,627,484,0,0,143,69,74,143,0
2024-01-13,UG,Georgia,604,473,1,0,131,66,64,130,1
2024-01-14,UG,Georgia,621,469,0,0,152,77,75,152,0
2024-01-15,UG,Georgia,563,433,2,0,130,66,62,128,2
2024-01-16,UG,Georgia,592,460,1,1,132,64,67,131,0
2024-01-17,UG,Georgia,545,412,2,0,133,66,65,131,2
2024-01-18,UG,Georgia,575,430,0,0,145,73,72,145,0
2024-01-19,UG,Georgia,592,452,2,0,140,67,71,138,2
2024-01-20,UG,Georgia,608,484,0,0,124,63,61,124,0
2024-01-21,UG,Georgia,595,450,2,0,145,71,72,143,2
2024-01-22,UG,Georgia,556,441,0,0,115,57,58,115,0
2024-01-23,UG,Georgia,575,444,0,0,131,64,67,131,0
2024-01-24,UG,Georgia,577,459,2,0,118,58,58,116,2
2024-01-25,UG,Georgia,598,463,0,0,135,67,68,135,0
2024-01-26,UG,Georgia,590,445,2,0,145,73,70,143,2
2024-01-27,UG,Georgia,587,459,1,0,128,65,62,127,1
2024-01-28,UG,Georgia,608,468,2,0,140,70,68,138,2
2024-01-29,UG,Georgia,526,419,0,0,107,55,52,107,0
2024-01-30,UG,Georgia,569,447,0,0,122,61,61,122,0
2024-01-31,UG,Georgia,557,446,2,0,111,55,54,109,2
2024-02-01,UG,Georgia,541,410,0,0,131,63,68,131,0
2024-02-02,UG,Georgia,599,457,1,1,142,71,70,141,0
2024-02-03,UG,Georgia,583,468,0,0,115,57,58,115,0
2024-02-04,UG,Georgia,601,466,0,0,135,66,69,135,0
2024-01-01,ED,Germany,5950,3008,227,3,2942,1384,1331,2715,224
2024-01-02,ED,Germany,6684,3097,354,11,3587,1631,1602,3233,343
2024-01-03,ED,Germany,6843,3132,360,22,3711,1679,1672,3351,338
2024-01-04,ED,Germany,279,-3486,369,17,3765,1693,1703,3396,352
2024-01-05,ED,Germany,7406,3332,424,25,4074,1814,1836,3650,399
2024-01-06,ED,Germany,6900,3391,266,4,3509,1632,1611,3243,262
2024-01-07,ED,Germany,7149,3354,319,1,3795,1721,1755,3476,318
2024-01-08,ED,Germany,6997,3097,496,17,3900,1692,1712,3404,479
2024-01-09,ED,Germany,6082,2540,546,22,3542,1494,1502,2996,524
2024-01-10,ED,Germany,6303,2636,594,34,3667,1540,1533,3073,560
2024-01-11,ED,Germany,6487,2762,573,19,3725,1576,1576,3152,554
2024-01-12,ED,Germany,6996,3134,458,7,3862,1706,1698,3404,451
2024-01-13,ED,Germany,6150,3063,291,5,3087,1406,1390,2796,286
2024-01-14,ED,Germany,6700,3199,353,7,3501,1557,1591,3148,346
2024-01-15,ED,Germany,6547,2965,452,11,3582,1527,1603,3130,441
2024-01-16,ED,Germany,5794,2444,536,27,3350,1411,1403,2814,509
2024-01-17,ED,Germany,4886,2547,314,22,2339,1007,1018,2025,292
2024-01-18,ED,Germany,6041,2766,454,22,3275,1414,1407,2821,432
2024-01-19,ED,Germany,7066,3121,547,23,3945,1727,1671,3398,524
2024-01-20,ED,Germany,6168,3038,385,10,3130,1384,1361,2745,375
2024-01-21,ED,Germany,6453,3036,415,14,3417,1485,1517,3002,401
2024-01-22,ED,Germany,6534,2867,484,16,3667,1582,1601,3183,468
2024-01-23,ED,Germany,5891,2401,616,43,3490,1441,1433,2874,573
2024-01-24,ED,Germany,5949,2435,523,16,3514,1501,1490,2991,507
2024-01-25,ED,Germany,6479,2669,645,31,3810,1575,1590,3165,614
2024-01-26,ED,Germany,6941,3039,568,20,3902,1673,1661,3334,548
2024-01-27,ED,Germany,6349,3096,447,15,3253,1415,1391,2806,432
2024-01-28,ED,Germany,6693,3132,449,6,3561,1552,1560,3112,443
2024-01-29,ED,Germany,6838,3012,598,18,3826,1582,1646,3228,580
2024-01-30,ED,Germany,6085,2502,640,34,3583,1473,1470,2943,606
2024-01-31,ED,Germany,6399,2646,678,23,3753,1562,1513,3075,655
2024-02-01,ED,Germany,5983,2790,489,25,3193,1340,1364,2704,464
2024-02-02,ED,Germany,7162,3011,604,28,4151,1790,1757,3547,576
2024-02-03,ED,Germany,6314,3069,353,4,3245,1469,1423,2892,349
2024-02-04,ED,Germany,6737,3210,354,3,3527,1565,1608,3173,351
2024-01-01,LG,Greece,1580,995,210,0,585,187,188,375,210
2024-01-02,LG,Greece,1757,1033,270,9,724,229,225,454,261
2024-01-03,LG,Greece,1757,1050,255,19,707,225,227,452,236
2024-01-04,LG,Greece,85,-595,279,17,680,205,196,401,262
2024-01-05,LG,Greece,1912,1164,297,21,748,225,226,451,276
2024-01-06,LG,Greece,1963,1289,258,4,674,204,212,416,254
2024-01-07,LG,Greece,1932,1216,256,5,716,233,227,460,251
2024-01-08,LG,Greece,1713,1002,297,9,711,210,204,414,288
2024-01-09,LG,Greece,1524,960,249,24,564,156,159,315,225
2024-01-10,LG,Greece,1504,918,251,22,586,168,167,335,229
2024-01-11,LG,Greece,1644,1028,294,27,616,163,159,322,267
2024-01-12,LG,Greece,1614,937,283,16,677,195,199,394,267
2024-01-13,LG,Greece,1609,1086,230,6,523,146,147,293,224
2024-01-14,LG,Greece,1694,1092,243,10,602,180,179,359,233
2024-01-15,LG,Greece,1490,871,258,7,619,181,180,361,251
2024-01-16,LG,Greece,1378,847,250,22,531,143,138,281,228
2024-01-17,LG,Greece,1407,841,248,25,566,158,160,318,223
2024-01-18,LG,Greece,1486,907,273,26,579,153,153,306,247
2024-01-19,LG,Greece,1605,948,278,17,657,189,190,379,261
2024-01-20,LG,Greece,1562,1057,220,5,505,142,143,285,215
2024-01-21,LG,Greece,1615,1054,213,1,561,176,172,348,212
2024-01-22,LG,Greece,1469,856,248,16,613,176,189,365,232
2024-01-23,LG,Greece,1376,810,268,37,566,152,146,298,231
2024-01-24,LG,Greece,1379,828,252,38,551,149,150,299,214
2024-01-25,LG,Greece,1499,891,285,24,608,166,157,323,261
2024-01-26,LG,Greece,1549,901,271,14,648,186,191,377,257
2024-01-27,LG,Greece,1574,1060,226,14,514,143,145,288,212
2024-01-28,LG,Greece,1571,1001,228,5,570,172,170,342,223
2024-01-29,LG,Greece,1469,843,267,24,626,181,178,359,243
2024-01-30,LG,Greece,1370,839,251,29,531,140,140,280,222
2024-01-31,LG,Greece,1485,909,262,21,576,158,156,314,241
2024-02-01,LG,Greece,1583,951,286,15,632,171,175,346,271
2024-02-02,LG,Greece,1674,982,283,16,692,206,203,409,267
2024-02-03,LG,Greece,1619,1095,227,8,524,149,148,297,219
2024-02-04,LG,Greece,1710,1113,243,9,597,181,173,354,234
2024-01-01,LH,Hungary,2200,1898,2,0,302,150,150,300,2
2024-01-02,LH,Hungary,2294,1991,0,0,303,151,152,303,0
2024-01-03,LH,Hungary,2407,2072,1,1,335,167,167,334,0
2024-01-04,LH,Hungary,214,-92,1,0,306,157,148,305,1
2024-01-05,LH,Hungary,2562,2215,5,2,347,169,173,342,3
2024-01-06,LH,Hungary,2499,2239,0,0,260,131,129,260,0
2024-01-07,LH,Hungary,2580,2272,0,0,308,151,157,308,0
2024-01-08,LH,Hungary,2446,2115,2,0,331,165,164,329,2
2024-01-09,LH,Hungary,2198,1952,1,1,246,127,118,245,0
2024-01-10,LH,Hungary,2294,2014,1,0,280,137,142,279,1
2024-01-11,LH,Hungary,2321,2041,3,1,280,138,139,277,2
2024-01-12,LH,Hungary,2420,2095,3,3,325,159,163,322,0
2024-01-13,LH,Hungary,2237,1993,1,1,244,121,122,243,0
2024-01-14,LH,Hungary,2339,2043,0,0,296,147,149,296,0
2024-01-15,LH,Hungary,2270,1935,6,1,335,166,163,329,5
2024-01-16,LH,Hungary,2037,1789,5,2,248,125,118,243,3
2024-01-17,LH,Hungary,2014,1723,6,0,291,144,141,285,6
2024-01-18,LH,Hungary,2194,1924,1,1,270,133,136,269,0
2024-01-19,LH,Hungary,2386,2053,2,0,333,161,170,331,2
2024-01-20,LH,Hungary,2314,2065,5,3,249,129,115,244,2
2024-01-21,LH,Hungary,2337,2059,0,0,278,137,141,278,0
2024-01-22,LH,Hungary,2266,1940,2,0,326,163,161,324,2
2024-01-23,LH,Hungary,2037,1786,3,1,251,126,122,248,2
2024-01-24,LH,Hungary,2048,1763,2,0,285,141,142,283,2
2024-01-25,LH,Hungary,2189,1910,4,0,279,136,139,275,4
2024-01-26,LH,Hungary,2285,1947,7,1,338,161,170,331,6
2024-01-27,LH,Hungary,2211,1965,3,0,246,125,118,243,3
2024-01-28,LH,Hungary,2346,2055,1,0,291,146,144,290,1
2024-01-29,LH,Hungary,2151,1828,4,2,323,163,156,319,2
2024-01-30,LH,Hungary,2062,1808,1,1,254,125,128,253,0
2024-01-31,LH,Hungary,2084,1794,6,1,290,141,143,284,5
2024-02-01,LH,Hungary,2067,1786,4,2,281,138,139,277,2
2024-02-02,LH,Hungary,2315,1990,1,0,325,162,162,324,1
2024-02-03,LH,Hungary,2191,1953,1,1,238,119,118,237,0
2024-02-04,LH,Hungary,2275,1984,2,2,291,141,148,289,0
2024-01-01,EI,Ireland,1317,585,9,0,732,360,363,723,9
2024-01-02,EI,Ireland,1310,592,18,4,718,350,350,700,14
2024-01-03,EI,Ireland,1427,695,17,4,732,355,360,715,13
2024-01-04,EI,Ireland,138,-623,18,4,761,371,372,743,14
2024-01-05,EI,Ireland,1595,749,22,6,846,412,412,824,16
2024-01-06,EI,Ireland,1456,748,14,2,708,346,348,694,12
2024-01-07,EI,Ireland,1592,781,11,1,811,398,402,800,10
2024-01-08,EI,Ireland,1471,721,17,3,750,372,361,733,14
2024-01-09,EI,Ireland,1261,738,19,2,523,252,252,504,17
2024-01-10,EI,Ireland,1198,655,17,3,543,263,263,526,14
2024-01-11,EI,Ireland,1343,738,21,5,605,292,292,584,16
2024-01-12,EI,Ireland,1443,690,26,14,753,361,366,727,12
2024-01-13,EI,Ireland,1287,670,11,3,617,304,302,606,8
2024-01-14,EI,Ireland,1289,591,9,1,698,340,349,689,8
2024-01-15,EI,Ireland,1394,702,18,5,692,342,332,674,13
2024-01-16,EI,Ireland,1176,631,19,5,545,261,265,526,14
2024-01-17,EI,Ireland,1145,614,14,3,531,262,255,517,11
2024-01-18,EI,Ireland,1238,634,17,4,604,294,293,587,13
2024-01-19,EI,Ireland,1520,773,16,7,747,366,365,731,9
2024-01-20,EI,Ireland,1198,589,8,0,609,301,300,601,8
2024-01-21,EI,Ireland,1107,621,12,0,486,233,241,474,12
2024-01-22,EI,Ireland,1164,442,11,1,722,355,356,711,10
2024-01-23,EI,Ireland,1078,551,11,1,527,255,261,516,10
2024-01-24,EI,Ireland,1090,512,22,6,578,278,278,556,16
2024-01-25,EI,Ireland,1217,588,18,4,629,307,304,611,14
2024-01-26,EI,Ireland,1398,642,20,5,756,368,368,736,15
2024-01-27,EI,Ireland,1278,672,9,1,606,298,299,597,8
2024-01-28,EI,Ireland,1307,589,12,3,718,353,353,706,9
2024-01-29,EI,Ireland,1320,634,16,4,686,335,335,670,12
2024-01-30,EI,Ireland,1165,606,19,6,559,267,273,540,13
2024-01-31,EI,Ireland,1042,466,16,6,576,284,276,560,10
2024-02-01,EI,Ireland,1267,639,22,6,628,306,300,606,16
2024-02-02,EI,Ireland,1407,587,22,7,820,398,400,798,15
2024-02-03,EI,Ireland,1170,524,14,4,646,316,316,632,10
2024-02-04,EI,Ireland,1245,493,12,2,752,367,373,740,10
2024-01-01,LL,Israel,188,3,23,4,185,82,80,162,19
2024-01-02,LL,Israel,186,6,27,2,180,77,76,153,25
2024-01-03,LL,Israel,179,10,19,1,169,76,74,150,18
2024-01-04,LL,Israel,15,-192,33,1,207,87,87,174,32
2024-01-05,LL,Israel,145,18,21,2,127,51,55,106,19
2024-01-06,LL,Israel,102,8,17,2,94,37,40,77,15
2024-01-07,LL,Israel,212,0,29,6,212,93,90,183,23
2024-01-08,LL,Israel,210,8,22,3,202,91,89,180,19
2024-01-09,LL,Israel,188,23,19,1,165,75,71,146,18
2024-01-10,LL,Israel,193,2,25,3,191,81,85,166,22
2024-01-11,LL,Israel,241,2,34,4,239,100,105,205,30
2024-01-12,LL,Israel,151,19,14,1,132,57,61,118,13
2024-01-13,LL,Israel,109,-3,21,2,112,44,47,91,19
2024-01-14,LL,Israel,222,-6,25,4,228,105,98,203,21
2024-01-15,LL,Israel,197,9,16,1,188,86,86,172,15
2024-01-16,LL,Israel,173,13,25,4,160,68,67,135,21
2024-01-17,LL,Israel,191,6,24,3,185,79,82,161,21
2024-01-18,LL,Israel,227,2,28,0,225,99,98,197,28
2024-01-19,LL,Israel,145,16,13,1,129,59,57,116,12
2024-01-20,LL,Israel,99,-3,19,1,102,41,42,83,18
2024-01-21,LL,Israel,236,-3,28,2,239,105,106,211,26
2024-01-22,LL,Israel,221,12,17,1,209,95,97,192,16
2024-01-23,LL,Israel,178,7,25,2,171,72,74,146,23
2024-01-24,LL,Israel,210,2,30,1,208,92,86,178,29
2024-01-25,LL,Israel,224,4,21,1,220,96,103,199,20
2024-01-26,LL,Israel,145,17,15,2,128,57,56,113,13
2024-01-27,LL,Israel,97,0,17,1,97,41,39,80,16
2024-01-28,LL,Israel,241,-7,38,3,248,105,105,210,35
2024-01-29,LL,Israel,201,10,20,2,191,88,83,171,18
2024-01-30,LL,Israel,179,3,25,4,176,73,78,151,21
2024-01-31,LL,Israel,202,0,20,4,202,95,87,182,16
2024-02-01,LL,Israel,250,4,29,5,246,108,109,217,24
2024-02-02,LL,Israel,168,22,18,4,146,65,63,128,14
2024-02-03,LL,Israel,115,3,19,2,112,44,49,93,17
2024-02-04,LL,Israel,250,-2,22,3,252,118,112,230,19
2024-01-01,LI,Italy,4331,1335,664,3,2996,1171,1161,2332,661
2024-01-02,LI,Italy,4525,1480,713,11,3045,1164,1168,2332,702
2024-01-03,LI,Italy,4530,1457,755,29,3073,1156,1162,2318,726
2024-01-04,LI,Italy,110,-3005,776,25,3115,1167,1172,2339,751
2024-01-05,LI,Italy,4863,1584,750,19,3279,1260,1269,2529,731
2024-01-06,LI,Italy,4633,1643,672,5,2990,1159,1159,2318,667
2024-01-07,LI,Italy,4907,1669,728,10,3238,1250,1260,2510,718
2024-01-08,LI,Italy,4554,1425,769,25,3129,1187,1173,2360,744
2024-01-09,LI,Italy,3624,1165,625,22,2459,916,918,1834,603
2024-01-10,LI,Italy,3687,1204,670,27,2483,898,915,1813,643
2024-01-11,LI,Italy,3791,1235,659,21,2556,944,953,1897,638
2024-01-12,LI,Italy,4432,1363,753,19,3069,1145,1171,2316,734
2024-01-13,LI,Italy,4004,1388,604,15,2616,1016,996,2012,589
2024-01-14,LI,Italy,4277,1464,620,9,2813,1091,1102,2193,611
2024-01-15,LI,Italy,4191,1262,714,26,2929,1110,1105,2215,688
2024-01-16,LI,Italy,3408,1103,617,34,2305,848,840,1688,583
2024-01-17,LI,Italy,3414,1053,653,34,2361,847,861,1708,619
2024-01-18,LI,Italy,3596,1107,635,30,2489,931,923,1854,605
2024-01-19,LI,Italy,4365,1350,738,34,3015,1137,1140,2277,704
2024-01-20,LI,Italy,3886,1338,591,10,2548,984,973,1957,581
2024-01-21,LI,Italy,4201,1392,634,9,2809,1083,1092,2175,625
2024-01-22,LI,Italy,4134,1232,736,34,2902,1098,1068,2166,702
2024-01-23,LI,Italy,3377,1020,656,33,2357,842,859,1701,623
2024-01-24,LI,Italy,3545,1144,645,34,2401,866,890,1756,611
2024-01-25,LI,Italy,3712,1165,646,41,2547,953,948,1901,605
2024-01-26,LI,Italy,4332,1295,749,18,3037,1141,1147,2288,731
2024-01-27,LI,Italy,3895,1309,601,10,2586,1007,978,1985,591
2024-01-28,LI,Italy,4144,1344,617,9,2800,1084,1099,2183,608
2024-01-29,LI,Italy,4127,1188,722,25,2939,1112,1105,2217,697
2024-01-30,LI,Italy,3401,1027,635,27,2374,874,865,1739,608
2024-01-31,LI,Italy,3582,1151,640,28,2431,901,890,1791,612
2024-02-01,LI,Italy,3754,1176,639,20,2578,968,971,1939,619
2024-02-02,LI,Italy,4420,1358,727,10,3062,1151,1184,2335,717
2024-02-03,LI,Italy,4056,1441,604,8,2615,1014,997,2011,596
2024-02-04,LI,Italy,4366,1475,635,12,2891,1129,1127,2256,623
2024-01-01,EV,Latvia,466,312,0,0,154,78,76,154,0
2024-01-02,EV,Latvia,484,343,2,2,141,70,69,139,0
2024-01-03,EV,Latvia,477,335,3,3,142,70,69,139,0
2024-01-04,EV,Latvia,26,-146,1,1,172,86,85,171,0
2024-01-05,EV,Latvia,548,377,0,0,171,86,85,171,0
2024-01-06,EV,Latvia,506,363,1,1,143,71,71,142,0
2024-01-07,EV,Latvia,555,384,0,0,171,82,89,171,0
2024-01-08,EV,Latvia,558,376,1,1,182,91,90,181,0
2024-01-09,EV,Latvia,423,322,1,1,101,49,51,100,0
2024-01-10,EV,Latvia,422,319,4,4,103,49,50,99,0
2024-01-11,EV,Latvia,450,322,2,2,128,65,61,126,0
2024-01-12,EV,Latvia,475,316,0,0,159,81,78,159,0
2024-01-13,EV,Latvia,448,322,0,0,126,62,64,126,0
2024-01-14,EV,Latvia,487,336,0,0,151,74,77,151,0
2024-01-15,EV,Latvia,485,316,0,0,169,84,85,169,0
2024-01-16,EV,Latvia,351,264,0,0,87,44,43,87,0
2024-01-17,EV,Latvia,396,293,1,1,103,52,50,102,0
2024-01-18,EV,Latvia,423,309,1,1,114,57,56,113,0
2024-01-19,EV,Latvia,478,328,0,0,150,76,74,150,0
2024-01-20,EV,Latvia,433,315,0,0,118,58,60,118,0
2024-01-21,EV,Latvia,503,355,0,0,148,75,73,148,0
2024-01-22,EV,Latvia,486,321,2,2,165,80,83,163,0
2024-01-23,EV,Latvia,387,293,0,0,94,48,46,94,0
2024-01-24,EV,Latvia,405,302,1,1,103,49,53,102,0
2024-01-25,EV,Latvia,438,325,0,0,113,58,55,113,0
2024-01-26,EV,Latvia,498,346,0,0,152,78,74,152,0
2024-01-27,EV,Latvia,445,319,2,2,126,59,65,124,0
2024-01-28,EV,Latvia,492,345,1,1,147,74,72,146,0
2024-01-29,EV,Latvia,508,342,1,1,166,82,83,165,0
2024-01-30,EV,Latvia,354,272,0,0,82,41,41,82,0
2024-01-31,EV,Latvia,390,291,0,0,99,48,51,99,0
2024-02-01,EV,Latvia,375,267,1,1,108,55,52,107,0
2024-02-02,EV,Latvia,425,282,2,2,143,72,69,141,0
2024-02-03,EV,Latvia,440,319,0,0,121,59,62,121,0
2024-02-04,EV,Latvia,493,343,0,0,150,74,76,150,0
2024-01-01,EY,Lithuania,419,309,1,1,110,51,58,109,0
2024-01-02,EY,Lithuania,473,334,7,6,139,64,68,132,1
2024-01-03,EY,Lithuania,473,328,5,4,145,73,67,140,1
2024-01-04,EY,Lithuania,23,-113,3,3,136,65,68,133,0
2024-01-05,EY,Lithuania,512,364,7,6,148,71,70,141,1
2024-01-06,EY,Lithuania,493,353,3,3,140,68,69,137,0
2024-01-07,EY,Lithuania,524,385,5,3,139,67,67,134,2
2024-01-08,EY,Lithuania,507,367,8,7,140,66,66,132,1
2024-01-09,EY,Lithuania,414,300,9,8,114,53,52,105,1
2024-01-10,EY,Lithuania,401,282,0,0,119,61,58,119,0
2024-01-11,EY,Lithuania,426,299,8,8,127,57,62,119,0
2024-01-12,EY,Lithuania,439,299,2,2,140,71,67,138,0
2024-01-13,EY,Lithuania,403,291,2,1,112,55,55,110,1
2024-01-14,EY,Lithuania,446,320,1,1,126,62,63,125,0
2024-01-15,EY,Lithuania,448,316,1,0,132,65,66,131,1
2024-01-16,EY,Lithuania,348,243,5,4,105,49,51,100,1
2024-01-17,EY,Lithuania,360,242,9,8,118,54,55,109,1
2024-01-18,EY,Lithuania,390,263,9,8,127,60,58,118,1
2024-01-19,EY,Lithuania,432,286,6,3,146,70,70,140,3
2024-01-20,EY,Lithuania,387,277,2,2,110,55,53,108,0
2024-01-21,EY,Lithuania,441,322,1,0,119,58,60,118,1
2024-01-22,EY,Lithuania,428,298,1,0,130,64,65,129,1
2024-01-23,EY,Lithuania,369,262,8,8,107,50,49,99,0
2024-01-24,EY,Lithuania,364,250,4,4,114,56,54,110,0
2024-01-25,EY,Lithuania,394,272,4,3,122,58,60,118,1
2024-01-26,EY,Lithuania,439,295,8,8,144,69,67,136,0
2024-01-27,EY,Lithuania,394,281,4,3,113,56,53,109,1
2024-01-28,EY,Lithuania,420,291,2,1,129,60,67,127,1
2024-01-29,EY,Lithuania,436,307,2,1,129,64,63,127,1
2024-01-30,EY,Lithuania,338,233,7,6,105,48,50,98,1
2024-01-31,EY,Lithuania,354,234,7,7,120,59,54,113,0
2024-02-01,EY,Lithuania,358,250,5,4,108,48,55,103,1
2024-02-02,EY,Lithuania,398,262,5,4,136,66,65,131,1
2024-02-03,EY,Lithuania,395,291,5,3,104,50,49,99,2
2024-02-04,EY,Lithuania,433,310,3,3,123,58,62,120,0
2024-01-01,LM,Malta,352,196,0,0,156,79,77,156,0
2024-01-02,LM,Malta,316,174,3,3,142,69,70,139,0
2024-01-03,LM,Malta,342,198,2,2,144,71,71,142,0
2024-01-04,LM,Malta,16,-125,1,1,141,67,73,140,0
2024-01-05,LM,Malta,366,188,2,2,178,89,87,176,0
2024-01-06,LM,Malta,381,213,0,0,168,85,83,168,0
2024-01-07,LM,Malta,376,235,0,0,141,70,71,141,0
2024-01-08,LM,Malta,394,228,0,0,166,83,83,166,0
2024-01-09,LM,Malta,302,214,0,0,88,42,46,88,0
2024-01-10,LM,Malta,293,200,2,2,93,46,45,91,0
2024-01-11,LM,Malta,310,200,4,4,110,53,53,106,0
2024-01-12,LM,Malta,337,176,1,1,161,83,77,160,0
2024-01-13,LM,Malta,347,194,0,0,153,74,79,153,0
2024-01-14,LM,Malta,318,176,0,0,142,70,72,142,0
2024-01-15,LM,Malta,341,189,0,0,152,76,76,152,0
2024-01-16,LM,Malta,256,173,0,0,83,42,41,83,0
2024-01-17,LM,Malta,256,168,1,1,88,43,44,87,0
2024-01-18,LM,Malta,293,189,1,1,104,52,51,103,0
2024-01-19,LM,Malta,312,163,1,1,149,75,73,148,0
2024-01-20,LM,Malta,346,201,1,1,145,71,73,144,0
2024-01-21,LM,Malta,327,195,0,0,132,64,68,132,0
2024-01-22,LM,Malta,329,176,0,0,153,78,75,153,0
2024-01-23,LM,Malta,266,181,0,0,85,44,41,85,0
2024-01-24,LM,Malta,255,170,1,1,85,41,43,84,0
2024-01-25,LM,Malta,291,178,0,0,113,56,57,113,0
2024-01-26,LM,Malta,314,159,1,1,155,78,76,154,0
2024-01-27,LM,Malta,319,169,1,1,150,74,75,149,0
2024-01-28,LM,Malta,317,184,1,1,133,64,68,132,0
2024-01-29,LM,Malta,317,168,0,0,149,79,70,149,0
2024-01-30,LM,Malta,240,164,0,0,76,37,39,76,0
2024-01-31,LM,Malta,271,179,3,3,92,46,43,89,0
2024-02-01,LM,Malta,287,181,2,2,106,50,54,104,0
2024-02-02,LM,Malta,336,182,3,3,154,75,76,151,0
2024-02-03,LM,Malta,324,177,2,2,147,73,72,145,0
2024-02-04,LM,Malta,329,198,1,1,131,64,66,130,0
2024-01-01,LU,Moldova,29,-1,0,0,30,13,17,30,0
2024-01-02,LU,Moldova,62,1,0,0,61,32,29,61,0
2024-01-03,LU,Moldova,60,-1,0,0,61,30,31,61,0
2024-01-04,LU,Moldova,3,-61,0,0,64,31,33,64,0
2024-01-05,LU,Moldova,68,2,0,0,66,32,34,66,0
2024-01-06,LU,Moldova,62,1,0,0,61,32,29,61,0
2024-01-07,LU,Moldova,68,-2,0,0,70,35,35,70,0
2024-01-08,LU,Moldova,37,4,0,0,33,16,17,33,0
2024-01-09,LU,Moldova,65,-1,0,0,66,34,32,66,0
2024-01-10,LU,Moldova,62,-1,0,0,63,31,32,63,0
2024-01-11,LU,Moldova,60,-1,0,0,61,31,30,61,0
2024-01-12,LU,Moldova,65,1,0,0,64,32,32,64,0
2024-01-13,LU,Moldova,54,1,0,0,53,28,25,53,0
2024-01-14,LU,Moldova,63,0,0,0,63,31,32,63,0
2024-01-15,LU,Moldova,58,1,1,1,57,27,29,56,0
2024-01-16,LU,Moldova,71,0,0,0,71,35,36,71,0
2024-01-17,LU,Moldova,59,2,0,0,57,29,28,57,0
2024-01-18,LU,Moldova,59,0,0,0,59,29,30,59,0
2024-01-19,LU,Moldova,60,0,0,0,60,30,30,60,0
2024-01-20,LU,Moldova,53,1,0,0,52,27,25,52,0
2024-01-21,LU,Moldova,69,0,0,0,69,34,35,69,0
2024-01-22,LU,Moldova,56,1,0,0,55,27,28,55,0
2024-01-23,LU,Moldova,62,-1,0,0,63,33,30,63,0
2024-01-24,LU,Moldova,60,3,0,0,57,28,29,57,0
2024-01-25,LU,Moldova,61,-2,0,0,63,30,33,63,0
2024-01-26,LU,Moldova,67,1,0,0,66,33,33,66,0
2024-01-27,LU,Moldova,54,0,0,0,54,29,25,54,0
2024-01-28,LU,Moldova,65,-1,0,0,66,32,34,66,0
2024-01-29,LU,Moldova,51,3,0,0,48,25,23,48,0
2024-01-30,LU,Moldova,65,-3,0,0,68,31,37,68,0
2024-01-31,LU,Moldova,62,3,0,0,59,32,27,59,0
2024-02-01,LU,Moldova,60,-2,0,0,62,30,32,62,0
2024-02-02,LU,Moldova,70,1,0,0,69,35,34,69,0
2024-02-03,LU,Moldova,47,0,0,0,47,24,23,47,0
2024-02-04,LU,Moldova,60,-1,0,0,61,30,31,61,0
2024-01-01,GM,Morocco,1436,791,55,0,645,292,298,590,55
2024-01-02,GM,Morocco,1570,899,71,2,671,302,298,600,69
2024-01-03,GM,Morocco,1539,886,78,6,653,294,281,575,72
2024-01-04,GM,Morocco,53,-567,61,1,620,280,279,559,60
2024-01-05,GM,Morocco,1615,921,68,0,694,315,311,626,68
2024-01-06,GM,Morocco,1849,1138,55,2,711,328,328,656,53
2024-01-07,GM,Morocco,1657,1002,69,0,655,290,296,586,69
2024-01-08,GM,Morocco,1488,818,73,2,670,299,298,597,71
2024-01-09,GM,Morocco,1229,749,63,2,480,207,210,417,61
2024-01-10,GM,Morocco,1220,733,68,2,487,213,206,419,66
2024-01-11,GM,Morocco,1283,796,60,0,487,214,213,427,60
2024-01-12,GM,Morocco,1427,818,76,2,609,265,268,533,74
2024-01-13,GM,Morocco,1661,1049,49,1,612,282,281,563,48
2024-01-14,GM,Morocco,1506,927,60,0,579,262,257,519,60
2024-01-15,GM,Morocco,1295,720,65,5,575,256,254,510,60
2024-01-16,GM,Morocco,1142,706,63,3,436,188,185,373,60
2024-01-17,GM,Morocco,1074,638,63,4,436,190,183,373,59
2024-01-18,GM,Morocco,1175,729,57,5,446,191,198,389,52
2024-01-19,GM,Morocco,1325,741,72,0,584,261,251,512,72
2024-01-20,GM,Morocco,1586,1010,48,1,576,264,264,528,47
2024-01-21,GM,Morocco,1429,871,62,0,558,249,247,496,62
2024-01-22,GM,Morocco,1250,687,68,4,563,242,253,495,64
2024-01-23,GM,Morocco,1108,689,65,2,419,178,176,354,63
2024-01-24,GM,Morocco,1114,646,80,3,468,195,193,388,77
2024-01-25,GM,Morocco,1239,767,66,1,472,204,202,406,65
2024-01-26,GM,Morocco,1387,791,73,1,596,266,257,523,72
2024-01-27,GM,Morocco,1587,1000,52,1,587,266,269,535,51
2024-01-28,GM,Morocco,1471,912,59,0,559,252,248,500,59
2024-01-29,GM,Morocco,1263,714,57,3,549,245,247,492,54
2024-01-30,GM,Morocco,1115,710,45,2,405,181,179,360,43
2024-01-31,GM,Morocco,1095,655,62,2,440,190,188,378,60
2024-02-01,GM,Morocco,1226,758,66,5,468,203,199,402,61
2024-02-02,GM,Morocco,1410,809,80,3,601,257,264,521,77
2024-02-03,GM,Morocco,1611,1023,52,1,588,273,263,536,51
2024-02-04,GM,Morocco,1467,909,60,1,558,250,248,498,59
2024-01-01,EH,Netherlands,2834,1442,10,1,1392,694,688,1382,9
2024-01-02,EH,Netherlands,2939,1571,19,2,1368,667,682,1349,17
2024-01-03,EH,Netherlands,3119,1660,43,10,1459,711,705,1416,33
2024-01-04,EH,Netherlands,152,-1358,48,10,1510,736,726,1462,38
2024-01-05,EH,Netherlands,3194,1669,40,12,1525,738,747,1485,28
2024-01-06,EH,Netherlands,3089,1719,7,1,1370,669,694,1363,6
2024-01-07,EH,Netherlands,3191,1691,15,1,1500,752,733,1485,14
2024-01-08,EH,Netherlands,3066,1629,50,12,1437,692,695,1387,38
2024-01-09,EH,Netherlands,2675,1331,62,14,1344,637,645,1282,48
2024-01-10,EH,Netherlands,2754,1383,62,12,1371,655,654,1309,50
2024-01-11,EH,Netherlands,2911,1459,55,17,1452,710,687,1397,38
2024-01-12,EH,Netherlands,3184,1709,56,18,1475,696,723,1419,38
2024-01-13,EH,Netherlands,2809,1564,16,4,1245,618,611,1229,12
2024-01-14,EH,Netherlands,3063,1683,17,2,1380,682,681,1363,15
2024-01-15,EH,Netherlands,2740,1498,31,5,1242,596,615,1211,26
2024-01-16,EH,Netherlands,2444,1269,41,5,1175,571,563,1134,36
2024-01-17,EH,Netherlands,2463,1178,39,4,1285,630,616,1246,35
2024-01-18,EH,Netherlands,2740,1339,41,4,1401,684,676,1360,37
2024-01-19,EH,Netherlands,3124,1633,61,8,1491,712,718,1430,53
2024-01-20,EH,Netherlands,2703,1474,24,3,1229,598,607,1205,21
2024-01-21,EH,Netherlands,2753,1423,24,3,1330,647,659,1306,21
2024-01-22,EH,Netherlands,2815,1506,46,3,1309,652,611,1263,43
2024-01-23,EH,Netherlands,2566,1283,48,8,1283,605,630,1235,40
2024-01-24,EH,Netherlands,2438,1168,36,4,1270,624,610,1234,32
2024-01-25,EH,Netherlands,2821,1377,35,3,1444,702,707,1409,32
2024-01-26,EH,Netherlands,2902,1562,42,3,1340,650,648,1298,39
2024-01-27,EH,Netherlands,2734,1509,19,2,1225,600,606,1206,17
2024-01-28,EH,Netherlands,3021,1598,30,2,1423,701,692,1393,28
2024-01-29,EH,Netherlands,3004,1530,43,9,1474,716,715,1431,34
2024-01-30,EH,Netherlands,2640,1331,46,4,1309,627,636,1263,42
2024-01-31,EH,Netherlands,2696,1309,69,9,1387,650,668,1318,60
2024-02-01,EH,Netherlands,2785,1325,60,9,1460,709,691,1400,51
2024-02-02,EH,Netherlands,3128,1622,49,11,1506,735,722,1457,38
2024-02-03,EH,Netherlands,2742,1505,16,2,1237,610,611,1221,14
2024-02-04,EH,Netherlands,3029,1616,16,4,1413,701,696,1397,12
2024-01-01,LW,North Macedonia,443,385,0,0,58,28,30,58,0
2024-01-02,LW,North Macedonia,473,406,0,0,67,36,31,67,0
2024-01-03,LW,North Macedonia,474,416,0,0,58,29,29,58,0
2024-01-04,LW,North Macedonia,24,-44,0,0,68,31,37,68,0
2024-01-05,LW,North Macedonia,492,441,0,0,51,29,22,51,0
2024-01-06,LW,North Macedonia,569,496,0,0,73,32,41,73,0
2024-01-07,LW,North Macedonia,533,460,0,0,73,36,37,73,0
2024-01-08,LW,North Macedonia,441,376,0,0,65,33,32,65,0
2024-01-09,LW,North Macedonia,362,292,0,0,70,35,35,70,0
2024-01-10,LW,North Macedonia,354,292,0,0,62,31,31,62,0
2024-01-11,LW,North Macedonia,397,333,0,0,64,32,32,64,0
2024-01-12,LW,North Macedonia,452,384,0,0,68,34,34,68,0
2024-01-13,LW,North Macedonia,446,378,0,0,68,34,34,68,0
2024-01-14,LW,North Macedonia,477,411,0,0,66,33,33,66,0
2024-01-15,LW,North Macedonia,420,353,0,0,67,33,34,67,0
2024-01-16,LW,North Macedonia,345,274,0,0,71,36,35,71,0
2024-01-17,LW,North Macedonia,360,298,0,0,62,30,32,62,0
2024-01-18,LW,North Macedonia,362,293,0,0,69,35,34,69,0
2024-01-19,LW,North Macedonia,354,295,0,0,59,30,29,59,0
2024-01-20,LW,North Macedonia,373,310,0,0,63,31,32,63,0
2024-01-21,LW,North Macedonia,451,383,0,0,68,33,35,68,0
2024-01-22,LW,North Macedonia,370,307,0,0,63,34,29,63,0
2024-01-23,LW,North Macedonia,322,272,0,0,50,25,25,50,0
2024-01-24,LW,North Macedonia,380,324,0,0,56,28,28,56,0
2024-01-25,LW,North Macedonia,351,300,0,0,51,26,25,51,0
2024-01-26,LW,North Macedonia,417,362,0,0,55,26,29,55,0
2024-01-27,LW,North Macedonia,365,305,0,0,60,31,29,60,0
2024-01-28,LW,North Macedonia,424,369,0,0,55,27,28,55,0
2024-01-29,LW,North Macedonia,376,318,0,0,58,29,29,58,0
2024-01-30,LW,North Macedonia,332,284,0,0,48,24,24,48,0
2024-01-31,LW,North Macedonia,411,358,0,0,53,26,27,53,0
2024-02-01,LW,North Macedonia,405,352,0,0,53,28,25,53,0
2024-02-02,LW,North Macedonia,418,360,0,0,58,28,30,58,0
2024-02-03,LW,North Macedonia,411,357,0,0,54,28,26,54,0
2024-02-04,LW,North Macedonia,428,376,0,0,52,25,27,52,0
2024-01-01,EN,Norway,1184,265,501,1,919,207,211,418,500
2024-01-02,EN,Norway,1402,237,750,2,1165,211,204,415,748
2024-01-03,EN,Norway,1407,218,738,5,1189,222,229,451,733
2024-01-04,EN,Norway,47,-1226,775,2,1273,248,250,498,773
2024-01-05,EN,Norway,1415,198,713,6,1217,250,254,504,707
2024-01-06,EN,Norway,887,222,247,4,665,215,203,418,243
2024-01-07,EN,Norway,1240,230,515,2,1010,240,255,495,513
2024-01-08,EN,Norway,1380,145,772,11,1235,238,225,463,761
2024-01-09,EN,Norway,1317,143,800,8,1174,185,189,374,792
2024-01-10,EN,Norway,1395,165,792,13,1230,218,220,438,779
2024-01-11,EN,Norway,1436,180,809,21,1256,224,223,447,788
2024-01-12,EN,Norway,1448,184,784,18,1264,240,240,480,766
2024-01-13,EN,Norway,753,200,209,6,553,175,169,344,203
2024-01-14,EN,Norway,1208,224,534,4,984,219,231,450,530
2024-01-15,EN,Norway,1308,185,731,8,1123,199,193,392,723
2024-01-16,EN,Norway,1188,190,680,10,998,159,159,318,670
2024-01-17,EN,Norway,1206,185,690,9,1021,162,169,331,681
2024-01-18,EN,Norway,1285,204,672,12,1081,206,203,409,660
2024-01-19,EN,Norway,1433,175,773,17,1258,243,242,485,756
2024-01-20,EN,Norway,887,211,303,6,676,191,182,373,297
2024-01-21,EN,Norway,1310,268,605,4,1042,212,225,437,601
2024-01-22,EN,Norway,1282,200,692,3,1082,199,191,390,689
2024-01-23,EN,Norway,1424,213,827,28,1211,188,196,384,799
2024-01-24,EN,Norway,1410,209,796,8,1201,204,201,405,788
2024-01-25,EN,Norway,1546,196,875,21,1350,238,237,475,854
2024-01-26,EN,Norway,1510,211,796,7,1299,249,254,503,789
2024-01-27,EN,Norway,838,205,251,6,633,193,189,382,245
2024-01-28,EN,Norway,1250,240,564,4,1010,220,226,446,560
2024-01-29,EN,Norway,1110,174,496,14,936,220,220,440,482
2024-01-30,EN,Norway,1247,161,708,7,1086,191,187,378,701
2024-01-31,EN,Norway,1152,129,613,16,1023,204,206,410,597
2024-02-01,EN,Norway,1158,156,568,12,1002,216,218,434,556
2024-02-02,EN,Norway,1413,192,747,6,1221,236,238,474,741
2024-02-03,EN,Norway,803,193,239,5,610,189,182,371,234
2024-02-04,EN,Norway,1233,200,570,9,1033,226,237,463,561
2024-01-01,EP,Poland,1570,682,62,0,888,416,410,826,62
2024-01-02,EP,Poland,1647,676,76,3,971,444,451,895,73
2024-01-03,EP,Poland,1649,650,92,8,999,454,453,907,84
2024-01-04,EP,Poland,66,-948,93,10,1014,469,452,921,83
2024-01-05,EP,Poland,1839,713,129,34,1126,488,509,997,95
2024-01-06,EP,Poland,1725,752,61,2,973,453,459,912,59
2024-01-07,EP,Poland,1701,717,79,6,984,454,451,905,73
2024-01-08,EP,Poland,1752,668,117,15,1084,479,488,967,102
2024-01-09,EP,Poland,1407,560,110,16,847,364,373,737,94
2024-01-10,EP,Poland,1405,568,89,10,837,376,372,748,79
2024-01-11,EP,Poland,1483,567,89,3,916,416,411,827,86
2024-01-12,EP,Poland,1710,667,107,11,1043,461,475,936,96
2024-01-13,EP,Poland,1601,681,59,2,920,437,424,861,57
2024-01-14,EP,Poland,1625,664,80,2,961,438,443,881,78
2024-01-15,EP,Poland,1634,628,105,9,1006,452,449,901,96
2024-01-16,EP,Poland,1375,518,111,22,857,367,379,746,89
2024-01-17,EP,Poland,1294,506,104,13,788,343,341,684,91
2024-01-18,EP,Poland,1443,566,98,10,877,397,382,779,88
2024-01-19,EP,Poland,1724,663,120,21,1061,468,473,941,99
2024-01-20,EP,Poland,1545,636,70,5,909,416,423,839,65
2024-01-21,EP,Poland,1574,633,89,10,941,427,425,852,79
2024-01-22,EP,Poland,1684,648,110,16,1036,461,465,926,94
2024-01-23,EP,Poland,1378,554,110,15,824,358,356,714,95
2024-01-24,EP,Poland,1359,531,86,8,828,368,374,742,78
2024-01-25,EP,Poland,1490,566,98,8,924,420,406,826,90
2024-01-26,EP,Poland,1731,648,138,14,1083,470,475,945,124
2024-01-27,EP,Poland,1506,630,64,4,876,406,406,812,60
2024-01-28,EP,Poland,1605,654,79,8,951,432,440,872,71
2024-01-29,EP,Poland,1719,645,144,35,1074,467,463,930,109
2024-01-30,EP,Poland,1364,494,135,35,870,367,368,735,100
2024-01-31,EP,Poland,1375,498,118,27,877,379,380,759,91
2024-02-01,EP,Poland,1424,489,110,15,935,417,408,825,95
2024-02-02,EP,Poland,1701,623,122,13,1078,472,484,956,109
2024-02-03,EP,Poland,1516,657,58,4,859,404,397,801,54
2024-02-04,EP,Poland,1584,656,76,5,928,426,426,852,71
2024-01-01,LP,Portugal,2050,988,148,0,1062,451,463,914,148
2024-01-02,LP,Portugal,2213,1078,192,0,1135,476,467,943,192
2024-01-03,LP,Portugal,2049,1014,176,1,1035,440,419,859,175
2024-01-04,LP,Portugal,105,-981,153,1,1086,460,473,933,152
2024-01-05,LP,Portugal,2299,1192,150,1,1107,480,477,957,149
2024-01-06,LP,Portugal,2530,1398,139,0,1132,503,490,993,139
2024-01-07,LP,Portugal,2331,1235,136,3,1096,479,481,960,133
2024-01-08,LP,Portugal,2067,1033,147,0,1034,435,452,887,147
2024-01-09,LP,Portugal,1850,1035,135,1,815,343,337,680,134
2024-01-10,LP,Portugal,1692,922,131,2,770,326,313,639,129
2024-01-11,LP,Portugal,1824,983,126,2,841,352,363,715,124
2024-01-12,LP,Portugal,1980,999,158,3,981,413,410,823,155
2024-01-13,LP,Portugal,2055,1159,132,4,896,380,384,764,128
2024-01-14,LP,Portugal,2006,1007,131,0,999,441,427,868,131
2024-01-15,LP,Portugal,1837,892,144,1,945,393,408,801,143
2024-01-16,LP,Portugal,1603,886,120,2,717,302,295,597,118
2024-01-17,LP,Portugal,1538,842,128,1,696,282,286,568,127
2024-01-18,LP,Portugal,1775,955,139,4,820,340,341,681,135
2024-01-19,LP,Portugal,1936,1004,138,0,932,400,394,794,138
2024-01-20,LP,Portugal,2099,1236,129,1,863,365,369,734,128
2024-01-21,LP,Portugal,2021,1100,125,0,921,399,397,796,125
2024-01-22,LP,Portugal,1846,930,133,0,916,387,396,783,133
2024-01-23,LP,Portugal,1648,914,143,3,734,301,290,591,140
2024-01-24,LP,Portugal,1498,780,125,0,718,294,299,593,125
2024-01-25,LP,Portugal,1704,877,141,1,827,340,346,686,140
2024-01-26,LP,Portugal,1911,957,152,2,954,410,392,802,150
2024-01-27,LP,Portugal,2058,1186,128,0,872,371,373,744,128
2024-01-28,LP,Portugal,2018,1048,130,0,970,417,423,840,130
2024-01-29,LP,Portugal,1761,854,138,0,907,379,390,769,138
2024-01-30,LP,Portugal,1657,918,134,3,739,308,297,605,131
2024-01-31,LP,Portugal,1687,947,124,0,740,316,300,616,124
2024-02-01,LP,Portugal,1834,991,142,0,843,346,355,701,142
2024-02-02,LP,Portugal,2024,1045,147,1,979,415,417,832,146
2024-02-03,LP,Portugal,2179,1267,124,0,912,396,392,788,124
2024-02-04,LP,Portugal,2023,1023,135,0,1000,430,435,865,135
2024-01-01,LR,Romania,1675,1297,13,4,378,180,185,365,9
2024-01-02,LR,Romania,1794,1361,30,4,433,201,202,403,26
2024-01-03,LR,Romania,1919,1411,50,9,508,226,232,458,41
2024-01-04,LR,Romania,207,-296,50,7,503,226,227,453,43
2024-01-05,LR,Romania,2011,1498,52,5,513,228,233,461,47
2024-01-06,LR,Romania,1970,1538,26,4,432,204,202,406,22
2024-01-07,LR,Romania,2031,1541,35,4,490,224,231,455,31
2024-01-08,LR,Romania,1917,1414,48,0,503,226,229,455,48
2024-01-09,LR,Romania,1838,1392,55,8,446,199,192,391,47
2024-01-10,LR,Romania,1889,1406,57,9,483,209,217,426,48
2024-01-11,LR,Romania,1879,1424,65,6,455,198,192,390,59
2024-01-12,LR,Romania,1940,1436,69,8,504,218,217,435,61
2024-01-13,LR,Romania,1853,1451,30,7,402,190,182,372,23
2024-01-14,LR,Romania,1882,1437,33,5,445,204,208,412,28
2024-01-15,LR,Romania,1850,1343,60,11,507,221,226,447,49
2024-01-16,LR,Romania,1705,1297,59,14,408,177,172,349,45
2024-01-17,LR,Romania,1697,1256,70,10,441,183,188,371,60
2024-01-18,LR,Romania,1815,1380,68,11,435,185,182,367,57
2024-01-19,LR,Romania,1908,1418,72,7,490,206,212,418,65
2024-01-20,LR,Romania,1829,1467,26,4,362,171,165,336,22
2024-01-21,LR,Romania,1854,1422,43,7,432,193,196,389,36
2024-01-22,LR,Romania,1810,1334,69,9,476,205,202,407,60
2024-01-23,LR,Romania,1728,1318,64,6,410,173,173,346,58
2024-01-24,LR,Romania,1732,1334,42,2,398,179,177,356,40
2024-01-25,LR,Romania,1855,1419,92,20,436,172,172,344,72
2024-01-26,LR,Romania,1833,1362,74,11,471,202,195,397,63
2024-01-27,LR,Romania,1753,1390,28,4,363,170,165,335,24
2024-01-28,LR,Romania,1873,1449,32,5,424,193,199,392,27
2024-01-29,LR,Romania,1741,1268,78,9,473,193,202,395,69
2024-01-30,LR,Romania,1767,1346,73,15,421,175,173,348,58
2024-01-31,LR,Romania,1767,1312,78,14,455,189,188,377,64
2024-02-01,LR,Romania,1709,1288,72,11,421,175,174,349,61
2024-02-02,LR,Romania,1853,1398,56,7,455,200,199,399,49
2024-02-03,LR,Romania,1776,1423,25,4,353,164,164,328,21
2024-02-04,LR,Romania,1838,1430,32,7,408,186,190,376,25
2024-01-01,LY,Serbia & Montenegro,1715,1437,17,0,278,130,131,261,17
2024-01-02,LY,Serbia & Montenegro,1913,1662,19,0,251,112,120,232,19
2024-01-03,LY,Serbia & Montenegro,1886,1627,22,0,259,122,115,237,22
2024-01-04,LY,Serbia & Montenegro,73,-172,20,0,245,114,111,225,20
2024-01-05,LY,Serbia & Montenegro,2013,1711,16,0,302,139,147,286,16
2024-01-06,LY,Serbia & Montenegro,2147,1894,20,0,253,119,114,233,20
2024-01-07,LY,Serbia & Montenegro,2088,1832,19,0,256,118,119,237,19
2024-01-08,LY,Serbia & Montenegro,1795,1515,18,3,280,130,132,262,15
2024-01-09,LY,Serbia & Montenegro,1606,1354,18,0,252,117,117,234,18
2024-01-10,LY,Serbia & Montenegro,1635,1403,20,0,232,109,103,212,20
2024-01-11,LY,Serbia & Montenegro,1647,1413,17,0,234,107,110,217,17
2024-01-12,LY,Serbia & Montenegro,1794,1505,16,0,289,136,137,273,16
2024-01-13,LY,Serbia & Montenegro,1825,1587,21,1,238,109,108,217,20
2024-01-14,LY,Serbia & Montenegro,1862,1618,18,0,244,112,114,226,18
2024-01-15,LY,Serbia & Montenegro,1641,1365,15,1,276,129,132,261,14
2024-01-16,LY,Serbia & Montenegro,1436,1210,19,1,226,102,105,207,18
2024-01-17,LY,Serbia & Montenegro,1477,1268,21,1,209,96,92,188,20
2024-01-18,LY,Serbia & Montenegro,1569,1347,15,1,222,108,99,207,14
2024-01-19,LY,Serbia & Montenegro,1712,1442,15,1,270,126,129,255,14
2024-01-20,LY,Serbia & Montenegro,1741,1520,19,1,221,101,101,202,18
2024-01-21,LY,Serbia & Montenegro,1800,1595,19,0,205,98,88,186,19
2024-01-22,LY,Serbia & Montenegro,1606,1317,16,1,289,131,142,273,15
2024-01-23,LY,Serbia & Montenegro,1394,1199,20,1,195,87,88,175,19
2024-01-24,LY,Serbia & Montenegro,1491,1298,22,2,193,85,86,171,20
2024-01-25,LY,Serbia & Montenegro,1480,1263,21,1,217,97,99,196,20
2024-01-26,LY,Serbia & Montenegro,1707,1432,16,2,275,128,131,259,14
2024-01-27,LY,Serbia & Montenegro,1729,1512,20,0,217,98,99,197,20
2024-01-28,LY,Serbia & Montenegro,1753,1507,18,0,246,113,115,228,18
2024-01-29,LY,Serbia & Montenegro,1541,1274,15,0,267,125,127,252,15
2024-01-30,LY,Serbia & Montenegro,1393,1187,23,4,206,93,90,183,19
2024-01-31,LY,Serbia & Montenegro,1518,1301,23,0,217,98,96,194,23
2024-02-01,LY,Serbia & Montenegro,1509,1286,18,2,223,104,101,205,16
2024-02-02,LY,Serbia & Montenegro,1749,1497,16,2,252,118,118,236,14
2024-02-03,LY,Serbia & Montenegro,1779,1563,26,3,216,95,95,190,23
2024-02-04,LY,Serbia & Montenegro,1772,1549,18,0,223,101,104,205,18
2024-01-01,LZ,Slovakia,1056,1016,0,0,40,19,21,40,0
2024-01-02,LZ,Slovakia,1134,1076,4,0,58,29,25,54,4
2024-01-03,LZ,Slovakia,1169,1120,3,0,49,24,22,46,3
2024-01-04,LZ,Slovakia,100,41,7,2,59,25,27,52,5
2024-01-05,LZ,Slovakia,1283,1218,5,2,65,29,31,60,3
2024-01-06,LZ,Slovakia,1249,1207,1,0,42,22,19,41,1
2024-01-07,LZ,Slovakia,1280,1219,1,0,61,28,32,60,1
2024-01-08,LZ,Slovakia,1187,1132,1,1,55,27,27,54,0
2024-01-09,LZ,Slovakia,998,967,3,2,31,15,13,28,1
2024-01-10,LZ,Slovakia,1077,1033,4,1,44,19,21,40,3
2024-01-11,LZ,Slovakia,1097,1040,7,1,57,25,25,50,6
2024-01-12,LZ,Slovakia,1153,1090,6,1,63,29,28,57,5
2024-01-13,LZ,Slovakia,1152,1108,3,0,44,22,19,41,3
2024-01-14,LZ,Slovakia,1159,1115,1,0,44,22,21,43,1
2024-01-15,LZ,Slovakia,1139,1081,2,1,58,27,29,56,1
2024-01-16,LZ,Slovakia,1033,987,2,2,46,22,22,44,0
2024-01-17,LZ,Slovakia,1012,960,4,0,52,24,24,48,4
2024-01-18,LZ,Slovakia,1101,1043,4,0,58,27,27,54,4
2024-01-19,LZ,Slovakia,1174,1111,9,0,63,26,28,54,9
2024-01-20,LZ,Slovakia,1148,1091,5,1,57,27,25,52,4
2024-01-21,LZ,Slovakia,1103,1044,8,0,59,25,26,51,8
2024-01-22,LZ,Slovakia,1134,1058,9,1,76,34,33,67,8
2024-01-23,LZ,Slovakia,1029,979,4,0,50,22,24,46,4
2024-01-24,LZ,Slovakia,1023,963,2,0,60,28,30,58,2
2024-01-25,LZ,Slovakia,1138,1093,1,0,45,22,22,44,1
2024-01-26,LZ,Slovakia,1099,1049,2,1,50,27,21,48,1
2024-01-27,LZ,Slovakia,1158,1112,1,0,46,23,22,45,1
2024-01-28,LZ,Slovakia,1154,1105,2,0,49,23,24,47,2
2024-01-29,LZ,Slovakia,1072,1012,6,0,60,26,28,54,6
2024-01-30,LZ,Slovakia,1019,967,3,1,52,26,23,49,2
2024-01-31,LZ,Slovakia,997,949,3,1,48,21,24,45,2
2024-02-01,LZ,Slovakia,1012,940,5,0,72,31,36,67,5
2024-02-02,LZ,Slovakia,1217,1163,2,0,54,27,25,52,2
2024-02-03,LZ,Slovakia,1185,1139,4,3,46,22,20,42,1
2024-02-04,LZ,Slovakia,1183,1136,5,0,47,19,23,42,5
2024-01-01,LJ,Slovenia,937,907,0,0,30,15,15,30,0
2024-01-02,LJ,Slovenia,963,920,1,1,43,21,21,42,0
2024-01-03,LJ,Slovenia,994,936,1,1,58,27,30,57,0
2024-01-04,LJ,Slovenia,25,-36,9,1,61,25,27,52,8
2024-01-05,LJ,Slovenia,1090,1034,0,0,56,28,28,56,0
2024-01-06,LJ,Slovenia,1125,1088,0,0,37,20,17,37,0
2024-01-07,LJ,Slovenia,1119,1077,0,0,42,20,22,42,0
2024-01-08,LJ,Slovenia,948,901,1,1,47,23,23,46,0
2024-01-09,LJ,Slovenia,804,758,1,1,46,23,22,45,0
2024-01-10,LJ,Slovenia,818,771,3,1,47,22,22,44,2
2024-01-11,LJ,Slovenia,827,764,3,0,63,30,30,60,3
2024-01-12,LJ,Slovenia,958,911,0,0,47,22,25,47,0
2024-01-13,LJ,Slovenia,1025,986,1,0,39,18,20,38,1
2024-01-14,LJ,Slovenia,1060,1013,1,1,47,22,24,46,0
2024-01-15,LJ,Slovenia,884,836,2,2,48,24,22,46,0
2024-01-16,LJ,Slovenia,787,733,2,1,54,27,25,52,1
2024-01-17,LJ,Slovenia,754,718,0,0,36,16,20,36,0
2024-01-18,LJ,Slovenia,834,778,1,0,56,30,25,55,1
2024-01-19,LJ,Slovenia,938,895,1,0,43,20,22,42,1
2024-01-20,LJ,Slovenia,924,874,0,0,50,25,25,50,0
2024-01-21,LJ,Slovenia,979,924,0,0,55,26,29,55,0
2024-01-22,LJ,Slovenia,795,746,5,1,49,23,21,44,4
2024-01-23,LJ,Slovenia,745,698,7,1,47,20,20,40,6
2024-01-24,LJ,Slovenia,787,729,6,1,58,27,25,52,5
2024-01-25,LJ,Slovenia,776,723,2,1,53,26,25,51,1
2024-01-26,LJ,Slovenia,947,881,3,3,66,27,36,63,0
2024-01-27,LJ,Slovenia,861,809,3,1,52,25,24,49,2
2024-01-28,LJ,Slovenia,927,866,3,2,61,30,28,58,1
2024-01-29,LJ,Slovenia,837,793,2,2,44,21,21,42,0
2024-01-30,LJ,Slovenia,734,673,8,1,61,29,24,53,7
2024-01-31,LJ,Slovenia,808,750,2,0,58,28,28,56,2
2024-02-01,LJ,Slovenia,780,717,4,1,63,29,30,59,3
2024-02-02,LJ,Slovenia,919,867,1,0,52,26,25,51,1
2024-02-03,LJ,Slovenia,924,878,5,1,46,20,21,41,4
2024-02-04,LJ,Slovenia,956,909,4,2,47,23,20,43,2
2024-01-01,LE,Spain,4951,1114,973,1,3837,1439,1425,2864,972
2024-01-02,LE,Spain,5197,1082,1056,14,4115,1551,1508,3059,1042
2024-01-03,LE,Spain,4981,987,1033,12,3994,1486,1475,2961,1021
2024-01-04,LE,Spain,108,-4025,1070,15,4133,1523,1540,3063,1055
2024-01-05,LE,Spain,5256,1162,1006,6,4094,1545,1543,3088,1000
2024-01-06,LE,Spain,5328,1238,898,7,4090,1605,1587,3192,891
2024-01-07,LE,Spain,5384,1101,1063,4,4283,1613,1607,3220,1059
2024-01-08,LE,Spain,4972,1087,1056,24,3885,1422,1407,2829,1032
2024-01-09,LE,Spain,4136,799,1015,26,3337,1163,1159,2322,989
2024-01-10,LE,Spain,3957,743,991,30,3214,1107,1116,2223,961
2024-01-11,LE,Spain,4223,754,1066,31,3469,1200,1203,2403,1035
2024-01-12,LE,Spain,4962,914,1231,35,4048,1411,1406,2817,1196
2024-01-13,LE,Spain,4635,927,931,24,3708,1387,1390,2777,907
2024-01-14,LE,Spain,4919,946,1081,19,3973,1451,1441,2892,1062
2024-01-15,LE,Spain,4591,872,1108,24,3719,1306,1305,2611,1084
2024-01-16,LE,Spain,3754,664,960,20,3090,1069,1061,2130,940
2024-01-17,LE,Spain,3633,566,997,28,3067,1038,1032,2070,969
2024-01-18,LE,Spain,4059,661,1063,35,3398,1164,1171,2335,1028
2024-01-19,LE,Spain,4791,857,1214,10,3934,1358,1362,2720,1204
2024-01-20,LE,Spain,4533,866,949,16,3667,1362,1356,2718,933
2024-01-21,LE,Spain,4766,872,1136,20,3894,1386,1372,2758,1116
2024-01-22,LE,Spain,4533,866,1118,25,3667,1271,1278,2549,1093
2024-01-23,LE,Spain,3761,622,1048,57,3139,1050,1041,2091,991
2024-01-24,LE,Spain,3832,613,1088,48,3219,1056,1075,2131,1040
2024-01-25,LE,Spain,4119,645,1109,47,3474,1181,1184,2365,1062
2024-01-26,LE,Spain,4847,845,1268,31,4002,1357,1377,2734,1237
2024-01-27,LE,Spain,4535,843,980,22,3692,1361,1351,2712,958
2024-01-28,LE,Spain,4835,880,1146,20,3955,1412,1397,2809,1126
2024-01-29,LE,Spain,4829,1135,1148,40,3694,1273,1273,2546,1108
2024-01-30,LE,Spain,4122,935,1037,55,3187,1088,1062,2150,982
2024-01-31,LE,Spain,4133,931,1037,50,3202,1073,1092,2165,987
2024-02-01,LE,Spain,4578,1024,1106,37,3554,1207,1241,2448,1069
2024-02-02,LE,Spain,5322,1285,1277,25,4037,1383,1377,2760,1252
2024-02-03,LE,Spain,5034,1230,1018,24,3804,1383,1403,2786,994
2024-02-04,LE,Spain,5313,1255,1178,20,4058,1456,1424,2880,1158
2024-01-01,ES,Sweden,1285,761,90,2,524,214,220,434,88
2024-01-02,ES,Sweden,1463,787,206,3,676,234,236,470,203
2024-01-03,ES,Sweden,1488,812,195,5,676,236,245,481,190
2024-01-04,ES,Sweden,54,-699,234,5,753,258,261,519,229
2024-01-05,ES,Sweden,1551,795,197,13,756,281,278,559,184
2024-01-06,ES,Sweden,1275,761,70,5,514,221,223,444,65
2024-01-07,ES,Sweden,1642,901,212,5,741,262,267,529,207
2024-01-08,ES,Sweden,1583,760,244,21,823,295,284,579,223
2024-01-09,ES,Sweden,1325,631,242,15,694,225,227,452,227
2024-01-10,ES,Sweden,1396,704,255,13,692,218,219,437,242
2024-01-11,ES,Sweden,1422,697,248,14,725,237,240,477,234
2024-01-12,ES,Sweden,1631,840,236,9,791,281,274,555,227
2024-01-13,ES,Sweden,1179,731,71,2,448,190,187,377,69
2024-01-14,ES,Sweden,1553,869,193,5,684,242,249,491,188
2024-01-15,ES,Sweden,1545,767,254,5,778,265,259,524,249
2024-01-16,ES,Sweden,1338,656,261,7,682,209,212,421,254
2024-01-17,ES,Sweden,1355,696,249,4,659,200,210,410,245
2024-01-18,ES,Sweden,1545,764,292,13,781,248,241,489,279
2024-01-19,ES,Sweden,1711,875,284,5,836,275,277,552,279
2024-01-20,ES,Sweden,1245,770,83,8,475,197,195,392,75
2024-01-21,ES,Sweden,1547,888,192,1,659,231,236,467,191
2024-01-22,ES,Sweden,1598,818,264,13,780,257,259,516,251
2024-01-23,ES,Sweden,1440,704,276,4,736,230,230,460,272
2024-01-24,ES,Sweden,1519,776,284,7,743,230,229,459,277
2024-01-25,ES,Sweden,1620,792,318,15,828,257,253,510,303
2024-01-26,ES,Sweden,1735,891,270,1,844,287,287,574,269
2024-01-27,ES,Sweden,1216,765,68,0,451,190,193,383,68
2024-01-28,ES,Sweden,1555,863,201,8,692,240,251,491,193
2024-01-29,ES,Sweden,1666,808,293,14,858,286,279,565,279
2024-01-30,ES,Sweden,1378,652,272,10,726,226,228,454,262
2024-01-31,ES,Sweden,1545,766,309,13,779,237,233,470,296
2024-02-01,ES,Sweden,1428,655,291,9,773,242,240,482,282
2024-02-02,ES,Sweden,1628,784,289,11,844,277,278,555,278
2024-02-03,ES,Sweden,1285,763,93,2,522,215,214,429,91
2024-02-04,ES,Sweden,1620,910,221,2,710,240,249,489,219
2024-01-01,LS,Switzerland,2512,1418,24,0,1094,538,532,1070,24
2024-01-02,LS,Switzerland,2699,1481,47,2,1218,581,590,1171,45
2024-01-03,LS,Switzerland,2639,1488,49,4,1151,549,553,1102,45
2024-01-04,LS,Switzerland,75,-1133,45,5,1208,584,579,1163,40
2024-01-05,LS,Switzerland,2840,1557,37,1,1283,628,618,1246,36
2024-01-06,LS,Switzerland,2853,1517,34,1,1336,647,655,1302,33
2024-01-07,LS,Switzerland,2987,1602,35,0,1385,678,672,1350,35
2024-01-08,LS,Switzerland,2609,1436,46,1,1173,564,563,1127,45
2024-01-09,LS,Switzerland,2104,1146,30,0,958,466,462,928,30
2024-01-10,LS,Switzerland,2194,1190,50,0,1004,482,472,954,50
2024-01-11,LS,Switzerland,2257,1205,54,4,1052,490,508,998,50
2024-01-12,LS,Switzerland,2562,1313,61,2,1249,592,596,1188,59
2024-01-13,LS,Switzerland,2352,1228,34,2,1124,543,547,1090,32
2024-01-14,LS,Switzerland,2639,1315,39,2,1324,640,645,1285,37
2024-01-15,LS,Switzerland,2402,1129,60,1,1273,587,626,1213,59
2024-01-16,LS,Switzerland,2011,1003,65,8,1008,472,471,943,57
2024-01-17,LS,Switzerland,1843,902,36,0,941,456,449,905,36
2024-01-18,LS,Switzerland,2241,1087,41,1,1154,563,550,1113,40
2024-01-19,LS,Switzerland,2633,1285,56,4,1348,664,628,1292,52
2024-01-20,LS,Switzerland,2347,1233,33,2,1114,530,551,1081,31
2024-01-21,LS,Switzerland,2534,1286,46,2,1248,615,587,1202,44
2024-01-22,LS,Switzerland,2366,1252,44,1,1114,536,534,1070,43
2024-01-23,LS,Switzerland,1965,1031,56,3,934,438,440,878,53
2024-01-24,LS,Switzerland,2207,1199,49,2,1008,483,476,959,47
2024-01-25,LS,Switzerland,2352,1228,47,1,1124,536,541,1077,46
2024-01-26,LS,Switzerland,2709,1466,53,2,1243,582,608,1190,51
2024-01-27,LS,Switzerland,2478,1320,62,4,1158,543,553,1096,58
2024-01-28,LS,Switzerland,2654,1378,42,4,1276,629,605,1234,38
2024-01-29,LS,Switzerland,2507,1359,67,3,1148,545,536,1081,64
2024-01-30,LS,Switzerland,2048,1116,55,4,932,436,441,877,51
2024-01-31,LS,Switzerland,2170,1128,63,4,1042,496,483,979,59
2024-02-01,LS,Switzerland,2284,1185,43,3,1099,523,533,1056,40
2024-02-02,LS,Switzerland,2777,1512,63,7,1265,591,611,1202,56
2024-02-03,LS,Switzerland,2625,1443,44,2,1182,566,572,1138,42
2024-02-04,LS,Switzerland,2782,1497,43,1,1285,636,606,1242,42
2024-01-01,LT,Türkiye,3619,1274,750,0,2345,799,796,1595,750
2024-01-02,LT,Türkiye,3863,1363,730,4,2500,889,881,1770,726
2024-01-03,LT,Türkiye,3876,1403,754,4,2473,856,863,1719,750
2024-01-04,LT,Türkiye,339,-2078,714,4,2417,860,843,1703,710
2024-01-05,LT,Türkiye,4104,1462,794,4,2642,936,912,1848,790
2024-01-06,LT,Türkiye,4133,1469,748,7,2664,948,968,1916,741
2024-01-07,LT,Türkiye,4148,1486,762,4,2662,948,952,1900,758
2024-01-08,LT,Türkiye,3807,1344,757,4,2463,847,859,1706,753
2024-01-09,LT,Türkiye,3674,1352,693,4,2322,809,820,1629,689
2024-01-10,LT,Türkiye,3720,1381,717,7,2339,814,808,1622,710
2024-01-11,LT,Türkiye,3769,1414,737,9,2355,808,810,1618,728
2024-01-12,LT,Türkiye,3830,1425,756,3,2405,833,816,1649,753
2024-01-13,LT,Türkiye,3860,1414,743,2,2446,850,853,1703,741
2024-01-14,LT,Türkiye,3918,1463,764,1,2455,850,841,1691,763
2024-01-15,LT,Türkiye,3611,1305,759,3,2306,763,784,1547,756
2024-01-16,LT,Türkiye,3504,1309,704,4,2195,747,744,1491,700
2024-01-17,LT,Türkiye,3565,1291,759,5,2274,758,757,1515,754
2024-01-18,LT,Türkiye,3723,1369,771,3,2354,797,786,1583,768
2024-01-19,LT,Türkiye,3907,1380,851,3,2527,846,830,1676,848
2024-01-20,LT,Türkiye,3955,1372,832,5,2583,863,888,1751,827
2024-01-21,LT,Türkiye,4029,1483,841,1,2546,855,850,1705,840
2024-01-22,LT,Türkiye,3683,1301,817,4,2382,780,785,1565,813
2024-01-23,LT,Türkiye,3548,1292,759,3,2256,745,752,1497,756
2024-01-24,LT,Türkiye,3698,1371,787,2,2327,775,765,1540,785
2024-01-25,LT,Türkiye,3790,1405,830,3,2385,774,781,1555,827
2024-01-26,LT,Türkiye,3782,1351,853,8,2431,788,790,1578,845
2024-01-27,LT,Türkiye,3780,1350,813,3,2430,808,809,1617,810
2024-01-28,LT,Türkiye,3991,1460,854,3,2531,844,833,1677,851
2024-01-29,LT,Türkiye,3574,1249,807,3,2325,752,766,1518,804
2024-01-30,LT,Türkiye,3596,1330,741,1,2266,761,764,1525,740
2024-01-31,LT,Türkiye,3705,1349,798,5,2356,774,784,1558,793
2024-02-01,LT,Türkiye,3693,1318,842,7,2375,778,755,1533,835
2024-02-02,LT,Türkiye,3959,1395,898,4,2564,842,824,1666,894
2024-02-03,LT,Türkiye,3964,1400,856,2,2564,841,867,1708,854
2024-02-04,LT,Türkiye,4031,1418,889,4,2613,862,862,1724,885
2024-01-01,UK,Ukraine,1,1,0,0,0,0,0,0,0
2024-01-02,UK,Ukraine,4,4,0,0,0,0,0,0,0
2024-01-03,UK,Ukraine,4,4,0,0,0,0,0,0,0
2024-01-04,UK,Ukraine,0,-1,0,0,1,0,1,1,0
2024-01-05,UK,Ukraine,3,3,0,0,0,0,0,0,0
2024-01-06,UK,Ukraine,6,6,0,0,0,0,0,0,0
2024-01-07,UK,Ukraine,1,1,0,0,0,0,0,0,0
2024-01-08,UK,Ukraine,3,3,0,0,0,0,0,0,0
2024-01-09,UK,Ukraine,3,3,0,0,0,0,0,0,0
2024-01-10,UK,Ukraine,3,3,0,0,0,0,0,0,0
2024-01-11,UK,Ukraine,0,0,0,0,0,0,0,0,0
2024-01-12,UK,Ukraine,5,5,0,0,0,0,0,0,0
2024-01-13,UK,Ukraine,4,3,0,0,1,0,1,1,0
2024-01-14,UK,Ukraine,3,3,0,0,0,0,0,0,0
2024-01-15,UK,Ukraine,3,3,0,0,0,0,0,0,0
2024-01-16,UK,Ukraine,4,4,0,0,0,0,0,0,0
2024-01-17,UK,Ukraine,2,2,0,0,0,0,0,0,0
2024-01-18,UK,Ukraine,2,2,0,0,0,0,0,0,0
2024-01-19,UK,Ukraine,5,5,0,0,0,0,0,0,0
2024-01-20,UK,Ukraine,4,4,0,0,0,0,0,0,0
2024-01-21,UK,Ukraine,3,3,0,0,0,0,0,0,0
2024-01-22,UK,Ukraine,4,4,0,0,0,0,0,0,0
2024-01-23,UK,Ukraine,3,3,0,0,0,0,0,0,0
2024-01-24,UK,Ukraine,3,3,0,0,0,0,0,0,0
2024-01-25,UK,Ukraine,2,2,0,0,0,0,0,0,0
2024-01-26,UK,Ukraine,4,4,0,0,0,0,0,0,0
2024-01-27,UK,Ukraine,1,1,0,0,0,0,0,0,0
2024-01-28,UK,Ukraine,2,2,0,0,0,0,0,0,0
2024-01-29,UK,Ukraine,3,3,0,0,0,0,0,0,0
2024-01-30,UK,Ukraine,2,2,0,0,0,0,0,0,0
2024-01-31,UK,Ukraine,1,1,0,0,0,0,0,0,0
2024-02-01,UK,Ukraine,2,2,0,0,0,0,0,0,0
2024-02-02,UK,Ukraine,5,5,0,0,0,0,0,0,0
2024-02-03,UK,Ukraine,3,3,0,0,0,0,0,0,0
2024-02-04,UK,Ukraine,2,2,0,0,0,0,0,0,0
2024-01-01,EG,United Kingdom,5460,1228,441,0,4232,1894,1897,3791,441
2024-01-02,EG,United Kingdom,6005,1312,662,6,4693,1993,2038,4031,656
2024-01-03,EG,United Kingdom,6066,1365,782,11,4701,1943,1976,3919,771
2024-01-04,EG,United Kingdom,322,-4599,784,15,4921,2062,2075,4137,769
2024-01-05,EG,United Kingdom,6586,1446,822,9,5140,2162,2156,4318,813
2024-01-06,EG,United Kingdom,6073,1428,502,7,4645,2065,2078,4143,495
2024-01-07,EG,United Kingdom,6322,1409,591,3,4913,2155,2167,4322,588
2024-01-08,EG,United Kingdom,6021,1357,742,17,4664,1957,1965,3922,725
2024-01-09,EG,United Kingdom,4989,1204,723,12,3785,1534,1528,3062,711
2024-01-10,EG,United Kingdom,4973,1176,713,13,3797,1536,1548,3084,700
2024-01-11,EG,United Kingdom,5463,1268,789,16,4195,1720,1686,3406,773
2024-01-12,EG,United Kingdom,6107,1294,869,14,4813,1959,1985,3944,855
2024-01-13,EG,United Kingdom,5421,1306,481,7,4115,1819,1815,3634,474
2024-01-14,EG,United Kingdom,5859,1288,620,6,4571,1971,1980,3951,614
2024-01-15,EG,United Kingdom,5639,1208,713,12,4431,1876,1842,3718,701
2024-01-16,EG,United Kingdom,4635,1040,633,16,3595,1476,1486,2962,617
2024-01-17,EG,United Kingdom,4496,971,656,20,3525,1418,1451,2869,636
2024-01-18,EG,United Kingdom,5191,1086,699,11,4105,1704,1702,3406,688
2024-01-19,EG,United Kingdom,6120,1333,823,22,4787,1982,1982,3964,801
2024-01-20,EG,United Kingdom,5312,1268,463,9,4044,1803,1778,3581,454
2024-01-21,EG,United Kingdom,5152,1148,436,13,4004,1805,1763,3568,423
2024-01-22,EG,United Kingdom,5698,1159,772,12,4539,1858,1909,3767,760
2024-01-23,EG,United Kingdom,4625,1035,633,13,3590,1476,1481,2957,620
2024-01-24,EG,United Kingdom,4685,1025,661,7,3660,1497,1502,2999,654
2024-01-25,EG,United Kingdom,5381,1148,787,16,4233,1716,1730,3446,771
2024-01-26,EG,United Kingdom,6035,1194,840,11,4841,2005,1996,4001,829
2024-01-27,EG,United Kingdom,5305,1274,475,12,4031,1790,1766,3556,463
2024-01-28,EG,United Kingdom,5818,1291,586,5,4527,1957,1984,3941,581
2024-01-29,EG,United Kingdom,5802,1227,798,18,4575,1893,1884,3777,780
2024-01-30,EG,United Kingdom,4869,1076,711,19,3793,1545,1537,3082,692
2024-01-31,EG,United Kingdom,4864,1091,655,8,3773,1554,1564,3118,647
2024-02-01,EG,United Kingdom,5454,1138,790,21,4316,1775,1751,3526,769
2024-02-02,EG,United Kingdom,6165,1280,787,14,4885,2060,2038,4098,773
2024-02-03,EG,United Kingdom,5457,1262,500,10,4195,1849,1846,3695,490
2024-02-04,EG,United Kingdom,6031,1308,652,4,4723,2017,2054,4071,648
