entry_date,country_icao_code,country_name,flt_daio,flt_o,flt_i,flt_c,flt_dai,flt_d,flt_a,flt_da,flt_i_excl_c
2020-01-01,LA,Albania,383,315,0,0,68,34,34,68,0
2020-01-02,LA,Albania,448,365,0,0,83,41,42,83,0
2020-01-03,LA,Albania,489,409,0,0,80,40,40,80,0
2020-01-04,LA,Albania,514,443,0,0,71,35,36,71,0
2020-01-05,LA,Albania,539,448,0,0,91,46,45,91,0
2020-01-06,LA,Albania,469,387,0,0,82,40,42,82,0
2020-01-07,LA,Albania,362,281,0,0,81,42,39,81,0
2020-01-08,LA,Albania,429,353,0,0,76,38,38,76,0
2020-01-09,LA,Albania,426,346,0,0,80,40,40,80,0
2020-01-10,LA,Albania,458,385,0,0,73,36,37,73,0
2020-01-11,LA,Albania,484,417,0,0,67,34,33,67,0
2020-01-12,LA,Albania,489,426,0,0,63,32,31,63,0
2020-01-13,LA,Albania,405,333,1,1,72,35,36,71,0
2020-01-14,LA,Albania,315,258,0,0,57,28,29,57,0
2020-01-15,LA,Albania,345,287,0,0,58,28,30,58,0
2020-01-16,LA,Albania,393,323,0,0,70,35,35,70,0
2020-01-17,LA,Albania,445,378,0,0,67,34,33,67,0
2020-01-18,LA,Albania,465,415,0,0,50,26,24,50,0
2020-01-19,LA,Albania,443,391,0,0,52,28,24,52,0
2020-01-20,LA,Albania,386,312,1,1,74,34,39,73,0
2020-01-21,LA,Albania,274,218,0,0,56,27,29,56,0
2020-01-22,LA,Albania,366,311,0,0,55,28,27,55,0
2020-01-23,LA,Albania,389,320,0,0,69,34,35,69,0
2020-01-24,LA,Albania,454,392,0,0,62,31,31,62,0
2020-01-25,LA,Albania,429,375,0,0,54,28,26,54,0
2020-01-26,LA,Albania,462,402,0,0,60,28,32,60,0
2020-01-27,LA,Albania,370,303,0,0,67,34,33,67,0
2020-01-28,LA,Albania,329,275,0,0,54,27,27,54,0
2020-01-29,LA,Albania,371,321,0,0,50,26,24,50,0
2020-01-30,LA,Albania,379,315,0,0,64,32,32,64,0
2020-01-31,LA,Albania,450,385,0,0,65,33,32,65,0
2020-02-01,LA,Albania,460,410,0,0,50,25,25,50,0
2020-02-02,LA,Albania,455,397,0,0,58,28,30,58,0
2020-02-03,LA,Albania,413,348,0,0,65,33,32,65,0
2020-02-04,LA,Albania,323,273,0,0,50,25,25,50,0
2020-02-05,LA,Albania,333,284,0,0,49,25,24,49,0
2020-02-06,LA,Albania,376,306,0,0,70,34,36,70,0
2020-02-07,LA,Albania,446,383,0,0,63,32,31,63,0
2020-02-08,LA,Albania,474,419,0,0,55,28,27,55,0
2020-02-09,LA,Albania,461,403,0,0,58,27,31,58,0
2020-02-10,LA,Albania,375,307,0,0,68,35,33,68,0
2020-02-11,LA,Albania,357,303,0,0,54,26,28,54,0
2020-02-12,LA,Albania,374,317,0,0,57,29,28,57,0
2020-02-13,LA,Albania,363,293,0,0,70,35,35,70,0
2020-02-14,LA,Albania,426,356,0,0,70,35,35,70,0
2020-02-15,LA,Albania,488,434,0,0,54,27,27,54,0
2020-02-16,LA,Albania,472,409,0,0,63,31,32,63,0
2020-02-17,LA,Albania,405,338,0,0,67,34,33,67,0
2020-02-18,LA,Albania,371,318,0,0,53,26,27,53,0
2020-02-19,LA,Albania,372,314,0,0,58,29,29,58,0
2020-02-20,LA,Albania,415,343,0,0,72,36,36,72,0
2020-02-21,LA,Albania,468,403,0,0,65,33,32,65,0
2020-02-22,LA,Albania,469,417,0,0,52,27,25,52,0
2020-02-23,LA,Albania,479,418,0,0,61,30,31,61,0
2020-02-24,LA,Albania,418,348,0,0,70,35,35,70,0
2020-02-25,LA,Albania,340,287,0,0,53,27,26,53,0
2020-02-26,LA,Albania,393,335,0,0,58,28,30,58,0
2020-02-27,LA,Albania,405,333,0,0,72,36,36,72,0
2020-02-28,LA,Albania,432,364,0,0,68,34,34,68,0
2020-02-29,LA,Albania,475,425,0,0,50,26,24,50,0
2020-03-01,LA,Albania,456,395,0,0,61,29,32,61,0
2020-03-02,LA,Albania,376,304,0,0,72,36,36,72,0
2020-03-03,LA,Albania,338,283,0,0,55,28,27,55,0
2020-03-04,LA,Albania,343,290,0,0,53,26,27,53,0
2020-03-05,LA,Albania,367,298,0,0,69,34,35,69,0
2020-03-06,LA,Albania,393,326,0,0,67,35,32,67,0
2020-03-07,LA,Albania,380,328,0,0,52,27,25,52,0
2020-03-08,LA,Albania,405,352,0,0,53,25,28,53,0
2020-03-09,LA,Albania,310,264,0,0,46,25,21,46,0
2020-03-10,LA,Albania,281,244,0,0,37,18,19,37,0
2020-03-11,LA,Albania,302,269,0,0,33,17,16,33,0
2020-03-12,LA,Albania,328,286,0,0,42,21,21,42,0
2020-03-13,LA,Albania,335,299,0,0,36,18,18,36,0
2020-03-14,LA,Albania,347,321,0,0,26,14,12,26,0
2020-03-15,LA,Albania,331,303,0,0,28,14,14,28,0
2020-03-16,LA,Albania,287,257,0,0,30,16,14,30,0
2020-03-17,LA,Albania,232,211,0,0,21,10,11,21,0
2020-03-18,LA,Albania,258,241,1,1,17,8,8,16,0
2020-03-19,LA,Albania,214,197,0,0,17,9,8,17,0
2020-03-20,LA,Albania,213,201,0,0,12,6,6,12,0
2020-03-21,LA,Albania,197,187,0,0,10,5,5,10,0
2020-03-22,LA,Albania,153,143,0,0,10,5,5,10,0
2020-03-23,LA,Albania,114,108,0,0,6,3,3,6,0
2020-03-24,LA,Albania,62,55,0,0,7,3,4,7,0
2020-03-25,LA,Albania,71,66,0,0,5,3,2,5,0
2020-03-26,LA,Albania,66,58,0,0,8,4,4,8,0
2020-03-27,LA,Albania,72,55,0,0,17,8,9,17,0
2020-03-28,LA,Albania,65,58,0,0,7,3,4,7,0
2020-03-29,LA,Albania,53,51,0,0,2,1,1,2,0
2020-03-30,LA,Albania,51,41,0,0,10,5,5,10,0
2020-03-31,LA,Albania,55,47,0,0,8,4,4,8,0
2020-04-01,LA,Albania,62,56,0,0,6,3,3,6,0
2020-04-02,LA,Albania,45,42,0,0,3,2,1,3,0
2020-04-03,LA,Albania,53,41,0,0,12,6,6,12,0
2020-04-04,LA,Albania,47,47,0,0,0,0,0,0,0
2020-04-05,LA,Albania,49,47,0,0,2,1,1,2,0
2020-04-06,LA,Albania,40,36,0,0,4,2,2,4,0
2020-04-07,LA,Albania,45,39,0,0,6,3,3,6,0
2020-04-08,LA,Albania,49,43,0,0,6,3,3,6,0
2020-04-09,LA,Albania,53,49,0,0,4,2,2,4,0
2020-04-10,LA,Albania,48,42,0,0,6,3,3,6,0
2020-04-11,LA,Albania,55,55,0,0,0,0,0,0,0
2020-04-12,LA,Albania,49,49,0,0,0,0,0,0,0
2020-04-13,LA,Albania,50,46,0,0,4,2,2,4,0
2020-04-14,LA,Albania,36,34,0,0,2,1,1,2,0
2020-04-15,LA,Albania,60,58,0,0,2,1,1,2,0
2020-04-16,LA,Albania,44,40,0,0,4,2,2,4,0
2020-04-17,LA,Albania,59,53,0,0,6,3,3,6,0
2020-04-18,LA,Albania,51,46,0,0,5,2,3,5,0
2020-04-19,LA,Albania,43,39,0,0,4,2,2,4,0
2020-04-20,LA,Albania,55,47,0,0,8,4,4,8,0
2020-04-21,LA,Albania,52,46,0,0,6,3,3,6,0
2020-04-22,LA,Albania,72,68,0,0,4,2,2,4,0
2020-04-23,LA,Albania,61,53,0,0,8,4,4,8,0
2020-04-24,LA,Albania,49,37,0,0,12,6,6,12,0
2020-04-25,LA,Albania,52,48,0,0,4,2,2,4,0
2020-04-26,LA,Albania,65,63,0,0,2,1,1,2,0
2020-04-27,LA,Albania,49,43,0,0,6,3,3,6,0
2020-04-28,LA,Albania,51,46,0,0,5,2,3,5,0
2020-04-29,LA,Albania,71,59,0,0,12,6,6,12,0
2020-04-30,LA,Albania,61,54,0,0,7,4,3,7,0
2020-05-01,LA,Albania,61,59,0,0,2,1,1,2,0
2020-05-02,LA,Albania,52,50,0,0,2,1,1,2,0
2020-05-03,LA,Albania,63,57,0,0,6,3,3,6,0
2020-05-04,LA,Albania,62,56,0,0,6,3,3,6,0
2020-05-05,LA,Albania,49,41,0,0,8,4,4,8,0
2020-05-06,LA,Albania,73,61,0,0,12,6,6,12,0
2020-05-07,LA,Albania,73,63,0,0,10,5,5,10,0
2020-05-08,LA,Albania,76,66,0,0,10,5,5,10,0
2020-05-09,LA,Albania,69,62,0,0,7,4,3,7,0
2020-05-10,LA,Albania,71,71,0,0,0,0,0,0,0
2020-05-11,LA,Albania,54,50,0,0,4,2,2,4,0
2020-05-12,LA,Albania,74,66,0,0,8,4,4,8,0
2020-05-13,LA,Albania,68,58,0,0,10,5,5,10,0
2020-05-14,LA,Albania,72,65,0,0,7,3,4,7,0
2020-05-15,LA,Albania,71,59,0,0,12,6,6,12,0
2020-05-16,LA,Albania,64,60,0,0,4,2,2,4,0
2020-05-17,LA,Albania,62,58,0,0,4,2,2,4,0
2020-05-18,LA,Albania,59,53,0,0,6,3,3,6,0
2020-05-19,LA,Albania,64,60,0,0,4,2,2,4,0
2020-05-20,LA,Albania,100,88,0,0,12,6,6,12,0
2020-05-21,LA,Albania,94,84,0,0,10,5,5,10,0
2020-05-22,LA,Albania,65,55,0,0,10,5,5,10,0
2020-05-23,LA,Albania,70,64,0,0,6,3,3,6,0
2020-05-24,LA,Albania,63,58,0,0,5,3,2,5,0
2020-05-25,LA,Albania,48,46,0,0,2,1,1,2,0
2020-05-26,LA,Albania,59,55,0,0,4,2,2,4,0
2020-05-27,LA,Albania,63,59,0,0,4,2,2,4,0
2020-05-28,LA,Albania,70,57,0,0,13,6,7,13,0
2020-05-29,LA,Albania,66,49,0,0,17,9,8,17,0
2020-05-30,LA,Albania,71,60,0,0,11,5,6,11,0
2020-05-31,LA,Albania,63,57,0,0,6,3,3,6,0
2020-06-01,LA,Albania,39,31,0,0,8,4,4,8,0
2020-06-02,LA,Albania,67,59,0,0,8,4,4,8,0
2020-06-03,LA,Albania,68,57,0,0,11,5,6,11,0
2020-06-04,LA,Albania,70,66,0,0,4,2,2,4,0
2020-06-05,LA,Albania,77,66,2,2,11,4,5,9,0
2020-06-06,LA,Albania,80,74,0,0,6,4,2,6,0
2020-06-07,LA,Albania,75,73,0,0,2,1,1,2,0
2020-06-08,LA,Albania,67,51,0,0,16,8,8,16,0
2020-06-09,LA,Albania,60,56,0,0,4,2,2,4,0
2020-06-10,LA,Albania,60,50,0,0,10,5,5,10,0
2020-06-11,LA,Albania,82,75,0,0,7,4,3,7,0
2020-06-12,LA,Albania,58,52,0,0,6,3,3,6,0
2020-06-13,LA,Albania,68,64,0,0,4,2,2,4,0
2020-06-14,LA,Albania,87,83,0,0,4,1,3,4,0
2020-06-15,LA,Albania,80,66,0,0,14,7,7,14,0
2020-06-16,LA,Albania,83,69,0,0,14,7,7,14,0
2020-06-17,LA,Albania,100,80,0,0,20,10,10,20,0
2020-06-18,LA,Albania,118,99,0,0,19,10,9,19,0
2020-06-19,LA,Albania,120,106,0,0,14,7,7,14,0
2020-06-20,LA,Albania,111,103,0,0,8,4,4,8,0
2020-06-21,LA,Albania,110,99,0,0,11,6,5,11,0
2020-06-22,LA,Albania,100,78,0,0,22,10,12,22,0
2020-06-23,LA,Albania,113,85,0,0,28,14,14,28,0
2020-06-24,LA,Albania,123,93,0,0,30,15,15,30,0
2020-06-25,LA,Albania,129,98,0,0,31,15,16,31,0
2020-06-26,LA,Albania,160,120,0,0,40,20,20,40,0
2020-06-27,LA,Albania,141,118,0,0,23,12,11,23,0
2020-06-28,LA,Albania,168,144,0,0,24,12,12,24,0
2020-06-29,LA,Albania,130,98,0,0,32,16,16,32,0
2020-06-30,LA,Albania,155,121,0,0,34,16,18,34,0
2020-07-01,LA,Albania,264,219,0,0,45,23,22,45,0
2020-07-02,LA,Albania,292,245,0,0,47,22,25,47,0
2020-07-03,LA,Albania,370,306,0,0,64,32,32,64,0
2020-07-04,LA,Albania,386,348,0,0,38,19,19,38,0
2020-07-05,LA,Albania,369,320,0,0,49,25,24,49,0
2020-07-06,LA,Albania,317,259,0,0,58,28,30,58,0
2020-07-07,LA,Albania,264,221,0,0,43,22,21,43,0
2020-07-08,LA,Albania,299,255,0,0,44,22,22,44,0
2020-07-09,LA,Albania,322,277,0,0,45,23,22,45,0
2020-07-10,LA,Albania,385,326,0,0,59,30,29,59,0
2020-07-11,LA,Albania,451,417,0,0,34,17,17,34,0
2020-07-12,LA,Albania,395,346,0,0,49,24,25,49,0
2020-07-13,LA,Albania,345,270,0,0,75,35,40,75,0
2020-07-14,LA,Albania,297,229,0,0,68,33,35,68,0
2020-07-15,LA,Albania,340,289,0,0,51,27,24,51,0
2020-07-16,LA,Albania,358,299,0,0,59,28,31,59,0
2020-07-17,LA,Albania,396,317,0,0,79,40,39,79,0
2020-07-18,LA,Albania,522,458,0,0,64,32,32,64,0
2020-07-19,LA,Albania,453,386,0,0,67,34,33,67,0
2020-07-20,LA,Albania,365,279,0,0,86,42,44,86,0
2020-07-21,LA,Albania,350,278,0,0,72,36,36,72,0
2020-07-22,LA,Albania,370,308,0,0,62,32,30,62,0
2020-07-23,LA,Albania,407,333,0,0,74,36,38,74,0
2020-07-24,LA,Albania,448,358,0,0,90,46,44,90,0
2020-07-25,LA,Albania,621,557,0,0,64,33,31,64,0
2020-07-26,LA,Albania,487,423,0,0,64,32,32,64,0
2020-07-27,LA,Albania,389,305,0,0,84,41,43,84,0
2020-07-28,LA,Albania,379,312,0,0,67,33,34,67,0
2020-07-29,LA,Albania,406,336,0,0,70,35,35,70,0
2020-07-30,LA,Albania,422,353,0,0,69,35,34,69,0
2020-07-31,LA,Albania,511,423,0,0,88,44,44,88,0
2020-08-01,LA,Albania,708,635,0,0,73,36,37,73,0
2020-08-02,LA,Albania,613,531,0,0,82,42,40,82,0
2020-08-03,LA,Albania,454,368,0,0,86,42,44,86,0
2020-08-04,LA,Albania,454,389,0,0,65,32,33,65,0
2020-08-05,LA,Albania,461,380,0,0,81,42,39,81,0
2020-08-06,LA,Albania,439,372,0,0,67,32,35,67,0
2020-08-07,LA,Albania,560,464,0,0,96,47,49,96,0
2020-08-08,LA,Albania,667,611,0,0,56,28,28,56,0
2020-08-09,LA,Albania,624,551,0,0,73,37,36,73,0
2020-08-10,LA,Albania,444,361,0,0,83,41,42,83,0
2020-08-11,LA,Albania,443,380,0,0,63,30,33,63,0
2020-08-12,LA,Albania,480,409,0,0,71,38,33,71,0
2020-08-13,LA,Albania,456,393,0,0,63,30,33,63,0
2020-08-14,LA,Albania,533,440,0,0,93,47,46,93,0
2020-08-15,LA,Albania,756,700,0,0,56,28,28,56,0
2020-08-16,LA,Albania,623,548,0,0,75,39,36,75,0
2020-08-17,LA,Albania,517,432,0,0,85,41,44,85,0
2020-08-18,LA,Albania,449,385,0,0,64,32,32,64,0
2020-08-19,LA,Albania,477,397,0,0,80,40,40,80,0
2020-08-20,LA,Albania,477,409,0,0,68,34,34,68,0
2020-08-21,LA,Albania,543,454,0,0,89,45,44,89,0
2020-08-22,LA,Albania,677,619,0,0,58,29,29,58,0
2020-08-23,LA,Albania,640,571,0,0,69,35,34,69,0
2020-08-24,LA,Albania,456,375,0,0,81,39,42,81,0
2020-08-25,LA,Albania,471,404,0,0,67,33,34,67,0
2020-08-26,LA,Albania,458,388,0,0,70,37,33,70,0
2020-08-27,LA,Albania,474,408,0,0,66,32,34,66,0
2020-08-28,LA,Albania,563,468,0,0,95,48,47,95,0
2020-08-29,LA,Albania,641,585,0,0,56,28,28,56,0
2020-08-30,LA,Albania,571,497,0,0,74,38,36,74,0
2020-08-31,LA,Albania,428,352,0,0,76,37,39,76,0
2020-09-01,LA,Albania,392,328,0,0,64,31,33,64,0
2020-09-02,LA,Albania,395,336,0,0,59,31,28,59,0
2020-09-03,LA,Albania,427,360,0,0,67,32,35,67,0
2020-09-04,LA,Albania,516,427,0,0,89,45,44,89,0
2020-09-05,LA,Albania,612,559,0,0,53,27,26,53,0
2020-09-06,LA,Albania,536,472,0,0,64,31,33,64,0
2020-09-07,LA,Albania,400,331,0,0,69,35,34,69,0
2020-09-08,LA,Albania,386,329,0,0,57,28,29,57,0
2020-09-09,LA,Albania,408,351,0,0,57,31,26,57,0
2020-09-10,LA,Albania,399,347,0,0,52,25,27,52,0
2020-09-11,LA,Albania,492,411,0,0,81,40,41,81,0
2020-09-12,LA,Albania,592,546,0,0,46,23,23,46,0
2020-09-13,LA,Albania,541,479,0,0,62,30,32,62,0
2020-09-14,LA,Albania,376,315,0,0,61,31,30,61,0
2020-09-15,LA,Albania,364,314,0,0,50,26,24,50,0
2020-09-16,LA,Albania,350,305,0,0,45,21,24,45,0
2020-09-17,LA,Albania,347,304,0,0,43,23,20,43,0
2020-09-18,LA,Albania,418,350,0,0,68,35,33,68,0
2020-09-19,LA,Albania,587,541,0,0,46,22,24,46,0
2020-09-20,LA,Albania,549,491,0,0,58,29,29,58,0
2020-09-21,LA,Albania,363,310,0,0,53,27,26,53,0
2020-09-22,LA,Albania,283,238,0,0,45,22,23,45,0
2020-09-23,LA,Albania,336,287,0,0,49,26,23,49,0
2020-09-24,LA,Albania,319,274,0,0,45,22,23,45,0
2020-09-25,LA,Albania,430,360,0,0,70,34,36,70,0
2020-09-26,LA,Albania,504,468,0,0,36,18,18,36,0
2020-09-27,LA,Albania,458,402,0,0,56,28,28,56,0
2020-09-28,LA,Albania,352,291,0,0,61,31,30,61,0
2020-09-29,LA,Albania,294,254,0,0,40,21,19,40,0
2020-09-30,LA,Albania,296,244,0,0,52,23,29,52,0
2020-10-01,LA,Albania,281,224,0,0,57,28,29,57,0
2020-10-02,LA,Albania,402,331,0,0,71,37,34,71,0
2020-10-03,LA,Albania,505,458,0,0,47,23,24,47,0
2020-10-04,LA,Albania,503,445,0,0,58,28,30,58,0
2020-10-05,LA,Albania,320,272,0,0,48,26,22,48,0
2020-10-06,LA,Albania,258,223,0,0,35,16,19,35,0
2020-10-07,LA,Albania,252,202,0,0,50,26,24,50,0
2020-10-08,LA,Albania,268,224,0,0,44,22,22,44,0
2020-10-09,LA,Albania,377,326,0,0,51,26,25,51,0
2020-10-10,LA,Albania,533,490,0,0,43,22,21,43,0
2020-10-11,LA,Albania,432,381,0,0,51,23,28,51,0
2020-10-12,LA,Albania,293,242,0,0,51,27,24,51,0
2020-10-13,LA,Albania,232,195,0,0,37,19,18,37,0
2020-10-14,LA,Albania,251,211,0,0,40,19,21,40,0
2020-10-15,LA,Albania,158,115,0,0,43,23,20,43,0
2020-10-16,LA,Albania,410,351,0,0,59,29,30,59,0
2020-10-17,LA,Albania,485,439,0,0,46,22,24,46,0
2020-10-18,LA,Albania,405,357,0,0,48,24,24,48,0
2020-10-19,LA,Albania,285,231,0,0,54,28,26,54,0
2020-10-20,LA,Albania,207,168,0,0,39,20,19,39,0
2020-10-21,LA,Albania,254,220,0,0,34,15,19,34,0
2020-10-22,LA,Albania,250,202,0,0,48,24,24,48,0
2020-10-23,LA,Albania,341,283,0,0,58,29,29,58,0
2020-10-24,LA,Albania,503,447,0,0,56,27,29,56,0
2020-10-25,LA,Albania,395,338,0,0,57,29,28,57,0
2020-10-26,LA,Albania,245,189,0,0,56,29,27,56,0
2020-10-27,LA,Albania,198,155,0,0,43,22,21,43,0
2020-10-28,LA,Albania,241,199,0,0,42,20,22,42,0
2020-10-29,LA,Albania,225,181,0,0,44,23,21,44,0
2020-10-30,LA,Albania,306,254,0,0,52,25,27,52,0
2020-10-31,LA,Albania,379,339,0,0,40,20,20,40,0
2020-11-01,LA,Albania,382,325,0,0,57,28,29,57,0
2020-11-02,LA,Albania,210,145,0,0,65,35,30,65,0
2020-11-03,LA,Albania,185,154,0,0,31,15,16,31,0
2020-11-04,LA,Albania,202,158,0,0,44,20,24,44,0
2020-11-05,LA,Albania,211,163,0,0,48,24,24,48,0
2020-11-06,LA,Albania,215,164,0,0,51,27,24,51,0
2020-11-07,LA,Albania,273,233,0,0,40,19,21,40,0
2020-11-08,LA,Albania,282,224,0,0,58,29,29,58,0
2020-11-09,LA,Albania,180,121,0,0,59,31,28,59,0
2020-11-10,LA,Albania,152,112,0,0,40,19,21,40,0
2020-11-11,LA,Albania,169,126,0,0,43,24,19,43,0
2020-11-12,LA,Albania,165,119,0,0,46,23,23,46,0
2020-11-13,LA,Albania,210,141,0,0,69,33,36,69,0
2020-11-14,LA,Albania,214,176,0,0,38,19,19,38,0
2020-11-15,LA,Albania,201,157,0,0,44,22,22,44,0
2020-11-16,LA,Albania,159,103,0,0,56,30,26,56,0
2020-11-17,LA,Albania,111,85,0,0,26,12,14,26,0
2020-11-18,LA,Albania,155,116,0,0,39,20,19,39,0
2020-11-19,LA,Albania,132,93,0,0,39,20,19,39,0
2020-11-20,LA,Albania,171,118,0,0,53,26,27,53,0
2020-11-21,LA,Albania,174,145,0,0,29,14,15,29,0
2020-11-22,LA,Albania,180,148,0,0,32,15,17,32,0
2020-11-23,LA,Albania,125,88,0,0,37,21,16,37,0
2020-11-24,LA,Albania,100,85,0,0,15,7,8,15,0
2020-11-25,LA,Albania,140,117,0,0,23,12,11,23,0
2020-11-26,LA,Albania,122,96,0,0,26,12,14,26,0
2020-11-27,LA,Albania,161,125,0,0,36,17,19,36,0
2020-11-28,LA,Albania,161,132,0,0,29,16,13,29,0
2020-11-29,LA,Albania,189,157,0,0,32,15,17,32,0
2020-11-30,LA,Albania,139,103,0,0,36,19,17,36,0
2020-12-01,LA,Albania,105,92,0,0,13,6,7,13,0
2020-12-02,LA,Albania,142,106,0,0,36,16,20,36,0
2020-12-03,LA,Albania,160,129,0,0,31,16,15,31,0
2020-12-04,LA,Albania,166,127,0,0,39,21,18,39,0
2020-12-05,LA,Albania,180,146,0,0,34,17,17,34,0
2020-12-06,LA,Albania,182,150,0,0,32,15,17,32,0
2020-12-07,LA,Albania,145,106,0,0,39,20,19,39,0
2020-12-08,LA,Albania,120,100,0,0,20,11,9,20,0
2020-12-09,LA,Albania,148,122,0,0,26,13,13,26,0
2020-12-10,LA,Albania,154,122,0,0,32,14,18,32,0
2020-12-11,LA,Albania,177,137,0,0,40,20,20,40,0
2020-12-12,LA,Albania,188,154,0,0,34,17,17,34,0
2020-12-13,LA,Albania,183,147,0,0,36,17,19,36,0
2020-12-14,LA,Albania,155,112,0,0,43,23,20,43,0
2020-12-15,LA,Albania,133,114,0,0,19,10,9,19,0
2020-12-16,LA,Albania,174,151,0,0,23,11,12,23,0
2020-12-17,LA,Albania,219,176,0,0,43,21,22,43,0
2020-12-18,LA,Albania,274,221,0,0,53,26,27,53,0
2020-12-19,LA,Albania,324,275,0,0,49,25,24,49,0
2020-12-20,LA,Albania,312,263,0,0,49,24,25,49,0
2020-12-21,LA,Albania,189,146,0,0,43,23,20,43,0
2020-12-22,LA,Albania,197,161,0,0,36,18,18,36,0
2020-12-23,LA,Albania,236,198,0,0,38,19,19,38,0
2020-12-24,LA,Albania,230,193,0,0,37,19,18,37,0
2020-12-25,LA,Albania,156,135,0,0,21,10,11,21,0
2020-12-26,LA,Albania,224,198,0,0,26,13,13,26,0
2020-12-27,LA,Albania,253,210,0,0,43,20,23,43,0
2020-12-28,LA,Albania,154,108,0,0,46,25,21,46,0
2020-12-29,LA,Albania,157,136,0,0,21,11,10,21,0
2020-12-30,LA,Albania,182,152,0,0,30,14,16,30,0
2020-12-31,LA,Albania,150,127,0,0,23,12,11,23,0
2020-01-01,UD,Armenia,186,113,0,0,73,38,35,73,0
2020-01-02,UD,Armenia,196,120,0,0,76,38,38,76,0
2020-01-03,UD,Armenia,191,119,0,0,72,36,36,72,0
2020-01-04,UD,Armenia,192,106,0,0,86,43,43,86,0
2020-01-05,UD,Armenia,181,95,0,0,86,42,44,86,0
2020-01-06,UD,Armenia,177,90,0,0,87,45,42,87,0
2020-01-07,UD,Armenia,202,110,0,0,92,46,46,92,0
2020-01-08,UD,Armenia,190,102,0,0,88,44,44,88,0
2020-01-09,UD,Armenia,163,90,0,0,73,36,37,73,0
2020-01-10,UD,Armenia,161,91,0,0,70,35,35,70,0
2020-01-11,UD,Armenia,153,76,0,0,77,38,39,77,0
2020-01-12,UD,Armenia,164,94,0,0,70,34,36,70,0
2020-01-13,UD,Armenia,141,69,0,0,72,37,35,72,0
2020-01-14,UD,Armenia,181,112,0,0,69,32,37,69,0
2020-01-15,UD,Armenia,176,104,0,0,72,38,34,72,0
2020-01-16,UD,Armenia,155,89,0,0,66,32,34,66,0
2020-01-17,UD,Armenia,153,87,0,0,66,34,32,66,0
2020-01-18,UD,Armenia,162,85,0,0,77,39,38,77,0
2020-01-19,UD,Armenia,149,81,0,0,68,34,34,68,0
2020-01-20,UD,Armenia,151,85,0,0,66,32,34,66,0
2020-01-21,UD,Armenia,167,98,0,0,69,34,35,69,0
2020-01-22,UD,Armenia,163,102,0,0,61,32,29,61,0
2020-01-23,UD,Armenia,172,103,0,0,69,33,36,69,0
2020-01-24,UD,Armenia,155,95,0,0,60,31,29,60,0
2020-01-25,UD,Armenia,170,101,0,0,69,34,35,69,0
2020-01-26,UD,Armenia,166,96,0,0,70,38,32,70,0
2020-01-27,UD,Armenia,144,85,0,0,59,29,30,59,0
2020-01-28,UD,Armenia,163,98,0,0,65,31,34,65,0
2020-01-29,UD,Armenia,163,107,0,0,56,29,27,56,0
2020-01-30,UD,Armenia,136,79,0,0,57,28,29,57,0
2020-01-31,UD,Armenia,164,104,0,0,60,30,30,60,0
2020-02-01,UD,Armenia,137,70,0,0,67,34,33,67,0
2020-02-02,UD,Armenia,149,81,0,0,68,34,34,68,0
2020-02-03,UD,Armenia,153,92,0,0,61,31,30,61,0
2020-02-04,UD,Armenia,146,78,0,0,68,34,34,68,0
2020-02-05,UD,Armenia,140,86,0,0,54,28,26,54,0
2020-02-06,UD,Armenia,156,94,0,0,62,30,32,62,0
2020-02-07,UD,Armenia,160,101,0,0,59,30,29,59,0
2020-02-08,UD,Armenia,159,93,0,0,66,32,34,66,0
2020-02-09,UD,Armenia,153,87,0,0,66,33,33,66,0
2020-02-10,UD,Armenia,138,79,0,0,59,30,29,59,0
2020-02-11,UD,Armenia,157,90,0,0,67,32,35,67,0
2020-02-12,UD,Armenia,146,89,0,0,57,30,27,57,0
2020-02-13,UD,Armenia,141,84,0,0,57,28,29,57,0
2020-02-14,UD,Armenia,154,90,0,0,64,33,31,64,0
2020-02-15,UD,Armenia,162,94,0,0,68,33,35,68,0
2020-02-16,UD,Armenia,145,79,0,0,66,32,34,66,0
2020-02-17,UD,Armenia,145,86,0,0,59,30,29,59,0
2020-02-18,UD,Armenia,151,84,0,0,67,33,34,67,0
2020-02-19,UD,Armenia,140,88,0,0,52,28,24,52,0
2020-02-20,UD,Armenia,149,89,0,0,60,30,30,60,0
2020-02-21,UD,Armenia,163,106,0,0,57,30,27,57,0
2020-02-22,UD,Armenia,188,115,0,0,73,36,37,73,0
2020-02-23,UD,Armenia,148,83,0,0,65,32,33,65,0
2020-02-24,UD,Armenia,146,81,0,0,65,33,32,65,0
2020-02-25,UD,Armenia,149,83,0,0,66,32,34,66,0
2020-02-26,UD,Armenia,149,90,0,0,59,30,29,59,0
2020-02-27,UD,Armenia,164,113,0,0,51,25,26,51,0
2020-02-28,UD,Armenia,191,129,0,0,62,33,29,62,0
2020-02-29,UD,Armenia,149,80,0,0,69,34,35,69,0
2020-03-01,UD,Armenia,150,82,0,0,68,34,34,68,0
2020-03-02,UD,Armenia,134,73,0,0,61,31,30,61,0
2020-03-03,UD,Armenia,144,76,0,0,68,33,35,68,0
2020-03-04,UD,Armenia,178,119,0,0,59,30,29,59,0
2020-03-05,UD,Armenia,168,110,0,0,58,29,29,58,0
2020-03-06,UD,Armenia,160,99,0,0,61,30,31,61,0
2020-03-07,UD,Armenia,172,94,0,0,78,40,38,78,0
2020-03-08,UD,Armenia,161,100,0,0,61,30,31,61,0
2020-03-09,UD,Armenia,172,104,0,0,68,35,33,68,0
2020-03-10,UD,Armenia,158,89,0,0,69,32,37,69,0
2020-03-11,UD,Armenia,165,103,0,0,62,33,29,62,0
2020-03-12,UD,Armenia,132,80,0,0,52,25,27,52,0
2020-03-13,UD,Armenia,145,83,0,0,62,32,30,62,0
2020-03-14,UD,Armenia,172,105,0,0,67,33,34,67,0
2020-03-15,UD,Armenia,147,83,0,0,64,31,33,64,0
2020-03-16,UD,Armenia,139,78,0,0,61,31,30,61,0
2020-03-17,UD,Armenia,133,80,0,0,53,27,26,53,0
2020-03-18,UD,Armenia,120,75,0,0,45,23,22,45,0
2020-03-19,UD,Armenia,104,71,0,0,33,18,15,33,0
2020-03-20,UD,Armenia,93,56,0,0,37,18,19,37,0
2020-03-21,UD,Armenia,68,48,0,0,20,11,9,20,0
2020-03-22,UD,Armenia,71,48,0,0,23,12,11,23,0
2020-03-23,UD,Armenia,61,44,0,0,17,8,9,17,0
2020-03-24,UD,Armenia,64,45,0,0,19,9,10,19,0
2020-03-25,UD,Armenia,48,35,0,0,13,7,6,13,0
2020-03-26,UD,Armenia,38,27,0,0,11,5,6,11,0
2020-03-27,UD,Armenia,34,20,0,0,14,6,8,14,0
2020-03-28,UD,Armenia,36,19,0,0,17,9,8,17,0
2020-03-29,UD,Armenia,36,27,0,0,9,4,5,9,0
2020-03-30,UD,Armenia,33,20,0,0,13,7,6,13,0
2020-03-31,UD,Armenia,17,15,0,0,2,1,1,2,0
2020-04-01,UD,Armenia,20,14,0,0,6,3,3,6,0
2020-04-02,UD,Armenia,23,19,0,0,4,2,2,4,0
2020-04-03,UD,Armenia,19,12,0,0,7,3,4,7,0
2020-04-04,UD,Armenia,27,24,0,0,3,2,1,3,0
2020-04-05,UD,Armenia,26,20,0,0,6,2,4,6,0
2020-04-06,UD,Armenia,28,23,0,0,5,3,2,5,0
2020-04-07,UD,Armenia,32,22,0,0,10,6,4,10,0
2020-04-08,UD,Armenia,21,14,0,0,7,3,4,7,0
2020-04-09,UD,Armenia,18,14,0,0,4,2,2,4,0
2020-04-10,UD,Armenia,23,19,0,0,4,1,3,4,0
2020-04-11,UD,Armenia,14,13,0,0,1,1,0,1,0
2020-04-12,UD,Armenia,20,14,0,0,6,3,3,6,0
2020-04-13,UD,Armenia,21,13,0,0,8,4,4,8,0
2020-04-14,UD,Armenia,17,14,0,0,3,1,2,3,0
2020-04-15,UD,Armenia,29,20,0,0,9,5,4,9,0
2020-04-16,UD,Armenia,30,24,0,0,6,1,5,6,0
2020-04-17,UD,Armenia,30,19,0,0,11,7,4,11,0
2020-04-18,UD,Armenia,17,15,0,0,2,1,1,2,0
2020-04-19,UD,Armenia,22,15,0,0,7,4,3,7,0
2020-04-20,UD,Armenia,21,12,0,0,9,5,4,9,0
2020-04-21,UD,Armenia,26,19,0,0,7,1,6,7,0
2020-04-22,UD,Armenia,36,27,0,0,9,5,4,9,0
2020-04-23,UD,Armenia,39,25,0,0,14,7,7,14,0
2020-04-24,UD,Armenia,20,8,0,0,12,6,6,12,0
2020-04-25,UD,Armenia,21,16,0,0,5,2,3,5,0
2020-04-26,UD,Armenia,20,14,0,0,6,4,2,6,0
2020-04-27,UD,Armenia,26,10,0,0,16,9,7,16,0
2020-04-28,UD,Armenia,22,12,0,0,10,4,6,10,0
2020-04-29,UD,Armenia,27,20,0,0,7,5,2,7,0
2020-04-30,UD,Armenia,30,17,0,0,13,7,6,13,0
2020-05-01,UD,Armenia,20,12,0,0,8,2,6,8,0
2020-05-02,UD,Armenia,29,24,0,0,5,4,1,5,0
2020-05-03,UD,Armenia,21,16,0,0,5,1,4,5,0
2020-05-04,UD,Armenia,16,10,0,0,6,4,2,6,0
2020-05-05,UD,Armenia,20,11,0,0,9,4,5,9,0
2020-05-06,UD,Armenia,25,18,0,0,7,4,3,7,0
2020-05-07,UD,Armenia,25,22,0,0,3,2,1,3,0
2020-05-08,UD,Armenia,20,16,0,0,4,1,3,4,0
2020-05-09,UD,Armenia,24,18,0,0,6,4,2,6,0
2020-05-10,UD,Armenia,17,8,0,0,9,5,4,9,0
2020-05-11,UD,Armenia,18,17,0,0,1,1,0,1,0
2020-05-12,UD,Armenia,26,20,0,0,6,3,3,6,0
2020-05-13,UD,Armenia,25,19,0,0,6,3,3,6,0
2020-05-14,UD,Armenia,24,16,0,0,8,2,6,8,0
2020-05-15,UD,Armenia,28,15,0,0,13,8,5,13,0
2020-05-16,UD,Armenia,16,15,0,0,1,1,0,1,0
2020-05-17,UD,Armenia,22,15,0,0,7,3,4,7,0
2020-05-18,UD,Armenia,18,13,0,0,5,3,2,5,0
2020-05-19,UD,Armenia,17,10,0,0,7,3,4,7,0
2020-05-20,UD,Armenia,22,14,0,0,8,3,5,8,0
2020-05-21,UD,Armenia,25,20,0,0,5,4,1,5,0
2020-05-22,UD,Armenia,41,33,0,0,8,4,4,8,0
2020-05-23,UD,Armenia,27,17,0,0,10,6,4,10,0
2020-05-24,UD,Armenia,35,28,0,0,7,2,5,7,0
2020-05-25,UD,Armenia,32,25,0,0,7,4,3,7,0
2020-05-26,UD,Armenia,20,13,0,0,7,3,4,7,0
2020-05-27,UD,Armenia,25,15,0,0,10,5,5,10,0
2020-05-28,UD,Armenia,30,23,0,0,7,4,3,7,0
2020-05-29,UD,Armenia,33,24,0,0,9,4,5,9,0
2020-05-30,UD,Armenia,24,17,0,0,7,4,3,7,0
2020-05-31,UD,Armenia,36,25,0,0,11,6,5,11,0
2020-06-01,UD,Armenia,22,18,0,0,4,2,2,4,0
2020-06-02,UD,Armenia,37,24,0,0,13,6,7,13,0
2020-06-03,UD,Armenia,26,22,0,0,4,2,2,4,0
2020-06-04,UD,Armenia,45,26,0,0,19,9,10,19,0
2020-06-05,UD,Armenia,33,22,0,0,11,6,5,11,0
2020-06-06,UD,Armenia,20,16,0,0,4,2,2,4,0
2020-06-07,UD,Armenia,27,18,0,0,9,5,4,9,0
2020-06-08,UD,Armenia,24,14,0,0,10,5,5,10,0
2020-06-09,UD,Armenia,36,29,0,0,7,4,3,7,0
2020-06-10,UD,Armenia,30,22,0,0,8,4,4,8,0
2020-06-11,UD,Armenia,29,22,0,0,7,2,5,7,0
2020-06-12,UD,Armenia,31,25,0,0,6,3,3,6,0
2020-06-13,UD,Armenia,33,21,0,0,12,5,7,12,0
2020-06-14,UD,Armenia,31,20,0,0,11,6,5,11,0
2020-06-15,UD,Armenia,30,21,0,0,9,5,4,9,0
2020-06-16,UD,Armenia,29,19,0,0,10,6,4,10,0
2020-06-17,UD,Armenia,34,27,0,0,7,3,4,7,0
2020-06-18,UD,Armenia,48,31,0,0,17,9,8,17,0
2020-06-19,UD,Armenia,32,18,0,0,14,6,8,14,0
2020-06-20,UD,Armenia,37,22,0,0,15,9,6,15,0
2020-06-21,UD,Armenia,26,21,0,0,5,2,3,5,0
2020-06-22,UD,Armenia,22,15,0,0,7,4,3,7,0
2020-06-23,UD,Armenia,50,26,0,0,24,12,12,24,0
2020-06-24,UD,Armenia,36,18,0,0,18,9,9,18,0
2020-06-25,UD,Armenia,33,23,0,0,10,7,3,10,0
2020-06-26,UD,Armenia,41,28,0,0,13,6,7,13,0
2020-06-27,UD,Armenia,34,27,0,0,7,4,3,7,0
2020-06-28,UD,Armenia,29,18,0,0,11,5,6,11,0
2020-06-29,UD,Armenia,26,19,0,0,7,4,3,7,0
2020-06-30,UD,Armenia,36,24,0,0,12,6,6,12,0
2020-07-01,UD,Armenia,34,23,0,0,11,7,4,11,0
2020-07-02,UD,Armenia,26,20,0,0,6,2,4,6,0
2020-07-03,UD,Armenia,36,22,0,0,14,7,7,14,0
2020-07-04,UD,Armenia,35,30,0,0,5,3,2,5,0
2020-07-05,UD,Armenia,39,32,0,0,7,4,3,7,0
2020-07-06,UD,Armenia,20,16,0,0,4,1,3,4,0
2020-07-07,UD,Armenia,39,31,0,0,8,4,4,8,0
2020-07-08,UD,Armenia,36,28,0,0,8,4,4,8,0
2020-07-09,UD,Armenia,51,40,0,0,11,6,5,11,0
2020-07-10,UD,Armenia,44,34,0,0,10,4,6,10,0
2020-07-11,UD,Armenia,30,22,0,0,8,5,3,8,0
2020-07-12,UD,Armenia,18,12,0,0,6,3,3,6,0
2020-07-13,UD,Armenia,26,20,0,0,6,3,3,6,0
2020-07-14,UD,Armenia,23,13,0,0,10,5,5,10,0
2020-07-15,UD,Armenia,17,9,0,0,8,2,6,8,0
2020-07-16,UD,Armenia,35,19,0,0,16,10,6,16,0
2020-07-17,UD,Armenia,35,17,0,0,18,9,9,18,0
2020-07-18,UD,Armenia,24,18,0,0,6,4,2,6,0
2020-07-19,UD,Armenia,20,10,0,0,10,4,6,10,0
2020-07-20,UD,Armenia,24,11,0,0,13,6,7,13,0
2020-07-21,UD,Armenia,30,16,0,0,14,9,5,14,0
2020-07-22,UD,Armenia,19,5,0,0,14,6,8,14,0
2020-07-23,UD,Armenia,17,5,0,0,12,6,6,12,0
2020-07-24,UD,Armenia,16,7,0,0,9,4,5,9,0
2020-07-25,UD,Armenia,18,5,0,0,13,6,7,13,0
2020-07-26,UD,Armenia,10,0,0,0,10,6,4,10,0
2020-07-27,UD,Armenia,16,7,0,0,9,5,4,9,0
2020-07-28,UD,Armenia,13,5,0,0,8,4,4,8,0
2020-07-29,UD,Armenia,23,12,0,0,11,6,5,11,0
2020-07-30,UD,Armenia,13,2,0,0,11,6,5,11,0
2020-07-31,UD,Armenia,11,4,0,0,7,3,4,7,0
2020-08-01,UD,Armenia,20,8,0,0,12,6,6,12,0
2020-08-02,UD,Armenia,16,6,0,0,10,5,5,10,0
2020-08-03,UD,Armenia,16,5,0,0,11,5,6,11,0
2020-08-04,UD,Armenia,28,10,0,0,18,10,8,18,0
2020-08-05,UD,Armenia,18,9,0,0,9,5,4,9,0
2020-08-06,UD,Armenia,17,5,0,0,12,6,6,12,0
2020-08-07,UD,Armenia,16,5,0,0,11,6,5,11,0
2020-08-08,UD,Armenia,29,9,0,0,20,11,9,20,0
2020-08-09,UD,Armenia,17,10,0,0,7,3,4,7,0
2020-08-10,UD,Armenia,23,10,0,0,13,7,6,13,0
2020-08-11,UD,Armenia,23,6,0,0,17,9,8,17,0
2020-08-12,UD,Armenia,18,5,0,0,13,5,8,13,0
2020-08-13,UD,Armenia,26,3,0,0,23,10,13,23,0
2020-08-14,UD,Armenia,27,10,0,0,17,10,7,17,0
2020-08-15,UD,Armenia,21,6,0,0,15,8,7,15,0
2020-08-16,UD,Armenia,13,5,0,0,8,2,6,8,0
2020-08-17,UD,Armenia,25,11,0,0,14,8,6,14,0
2020-08-18,UD,Armenia,18,6,0,0,12,5,7,12,0
2020-08-19,UD,Armenia,19,3,0,0,16,9,7,16,0
2020-08-20,UD,Armenia,26,10,0,0,16,8,8,16,0
2020-08-21,UD,Armenia,28,11,0,0,17,7,10,17,0
2020-08-22,UD,Armenia,26,3,0,0,23,14,9,23,0
2020-08-23,UD,Armenia,10,4,0,0,6,2,4,6,0
2020-08-24,UD,Armenia,23,7,0,0,16,8,8,16,0
2020-08-25,UD,Armenia,31,9,1,0,22,11,10,21,1
2020-08-26,UD,Armenia,21,7,0,0,14,7,7,14,0
2020-08-27,UD,Armenia,21,8,0,0,13,7,6,13,0
2020-08-28,UD,Armenia,35,10,0,0,25,11,14,25,0
2020-08-29,UD,Armenia,34,9,0,0,25,15,10,25,0
2020-08-30,UD,Armenia,14,1,0,0,13,6,7,13,0
2020-08-31,UD,Armenia,28,9,0,0,19,9,10,19,0
2020-09-01,UD,Armenia,24,7,0,0,17,9,8,17,0
2020-09-02,UD,Armenia,24,10,1,0,14,7,6,13,1
2020-09-03,UD,Armenia,24,7,0,0,17,9,8,17,0
2020-09-04,UD,Armenia,34,9,1,0,25,12,12,24,1
2020-09-05,UD,Armenia,32,16,0,0,16,8,8,16,0
2020-09-06,UD,Armenia,32,9,0,0,23,11,12,23,0
2020-09-07,UD,Armenia,28,7,0,0,21,9,12,21,0
2020-09-08,UD,Armenia,34,7,0,0,27,15,12,27,0
2020-09-09,UD,Armenia,28,8,0,0,20,10,10,20,0
2020-09-10,UD,Armenia,18,2,0,0,16,9,7,16,0
2020-09-11,UD,Armenia,31,15,0,0,16,7,9,16,0
2020-09-12,UD,Armenia,21,5,0,0,16,8,8,16,0
2020-09-13,UD,Armenia,26,5,0,0,21,9,12,21,0
2020-09-14,UD,Armenia,16,4,0,0,12,7,5,12,0
2020-09-15,UD,Armenia,39,18,0,0,21,9,12,21,0
2020-09-16,UD,Armenia,32,15,0,0,17,10,7,17,0
2020-09-17,UD,Armenia,31,6,0,0,25,13,12,25,0
2020-09-18,UD,Armenia,37,8,0,0,29,14,15,29,0
2020-09-19,UD,Armenia,31,9,0,0,22,12,10,22,0
2020-09-20,UD,Armenia,29,5,0,0,24,10,14,24,0
2020-09-21,UD,Armenia,29,6,0,0,23,14,9,23,0
2020-09-22,UD,Armenia,27,7,0,0,20,9,11,20,0
2020-09-23,UD,Armenia,26,9,0,0,17,9,8,17,0
2020-09-24,UD,Armenia,24,3,0,0,21,10,11,21,0
2020-09-25,UD,Armenia,33,8,0,0,25,13,12,25,0
2020-09-26,UD,Armenia,30,7,0,0,23,13,10,23,0
2020-09-27,UD,Armenia,31,2,0,0,29,12,17,29,0
2020-09-28,UD,Armenia,33,12,0,0,21,13,8,21,0
2020-09-29,UD,Armenia,29,8,0,0,21,10,11,21,0
2020-09-30,UD,Armenia,21,5,0,0,16,7,9,16,0
2020-10-01,UD,Armenia,23,4,0,0,19,11,8,19,0
2020-10-02,UD,Armenia,25,3,0,0,22,10,12,22,0
2020-10-03,UD,Armenia,22,2,0,0,20,11,9,20,0
2020-10-04,UD,Armenia,26,0,0,0,26,12,14,26,0
2020-10-05,UD,Armenia,22,5,0,0,17,10,7,17,0
2020-10-06,UD,Armenia,27,3,0,0,24,11,13,24,0
2020-10-07,UD,Armenia,28,3,0,0,25,11,14,25,0
2020-10-08,UD,Armenia,28,1,0,0,27,12,15,27,0
2020-10-09,UD,Armenia,43,8,0,0,35,21,14,35,0
2020-10-10,UD,Armenia,30,7,0,0,23,11,12,23,0
2020-10-11,UD,Armenia,39,2,0,0,37,18,19,37,0
2020-10-12,UD,Armenia,22,6,0,0,16,9,7,16,0
2020-10-13,UD,Armenia,27,2,0,0,25,13,12,25,0
2020-10-14,UD,Armenia,21,6,0,0,15,6,9,15,0
2020-10-15,UD,Armenia,36,5,0,0,31,17,14,31,0
2020-10-16,UD,Armenia,32,3,0,0,29,15,14,29,0
2020-10-17,UD,Armenia,27,7,0,0,20,9,11,20,0
2020-10-18,UD,Armenia,25,1,0,0,24,12,12,24,0
2020-10-19,UD,Armenia,28,1,0,0,27,14,13,27,0
2020-10-20,UD,Armenia,27,2,0,0,25,12,13,25,0
2020-10-21,UD,Armenia,30,3,0,0,27,13,14,27,0
2020-10-22,UD,Armenia,24,5,0,0,19,11,8,19,0
2020-10-23,UD,Armenia,39,5,0,0,34,18,16,34,0
2020-10-24,UD,Armenia,34,6,0,0,28,13,15,28,0
2020-10-25,UD,Armenia,29,1,0,0,28,13,15,28,0
2020-10-26,UD,Armenia,39,6,0,0,33,17,16,33,0
2020-10-27,UD,Armenia,26,4,0,0,22,10,12,22,0
2020-10-28,UD,Armenia,34,7,0,0,27,13,14,27,0
2020-10-29,UD,Armenia,34,4,0,0,30,14,16,30,0
2020-10-30,UD,Armenia,49,10,0,0,39,21,18,39,0
2020-10-31,UD,Armenia,31,8,0,0,23,11,12,23,0
2020-11-01,UD,Armenia,27,2,0,0,25,12,13,25,0
2020-11-02,UD,Armenia,30,5,0,0,25,14,11,25,0
2020-11-03,UD,Armenia,31,3,0,0,28,14,14,28,0
2020-11-04,UD,Armenia,35,6,0,0,29,12,17,29,0
2020-11-05,UD,Armenia,35,6,0,0,29,17,12,29,0
2020-11-06,UD,Armenia,36,4,0,0,32,14,18,32,0
2020-11-07,UD,Armenia,51,23,0,0,28,15,13,28,0
2020-11-08,UD,Armenia,36,6,0,0,30,13,17,30,0
2020-11-09,UD,Armenia,23,2,0,0,21,12,9,21,0
2020-11-10,UD,Armenia,26,3,0,0,23,11,12,23,0
2020-11-11,UD,Armenia,34,3,0,0,31,14,17,31,0
2020-11-12,UD,Armenia,28,1,0,0,27,13,14,27,0
2020-11-13,UD,Armenia,18,1,0,0,17,7,10,17,0
2020-11-14,UD,Armenia,24,1,0,0,23,12,11,23,0
2020-11-15,UD,Armenia,20,2,0,0,18,8,10,18,0
2020-11-16,UD,Armenia,35,5,0,0,30,15,15,30,0
2020-11-17,UD,Armenia,26,1,0,0,25,14,11,25,0
2020-11-18,UD,Armenia,18,0,0,0,18,8,10,18,0
2020-11-19,UD,Armenia,21,2,0,0,19,11,8,19,0
2020-11-20,UD,Armenia,21,1,0,0,20,9,11,20,0
2020-11-21,UD,Armenia,23,1,0,0,22,11,11,22,0
2020-11-22,UD,Armenia,24,0,0,0,24,12,12,24,0
2020-11-23,UD,Armenia,18,0,0,0,18,8,10,18,0
2020-11-24,UD,Armenia,25,6,0,0,19,10,9,19,0
2020-11-25,UD,Armenia,26,10,0,0,16,7,9,16,0
2020-11-26,UD,Armenia,27,5,0,0,22,11,11,22,0
2020-11-27,UD,Armenia,27,7,0,0,20,10,10,20,0
2020-11-28,UD,Armenia,24,6,0,0,18,9,9,18,0
2020-11-29,UD,Armenia,23,4,0,0,19,9,10,19,0
2020-11-30,UD,Armenia,24,6,0,0,18,10,8,18,0
2020-12-01,UD,Armenia,27,8,0,0,19,9,10,19,0
2020-12-02,UD,Armenia,23,5,0,0,18,9,9,18,0
2020-12-03,UD,Armenia,23,6,0,0,17,8,9,17,0
2020-12-04,UD,Armenia,25,8,0,0,17,9,8,17,0
2020-12-05,UD,Armenia,26,3,0,0,23,11,12,23,0
2020-12-06,UD,Armenia,31,5,0,0,26,13,13,26,0
2020-12-07,UD,Armenia,30,5,0,0,25,13,12,25,0
2020-12-08,UD,Armenia,29,4,0,0,25,12,13,25,0
2020-12-09,UD,Armenia,17,4,0,0,13,6,7,13,0
2020-12-10,UD,Armenia,26,7,0,0,19,10,9,19,0
2020-12-11,UD,Armenia,33,9,0,0,24,12,12,24,0
2020-12-12,UD,Armenia,33,10,0,0,23,12,11,23,0
2020-12-13,UD,Armenia,30,5,0,0,25,12,13,25,0
2020-12-14,UD,Armenia,29,5,0,0,24,12,12,24,0
2020-12-15,UD,Armenia,33,3,0,0,30,15,15,30,0
2020-12-16,UD,Armenia,28,10,0,0,18,8,10,18,0
2020-12-17,UD,Armenia,29,9,0,0,20,9,11,20,0
2020-12-18,UD,Armenia,46,13,0,0,33,16,17,33,0
2020-12-19,UD,Armenia,38,10,1,1,28,14,13,27,0
2020-12-20,UD,Armenia,47,12,2,1,35,16,17,33,1
2020-12-21,UD,Armenia,40,15,1,1,25,13,11,24,0
2020-12-22,UD,Armenia,42,12,0,0,30,15,15,30,0
2020-12-23,UD,Armenia,27,12,0,0,15,8,7,15,0
2020-12-24,UD,Armenia,32,8,0,0,24,10,14,24,0
2020-12-25,UD,Armenia,44,14,0,0,30,16,14,30,0
2020-12-26,UD,Armenia,37,12,0,0,25,12,13,25,0
2020-12-27,UD,Armenia,52,10,0,0,42,21,21,42,0
2020-12-28,UD,Armenia,45,11,0,0,34,17,17,34,0
2020-12-29,UD,Armenia,61,19,0,0,42,21,21,42,0
2020-12-30,UD,Armenia,43,11,0,0,32,15,17,32,0
2020-12-31,UD,Armenia,36,10,0,0,26,15,11,26,0
2020-01-01,LO,Austria,2413,1780,22,0,633,317,294,611,22
2020-01-02,LO,Austria,3132,2178,35,1,954,464,455,919,34
2020-01-03,LO,Austria,3190,2245,42,0,945,450,453,903,42
2020-01-04,LO,Austria,3315,2343,35,0,972,464,473,937,35
2020-01-05,LO,Austria,3315,2386,34,0,929,459,436,895,34
2020-01-06,LO,Austria,3087,2220,39,0,867,409,419,828,39
2020-01-07,LO,Austria,2839,2062,35,0,777,373,369,742,35
2020-01-08,LO,Austria,2898,1986,57,2,912,425,430,855,55
2020-01-09,LO,Austria,2992,2089,45,1,903,431,427,858,44
2020-01-10,LO,Austria,3233,2273,38,1,960,462,460,922,37
2020-01-11,LO,Austria,3068,2158,39,0,910,426,445,871,39
2020-01-12,LO,Austria,3211,2287,45,1,924,447,432,879,44
2020-01-13,LO,Austria,2901,2027,44,1,874,408,422,830,43
2020-01-14,LO,Austria,2607,1818,35,0,789,380,374,754,35
2020-01-15,LO,Austria,2778,1900,49,3,878,414,415,829,46
2020-01-16,LO,Austria,2865,1972,52,0,893,419,422,841,52
2020-01-17,LO,Austria,3168,2207,50,3,961,456,455,911,47
2020-01-18,LO,Austria,2942,2074,34,1,868,413,421,834,33
2020-01-19,LO,Austria,3025,2166,38,1,859,419,402,821,37
2020-01-20,LO,Austria,3036,2165,36,0,871,413,422,835,36
2020-01-21,LO,Austria,2683,1919,35,0,764,372,357,729,35
2020-01-22,LO,Austria,2976,2090,47,1,886,413,426,839,46
2020-01-23,LO,Austria,2963,2037,60,0,926,429,437,866,60
2020-01-24,LO,Austria,3319,2321,53,2,998,466,479,945,51
2020-01-25,LO,Austria,2946,2031,38,0,915,426,451,877,38
2020-01-26,LO,Austria,3010,2087,43,1,923,461,419,880,42
2020-01-27,LO,Austria,2966,2104,41,1,862,409,412,821,40
2020-01-28,LO,Austria,2556,1813,32,2,743,355,356,711,30
2020-01-29,LO,Austria,2742,1900,37,1,842,408,397,805,36
2020-01-30,LO,Austria,2798,1915,50,0,883,420,413,833,50
2020-01-31,LO,Austria,3136,2158,57,1,978,452,469,921,56
2020-02-01,LO,Austria,3019,2071,39,2,948,452,457,909,37
2020-02-02,LO,Austria,2936,2052,38,0,884,431,415,846,38
2020-02-03,LO,Austria,2875,1999,37,0,876,419,420,839,37
2020-02-04,LO,Austria,2545,1825,29,2,720,347,344,691,27
2020-02-05,LO,Austria,2735,1932,24,1,803,386,393,779,23
2020-02-06,LO,Austria,2963,2031,52,4,932,446,434,880,48
2020-02-07,LO,Austria,3292,2300,60,2,992,459,473,932,58
2020-02-08,LO,Austria,3128,2148,44,0,980,462,474,936,44
2020-02-09,LO,Austria,2901,2044,48,2,857,407,402,809,46
2020-02-10,LO,Austria,2597,1816,37,2,781,375,369,744,35
2020-02-11,LO,Austria,2642,1871,35,1,771,374,362,736,34
2020-02-12,LO,Austria,2899,2022,41,3,877,419,417,836,38
2020-02-13,LO,Austria,3018,2069,53,1,949,451,445,896,52
2020-02-14,LO,Austria,3358,2319,47,1,1039,484,508,992,46
2020-02-15,LO,Austria,3290,2242,47,0,1048,500,501,1001,47
2020-02-16,LO,Austria,3120,2182,44,1,938,461,433,894,43
2020-02-17,LO,Austria,3135,2184,49,2,951,448,454,902,47
2020-02-18,LO,Austria,2929,2081,49,3,848,407,392,799,46
2020-02-19,LO,Austria,2996,2080,42,0,916,437,437,874,42
2020-02-20,LO,Austria,3176,2177,63,3,999,462,474,936,60
2020-02-21,LO,Austria,3404,2343,52,4,1061,501,508,1009,48
2020-02-22,LO,Austria,3345,2269,47,2,1076,509,520,1029,45
2020-02-23,LO,Austria,3220,2232,40,1,988,481,467,948,39
2020-02-24,LO,Austria,3140,2176,47,3,964,458,459,917,44
2020-02-25,LO,Austria,2893,2014,45,4,879,424,410,834,41
2020-02-26,LO,Austria,2981,2072,35,0,909,436,438,874,35
2020-02-27,LO,Austria,3032,2096,45,1,936,450,441,891,44
2020-02-28,LO,Austria,3342,2300,54,2,1042,492,496,988,52
2020-02-29,LO,Austria,3317,2306,50,2,1011,477,484,961,48
2020-03-01,LO,Austria,3207,2252,41,0,955,467,447,914,41
2020-03-02,LO,Austria,3137,2196,49,1,941,438,454,892,48
2020-03-03,LO,Austria,2838,2008,36,0,830,401,393,794,36
2020-03-04,LO,Austria,3022,2095,44,0,927,441,442,883,44
2020-03-05,LO,Austria,3112,2155,48,2,957,452,457,909,46
2020-03-06,LO,Austria,3364,2344,52,5,1020,487,481,968,47
2020-03-07,LO,Austria,3210,2280,40,1,930,440,450,890,39
2020-03-08,LO,Austria,3093,2177,44,1,916,441,431,872,43
2020-03-09,LO,Austria,2860,2056,35,1,804,384,385,769,34
2020-03-10,LO,Austria,2451,1748,36,1,703,335,332,667,35
2020-03-11,LO,Austria,2460,1735,27,0,725,340,358,698,27
2020-03-12,LO,Austria,2527,1779,37,1,748,358,353,711,36
2020-03-13,LO,Austria,2742,1913,42,1,829,385,402,787,41
2020-03-14,LO,Austria,2473,1693,24,1,780,374,382,756,23
2020-03-15,LO,Austria,2336,1587,46,1,749,355,348,703,45
2020-03-16,LO,Austria,1992,1489,24,1,503,236,243,479,23
2020-03-17,LO,Austria,1504,1232,10,1,272,129,133,262,9
2020-03-18,LO,Austria,1473,1202,15,5,271,126,130,256,10
2020-03-19,LO,Austria,1200,1017,10,4,183,84,89,173,6
2020-03-20,LO,Austria,1269,1092,9,4,177,86,82,168,5
2020-03-21,LO,Austria,920,809,2,2,111,54,55,109,0
2020-03-22,LO,Austria,828,723,8,8,105,46,51,97,0
2020-03-23,LO,Austria,660,576,8,4,84,38,38,76,4
2020-03-24,LO,Austria,568,495,5,3,73,34,34,68,2
2020-03-25,LO,Austria,489,416,7,4,73,33,33,66,3
2020-03-26,LO,Austria,452,355,11,7,97,41,45,86,4
2020-03-27,LO,Austria,429,351,6,0,78,35,37,72,6
2020-03-28,LO,Austria,347,293,2,0,54,23,29,52,2
2020-03-29,LO,Austria,327,284,0,0,43,23,20,43,0
2020-03-30,LO,Austria,358,295,2,0,63,31,30,61,2
2020-03-31,LO,Austria,384,325,4,1,59,26,29,55,3
2020-04-01,LO,Austria,386,304,5,2,82,38,39,77,3
2020-04-02,LO,Austria,380,314,8,4,66,29,29,58,4
2020-04-03,LO,Austria,368,300,6,0,68,30,32,62,6
2020-04-04,LO,Austria,273,231,2,1,42,23,17,40,1
2020-04-05,LO,Austria,263,231,1,0,32,16,15,31,1
2020-04-06,LO,Austria,271,230,0,0,41,21,20,41,0
2020-04-07,LO,Austria,279,224,7,0,55,22,26,48,7
2020-04-08,LO,Austria,354,278,9,3,76,34,33,67,6
2020-04-09,LO,Austria,349,299,9,5,50,21,20,41,4
2020-04-10,LO,Austria,310,265,2,1,45,21,22,43,1
2020-04-11,LO,Austria,241,200,3,3,41,20,18,38,0
2020-04-12,LO,Austria,254,213,3,0,41,19,19,38,3
2020-04-13,LO,Austria,252,220,1,0,32,14,17,31,1
2020-04-14,LO,Austria,296,231,4,1,65,32,29,61,3
2020-04-15,LO,Austria,353,269,13,5,84,34,37,71,8
2020-04-16,LO,Austria,328,257,6,2,71,31,34,65,4
2020-04-17,LO,Austria,334,263,7,3,71,35,29,64,4
2020-04-18,LO,Austria,218,172,7,1,46,19,20,39,6
2020-04-19,LO,Austria,248,215,0,0,33,16,17,33,0
2020-04-20,LO,Austria,317,269,2,1,48,25,21,46,1
2020-04-21,LO,Austria,326,265,3,2,61,30,28,58,1
2020-04-22,LO,Austria,370,288,11,3,82,34,37,71,8
2020-04-23,LO,Austria,394,311,7,0,83,40,36,76,7
2020-04-24,LO,Austria,387,306,9,0,81,32,40,72,9
2020-04-25,LO,Austria,294,248,2,0,46,24,20,44,2
2020-04-26,LO,Austria,312,254,4,0,58,28,26,54,4
2020-04-27,LO,Austria,346,296,5,2,50,22,23,45,3
2020-04-28,LO,Austria,394,312,5,1,82,39,38,77,4
2020-04-29,LO,Austria,421,344,3,2,77,38,36,74,1
2020-04-30,LO,Austria,418,329,2,2,89,42,45,87,0
2020-05-01,LO,Austria,363,298,4,2,65,30,31,61,2
2020-05-02,LO,Austria,294,246,2,2,48,22,24,46,0
2020-05-03,LO,Austria,303,250,5,1,53,23,25,48,4
2020-05-04,LO,Austria,374,293,18,3,81,32,31,63,15
2020-05-05,LO,Austria,354,291,5,0,63,32,26,58,5
2020-05-06,LO,Austria,412,326,19,4,86,33,34,67,15
2020-05-07,LO,Austria,442,341,22,6,101,38,41,79,16
2020-05-08,LO,Austria,425,333,14,2,92,39,39,78,12
2020-05-09,LO,Austria,327,258,19,0,69,26,24,50,19
2020-05-10,LO,Austria,339,293,4,0,46,21,21,42,4
2020-05-11,LO,Austria,385,312,7,2,73,35,31,66,5
2020-05-12,LO,Austria,412,315,19,3,97,39,39,78,16
2020-05-13,LO,Austria,431,337,29,3,94,33,32,65,26
2020-05-14,LO,Austria,443,358,19,3,85,32,34,66,16
2020-05-15,LO,Austria,469,384,13,1,85,38,34,72,12
2020-05-16,LO,Austria,349,285,16,0,64,24,24,48,16
2020-05-17,LO,Austria,386,319,17,1,67,25,25,50,16
2020-05-18,LO,Austria,429,323,26,4,106,44,36,80,22
2020-05-19,LO,Austria,420,303,24,2,117,49,44,93,22
2020-05-20,LO,Austria,517,391,35,5,126,45,46,91,30
2020-05-21,LO,Austria,485,385,24,3,100,34,42,76,21
2020-05-22,LO,Austria,443,352,20,2,91,35,36,71,18
2020-05-23,LO,Austria,368,291,22,2,77,27,28,55,20
2020-05-24,LO,Austria,380,316,7,2,64,28,29,57,5
2020-05-25,LO,Austria,418,339,12,3,79,34,33,67,9
2020-05-26,LO,Austria,456,360,13,5,96,46,37,83,8
2020-05-27,LO,Austria,563,413,43,4,150,58,49,107,39
2020-05-28,LO,Austria,523,395,15,0,128,60,53,113,15
2020-05-29,LO,Austria,500,386,16,2,114,50,48,98,14
2020-05-30,LO,Austria,420,350,10,1,70,30,30,60,9
2020-05-31,LO,Austria,402,331,14,1,71,29,28,57,13
2020-06-01,LO,Austria,462,387,13,1,75,30,32,62,12
2020-06-02,LO,Austria,509,379,33,2,130,45,52,97,31
2020-06-03,LO,Austria,600,450,20,1,150,65,65,130,19
2020-06-04,LO,Austria,596,442,33,5,154,61,60,121,28
2020-06-05,LO,Austria,592,482,18,3,110,46,46,92,15
2020-06-06,LO,Austria,527,404,14,3,123,54,55,109,11
2020-06-07,LO,Austria,538,438,13,3,100,43,44,87,10
2020-06-08,LO,Austria,546,434,19,2,112,45,48,93,17
2020-06-09,LO,Austria,553,416,21,2,137,62,54,116,19
2020-06-10,LO,Austria,636,476,24,1,160,71,65,136,23
2020-06-11,LO,Austria,622,485,19,0,137,52,66,118,19
2020-06-12,LO,Austria,711,557,29,3,154,66,59,125,26
2020-06-13,LO,Austria,598,478,9,4,120,53,58,111,5
2020-06-14,LO,Austria,615,495,9,0,120,57,54,111,9
2020-06-15,LO,Austria,861,634,16,2,227,105,106,211,14
2020-06-16,LO,Austria,816,576,41,8,240,98,101,199,33
2020-06-17,LO,Austria,900,642,19,3,258,118,121,239,16
2020-06-18,LO,Austria,919,633,35,4,286,125,126,251,31
2020-06-19,LO,Austria,1012,721,31,5,291,135,125,260,26
2020-06-20,LO,Austria,811,628,10,0,183,92,81,173,10
2020-06-21,LO,Austria,858,635,12,1,223,105,106,211,11
2020-06-22,LO,Austria,929,681,23,2,248,112,113,225,21
2020-06-23,LO,Austria,880,631,37,2,249,103,109,212,35
2020-06-24,LO,Austria,1030,720,30,2,310,146,134,280,28
2020-06-25,LO,Austria,999,715,23,6,284,126,135,261,17
2020-06-26,LO,Austria,1133,857,25,2,276,131,120,251,23
2020-06-27,LO,Austria,968,769,14,0,199,91,94,185,14
2020-06-28,LO,Austria,1007,770,14,1,237,109,114,223,13
2020-06-29,LO,Austria,1021,771,15,1,250,117,118,235,14
2020-06-30,LO,Austria,1014,707,34,2,307,139,134,273,32
2020-07-01,LO,Austria,1640,1168,32,1,472,222,218,440,31
2020-07-02,LO,Austria,1615,1170,26,1,445,211,208,419,25
2020-07-03,LO,Austria,1812,1343,17,0,469,221,231,452,17
2020-07-04,LO,Austria,1737,1366,23,0,371,176,172,348,23
2020-07-05,LO,Austria,1762,1344,21,3,418,203,194,397,18
2020-07-06,LO,Austria,1713,1269,41,2,444,204,199,403,39
2020-07-07,LO,Austria,1522,1116,42,4,406,180,184,364,38
2020-07-08,LO,Austria,1647,1185,48,3,462,215,199,414,45
2020-07-09,LO,Austria,1638,1200,48,6,438,194,196,390,42
2020-07-10,LO,Austria,1939,1451,29,5,488,234,225,459,24
2020-07-11,LO,Austria,1792,1429,17,2,363,173,173,346,15
2020-07-12,LO,Austria,1846,1405,20,0,441,209,212,421,20
2020-07-13,LO,Austria,1708,1266,32,1,442,205,205,410,31
2020-07-14,LO,Austria,1605,1178,40,3,427,195,192,387,37
2020-07-15,LO,Austria,1757,1318,28,2,439,203,208,411,26
2020-07-16,LO,Austria,1844,1395,39,2,449,205,205,410,37
2020-07-17,LO,Austria,2024,1577,28,4,447,216,203,419,24
2020-07-18,LO,Austria,2083,1717,24,1,366,171,171,342,23
2020-07-19,LO,Austria,1994,1574,28,1,420,199,193,392,27
2020-07-20,LO,Austria,1911,1494,34,2,417,193,190,383,32
2020-07-21,LO,Austria,1719,1318,28,2,401,180,193,373,26
2020-07-22,LO,Austria,1793,1390,43,4,403,182,178,360,39
2020-07-23,LO,Austria,1875,1446,40,2,429,197,192,389,38
2020-07-24,LO,Austria,2037,1609,31,3,428,200,197,397,28
2020-07-25,LO,Austria,2203,1807,28,1,396,181,187,368,27
2020-07-26,LO,Austria,2019,1663,16,1,356,167,173,340,15
2020-07-27,LO,Austria,1839,1443,28,1,396,183,185,368,27
2020-07-28,LO,Austria,1737,1367,41,5,370,166,163,329,36
2020-07-29,LO,Austria,1803,1411,38,1,392,178,176,354,37
2020-07-30,LO,Austria,1875,1433,29,2,442,207,206,413,27
2020-07-31,LO,Austria,2180,1692,34,2,488,229,225,454,32
2020-08-01,LO,Austria,2613,2103,21,0,510,247,242,489,21
2020-08-02,LO,Austria,2483,1953,21,0,530,248,261,509,21
2020-08-03,LO,Austria,2206,1701,18,0,505,241,246,487,18
2020-08-04,LO,Austria,2012,1590,22,5,422,199,201,400,17
2020-08-05,LO,Austria,2209,1704,34,1,505,237,234,471,33
2020-08-06,LO,Austria,2231,1744,28,1,487,234,225,459,27
2020-08-07,LO,Austria,2459,1893,21,3,566,275,270,545,18
2020-08-08,LO,Austria,2593,2097,15,0,496,241,240,481,15
2020-08-09,LO,Austria,2506,1982,20,3,524,249,255,504,17
2020-08-10,LO,Austria,2317,1752,38,4,565,266,261,527,34
2020-08-11,LO,Austria,1982,1569,21,1,413,199,193,392,20
2020-08-12,LO,Austria,2172,1698,34,0,474,221,219,440,34
2020-08-13,LO,Austria,2102,1617,40,1,485,226,219,445,39
2020-08-14,LO,Austria,2483,1898,33,0,585,278,274,552,33
2020-08-15,LO,Austria,2664,2140,27,0,524,248,249,497,27
2020-08-16,LO,Austria,2577,2002,28,0,575,265,282,547,28
2020-08-17,LO,Austria,2264,1734,33,2,530,241,256,497,31
2020-08-18,LO,Austria,2051,1590,29,3,461,212,220,432,26
2020-08-19,LO,Austria,2187,1695,35,2,492,234,223,457,33
2020-08-20,LO,Austria,2278,1727,34,0,551,259,258,517,34
2020-08-21,LO,Austria,2530,1926,28,2,604,291,285,576,26
2020-08-22,LO,Austria,2625,2140,22,1,485,232,231,463,21
2020-08-23,LO,Austria,2592,2028,28,1,564,264,272,536,27
2020-08-24,LO,Austria,2344,1805,32,1,539,253,254,507,31
2020-08-25,LO,Austria,2094,1649,32,3,445,211,202,413,29
2020-08-26,LO,Austria,2186,1711,41,1,475,212,222,434,40
2020-08-27,LO,Austria,2301,1808,41,1,493,232,220,452,40
2020-08-28,LO,Austria,2608,2010,40,1,598,275,283,558,39
2020-08-29,LO,Austria,2685,2194,22,2,491,235,234,469,20
2020-08-30,LO,Austria,2601,2068,20,0,533,253,260,513,20
2020-08-31,LO,Austria,2414,1843,44,1,571,260,267,527,43
2020-09-01,LO,Austria,2050,1621,26,0,429,205,198,403,26
2020-09-02,LO,Austria,2177,1652,48,2,525,246,231,477,46
2020-09-03,LO,Austria,2202,1669,40,0,533,248,245,493,40
2020-09-04,LO,Austria,2488,1903,33,1,585,274,278,552,32
2020-09-05,LO,Austria,2614,2130,30,0,484,222,232,454,30
2020-09-06,LO,Austria,2496,1958,27,1,538,264,247,511,26
2020-09-07,LO,Austria,2229,1725,23,1,504,232,249,481,22
2020-09-08,LO,Austria,1895,1462,42,4,433,193,198,391,38
2020-09-09,LO,Austria,2044,1553,30,0,491,234,227,461,30
2020-09-10,LO,Austria,2063,1557,47,0,506,229,230,459,47
2020-09-11,LO,Austria,2425,1835,36,2,590,281,273,554,34
2020-09-12,LO,Austria,2413,1944,26,3,469,213,230,443,23
2020-09-13,LO,Austria,2393,1836,31,1,557,269,257,526,30
2020-09-14,LO,Austria,2060,1527,45,2,533,241,247,488,43
2020-09-15,LO,Austria,1869,1452,38,1,417,195,184,379,37
2020-09-16,LO,Austria,1977,1497,27,7,480,222,231,453,20
2020-09-17,LO,Austria,1955,1474,29,2,481,238,214,452,27
2020-09-18,LO,Austria,2315,1717,39,2,598,279,280,559,37
2020-09-19,LO,Austria,2284,1869,20,2,415,198,197,395,18
2020-09-20,LO,Austria,2277,1765,32,0,512,234,246,480,32
2020-09-21,LO,Austria,1986,1482,34,1,504,235,235,470,33
2020-09-22,LO,Austria,1728,1318,50,1,410,182,178,360,49
2020-09-23,LO,Austria,1912,1486,35,4,426,191,200,391,31
2020-09-24,LO,Austria,1872,1390,53,5,482,216,213,429,48
2020-09-25,LO,Austria,2213,1706,30,2,507,242,235,477,28
2020-09-26,LO,Austria,2168,1805,13,2,363,178,172,350,11
2020-09-27,LO,Austria,2110,1636,21,0,474,219,234,453,21
2020-09-28,LO,Austria,1947,1479,31,1,468,215,222,437,30
2020-09-29,LO,Austria,1630,1254,37,2,376,169,170,339,35
2020-09-30,LO,Austria,1860,1407,62,2,453,193,198,391,60
2020-10-01,LO,Austria,1823,1363,40,2,460,221,199,420,38
2020-10-02,LO,Austria,2154,1658,32,5,496,236,228,464,27
2020-10-03,LO,Austria,2087,1756,19,1,331,148,164,312,18
2020-10-04,LO,Austria,2007,1585,18,1,422,205,199,404,17
2020-10-05,LO,Austria,1839,1394,44,4,445,193,208,401,40
2020-10-06,LO,Austria,1478,1163,45,3,315,138,132,270,42
2020-10-07,LO,Austria,1641,1278,33,1,363,165,165,330,32
2020-10-08,LO,Austria,1689,1259,47,0,430,198,185,383,47
2020-10-09,LO,Austria,2081,1613,47,0,468,215,206,421,47
2020-10-10,LO,Austria,2134,1796,22,1,338,162,154,316,21
2020-10-11,LO,Austria,1993,1599,20,1,394,181,193,374,19
2020-10-12,LO,Austria,1787,1409,24,2,378,175,179,354,22
2020-10-13,LO,Austria,1427,1143,30,4,284,132,122,254,26
2020-10-14,LO,Austria,1600,1257,33,1,343,151,159,310,32
2020-10-15,LO,Austria,1371,1023,47,1,348,148,153,301,46
2020-10-16,LO,Austria,2064,1647,26,1,417,197,194,391,25
2020-10-17,LO,Austria,1999,1713,16,0,286,136,134,270,16
2020-10-18,LO,Austria,1874,1473,35,1,401,185,181,366,34
2020-10-19,LO,Austria,1658,1237,48,4,421,182,191,373,44
2020-10-20,LO,Austria,1341,1042,40,3,299,134,125,259,37
2020-10-21,LO,Austria,1419,1083,43,7,336,146,147,293,36
2020-10-22,LO,Austria,1481,1110,51,5,371,167,153,320,46
2020-10-23,LO,Austria,1898,1471,36,2,427,195,196,391,34
2020-10-24,LO,Austria,2029,1718,26,2,311,151,134,285,24
2020-10-25,LO,Austria,1776,1419,27,4,357,166,164,330,23
2020-10-26,LO,Austria,1410,1061,31,0,349,156,162,318,31
2020-10-27,LO,Austria,1135,895,17,3,240,112,111,223,14
2020-10-28,LO,Austria,1410,1077,37,2,333,150,146,296,35
2020-10-29,LO,Austria,1355,1029,24,0,326,154,148,302,24
2020-10-30,LO,Austria,1626,1264,26,3,362,169,167,336,23
2020-10-31,LO,Austria,1714,1423,35,1,291,129,127,256,34
2020-11-01,LO,Austria,1661,1327,28,0,334,152,154,306,28
2020-11-02,LO,Austria,1294,917,39,4,377,162,176,338,35
2020-11-03,LO,Austria,1011,776,29,2,235,104,102,206,27
2020-11-04,LO,Austria,1054,823,28,0,231,99,104,203,28
2020-11-05,LO,Austria,1134,847,39,2,287,127,121,248,37
2020-11-06,LO,Austria,1384,1054,44,2,330,145,141,286,42
2020-11-07,LO,Austria,1193,964,23,3,229,104,102,206,20
2020-11-08,LO,Austria,1329,1044,18,2,285,131,136,267,16
2020-11-09,LO,Austria,1055,766,30,2,289,128,131,259,28
2020-11-10,LO,Austria,867,692,21,1,175,77,77,154,20
2020-11-11,LO,Austria,994,751,25,0,243,108,110,218,25
2020-11-12,LO,Austria,1010,743,33,3,267,119,115,234,30
2020-11-13,LO,Austria,1173,910,27,2,263,118,118,236,25
2020-11-14,LO,Austria,980,787,27,4,193,83,83,166,23
2020-11-15,LO,Austria,1123,891,24,3,232,100,108,208,21
2020-11-16,LO,Austria,926,681,14,0,245,117,114,231,14
2020-11-17,LO,Austria,743,591,14,1,152,74,64,138,13
2020-11-18,LO,Austria,882,621,27,1,261,116,118,234,26
2020-11-19,LO,Austria,829,631,15,0,198,94,89,183,15
2020-11-20,LO,Austria,994,759,13,2,235,113,109,222,11
2020-11-21,LO,Austria,737,636,7,0,101,47,47,94,7
2020-11-22,LO,Austria,914,733,6,1,181,88,87,175,5
2020-11-23,LO,Austria,750,559,8,0,191,95,88,183,8
2020-11-24,LO,Austria,626,506,5,0,120,60,55,115,5
2020-11-25,LO,Austria,817,600,16,1,217,93,108,201,15
2020-11-26,LO,Austria,722,543,12,0,179,83,84,167,12
2020-11-27,LO,Austria,1012,781,22,3,231,107,102,209,19
2020-11-28,LO,Austria,762,659,5,0,103,49,49,98,5
2020-11-29,LO,Austria,874,698,7,0,176,84,85,169,7
2020-11-30,LO,Austria,839,615,26,2,224,102,96,198,24
2020-12-01,LO,Austria,663,523,19,0,140,63,58,121,19
2020-12-02,LO,Austria,842,630,16,2,212,98,98,196,14
2020-12-03,LO,Austria,843,663,8,0,180,90,82,172,8
2020-12-04,LO,Austria,1027,791,16,2,236,108,112,220,14
2020-12-05,LO,Austria,798,705,1,0,93,49,43,92,1
2020-12-06,LO,Austria,935,740,12,1,195,91,92,183,11
2020-12-07,LO,Austria,863,627,17,0,236,111,108,219,17
2020-12-08,LO,Austria,672,554,18,2,118,45,55,100,16
2020-12-09,LO,Austria,902,681,12,0,221,100,109,209,12
2020-12-10,LO,Austria,963,751,13,0,212,106,93,199,13
2020-12-11,LO,Austria,1186,881,35,1,305,131,139,270,34
2020-12-12,LO,Austria,945,802,19,4,143,63,61,124,15
2020-12-13,LO,Austria,1059,838,13,1,221,99,109,208,12
2020-12-14,LO,Austria,956,714,27,1,242,106,109,215,26
2020-12-15,LO,Austria,866,678,15,0,188,88,85,173,15
2020-12-16,LO,Austria,1066,790,26,5,276,119,131,250,21
2020-12-17,LO,Austria,1261,970,33,4,291,140,118,258,29
2020-12-18,LO,Austria,1632,1232,23,2,400,189,188,377,21
2020-12-19,LO,Austria,1608,1275,15,2,333,163,155,318,13
2020-12-20,LO,Austria,1498,1201,24,1,297,134,139,273,23
2020-12-21,LO,Austria,1237,914,33,0,323,147,143,290,33
2020-12-22,LO,Austria,948,778,18,2,170,74,78,152,16
2020-12-23,LO,Austria,1303,954,51,4,349,143,155,298,47
2020-12-24,LO,Austria,897,793,6,0,104,48,50,98,6
2020-12-25,LO,Austria,658,524,4,0,134,71,59,130,4
2020-12-26,LO,Austria,965,788,23,0,177,82,72,154,23
2020-12-27,LO,Austria,1223,952,26,2,271,121,124,245,24
2020-12-28,LO,Austria,1006,743,27,3,263,118,118,236,24
2020-12-29,LO,Austria,802,648,32,3,154,62,60,122,29
2020-12-30,LO,Austria,1024,785,13,3,239,108,118,226,10
2020-12-31,LO,Austria,625,533,27,5,92,33,32,65,22
2020-01-01,EB,Belgium and Luxembourg,2428,1735,3,0,693,349,341,690,3
2020-01-02,EB,Belgium and Luxembourg,3019,2023,12,11,996,482,502,984,1
2020-01-03,EB,Belgium and Luxembourg,3127,2127,15,10,1000,498,487,985,5
2020-01-04,EB,Belgium and Luxembourg,2866,2067,10,6,799,390,399,789,4
2020-01-05,EB,Belgium and Luxembourg,3072,2068,13,3,1004,500,491,991,10
2020-01-06,EB,Belgium and Luxembourg,3079,2035,11,6,1044,513,520,1033,5
2020-01-07,EB,Belgium and Luxembourg,2866,1802,23,17,1064,522,519,1041,6
2020-01-08,EB,Belgium and Luxembourg,2760,1723,17,12,1037,511,509,1020,5
2020-01-09,EB,Belgium and Luxembourg,2900,1847,6,4,1053,520,527,1047,2
2020-01-10,EB,Belgium and Luxembourg,3051,1931,13,6,1120,566,541,1107,7
2020-01-11,EB,Belgium and Luxembourg,2524,1810,7,6,714,351,356,707,1
2020-01-12,EB,Belgium and Luxembourg,2755,1846,8,2,909,451,450,901,6
2020-01-13,EB,Belgium and Luxembourg,2953,1864,24,15,1089,520,545,1065,9
2020-01-14,EB,Belgium and Luxembourg,2533,1551,11,3,982,488,483,971,8
2020-01-15,EB,Belgium and Luxembourg,2740,1670,20,8,1070,530,520,1050,12
2020-01-16,EB,Belgium and Luxembourg,2907,1786,20,9,1121,548,553,1101,11
2020-01-17,EB,Belgium and Luxembourg,3092,1954,25,13,1138,575,538,1113,12
2020-01-18,EB,Belgium and Luxembourg,2486,1763,7,2,723,352,364,716,5
2020-01-19,EB,Belgium and Luxembourg,2690,1773,6,0,917,452,459,911,6
2020-01-20,EB,Belgium and Luxembourg,2990,1869,19,7,1121,541,561,1102,12
2020-01-21,EB,Belgium and Luxembourg,2686,1657,10,3,1029,510,509,1019,7
2020-01-22,EB,Belgium and Luxembourg,2816,1755,22,8,1061,525,514,1039,14
2020-01-23,EB,Belgium and Luxembourg,2998,1898,7,4,1100,545,548,1093,3
2020-01-24,EB,Belgium and Luxembourg,3152,2016,9,3,1136,577,550,1127,6
2020-01-25,EB,Belgium and Luxembourg,2541,1806,4,2,735,365,366,731,2
2020-01-26,EB,Belgium and Luxembourg,2742,1828,8,1,914,448,458,906,7
2020-01-27,EB,Belgium and Luxembourg,2950,1852,10,6,1098,525,563,1088,4
2020-01-28,EB,Belgium and Luxembourg,2541,1533,21,10,1008,499,488,987,11
2020-01-29,EB,Belgium and Luxembourg,2771,1720,16,9,1051,512,523,1035,7
2020-01-30,EB,Belgium and Luxembourg,2928,1850,20,8,1078,526,532,1058,12
2020-01-31,EB,Belgium and Luxembourg,3061,1936,18,7,1125,566,541,1107,11
2020-02-01,EB,Belgium and Luxembourg,2531,1825,6,3,706,350,350,700,3
2020-02-02,EB,Belgium and Luxembourg,2728,1824,7,2,904,450,447,897,5
2020-02-03,EB,Belgium and Luxembourg,2949,1858,16,7,1091,526,549,1075,9
2020-02-04,EB,Belgium and Luxembourg,2661,1641,17,13,1020,500,503,1003,4
2020-02-05,EB,Belgium and Luxembourg,2884,1799,16,11,1085,534,535,1069,5
2020-02-06,EB,Belgium and Luxembourg,2962,1840,38,19,1122,542,542,1084,19
2020-02-07,EB,Belgium and Luxembourg,3194,2029,20,10,1165,585,560,1145,10
2020-02-08,EB,Belgium and Luxembourg,2696,1931,9,4,765,380,376,756,5
2020-02-09,EB,Belgium and Luxembourg,2293,1535,2,0,758,373,383,756,2
2020-02-10,EB,Belgium and Luxembourg,2646,1663,9,1,983,482,492,974,8
2020-02-11,EB,Belgium and Luxembourg,2658,1636,9,4,1022,501,512,1013,5
2020-02-12,EB,Belgium and Luxembourg,2925,1795,22,17,1130,559,549,1108,5
2020-02-13,EB,Belgium and Luxembourg,3066,1918,9,5,1148,568,571,1139,4
2020-02-14,EB,Belgium and Luxembourg,3218,2038,22,16,1180,591,567,1158,6
2020-02-15,EB,Belgium and Luxembourg,2832,2042,9,6,790,388,393,781,3
2020-02-16,EB,Belgium and Luxembourg,2819,1886,3,0,933,460,470,930,3
2020-02-17,EB,Belgium and Luxembourg,3075,1907,16,8,1168,567,585,1152,8
2020-02-18,EB,Belgium and Luxembourg,2845,1802,11,7,1043,518,514,1032,4
2020-02-19,EB,Belgium and Luxembourg,2992,1861,16,13,1131,563,552,1115,3
2020-02-20,EB,Belgium and Luxembourg,3032,1897,20,5,1135,544,571,1115,15
2020-02-21,EB,Belgium and Luxembourg,3230,1993,20,11,1237,625,592,1217,9
2020-02-22,EB,Belgium and Luxembourg,2901,2052,9,2,849,415,425,840,7
2020-02-23,EB,Belgium and Luxembourg,2973,1970,12,5,1003,503,488,991,7
2020-02-24,EB,Belgium and Luxembourg,3112,1983,12,5,1129,543,574,1117,7
2020-02-25,EB,Belgium and Luxembourg,2904,1834,18,9,1070,529,523,1052,9
2020-02-26,EB,Belgium and Luxembourg,2921,1818,10,3,1103,545,548,1093,7
2020-02-27,EB,Belgium and Luxembourg,3009,1932,11,3,1077,533,533,1066,8
2020-02-28,EB,Belgium and Luxembourg,3225,2038,13,7,1187,598,576,1174,6
2020-02-29,EB,Belgium and Luxembourg,2854,2018,9,2,836,411,416,827,7
2020-03-01,EB,Belgium and Luxembourg,2998,1966,11,2,1032,512,509,1021,9
2020-03-02,EB,Belgium and Luxembourg,3055,1908,15,8,1147,556,576,1132,7
2020-03-03,EB,Belgium and Luxembourg,2846,1740,16,10,1106,545,545,1090,6
2020-03-04,EB,Belgium and Luxembourg,3005,1855,34,13,1150,560,556,1116,21
2020-03-05,EB,Belgium and Luxembourg,3085,1958,17,6,1127,551,559,1110,11
2020-03-06,EB,Belgium and Luxembourg,3254,2109,10,6,1145,581,554,1135,4
2020-03-07,EB,Belgium and Luxembourg,2681,1907,15,6,774,378,381,759,9
2020-03-08,EB,Belgium and Luxembourg,2985,2062,7,2,923,461,455,916,5
2020-03-09,EB,Belgium and Luxembourg,2863,1826,16,14,1037,502,519,1021,2
2020-03-10,EB,Belgium and Luxembourg,2584,1678,16,2,906,445,445,890,14
2020-03-11,EB,Belgium and Luxembourg,2705,1722,14,4,983,487,482,969,10
2020-03-12,EB,Belgium and Luxembourg,2791,1792,13,7,999,486,500,986,6
2020-03-13,EB,Belgium and Luxembourg,2938,1873,21,5,1065,533,511,1044,16
2020-03-14,EB,Belgium and Luxembourg,2418,1711,6,2,707,349,352,701,4
2020-03-15,EB,Belgium and Luxembourg,2595,1811,7,2,784,390,387,777,5
2020-03-16,EB,Belgium and Luxembourg,2374,1582,16,7,792,371,405,776,9
2020-03-17,EB,Belgium and Luxembourg,2013,1311,15,6,702,338,349,687,9
2020-03-18,EB,Belgium and Luxembourg,1847,1221,4,2,626,316,306,622,2
2020-03-19,EB,Belgium and Luxembourg,1790,1223,5,2,567,279,283,562,3
2020-03-20,EB,Belgium and Luxembourg,1678,1114,3,2,564,288,273,561,1
2020-03-21,EB,Belgium and Luxembourg,1328,1000,8,2,328,161,159,320,6
2020-03-22,EB,Belgium and Luxembourg,1067,732,5,5,335,166,164,330,0
2020-03-23,EB,Belgium and Luxembourg,840,515,10,6,325,143,172,315,4
2020-03-24,EB,Belgium and Luxembourg,832,474,9,5,358,179,170,349,4
2020-03-25,EB,Belgium and Luxembourg,727,441,11,8,286,133,142,275,3
2020-03-26,EB,Belgium and Luxembourg,726,439,14,12,287,138,135,273,2
2020-03-27,EB,Belgium and Luxembourg,693,393,10,10,300,151,139,290,0
2020-03-28,EB,Belgium and Luxembourg,462,292,0,0,170,85,85,170,0
2020-03-29,EB,Belgium and Luxembourg,445,276,0,0,169,92,77,169,0
2020-03-30,EB,Belgium and Luxembourg,497,276,3,3,221,93,125,218,0
2020-03-31,EB,Belgium and Luxembourg,565,308,4,2,257,135,118,253,2
2020-04-01,EB,Belgium and Luxembourg,527,278,13,11,249,116,120,236,2
2020-04-02,EB,Belgium and Luxembourg,548,287,12,9,261,122,127,249,3
2020-04-03,EB,Belgium and Luxembourg,484,257,3,2,227,122,102,224,1
2020-04-04,EB,Belgium and Luxembourg,368,238,2,2,130,65,63,128,0
2020-04-05,EB,Belgium and Luxembourg,330,176,2,2,154,76,76,152,0
2020-04-06,EB,Belgium and Luxembourg,419,213,5,2,206,89,112,201,3
2020-04-07,EB,Belgium and Luxembourg,438,222,2,2,216,110,104,214,0
2020-04-08,EB,Belgium and Luxembourg,468,236,9,9,232,111,112,223,0
2020-04-09,EB,Belgium and Luxembourg,488,252,5,5,236,114,117,231,0
2020-04-10,EB,Belgium and Luxembourg,376,180,3,2,196,102,91,193,1
2020-04-11,EB,Belgium and Luxembourg,292,150,2,2,142,77,63,140,0
2020-04-12,EB,Belgium and Luxembourg,301,159,0,0,142,70,72,142,0
2020-04-13,EB,Belgium and Luxembourg,293,156,6,4,137,65,66,131,2
2020-04-14,EB,Belgium and Luxembourg,422,204,5,4,218,102,111,213,1
2020-04-15,EB,Belgium and Luxembourg,477,231,2,2,246,121,123,244,0
2020-04-16,EB,Belgium and Luxembourg,483,241,6,5,242,116,120,236,1
2020-04-17,EB,Belgium and Luxembourg,448,229,4,2,219,118,97,215,2
2020-04-18,EB,Belgium and Luxembourg,314,185,0,0,129,64,65,129,0
2020-04-19,EB,Belgium and Luxembourg,346,198,2,1,148,74,72,146,1
2020-04-20,EB,Belgium and Luxembourg,418,207,2,1,211,92,117,209,1
2020-04-21,EB,Belgium and Luxembourg,484,227,5,3,257,131,121,252,2
2020-04-22,EB,Belgium and Luxembourg,498,264,2,2,234,114,118,232,0
2020-04-23,EB,Belgium and Luxembourg,539,274,8,6,265,126,131,257,2
2020-04-24,EB,Belgium and Luxembourg,478,249,6,5,229,120,103,223,1
2020-04-25,EB,Belgium and Luxembourg,360,225,0,0,135,67,68,135,0
2020-04-26,EB,Belgium and Luxembourg,384,219,1,0,165,86,78,164,1
2020-04-27,EB,Belgium and Luxembourg,415,206,7,3,209,87,115,202,4
2020-04-28,EB,Belgium and Luxembourg,519,265,6,6,254,128,120,248,0
2020-04-29,EB,Belgium and Luxembourg,518,262,11,5,256,121,124,245,6
2020-04-30,EB,Belgium and Luxembourg,535,282,5,1,253,122,126,248,4
2020-05-01,EB,Belgium and Luxembourg,416,220,2,0,196,103,91,194,2
2020-05-02,EB,Belgium and Luxembourg,337,205,1,0,132,69,62,131,1
2020-05-03,EB,Belgium and Luxembourg,388,220,1,0,168,88,79,167,1
2020-05-04,EB,Belgium and Luxembourg,461,237,5,3,224,93,126,219,2
2020-05-05,EB,Belgium and Luxembourg,545,265,4,4,280,139,137,276,0
2020-05-06,EB,Belgium and Luxembourg,557,278,4,3,279,135,140,275,1
2020-05-07,EB,Belgium and Luxembourg,609,308,8,5,301,147,146,293,3
2020-05-08,EB,Belgium and Luxembourg,517,255,12,6,262,131,119,250,6
2020-05-09,EB,Belgium and Luxembourg,383,215,3,0,168,88,77,165,3
2020-05-10,EB,Belgium and Luxembourg,411,244,2,0,167,86,79,165,2
2020-05-11,EB,Belgium and Luxembourg,502,259,5,4,243,103,135,238,1
2020-05-12,EB,Belgium and Luxembourg,607,298,20,16,309,151,138,289,4
2020-05-13,EB,Belgium and Luxembourg,598,307,14,8,291,135,142,277,6
2020-05-14,EB,Belgium and Luxembourg,627,319,12,8,308,147,149,296,4
2020-05-15,EB,Belgium and Luxembourg,620,307,14,12,313,156,143,299,2
2020-05-16,EB,Belgium and Luxembourg,437,258,6,5,179,89,84,173,1
2020-05-17,EB,Belgium and Luxembourg,436,243,4,1,193,97,92,189,3
2020-05-18,EB,Belgium and Luxembourg,539,297,12,8,242,105,125,230,4
2020-05-19,EB,Belgium and Luxembourg,624,314,12,8,310,147,151,298,4
2020-05-20,EB,Belgium and Luxembourg,625,324,12,10,301,146,143,289,2
2020-05-21,EB,Belgium and Luxembourg,591,309,8,6,282,138,136,274,2
2020-05-22,EB,Belgium and Luxembourg,589,304,30,20,285,132,123,255,10
2020-05-23,EB,Belgium and Luxembourg,451,282,6,2,169,87,76,163,4
2020-05-24,EB,Belgium and Luxembourg,502,300,3,3,202,105,94,199,0
2020-05-25,EB,Belgium and Luxembourg,555,310,10,2,245,104,131,235,8
2020-05-26,EB,Belgium and Luxembourg,642,331,16,12,311,143,152,295,4
2020-05-27,EB,Belgium and Luxembourg,662,343,15,10,319,153,151,304,5
2020-05-28,EB,Belgium and Luxembourg,639,310,18,8,329,158,153,311,10
2020-05-29,EB,Belgium and Luxembourg,610,309,16,12,301,149,136,285,4
2020-05-30,EB,Belgium and Luxembourg,456,254,15,14,202,93,94,187,1
2020-05-31,EB,Belgium and Luxembourg,471,273,4,3,198,95,99,194,1
2020-06-01,EB,Belgium and Luxembourg,532,277,4,2,255,114,137,251,2
2020-06-02,EB,Belgium and Luxembourg,645,333,15,4,312,155,142,297,11
2020-06-03,EB,Belgium and Luxembourg,654,324,14,10,330,156,160,316,4
2020-06-04,EB,Belgium and Luxembourg,709,375,15,12,334,159,160,319,3
2020-06-05,EB,Belgium and Luxembourg,695,396,15,13,299,149,135,284,2
2020-06-06,EB,Belgium and Luxembourg,494,288,9,7,206,101,96,197,2
2020-06-07,EB,Belgium and Luxembourg,554,317,5,2,237,117,115,232,3
2020-06-08,EB,Belgium and Luxembourg,627,339,14,9,288,121,153,274,5
2020-06-09,EB,Belgium and Luxembourg,665,340,23,8,325,153,149,302,15
2020-06-10,EB,Belgium and Luxembourg,664,341,21,11,323,151,151,302,10
2020-06-11,EB,Belgium and Luxembourg,689,346,15,11,343,161,167,328,4
2020-06-12,EB,Belgium and Luxembourg,693,352,21,10,341,169,151,320,11
2020-06-13,EB,Belgium and Luxembourg,469,284,14,4,185,95,76,171,10
2020-06-14,EB,Belgium and Luxembourg,547,330,13,1,217,97,107,204,12
2020-06-15,EB,Belgium and Luxembourg,786,402,12,6,384,178,194,372,6
2020-06-16,EB,Belgium and Luxembourg,789,369,15,5,420,208,197,405,10
2020-06-17,EB,Belgium and Luxembourg,821,404,17,7,417,196,204,400,10
2020-06-18,EB,Belgium and Luxembourg,847,426,25,16,421,201,195,396,9
2020-06-19,EB,Belgium and Luxembourg,904,440,26,16,464,228,210,438,10
2020-06-20,EB,Belgium and Luxembourg,644,369,15,8,275,137,123,260,7
2020-06-21,EB,Belgium and Luxembourg,746,408,6,0,338,162,170,332,6
2020-06-22,EB,Belgium and Luxembourg,873,435,20,7,438,190,228,418,13
2020-06-23,EB,Belgium and Luxembourg,892,436,17,11,456,224,215,439,6
2020-06-24,EB,Belgium and Luxembourg,977,495,20,9,482,231,231,462,11
2020-06-25,EB,Belgium and Luxembourg,965,504,19,14,461,225,217,442,5
2020-06-26,EB,Belgium and Luxembourg,966,501,15,9,465,230,220,450,6
2020-06-27,EB,Belgium and Luxembourg,713,408,8,4,305,155,142,297,4
2020-06-28,EB,Belgium and Luxembourg,810,464,7,2,346,159,180,339,5
2020-06-29,EB,Belgium and Luxembourg,958,492,16,5,466,209,241,450,11
2020-06-30,EB,Belgium and Luxembourg,1001,506,21,9,495,241,233,474,12
2020-07-01,EB,Belgium and Luxembourg,1398,733,23,7,665,326,316,642,16
2020-07-02,EB,Belgium and Luxembourg,1391,767,18,13,624,302,304,606,5
2020-07-03,EB,Belgium and Luxembourg,1431,797,20,12,634,316,298,614,8
2020-07-04,EB,Belgium and Luxembourg,1232,754,7,4,478,246,225,471,3
2020-07-05,EB,Belgium and Luxembourg,1259,755,3,2,504,245,256,501,1
2020-07-06,EB,Belgium and Luxembourg,1374,777,21,12,597,274,302,576,9
2020-07-07,EB,Belgium and Luxembourg,1323,744,15,3,579,285,279,564,12
2020-07-08,EB,Belgium and Luxembourg,1412,764,24,13,648,314,310,624,11
2020-07-09,EB,Belgium and Luxembourg,1437,801,23,10,636,304,309,613,13
2020-07-10,EB,Belgium and Luxembourg,1546,872,14,9,674,343,317,660,5
2020-07-11,EB,Belgium and Luxembourg,1350,826,17,8,524,257,250,507,9
2020-07-12,EB,Belgium and Luxembourg,1328,781,12,0,547,265,270,535,12
2020-07-13,EB,Belgium and Luxembourg,1435,814,19,11,621,280,322,602,8
2020-07-14,EB,Belgium and Luxembourg,1362,751,19,7,611,304,288,592,12
2020-07-15,EB,Belgium and Luxembourg,1561,891,30,15,670,321,319,640,15
2020-07-16,EB,Belgium and Luxembourg,1605,930,15,8,675,321,339,660,7
2020-07-17,EB,Belgium and Luxembourg,1670,961,11,5,709,356,342,698,6
2020-07-18,EB,Belgium and Luxembourg,1509,952,13,5,557,282,262,544,8
2020-07-19,EB,Belgium and Luxembourg,1554,979,5,0,575,281,289,570,5
2020-07-20,EB,Belgium and Luxembourg,1569,939,16,12,630,298,316,614,4
2020-07-21,EB,Belgium and Luxembourg,1508,875,11,7,633,318,304,622,4
2020-07-22,EB,Belgium and Luxembourg,1583,952,14,5,631,313,304,617,9
2020-07-23,EB,Belgium and Luxembourg,1574,925,27,12,649,310,312,622,15
2020-07-24,EB,Belgium and Luxembourg,1697,994,16,12,703,347,340,687,4
2020-07-25,EB,Belgium and Luxembourg,1559,1025,13,5,534,268,253,521,8
2020-07-26,EB,Belgium and Luxembourg,1543,967,3,2,576,286,287,573,1
2020-07-27,EB,Belgium and Luxembourg,1536,926,18,11,610,280,312,592,7
2020-07-28,EB,Belgium and Luxembourg,1446,835,12,7,611,299,300,599,5
2020-07-29,EB,Belgium and Luxembourg,1544,919,11,7,625,312,302,614,4
2020-07-30,EB,Belgium and Luxembourg,1551,899,26,12,652,308,318,626,14
2020-07-31,EB,Belgium and Luxembourg,1769,1046,19,5,723,350,354,704,14
2020-08-01,EB,Belgium and Luxembourg,1738,1143,9,2,595,310,276,586,7
2020-08-02,EB,Belgium and Luxembourg,1742,1127,2,1,615,302,311,613,1
2020-08-03,EB,Belgium and Luxembourg,1756,1101,10,2,655,309,336,645,8
2020-08-04,EB,Belgium and Luxembourg,1675,1021,12,9,654,321,321,642,3
2020-08-05,EB,Belgium and Luxembourg,1793,1117,21,8,676,331,324,655,13
2020-08-06,EB,Belgium and Luxembourg,1743,1076,22,13,667,329,316,645,9
2020-08-07,EB,Belgium and Luxembourg,1874,1177,25,13,697,339,333,672,12
2020-08-08,EB,Belgium and Luxembourg,1790,1185,7,1,605,306,292,598,6
2020-08-09,EB,Belgium and Luxembourg,1843,1226,0,0,617,308,309,617,0
2020-08-10,EB,Belgium and Luxembourg,1788,1135,9,2,653,303,341,644,7
2020-08-11,EB,Belgium and Luxembourg,1606,1003,18,7,603,296,289,585,11
2020-08-12,EB,Belgium and Luxembourg,1729,1051,17,9,678,331,330,661,8
2020-08-13,EB,Belgium and Luxembourg,1735,1073,7,7,662,330,325,655,0
2020-08-14,EB,Belgium and Luxembourg,1875,1219,23,13,656,324,309,633,10
2020-08-15,EB,Belgium and Luxembourg,1788,1217,8,4,571,282,281,563,4
2020-08-16,EB,Belgium and Luxembourg,1817,1190,5,2,627,313,309,622,3
2020-08-17,EB,Belgium and Luxembourg,1768,1116,16,6,652,298,338,636,10
2020-08-18,EB,Belgium and Luxembourg,1583,967,11,5,616,307,298,605,6
2020-08-19,EB,Belgium and Luxembourg,1785,1144,20,9,641,311,310,621,11
2020-08-20,EB,Belgium and Luxembourg,1765,1079,17,8,686,333,336,669,9
2020-08-21,EB,Belgium and Luxembourg,1873,1201,21,11,672,331,320,651,10
2020-08-22,EB,Belgium and Luxembourg,1738,1182,9,4,556,281,266,547,5
2020-08-23,EB,Belgium and Luxembourg,1852,1224,12,3,628,300,316,616,9
2020-08-24,EB,Belgium and Luxembourg,1794,1119,16,8,675,314,345,659,8
2020-08-25,EB,Belgium and Luxembourg,1687,1059,20,12,628,316,292,608,8
2020-08-26,EB,Belgium and Luxembourg,1750,1090,11,3,660,321,328,649,8
2020-08-27,EB,Belgium and Luxembourg,1834,1097,24,9,737,355,358,713,15
2020-08-28,EB,Belgium and Luxembourg,1860,1165,18,8,695,341,336,677,10
2020-08-29,EB,Belgium and Luxembourg,1756,1181,12,4,575,288,275,563,8
2020-08-30,EB,Belgium and Luxembourg,1858,1217,4,0,641,317,320,637,4
2020-08-31,EB,Belgium and Luxembourg,1887,1176,19,7,711,327,365,692,12
2020-09-01,EB,Belgium and Luxembourg,1602,1040,16,10,562,289,257,546,6
2020-09-02,EB,Belgium and Luxembourg,1693,1086,14,8,607,296,297,593,6
2020-09-03,EB,Belgium and Luxembourg,1775,1147,21,8,628,305,302,607,13
2020-09-04,EB,Belgium and Luxembourg,1839,1196,21,11,643,318,304,622,10
2020-09-05,EB,Belgium and Luxembourg,1673,1149,9,5,524,260,255,515,4
2020-09-06,EB,Belgium and Luxembourg,1740,1151,8,0,589,288,293,581,8
2020-09-07,EB,Belgium and Luxembourg,1692,1083,13,7,609,284,312,596,6
2020-09-08,EB,Belgium and Luxembourg,1529,954,23,12,575,279,273,552,11
2020-09-09,EB,Belgium and Luxembourg,1649,1048,16,11,601,289,296,585,5
2020-09-10,EB,Belgium and Luxembourg,1659,1069,11,5,590,293,286,579,6
2020-09-11,EB,Belgium and Luxembourg,1821,1154,17,12,667,337,313,650,5
2020-09-12,EB,Belgium and Luxembourg,1523,1054,10,3,469,235,224,459,7
2020-09-13,EB,Belgium and Luxembourg,1725,1144,8,4,581,280,293,573,4
2020-09-14,EB,Belgium and Luxembourg,1624,1023,11,5,601,277,313,590,6
2020-09-15,EB,Belgium and Luxembourg,1503,955,13,5,548,270,265,535,8
2020-09-16,EB,Belgium and Luxembourg,1561,967,16,5,594,291,287,578,11
2020-09-17,EB,Belgium and Luxembourg,1581,975,22,12,606,300,284,584,10
2020-09-18,EB,Belgium and Luxembourg,1745,1084,9,5,661,336,316,652,4
2020-09-19,EB,Belgium and Luxembourg,1439,966,10,2,473,239,224,463,8
2020-09-20,EB,Belgium and Luxembourg,1573,1011,3,0,562,267,292,559,3
2020-09-21,EB,Belgium and Luxembourg,1549,908,25,9,641,293,323,616,16
2020-09-22,EB,Belgium and Luxembourg,1453,875,17,6,578,282,279,561,11
2020-09-23,EB,Belgium and Luxembourg,1592,1001,19,8,591,284,288,572,11
2020-09-24,EB,Belgium and Luxembourg,1531,935,19,3,596,293,284,577,16
2020-09-25,EB,Belgium and Luxembourg,1692,1024,17,8,668,336,315,651,9
2020-09-26,EB,Belgium and Luxembourg,1348,914,8,6,434,217,209,426,2
2020-09-27,EB,Belgium and Luxembourg,1499,958,12,4,541,263,266,529,8
2020-09-28,EB,Belgium and Luxembourg,1544,953,14,9,591,273,304,577,5
2020-09-29,EB,Belgium and Luxembourg,1421,844,29,14,577,278,270,548,15
2020-09-30,EB,Belgium and Luxembourg,1520,915,25,10,605,293,287,580,15
2020-10-01,EB,Belgium and Luxembourg,1495,867,17,5,628,295,316,611,12
2020-10-02,EB,Belgium and Luxembourg,1662,1000,18,7,662,341,303,644,11
2020-10-03,EB,Belgium and Luxembourg,1346,902,13,7,444,220,211,431,6
2020-10-04,EB,Belgium and Luxembourg,1422,907,5,4,515,253,257,510,1
2020-10-05,EB,Belgium and Luxembourg,1424,872,9,5,552,249,294,543,4
2020-10-06,EB,Belgium and Luxembourg,1177,714,8,4,463,233,222,455,4
2020-10-07,EB,Belgium and Luxembourg,1351,827,16,10,524,256,252,508,6
2020-10-08,EB,Belgium and Luxembourg,1373,809,14,1,564,278,272,550,13
2020-10-09,EB,Belgium and Luxembourg,1573,961,28,9,612,300,284,584,19
2020-10-10,EB,Belgium and Luxembourg,1331,914,10,6,417,208,199,407,4
2020-10-11,EB,Belgium and Luxembourg,1402,863,10,7,539,258,271,529,3
2020-10-12,EB,Belgium and Luxembourg,1387,827,21,8,560,259,280,539,13
2020-10-13,EB,Belgium and Luxembourg,1205,695,15,10,510,257,238,495,5
2020-10-14,EB,Belgium and Luxembourg,1338,803,23,13,535,256,256,512,10
2020-10-15,EB,Belgium and Luxembourg,1375,807,21,12,568,262,285,547,9
2020-10-16,EB,Belgium and Luxembourg,1563,925,20,10,638,327,291,618,10
2020-10-17,EB,Belgium and Luxembourg,1424,966,9,6,458,231,218,449,3
2020-10-18,EB,Belgium and Luxembourg,1428,904,15,6,524,254,255,509,9
2020-10-19,EB,Belgium and Luxembourg,1319,778,21,14,541,241,279,520,7
2020-10-20,EB,Belgium and Luxembourg,1149,646,21,12,503,247,235,482,9
2020-10-21,EB,Belgium and Luxembourg,1293,773,21,10,520,247,252,499,11
2020-10-22,EB,Belgium and Luxembourg,1369,794,28,11,575,270,277,547,17
2020-10-23,EB,Belgium and Luxembourg,1552,933,22,11,619,303,294,597,11
2020-10-24,EB,Belgium and Luxembourg,1356,909,12,4,447,222,213,435,8
2020-10-25,EB,Belgium and Luxembourg,1304,815,5,0,489,242,242,484,5
2020-10-26,EB,Belgium and Luxembourg,1309,775,20,7,534,244,270,514,13
2020-10-27,EB,Belgium and Luxembourg,1108,627,19,6,481,234,228,462,13
2020-10-28,EB,Belgium and Luxembourg,1234,716,7,3,518,250,261,511,4
2020-10-29,EB,Belgium and Luxembourg,1316,738,17,10,578,286,275,561,7
2020-10-30,EB,Belgium and Luxembourg,1512,844,16,8,668,334,318,652,8
2020-10-31,EB,Belgium and Luxembourg,1298,806,10,7,492,250,232,482,3
2020-11-01,EB,Belgium and Luxembourg,1294,773,2,1,521,258,261,519,1
2020-11-02,EB,Belgium and Luxembourg,1226,724,2,1,502,234,266,500,1
2020-11-03,EB,Belgium and Luxembourg,1088,605,4,2,483,241,238,479,2
2020-11-04,EB,Belgium and Luxembourg,1163,672,8,2,491,238,245,483,6
2020-11-05,EB,Belgium and Luxembourg,1173,665,11,3,508,251,246,497,8
2020-11-06,EB,Belgium and Luxembourg,1354,745,12,3,609,302,295,597,9
2020-11-07,EB,Belgium and Luxembourg,1125,680,13,5,445,227,205,432,8
2020-11-08,EB,Belgium and Luxembourg,1173,681,4,0,492,241,247,488,4
2020-11-09,EB,Belgium and Luxembourg,1075,596,8,2,479,215,256,471,6
2020-11-10,EB,Belgium and Luxembourg,907,493,7,1,414,215,192,407,6
2020-11-11,EB,Belgium and Luxembourg,967,539,8,3,428,202,218,420,5
2020-11-12,EB,Belgium and Luxembourg,1044,581,16,5,463,228,219,447,11
2020-11-13,EB,Belgium and Luxembourg,1154,635,9,1,519,261,249,510,8
2020-11-14,EB,Belgium and Luxembourg,879,531,3,1,348,179,166,345,2
2020-11-15,EB,Belgium and Luxembourg,1012,580,2,1,432,211,219,430,1
2020-11-16,EB,Belgium and Luxembourg,989,536,10,2,453,204,239,443,8
2020-11-17,EB,Belgium and Luxembourg,916,466,11,3,450,223,216,439,8
2020-11-18,EB,Belgium and Luxembourg,975,531,14,3,444,217,213,430,11
2020-11-19,EB,Belgium and Luxembourg,1015,556,1,1,459,228,230,458,0
2020-11-20,EB,Belgium and Luxembourg,1112,580,7,2,532,275,250,525,5
2020-11-21,EB,Belgium and Luxembourg,877,517,5,0,360,182,173,355,5
2020-11-22,EB,Belgium and Luxembourg,947,544,2,0,403,200,201,401,2
2020-11-23,EB,Belgium and Luxembourg,932,522,9,2,410,191,210,401,7
2020-11-24,EB,Belgium and Luxembourg,798,402,6,0,396,195,195,390,6
2020-11-25,EB,Belgium and Luxembourg,976,538,12,4,438,210,216,426,8
2020-11-26,EB,Belgium and Luxembourg,938,496,4,3,442,219,219,438,1
2020-11-27,EB,Belgium and Luxembourg,1090,599,10,5,491,252,229,481,5
2020-11-28,EB,Belgium and Luxembourg,860,502,8,3,358,184,166,350,5
2020-11-29,EB,Belgium and Luxembourg,903,512,2,2,391,190,199,389,0
2020-11-30,EB,Belgium and Luxembourg,947,516,6,1,431,196,229,425,5
2020-12-01,EB,Belgium and Luxembourg,897,474,4,1,423,214,205,419,3
2020-12-02,EB,Belgium and Luxembourg,1035,583,6,2,452,222,224,446,4
2020-12-03,EB,Belgium and Luxembourg,1049,545,3,1,504,249,252,501,2
2020-12-04,EB,Belgium and Luxembourg,1118,606,4,2,512,257,251,508,2
2020-12-05,EB,Belgium and Luxembourg,900,555,1,0,345,186,158,344,1
2020-12-06,EB,Belgium and Luxembourg,929,523,3,2,406,195,208,403,1
2020-12-07,EB,Belgium and Luxembourg,986,512,10,4,474,217,247,464,6
2020-12-08,EB,Belgium and Luxembourg,919,501,8,5,418,209,201,410,3
2020-12-09,EB,Belgium and Luxembourg,1067,568,15,4,499,237,247,484,11
2020-12-10,EB,Belgium and Luxembourg,1127,604,7,2,523,254,262,516,5
2020-12-11,EB,Belgium and Luxembourg,1232,641,11,2,591,303,277,580,9
2020-12-12,EB,Belgium and Luxembourg,1011,628,1,0,383,197,185,382,1
2020-12-13,EB,Belgium and Luxembourg,1023,587,3,1,436,214,219,433,2
2020-12-14,EB,Belgium and Luxembourg,1130,613,13,4,517,233,271,504,9
2020-12-15,EB,Belgium and Luxembourg,1052,570,5,2,482,247,230,477,3
2020-12-16,EB,Belgium and Luxembourg,1184,632,12,9,552,273,267,540,3
2020-12-17,EB,Belgium and Luxembourg,1424,797,11,3,627,310,306,616,8
2020-12-18,EB,Belgium and Luxembourg,1602,916,14,7,686,340,332,672,7
2020-12-19,EB,Belgium and Luxembourg,1491,951,7,3,540,272,261,533,4
2020-12-20,EB,Belgium and Luxembourg,1430,887,7,1,543,275,261,536,6
2020-12-21,EB,Belgium and Luxembourg,1256,716,5,2,540,250,285,535,3
2020-12-22,EB,Belgium and Luxembourg,1155,634,8,3,521,254,259,513,5
2020-12-23,EB,Belgium and Luxembourg,1366,752,10,1,614,303,301,604,9
2020-12-24,EB,Belgium and Luxembourg,1036,563,5,0,473,241,227,468,5
2020-12-25,EB,Belgium and Luxembourg,599,353,1,0,246,124,121,245,1
2020-12-26,EB,Belgium and Luxembourg,1101,647,4,0,454,229,221,450,4
2020-12-27,EB,Belgium and Luxembourg,1205,691,5,1,514,249,260,509,4
2020-12-28,EB,Belgium and Luxembourg,1079,607,3,1,472,225,244,469,2
2020-12-29,EB,Belgium and Luxembourg,1009,541,9,0,468,240,219,459,9
2020-12-30,EB,Belgium and Luxembourg,1203,670,2,0,533,261,270,531,2
2020-12-31,EB,Belgium and Luxembourg,806,433,3,2,373,194,176,370,1
2020-01-01,LQ,Bosnia-Herzegovina,701,669,0,0,32,16,16,32,0
2020-01-02,LQ,Bosnia-Herzegovina,861,829,0,0,32,15,17,32,0
2020-01-03,LQ,Bosnia-Herzegovina,896,844,3,0,52,25,24,49,3
2020-01-04,LQ,Bosnia-Herzegovina,977,938,0,0,39,20,19,39,0
2020-01-05,LQ,Bosnia-Herzegovina,929,887,0,0,42,20,22,42,0
2020-01-06,LQ,Bosnia-Herzegovina,893,852,1,0,41,21,19,40,1
2020-01-07,LQ,Bosnia-Herzegovina,768,727,0,0,41,20,21,41,0
2020-01-08,LQ,Bosnia-Herzegovina,766,727,0,0,39,20,19,39,0
2020-01-09,LQ,Bosnia-Herzegovina,772,735,0,0,37,19,18,37,0
2020-01-10,LQ,Bosnia-Herzegovina,826,785,2,0,41,19,20,39,2
2020-01-11,LQ,Bosnia-Herzegovina,915,878,0,0,37,19,18,37,0
2020-01-12,LQ,Bosnia-Herzegovina,906,870,0,0,36,17,19,36,0
2020-01-13,LQ,Bosnia-Herzegovina,825,794,2,0,31,15,14,29,2
2020-01-14,LQ,Bosnia-Herzegovina,759,712,0,0,47,22,25,47,0
2020-01-15,LQ,Bosnia-Herzegovina,746,709,0,0,37,19,18,37,0
2020-01-16,LQ,Bosnia-Herzegovina,757,731,0,0,26,13,13,26,0
2020-01-17,LQ,Bosnia-Herzegovina,785,759,0,0,26,14,12,26,0
2020-01-18,LQ,Bosnia-Herzegovina,850,811,0,0,39,19,20,39,0
2020-01-19,LQ,Bosnia-Herzegovina,848,812,1,0,36,17,18,35,1
2020-01-20,LQ,Bosnia-Herzegovina,785,745,1,0,40,20,19,39,1
2020-01-21,LQ,Bosnia-Herzegovina,727,684,0,0,43,21,22,43,0
2020-01-22,LQ,Bosnia-Herzegovina,721,682,0,0,39,20,19,39,0
2020-01-23,LQ,Bosnia-Herzegovina,738,701,0,0,37,19,18,37,0
2020-01-24,LQ,Bosnia-Herzegovina,793,756,0,0,37,18,19,37,0
2020-01-25,LQ,Bosnia-Herzegovina,842,809,0,0,33,17,16,33,0
2020-01-26,LQ,Bosnia-Herzegovina,818,791,0,0,27,13,14,27,0
2020-01-27,LQ,Bosnia-Herzegovina,778,747,2,0,31,16,13,29,2
2020-01-28,LQ,Bosnia-Herzegovina,711,662,0,0,49,23,26,49,0
2020-01-29,LQ,Bosnia-Herzegovina,706,666,0,0,40,20,20,40,0
2020-01-30,LQ,Bosnia-Herzegovina,749,713,0,0,36,18,18,36,0
2020-01-31,LQ,Bosnia-Herzegovina,880,843,0,0,37,18,19,37,0
2020-02-01,LQ,Bosnia-Herzegovina,864,822,0,0,42,21,21,42,0
2020-02-02,LQ,Bosnia-Herzegovina,847,811,0,0,36,18,18,36,0
2020-02-03,LQ,Bosnia-Herzegovina,788,750,0,0,38,19,19,38,0
2020-02-04,LQ,Bosnia-Herzegovina,726,682,2,0,44,21,21,42,2
2020-02-05,LQ,Bosnia-Herzegovina,719,680,0,0,39,20,19,39,0
2020-02-06,LQ,Bosnia-Herzegovina,753,717,0,0,36,18,18,36,0
2020-02-07,LQ,Bosnia-Herzegovina,884,837,0,0,47,24,23,47,0
2020-02-08,LQ,Bosnia-Herzegovina,904,867,0,0,37,19,18,37,0
2020-02-09,LQ,Bosnia-Herzegovina,847,814,0,0,33,16,17,33,0
2020-02-10,LQ,Bosnia-Herzegovina,762,721,0,0,41,21,20,41,0
2020-02-11,LQ,Bosnia-Herzegovina,717,684,0,0,33,16,17,33,0
2020-02-12,LQ,Bosnia-Herzegovina,720,683,2,0,37,18,17,35,2
2020-02-13,LQ,Bosnia-Herzegovina,721,687,2,0,34,15,17,32,2
2020-02-14,LQ,Bosnia-Herzegovina,827,780,0,0,47,24,23,47,0
2020-02-15,LQ,Bosnia-Herzegovina,889,850,0,0,39,20,19,39,0
2020-02-16,LQ,Bosnia-Herzegovina,902,871,0,0,31,15,16,31,0
2020-02-17,LQ,Bosnia-Herzegovina,794,757,0,0,37,19,18,37,0
2020-02-18,LQ,Bosnia-Herzegovina,751,709,0,0,42,20,22,42,0
2020-02-19,LQ,Bosnia-Herzegovina,757,715,2,0,42,21,19,40,2
2020-02-20,LQ,Bosnia-Herzegovina,789,758,0,0,31,15,16,31,0
2020-02-21,LQ,Bosnia-Herzegovina,867,827,0,0,40,20,20,40,0
2020-02-22,LQ,Bosnia-Herzegovina,960,920,0,0,40,20,20,40,0
2020-02-23,LQ,Bosnia-Herzegovina,944,908,0,0,36,18,18,36,0
2020-02-24,LQ,Bosnia-Herzegovina,810,767,0,0,43,22,21,43,0
2020-02-25,LQ,Bosnia-Herzegovina,732,690,0,0,42,21,21,42,0
2020-02-26,LQ,Bosnia-Herzegovina,767,730,0,0,37,19,18,37,0
2020-02-27,LQ,Bosnia-Herzegovina,762,728,0,0,34,17,17,34,0
2020-02-28,LQ,Bosnia-Herzegovina,870,827,0,0,43,21,22,43,0
2020-02-29,LQ,Bosnia-Herzegovina,916,880,0,0,36,18,18,36,0
2020-03-01,LQ,Bosnia-Herzegovina,864,833,0,0,31,15,16,31,0
2020-03-02,LQ,Bosnia-Herzegovina,784,742,0,0,42,22,20,42,0
2020-03-03,LQ,Bosnia-Herzegovina,737,697,0,0,40,19,21,40,0
2020-03-04,LQ,Bosnia-Herzegovina,705,666,0,0,39,20,19,39,0
2020-03-05,LQ,Bosnia-Herzegovina,705,672,0,0,33,16,17,33,0
2020-03-06,LQ,Bosnia-Herzegovina,779,731,0,0,48,24,24,48,0
2020-03-07,LQ,Bosnia-Herzegovina,798,764,0,0,34,17,17,34,0
2020-03-08,LQ,Bosnia-Herzegovina,769,734,0,0,35,17,18,35,0
2020-03-09,LQ,Bosnia-Herzegovina,651,608,0,0,43,22,21,43,0
2020-03-10,LQ,Bosnia-Herzegovina,611,571,2,0,40,19,19,38,2
2020-03-11,LQ,Bosnia-Herzegovina,635,602,0,0,33,17,16,33,0
2020-03-12,LQ,Bosnia-Herzegovina,603,572,0,0,31,15,16,31,0
2020-03-13,LQ,Bosnia-Herzegovina,621,577,0,0,44,23,21,44,0
2020-03-14,LQ,Bosnia-Herzegovina,591,557,0,0,34,17,17,34,0
2020-03-15,LQ,Bosnia-Herzegovina,614,585,0,0,29,15,14,29,0
2020-03-16,LQ,Bosnia-Herzegovina,553,521,0,0,32,17,15,32,0
2020-03-17,LQ,Bosnia-Herzegovina,457,435,0,0,22,11,11,22,0
2020-03-18,LQ,Bosnia-Herzegovina,472,454,0,0,18,9,9,18,0
2020-03-19,LQ,Bosnia-Herzegovina,413,401,0,0,12,6,6,12,0
2020-03-20,LQ,Bosnia-Herzegovina,389,377,0,0,12,6,6,12,0
2020-03-21,LQ,Bosnia-Herzegovina,290,284,0,0,6,3,3,6,0
2020-03-22,LQ,Bosnia-Herzegovina,196,190,0,0,6,3,3,6,0
2020-03-23,LQ,Bosnia-Herzegovina,160,146,0,0,14,7,7,14,0
2020-03-24,LQ,Bosnia-Herzegovina,160,150,0,0,10,5,5,10,0
2020-03-25,LQ,Bosnia-Herzegovina,122,112,0,0,10,5,5,10,0
2020-03-26,LQ,Bosnia-Herzegovina,97,89,0,0,8,4,4,8,0
2020-03-27,LQ,Bosnia-Herzegovina,114,100,0,0,14,7,7,14,0
2020-03-28,LQ,Bosnia-Herzegovina,104,101,1,1,3,1,1,2,0
2020-03-29,LQ,Bosnia-Herzegovina,83,77,0,0,6,3,3,6,0
2020-03-30,LQ,Bosnia-Herzegovina,73,67,0,0,6,3,3,6,0
2020-03-31,LQ,Bosnia-Herzegovina,93,87,0,0,6,3,3,6,0
2020-04-01,LQ,Bosnia-Herzegovina,102,94,0,0,8,4,4,8,0
2020-04-02,LQ,Bosnia-Herzegovina,98,91,0,0,7,3,4,7,0
2020-04-03,LQ,Bosnia-Herzegovina,104,95,0,0,9,4,5,9,0
2020-04-04,LQ,Bosnia-Herzegovina,77,75,0,0,2,1,1,2,0
2020-04-05,LQ,Bosnia-Herzegovina,79,75,0,0,4,2,2,4,0
2020-04-06,LQ,Bosnia-Herzegovina,78,70,0,0,8,4,4,8,0
2020-04-07,LQ,Bosnia-Herzegovina,78,72,0,0,6,3,3,6,0
2020-04-08,LQ,Bosnia-Herzegovina,101,91,0,0,10,5,5,10,0
2020-04-09,LQ,Bosnia-Herzegovina,96,76,0,0,20,10,10,20,0
2020-04-10,LQ,Bosnia-Herzegovina,73,60,0,0,13,6,7,13,0
2020-04-11,LQ,Bosnia-Herzegovina,69,67,0,0,2,1,1,2,0
2020-04-12,LQ,Bosnia-Herzegovina,50,50,0,0,0,0,0,0,0
2020-04-13,LQ,Bosnia-Herzegovina,76,71,0,0,5,3,2,5,0
2020-04-14,LQ,Bosnia-Herzegovina,64,57,0,0,7,4,3,7,0
2020-04-15,LQ,Bosnia-Herzegovina,88,74,0,0,14,6,8,14,0
2020-04-16,LQ,Bosnia-Herzegovina,81,67,1,0,14,7,6,13,1
2020-04-17,LQ,Bosnia-Herzegovina,79,68,0,0,11,6,5,11,0
2020-04-18,LQ,Bosnia-Herzegovina,75,72,0,0,3,1,2,3,0
2020-04-19,LQ,Bosnia-Herzegovina,56,56,0,0,0,0,0,0,0
2020-04-20,LQ,Bosnia-Herzegovina,73,67,0,0,6,3,3,6,0
2020-04-21,LQ,Bosnia-Herzegovina,82,70,0,0,12,6,6,12,0
2020-04-22,LQ,Bosnia-Herzegovina,92,86,0,0,6,3,3,6,0
2020-04-23,LQ,Bosnia-Herzegovina,118,101,3,1,17,7,7,14,2
2020-04-24,LQ,Bosnia-Herzegovina,95,90,0,0,5,3,2,5,0
2020-04-25,LQ,Bosnia-Herzegovina,86,83,0,0,3,1,2,3,0
2020-04-26,LQ,Bosnia-Herzegovina,73,72,0,0,1,0,1,1,0
2020-04-27,LQ,Bosnia-Herzegovina,95,84,0,0,11,6,5,11,0
2020-04-28,LQ,Bosnia-Herzegovina,104,95,0,0,9,4,5,9,0
2020-04-29,LQ,Bosnia-Herzegovina,107,99,0,0,8,4,4,8,0
2020-04-30,LQ,Bosnia-Herzegovina,105,101,0,0,4,2,2,4,0
2020-05-01,LQ,Bosnia-Herzegovina,111,105,0,0,6,3,3,6,0
2020-05-02,LQ,Bosnia-Herzegovina,109,109,0,0,0,0,0,0,0
2020-05-03,LQ,Bosnia-Herzegovina,86,84,0,0,2,1,1,2,0
2020-05-04,LQ,Bosnia-Herzegovina,99,85,0,0,14,7,7,14,0
2020-05-05,LQ,Bosnia-Herzegovina,94,90,0,0,4,2,2,4,0
2020-05-06,LQ,Bosnia-Herzegovina,101,93,0,0,8,4,4,8,0
2020-05-07,LQ,Bosnia-Herzegovina,108,100,4,0,8,2,2,4,4
2020-05-08,LQ,Bosnia-Herzegovina,109,99,0,0,10,5,5,10,0
2020-05-09,LQ,Bosnia-Herzegovina,107,103,0,0,4,2,2,4,0
2020-05-10,LQ,Bosnia-Herzegovina,77,75,0,0,2,1,1,2,0
2020-05-11,LQ,Bosnia-Herzegovina,117,108,0,0,9,5,4,9,0
2020-05-12,LQ,Bosnia-Herzegovina,113,107,0,0,6,3,3,6,0
2020-05-13,LQ,Bosnia-Herzegovina,103,96,0,0,7,3,4,7,0
2020-05-14,LQ,Bosnia-Herzegovina,115,100,0,0,15,7,8,15,0
2020-05-15,LQ,Bosnia-Herzegovina,122,112,0,0,10,5,5,10,0
2020-05-16,LQ,Bosnia-Herzegovina,107,105,0,0,2,1,1,2,0
2020-05-17,LQ,Bosnia-Herzegovina,89,89,0,0,0,0,0,0,0
2020-05-18,LQ,Bosnia-Herzegovina,123,109,2,0,14,6,6,12,2
2020-05-19,LQ,Bosnia-Herzegovina,94,84,0,0,10,5,5,10,0
2020-05-20,LQ,Bosnia-Herzegovina,135,129,2,0,6,2,2,4,2
2020-05-21,LQ,Bosnia-Herzegovina,141,126,3,2,15,6,6,12,1
2020-05-22,LQ,Bosnia-Herzegovina,134,126,2,1,8,3,3,6,1
2020-05-23,LQ,Bosnia-Herzegovina,134,134,0,0,0,0,0,0,0
2020-05-24,LQ,Bosnia-Herzegovina,108,108,0,0,0,0,0,0,0
2020-05-25,LQ,Bosnia-Herzegovina,106,100,0,0,6,3,3,6,0
2020-05-26,LQ,Bosnia-Herzegovina,147,132,2,0,15,7,6,13,2
2020-05-27,LQ,Bosnia-Herzegovina,138,131,0,0,7,3,4,7,0
2020-05-28,LQ,Bosnia-Herzegovina,142,134,0,0,8,4,4,8,0
2020-05-29,LQ,Bosnia-Herzegovina,114,108,0,0,6,3,3,6,0
2020-05-30,LQ,Bosnia-Herzegovina,138,136,0,0,2,1,1,2,0
2020-05-31,LQ,Bosnia-Herzegovina,120,118,0,0,2,0,2,2,0
2020-06-01,LQ,Bosnia-Herzegovina,135,126,0,0,9,5,4,9,0
2020-06-02,LQ,Bosnia-Herzegovina,140,114,0,0,26,13,13,26,0
2020-06-03,LQ,Bosnia-Herzegovina,156,127,0,0,29,14,15,29,0
2020-06-04,LQ,Bosnia-Herzegovina,148,141,0,0,7,3,4,7,0
2020-06-05,LQ,Bosnia-Herzegovina,172,151,0,0,21,11,10,21,0
2020-06-06,LQ,Bosnia-Herzegovina,169,157,0,0,12,6,6,12,0
2020-06-07,LQ,Bosnia-Herzegovina,165,149,0,0,16,8,8,16,0
2020-06-08,LQ,Bosnia-Herzegovina,161,145,0,0,16,9,7,16,0
2020-06-09,LQ,Bosnia-Herzegovina,160,139,0,0,21,10,11,21,0
2020-06-10,LQ,Bosnia-Herzegovina,175,150,0,0,25,12,13,25,0
2020-06-11,LQ,Bosnia-Herzegovina,191,173,0,0,18,10,8,18,0
2020-06-12,LQ,Bosnia-Herzegovina,185,171,0,0,14,7,7,14,0
2020-06-13,LQ,Bosnia-Herzegovina,189,172,0,0,17,8,9,17,0
2020-06-14,LQ,Bosnia-Herzegovina,183,167,0,0,16,8,8,16,0
2020-06-15,LQ,Bosnia-Herzegovina,226,206,0,0,20,10,10,20,0
2020-06-16,LQ,Bosnia-Herzegovina,216,188,0,0,28,14,14,28,0
2020-06-17,LQ,Bosnia-Herzegovina,239,210,0,0,29,14,15,29,0
2020-06-18,LQ,Bosnia-Herzegovina,207,195,0,0,12,6,6,12,0
2020-06-19,LQ,Bosnia-Herzegovina,268,236,0,0,32,17,15,32,0
2020-06-20,LQ,Bosnia-Herzegovina,258,242,0,0,16,8,8,16,0
2020-06-21,LQ,Bosnia-Herzegovina,236,217,0,0,19,9,10,19,0
2020-06-22,LQ,Bosnia-Herzegovina,225,204,0,0,21,10,11,21,0
2020-06-23,LQ,Bosnia-Herzegovina,234,204,0,0,30,15,15,30,0
2020-06-24,LQ,Bosnia-Herzegovina,246,212,0,0,34,17,17,34,0
2020-06-25,LQ,Bosnia-Herzegovina,243,233,0,0,10,5,5,10,0
2020-06-26,LQ,Bosnia-Herzegovina,313,287,0,0,26,13,13,26,0
2020-06-27,LQ,Bosnia-Herzegovina,340,326,0,0,14,7,7,14,0
2020-06-28,LQ,Bosnia-Herzegovina,347,321,0,0,26,13,13,26,0
2020-06-29,LQ,Bosnia-Herzegovina,315,292,0,0,23,12,11,23,0
2020-06-30,LQ,Bosnia-Herzegovina,330,301,0,0,29,14,15,29,0
2020-07-01,LQ,Bosnia-Herzegovina,570,539,0,0,31,16,15,31,0
2020-07-02,LQ,Bosnia-Herzegovina,573,542,0,0,31,16,15,31,0
2020-07-03,LQ,Bosnia-Herzegovina,651,622,0,0,29,14,15,29,0
2020-07-04,LQ,Bosnia-Herzegovina,717,700,0,0,17,9,8,17,0
2020-07-05,LQ,Bosnia-Herzegovina,658,631,0,0,27,13,14,27,0
2020-07-06,LQ,Bosnia-Herzegovina,571,541,0,0,30,14,16,30,0
2020-07-07,LQ,Bosnia-Herzegovina,562,532,2,0,30,14,14,28,2
2020-07-08,LQ,Bosnia-Herzegovina,582,543,0,0,39,19,20,39,0
2020-07-09,LQ,Bosnia-Herzegovina,599,568,0,0,31,16,15,31,0
2020-07-10,LQ,Bosnia-Herzegovina,731,693,0,0,38,19,19,38,0
2020-07-11,LQ,Bosnia-Herzegovina,739,719,0,0,20,10,10,20,0
2020-07-12,LQ,Bosnia-Herzegovina,685,653,0,0,32,16,16,32,0
2020-07-13,LQ,Bosnia-Herzegovina,605,570,0,0,35,18,17,35,0
2020-07-14,LQ,Bosnia-Herzegovina,540,502,0,0,38,18,20,38,0
2020-07-15,LQ,Bosnia-Herzegovina,627,585,1,0,42,21,20,41,1
2020-07-16,LQ,Bosnia-Herzegovina,562,539,0,0,23,12,11,23,0
2020-07-17,LQ,Bosnia-Herzegovina,691,656,0,0,35,18,17,35,0
2020-07-18,LQ,Bosnia-Herzegovina,804,786,0,0,18,9,9,18,0
2020-07-19,LQ,Bosnia-Herzegovina,689,668,0,0,21,10,11,21,0
2020-07-20,LQ,Bosnia-Herzegovina,631,605,0,0,26,13,13,26,0
2020-07-21,LQ,Bosnia-Herzegovina,621,593,0,0,28,14,14,28,0
2020-07-22,LQ,Bosnia-Herzegovina,621,597,0,0,24,12,12,24,0
2020-07-23,LQ,Bosnia-Herzegovina,634,613,0,0,21,11,10,21,0
2020-07-24,LQ,Bosnia-Herzegovina,783,743,0,0,40,19,21,40,0
2020-07-25,LQ,Bosnia-Herzegovina,899,880,0,0,19,10,9,19,0
2020-07-26,LQ,Bosnia-Herzegovina,760,740,0,0,20,10,10,20,0
2020-07-27,LQ,Bosnia-Herzegovina,636,604,0,0,32,16,16,32,0
2020-07-28,LQ,Bosnia-Herzegovina,663,645,0,0,18,9,9,18,0
2020-07-29,LQ,Bosnia-Herzegovina,681,652,1,1,29,14,14,28,0
2020-07-30,LQ,Bosnia-Herzegovina,636,620,0,0,16,8,8,16,0
2020-07-31,LQ,Bosnia-Herzegovina,765,729,0,0,36,18,18,36,0
2020-08-01,LQ,Bosnia-Herzegovina,1114,1090,1,1,24,12,11,23,0
2020-08-02,LQ,Bosnia-Herzegovina,931,907,0,0,24,11,13,24,0
2020-08-03,LQ,Bosnia-Herzegovina,786,751,0,0,35,18,17,35,0
2020-08-04,LQ,Bosnia-Herzegovina,708,675,0,0,33,16,17,33,0
2020-08-05,LQ,Bosnia-Herzegovina,799,757,0,0,42,21,21,42,0
2020-08-06,LQ,Bosnia-Herzegovina,737,716,0,0,21,11,10,21,0
2020-08-07,LQ,Bosnia-Herzegovina,874,841,0,0,33,16,17,33,0
2020-08-08,LQ,Bosnia-Herzegovina,1108,1079,0,0,29,15,14,29,0
2020-08-09,LQ,Bosnia-Herzegovina,880,853,0,0,27,13,14,27,0
2020-08-10,LQ,Bosnia-Herzegovina,791,754,0,0,37,19,18,37,0
2020-08-11,LQ,Bosnia-Herzegovina,755,726,1,1,29,13,15,28,0
2020-08-12,LQ,Bosnia-Herzegovina,760,719,1,1,41,20,20,40,0
2020-08-13,LQ,Bosnia-Herzegovina,757,741,0,0,16,9,7,16,0
2020-08-14,LQ,Bosnia-Herzegovina,835,797,0,0,38,19,19,38,0
2020-08-15,LQ,Bosnia-Herzegovina,1094,1063,0,0,31,16,15,31,0
2020-08-16,LQ,Bosnia-Herzegovina,946,918,0,0,28,13,15,28,0
2020-08-17,LQ,Bosnia-Herzegovina,790,756,0,0,34,17,17,34,0
2020-08-18,LQ,Bosnia-Herzegovina,727,691,0,0,36,18,18,36,0
2020-08-19,LQ,Bosnia-Herzegovina,778,742,0,0,36,18,18,36,0
2020-08-20,LQ,Bosnia-Herzegovina,775,752,0,0,23,12,11,23,0
2020-08-21,LQ,Bosnia-Herzegovina,872,836,0,0,36,18,18,36,0
2020-08-22,LQ,Bosnia-Herzegovina,1107,1085,0,0,22,11,11,22,0
2020-08-23,LQ,Bosnia-Herzegovina,900,871,0,0,29,14,15,29,0
2020-08-24,LQ,Bosnia-Herzegovina,784,753,0,0,31,16,15,31,0
2020-08-25,LQ,Bosnia-Herzegovina,770,737,2,0,33,15,16,31,2
2020-08-26,LQ,Bosnia-Herzegovina,825,789,0,0,36,17,19,36,0
2020-08-27,LQ,Bosnia-Herzegovina,766,744,2,0,22,11,9,20,2
2020-08-28,LQ,Bosnia-Herzegovina,914,873,0,0,41,21,20,41,0
2020-08-29,LQ,Bosnia-Herzegovina,1083,1063,0,0,20,10,10,20,0
2020-08-30,LQ,Bosnia-Herzegovina,910,888,0,0,22,11,11,22,0
2020-08-31,LQ,Bosnia-Herzegovina,752,723,0,0,29,15,14,29,0
2020-09-01,LQ,Bosnia-Herzegovina,727,702,0,0,25,12,13,25,0
2020-09-02,LQ,Bosnia-Herzegovina,746,717,2,0,29,14,13,27,2
2020-09-03,LQ,Bosnia-Herzegovina,704,678,0,0,26,12,14,26,0
2020-09-04,LQ,Bosnia-Herzegovina,848,816,0,0,32,17,15,32,0
2020-09-05,LQ,Bosnia-Herzegovina,1022,1001,0,0,21,11,10,21,0
2020-09-06,LQ,Bosnia-Herzegovina,880,856,0,0,24,11,13,24,0
2020-09-07,LQ,Bosnia-Herzegovina,724,695,0,0,29,15,14,29,0
2020-09-08,LQ,Bosnia-Herzegovina,695,664,0,0,31,15,16,31,0
2020-09-09,LQ,Bosnia-Herzegovina,749,725,2,0,24,11,11,22,2
2020-09-10,LQ,Bosnia-Herzegovina,721,703,2,0,18,8,8,16,2
2020-09-11,LQ,Bosnia-Herzegovina,830,796,0,0,34,17,17,34,0
2020-09-12,LQ,Bosnia-Herzegovina,991,970,0,0,21,11,10,21,0
2020-09-13,LQ,Bosnia-Herzegovina,849,828,0,0,21,10,11,21,0
2020-09-14,LQ,Bosnia-Herzegovina,694,673,2,0,21,10,9,19,2
2020-09-15,LQ,Bosnia-Herzegovina,688,661,0,0,27,13,14,27,0
2020-09-16,LQ,Bosnia-Herzegovina,658,635,0,0,23,11,12,23,0
2020-09-17,LQ,Bosnia-Herzegovina,595,577,0,0,18,9,9,18,0
2020-09-18,LQ,Bosnia-Herzegovina,779,735,0,0,44,23,21,44,0
2020-09-19,LQ,Bosnia-Herzegovina,935,909,0,0,26,13,13,26,0
2020-09-20,LQ,Bosnia-Herzegovina,807,783,0,0,24,12,12,24,0
2020-09-21,LQ,Bosnia-Herzegovina,630,607,0,0,23,12,11,23,0
2020-09-22,LQ,Bosnia-Herzegovina,560,545,0,0,15,7,8,15,0
2020-09-23,LQ,Bosnia-Herzegovina,688,660,0,0,28,14,14,28,0
2020-09-24,LQ,Bosnia-Herzegovina,595,576,0,0,19,9,10,19,0
2020-09-25,LQ,Bosnia-Herzegovina,716,688,0,0,28,14,14,28,0
2020-09-26,LQ,Bosnia-Herzegovina,939,917,0,0,22,12,10,22,0
2020-09-27,LQ,Bosnia-Herzegovina,771,744,0,0,27,12,15,27,0
2020-09-28,LQ,Bosnia-Herzegovina,590,560,0,0,30,16,14,30,0
2020-09-29,LQ,Bosnia-Herzegovina,554,530,0,0,24,12,12,24,0
2020-09-30,LQ,Bosnia-Herzegovina,609,586,0,0,23,12,11,23,0
2020-10-01,LQ,Bosnia-Herzegovina,563,541,0,0,22,11,11,22,0
2020-10-02,LQ,Bosnia-Herzegovina,710,677,0,0,33,17,16,33,0
2020-10-03,LQ,Bosnia-Herzegovina,790,778,0,0,12,6,6,12,0
2020-10-04,LQ,Bosnia-Herzegovina,705,685,0,0,20,10,10,20,0
2020-10-05,LQ,Bosnia-Herzegovina,565,540,0,0,25,13,12,25,0
2020-10-06,LQ,Bosnia-Herzegovina,484,467,2,1,17,6,9,15,1
2020-10-07,LQ,Bosnia-Herzegovina,519,495,4,1,24,11,9,20,3
2020-10-08,LQ,Bosnia-Herzegovina,541,514,5,1,27,10,12,22,4
2020-10-09,LQ,Bosnia-Herzegovina,631,599,2,1,32,16,14,30,1
2020-10-10,LQ,Bosnia-Herzegovina,835,819,0,0,16,8,8,16,0
2020-10-11,LQ,Bosnia-Herzegovina,750,725,2,0,25,11,12,23,2
2020-10-12,LQ,Bosnia-Herzegovina,551,519,2,0,32,15,15,30,2
2020-10-13,LQ,Bosnia-Herzegovina,496,477,0,0,19,9,10,19,0
2020-10-14,LQ,Bosnia-Herzegovina,526,500,0,0,26,12,14,26,0
2020-10-15,LQ,Bosnia-Herzegovina,348,324,0,0,24,13,11,24,0
2020-10-16,LQ,Bosnia-Herzegovina,731,702,4,0,29,12,13,25,4
2020-10-17,LQ,Bosnia-Herzegovina,864,844,0,0,20,11,9,20,0
2020-10-18,LQ,Bosnia-Herzegovina,675,656,0,0,19,9,10,19,0
2020-10-19,LQ,Bosnia-Herzegovina,536,510,0,0,26,14,12,26,0
2020-10-20,LQ,Bosnia-Herzegovina,486,467,0,0,19,9,10,19,0
2020-10-21,LQ,Bosnia-Herzegovina,509,487,0,0,22,11,11,22,0
2020-10-22,LQ,Bosnia-Herzegovina,492,470,0,0,22,10,12,22,0
2020-10-23,LQ,Bosnia-Herzegovina,583,556,0,0,27,14,13,27,0
2020-10-24,LQ,Bosnia-Herzegovina,818,798,0,0,20,11,9,20,0
2020-10-25,LQ,Bosnia-Herzegovina,646,627,0,0,19,10,9,19,0
2020-10-26,LQ,Bosnia-Herzegovina,426,396,0,0,30,14,16,30,0
2020-10-27,LQ,Bosnia-Herzegovina,415,393,0,0,22,11,11,22,0
2020-10-28,LQ,Bosnia-Herzegovina,458,439,0,0,19,9,10,19,0
2020-10-29,LQ,Bosnia-Herzegovina,456,426,0,0,30,14,16,30,0
2020-10-30,LQ,Bosnia-Herzegovina,606,569,0,0,37,20,17,37,0
2020-10-31,LQ,Bosnia-Herzegovina,671,654,0,0,17,8,9,17,0
2020-11-01,LQ,Bosnia-Herzegovina,585,565,0,0,20,10,10,20,0
2020-11-02,LQ,Bosnia-Herzegovina,407,377,0,0,30,15,15,30,0
2020-11-03,LQ,Bosnia-Herzegovina,318,302,0,0,16,8,8,16,0
2020-11-04,LQ,Bosnia-Herzegovina,326,311,0,0,15,7,8,15,0
2020-11-05,LQ,Bosnia-Herzegovina,352,327,0,0,25,12,13,25,0
2020-11-06,LQ,Bosnia-Herzegovina,405,379,0,0,26,14,12,26,0
2020-11-07,LQ,Bosnia-Herzegovina,463,438,0,0,25,12,13,25,0
2020-11-08,LQ,Bosnia-Herzegovina,467,445,0,0,22,11,11,22,0
2020-11-09,LQ,Bosnia-Herzegovina,328,308,0,0,20,10,10,20,0
2020-11-10,LQ,Bosnia-Herzegovina,294,268,2,0,26,11,13,24,2
2020-11-11,LQ,Bosnia-Herzegovina,316,292,0,0,24,12,12,24,0
2020-11-12,LQ,Bosnia-Herzegovina,306,289,0,0,17,9,8,17,0
2020-11-13,LQ,Bosnia-Herzegovina,361,335,1,1,26,13,12,25,0
2020-11-14,LQ,Bosnia-Herzegovina,372,350,0,0,22,10,12,22,0
2020-11-15,LQ,Bosnia-Herzegovina,402,377,0,0,25,12,13,25,0
2020-11-16,LQ,Bosnia-Herzegovina,290,266,1,1,24,12,11,23,0
2020-11-17,LQ,Bosnia-Herzegovina,263,249,0,0,14,7,7,14,0
2020-11-18,LQ,Bosnia-Herzegovina,289,271,0,0,18,8,10,18,0
2020-11-19,LQ,Bosnia-Herzegovina,311,290,2,0,21,11,8,19,2
2020-11-20,LQ,Bosnia-Herzegovina,324,296,0,0,28,14,14,28,0
2020-11-21,LQ,Bosnia-Herzegovina,325,308,2,0,17,7,8,15,2
2020-11-22,LQ,Bosnia-Herzegovina,350,327,0,0,23,12,11,23,0
2020-11-23,LQ,Bosnia-Herzegovina,256,231,0,0,25,13,12,25,0
2020-11-24,LQ,Bosnia-Herzegovina,237,224,0,0,13,7,6,13,0
2020-11-25,LQ,Bosnia-Herzegovina,289,267,0,0,22,9,13,22,0
2020-11-26,LQ,Bosnia-Herzegovina,243,229,0,0,14,7,7,14,0
2020-11-27,LQ,Bosnia-Herzegovina,334,311,1,0,23,13,9,22,1
2020-11-28,LQ,Bosnia-Herzegovina,289,274,0,0,15,7,8,15,0
2020-11-29,LQ,Bosnia-Herzegovina,307,287,0,0,20,10,10,20,0
2020-11-30,LQ,Bosnia-Herzegovina,248,232,0,0,16,8,8,16,0
2020-12-01,LQ,Bosnia-Herzegovina,222,204,3,0,18,8,7,15,3
2020-12-02,LQ,Bosnia-Herzegovina,279,261,1,0,18,8,9,17,1
2020-12-03,LQ,Bosnia-Herzegovina,293,277,0,0,16,7,9,16,0
2020-12-04,LQ,Bosnia-Herzegovina,345,317,0,0,28,15,13,28,0
2020-12-05,LQ,Bosnia-Herzegovina,301,292,0,0,9,4,5,9,0
2020-12-06,LQ,Bosnia-Herzegovina,311,293,0,0,18,9,9,18,0
2020-12-07,LQ,Bosnia-Herzegovina,293,275,0,0,18,10,8,18,0
2020-12-08,LQ,Bosnia-Herzegovina,245,227,1,1,18,9,8,17,0
2020-12-09,LQ,Bosnia-Herzegovina,284,267,0,0,17,8,9,17,0
2020-12-10,LQ,Bosnia-Herzegovina,322,303,0,0,19,9,10,19,0
2020-12-11,LQ,Bosnia-Herzegovina,374,336,0,0,38,20,18,38,0
2020-12-12,LQ,Bosnia-Herzegovina,363,350,0,0,13,6,7,13,0
2020-12-13,LQ,Bosnia-Herzegovina,377,357,0,0,20,10,10,20,0
2020-12-14,LQ,Bosnia-Herzegovina,356,333,0,0,23,11,12,23,0
2020-12-15,LQ,Bosnia-Herzegovina,289,272,2,0,17,8,7,15,2
2020-12-16,LQ,Bosnia-Herzegovina,349,331,0,0,18,9,9,18,0
2020-12-17,LQ,Bosnia-Herzegovina,423,406,0,0,17,9,8,17,0
2020-12-18,LQ,Bosnia-Herzegovina,510,484,1,0,26,13,12,25,1
2020-12-19,LQ,Bosnia-Herzegovina,588,575,0,0,13,6,7,13,0
2020-12-20,LQ,Bosnia-Herzegovina,520,503,1,0,17,8,8,16,1
2020-12-21,LQ,Bosnia-Herzegovina,427,396,0,0,31,15,16,31,0
2020-12-22,LQ,Bosnia-Herzegovina,373,354,0,0,19,10,9,19,0
2020-12-23,LQ,Bosnia-Herzegovina,429,410,0,0,19,9,10,19,0
2020-12-24,LQ,Bosnia-Herzegovina,386,359,0,0,27,14,13,27,0
2020-12-25,LQ,Bosnia-Herzegovina,245,228,0,0,17,9,8,17,0
2020-12-26,LQ,Bosnia-Herzegovina,371,360,0,0,11,5,6,11,0
2020-12-27,LQ,Bosnia-Herzegovina,417,398,0,0,19,10,9,19,0
2020-12-28,LQ,Bosnia-Herzegovina,357,340,0,0,17,8,9,17,0
2020-12-29,LQ,Bosnia-Herzegovina,287,271,0,0,16,8,8,16,0
2020-12-30,LQ,Bosnia-Herzegovina,355,335,0,0,20,10,10,20,0
2020-12-31,LQ,Bosnia-Herzegovina,220,203,0,0,17,8,9,17,0
2020-01-01,LB,Bulgaria,1705,1568,6,0,137,65,66,131,6
2020-01-02,LB,Bulgaria,1966,1747,11,1,219,99,109,208,10
2020-01-03,LB,Bulgaria,2015,1814,7,0,201,97,97,194,7
2020-01-04,LB,Bulgaria,2165,1967,5,1,198,99,94,193,4
2020-01-05,LB,Bulgaria,2200,2013,4,0,187,91,92,183,4
2020-01-06,LB,Bulgaria,1919,1731,6,0,188,89,93,182,6
2020-01-07,LB,Bulgaria,1699,1519,10,2,180,86,84,170,8
2020-01-08,LB,Bulgaria,1731,1553,8,1,178,84,86,170,7
2020-01-09,LB,Bulgaria,1770,1608,7,0,162,78,77,155,7
2020-01-10,LB,Bulgaria,1795,1613,9,0,182,85,88,173,9
2020-01-11,LB,Bulgaria,1856,1685,5,1,171,83,83,166,4
2020-01-12,LB,Bulgaria,1933,1747,8,2,186,91,87,178,6
2020-01-13,LB,Bulgaria,1713,1536,6,0,177,85,86,171,6
2020-01-14,LB,Bulgaria,1611,1457,8,2,154,74,72,146,6
2020-01-15,LB,Bulgaria,1680,1525,4,0,155,75,76,151,4
2020-01-16,LB,Bulgaria,1664,1500,10,1,164,77,77,154,9
2020-01-17,LB,Bulgaria,1746,1570,8,2,176,85,83,168,6
2020-01-18,LB,Bulgaria,1847,1676,6,0,171,81,84,165,6
2020-01-19,LB,Bulgaria,1858,1682,4,0,176,85,87,172,4
2020-01-20,LB,Bulgaria,1692,1514,9,0,178,85,84,169,9
2020-01-21,LB,Bulgaria,1657,1490,11,0,167,78,78,156,11
2020-01-22,LB,Bulgaria,1727,1559,10,1,168,77,81,158,9
2020-01-23,LB,Bulgaria,1683,1531,9,1,152,73,70,143,8
2020-01-24,LB,Bulgaria,1780,1588,8,0,192,94,90,184,8
2020-01-25,LB,Bulgaria,1914,1750,4,0,164,80,80,160,4
2020-01-26,LB,Bulgaria,1892,1709,5,0,183,88,90,178,5
2020-01-27,LB,Bulgaria,1710,1521,7,0,189,92,90,182,7
2020-01-28,LB,Bulgaria,1649,1490,8,0,159,74,77,151,8
2020-01-29,LB,Bulgaria,1692,1528,12,1,164,75,77,152,11
2020-01-30,LB,Bulgaria,1640,1474,12,1,166,79,75,154,11
2020-01-31,LB,Bulgaria,1753,1557,9,1,196,93,94,187,8
2020-02-01,LB,Bulgaria,1854,1690,4,0,164,82,78,160,4
2020-02-02,LB,Bulgaria,1853,1669,4,0,184,89,91,180,4
2020-02-03,LB,Bulgaria,1659,1475,11,2,184,86,87,173,9
2020-02-04,LB,Bulgaria,1663,1483,16,2,180,81,83,164,14
2020-02-05,LB,Bulgaria,1671,1521,6,0,150,74,70,144,6
2020-02-06,LB,Bulgaria,1705,1536,7,0,169,79,83,162,7
2020-02-07,LB,Bulgaria,1754,1569,7,1,185,89,89,178,6
2020-02-08,LB,Bulgaria,1828,1654,6,0,174,85,83,168,6
2020-02-09,LB,Bulgaria,1790,1613,4,0,177,85,88,173,4
2020-02-10,LB,Bulgaria,1640,1460,12,0,180,84,84,168,12
2020-02-11,LB,Bulgaria,1604,1447,6,0,157,75,76,151,6
2020-02-12,LB,Bulgaria,1696,1531,7,1,165,80,78,158,6
2020-02-13,LB,Bulgaria,1773,1608,10,0,165,77,78,155,10
2020-02-14,LB,Bulgaria,1847,1656,7,0,191,92,92,184,7
2020-02-15,LB,Bulgaria,1885,1693,6,0,192,92,94,186,6
2020-02-16,LB,Bulgaria,1931,1745,5,0,186,93,88,181,5
2020-02-17,LB,Bulgaria,1733,1539,15,1,194,89,90,179,14
2020-02-18,LB,Bulgaria,1705,1534,13,3,171,77,81,158,10
2020-02-19,LB,Bulgaria,1771,1605,11,1,166,77,78,155,10
2020-02-20,LB,Bulgaria,1786,1621,12,1,165,78,75,153,11
2020-02-21,LB,Bulgaria,1825,1634,7,1,191,89,95,184,6
2020-02-22,LB,Bulgaria,1923,1739,4,0,184,91,89,180,4
2020-02-23,LB,Bulgaria,1900,1716,5,1,184,91,88,179,4
2020-02-24,LB,Bulgaria,1704,1517,6,0,187,89,92,181,6
2020-02-25,LB,Bulgaria,1700,1526,13,1,174,80,81,161,12
2020-02-26,LB,Bulgaria,1781,1605,13,1,176,83,80,163,12
2020-02-27,LB,Bulgaria,1781,1599,9,0,182,86,87,173,9
2020-02-28,LB,Bulgaria,1841,1641,11,1,200,96,93,189,10
2020-02-29,LB,Bulgaria,1933,1753,6,2,180,88,86,174,4
2020-03-01,LB,Bulgaria,1928,1741,4,0,187,90,93,183,4
2020-03-02,LB,Bulgaria,1793,1602,7,0,191,93,91,184,7
2020-03-03,LB,Bulgaria,1749,1576,6,0,173,82,85,167,6
2020-03-04,LB,Bulgaria,1870,1698,8,0,172,81,83,164,8
2020-03-05,LB,Bulgaria,1782,1611,15,0,171,78,78,156,15
2020-03-06,LB,Bulgaria,1896,1696,10,1,200,94,96,190,9
2020-03-07,LB,Bulgaria,1972,1804,4,0,168,86,78,164,4
2020-03-08,LB,Bulgaria,1893,1713,4,0,180,87,89,176,4
2020-03-09,LB,Bulgaria,1706,1530,8,0,176,84,84,168,8
2020-03-10,LB,Bulgaria,1644,1478,16,4,166,74,76,150,12
2020-03-11,LB,Bulgaria,1637,1482,15,0,155,70,70,140,15
2020-03-12,LB,Bulgaria,1595,1439,11,2,156,73,72,145,9
2020-03-13,LB,Bulgaria,1592,1430,7,1,162,78,77,155,6
2020-03-14,LB,Bulgaria,1644,1496,4,0,148,72,72,144,4
2020-03-15,LB,Bulgaria,1604,1454,5,1,150,72,73,145,4
2020-03-16,LB,Bulgaria,1362,1230,4,0,132,63,65,128,4
2020-03-17,LB,Bulgaria,1201,1079,7,0,122,57,58,115,7
2020-03-18,LB,Bulgaria,1124,1011,6,2,113,53,54,107,4
2020-03-19,LB,Bulgaria,1010,923,5,0,87,41,41,82,5
2020-03-20,LB,Bulgaria,1007,899,4,0,108,51,53,104,4
2020-03-21,LB,Bulgaria,778,702,2,0,76,37,37,74,2
2020-03-22,LB,Bulgaria,659,574,3,0,85,40,42,82,3
2020-03-23,LB,Bulgaria,497,423,3,0,74,36,35,71,3
2020-03-24,LB,Bulgaria,492,437,2,0,55,26,27,53,2
2020-03-25,LB,Bulgaria,392,342,2,0,50,21,27,48,2
2020-03-26,LB,Bulgaria,404,329,8,6,75,33,34,67,2
2020-03-27,LB,Bulgaria,374,318,3,0,56,26,27,53,3
2020-03-28,LB,Bulgaria,322,285,1,0,37,19,17,36,1
2020-03-29,LB,Bulgaria,317,290,1,0,27,12,14,26,1
2020-03-30,LB,Bulgaria,256,212,2,0,44,22,20,42,2
2020-03-31,LB,Bulgaria,314,270,3,0,44,20,21,41,3
2020-04-01,LB,Bulgaria,259,217,5,1,42,19,18,37,4
2020-04-02,LB,Bulgaria,287,244,7,1,43,19,17,36,6
2020-04-03,LB,Bulgaria,286,234,3,1,52,26,23,49,2
2020-04-04,LB,Bulgaria,256,227,1,0,29,14,14,28,1
2020-04-05,LB,Bulgaria,235,212,1,0,23,11,11,22,1
2020-04-06,LB,Bulgaria,244,207,2,0,37,18,17,35,2
2020-04-07,LB,Bulgaria,236,203,6,0,33,13,14,27,6
2020-04-08,LB,Bulgaria,274,221,14,4,53,20,19,39,10
2020-04-09,LB,Bulgaria,278,227,5,0,51,23,23,46,5
2020-04-10,LB,Bulgaria,282,231,3,0,51,25,23,48,3
2020-04-11,LB,Bulgaria,241,210,2,1,31,14,15,29,1
2020-04-12,LB,Bulgaria,212,186,2,0,26,13,11,24,2
2020-04-13,LB,Bulgaria,240,188,5,1,52,22,25,47,4
2020-04-14,LB,Bulgaria,217,187,3,1,30,14,13,27,2
2020-04-15,LB,Bulgaria,255,205,9,1,50,20,21,41,8
2020-04-16,LB,Bulgaria,272,225,4,0,47,22,21,43,4
2020-04-17,LB,Bulgaria,266,234,2,0,32,16,14,30,2
2020-04-18,LB,Bulgaria,256,236,2,1,20,9,9,18,1
2020-04-19,LB,Bulgaria,211,205,0,0,6,3,3,6,0
2020-04-20,LB,Bulgaria,268,233,2,0,35,15,18,33,2
2020-04-21,LB,Bulgaria,263,240,2,0,23,11,10,21,2
2020-04-22,LB,Bulgaria,316,275,9,1,41,16,16,32,8
2020-04-23,LB,Bulgaria,331,297,4,0,34,15,15,30,4
2020-04-24,LB,Bulgaria,302,268,5,1,34,15,14,29,4
2020-04-25,LB,Bulgaria,300,280,1,0,20,10,9,19,1
2020-04-26,LB,Bulgaria,256,234,2,0,22,9,11,20,2
2020-04-27,LB,Bulgaria,277,230,9,1,47,18,20,38,8
2020-04-28,LB,Bulgaria,308,273,7,3,35,14,14,28,4
2020-04-29,LB,Bulgaria,350,301,8,0,49,21,20,41,8
2020-04-30,LB,Bulgaria,304,264,2,0,40,20,18,38,2
2020-05-01,LB,Bulgaria,350,310,2,0,40,18,20,38,2
2020-05-02,LB,Bulgaria,301,271,1,0,30,14,15,29,1
2020-05-03,LB,Bulgaria,285,250,1,0,35,18,16,34,1
2020-05-04,LB,Bulgaria,349,288,18,12,61,20,23,43,6
2020-05-05,LB,Bulgaria,328,280,6,0,48,22,20,42,6
2020-05-06,LB,Bulgaria,340,303,4,0,37,17,16,33,4
2020-05-07,LB,Bulgaria,365,287,19,13,78,30,29,59,6
2020-05-08,LB,Bulgaria,340,287,2,0,53,26,25,51,2
2020-05-09,LB,Bulgaria,328,277,1,0,51,23,27,50,1
2020-05-10,LB,Bulgaria,322,275,2,0,47,24,21,45,2
2020-05-11,LB,Bulgaria,320,263,13,1,57,21,23,44,12
2020-05-12,LB,Bulgaria,310,261,3,1,49,24,22,46,2
2020-05-13,LB,Bulgaria,341,284,8,1,57,24,25,49,7
2020-05-14,LB,Bulgaria,391,330,8,1,61,27,26,53,7
2020-05-15,LB,Bulgaria,375,317,2,0,58,29,27,56,2
2020-05-16,LB,Bulgaria,349,306,1,0,43,20,22,42,1
2020-05-17,LB,Bulgaria,319,270,3,0,49,23,23,46,3
2020-05-18,LB,Bulgaria,340,267,7,1,73,31,35,66,6
2020-05-19,LB,Bulgaria,323,262,6,0,61,28,27,55,6
2020-05-20,LB,Bulgaria,367,313,4,0,54,27,23,50,4
2020-05-21,LB,Bulgaria,398,326,14,12,72,28,30,58,2
2020-05-22,LB,Bulgaria,363,306,2,0,57,27,28,55,2
2020-05-23,LB,Bulgaria,368,308,2,1,60,28,30,58,1
2020-05-24,LB,Bulgaria,332,291,1,0,41,23,17,40,1
2020-05-25,LB,Bulgaria,330,271,10,1,59,23,26,49,9
2020-05-26,LB,Bulgaria,374,310,6,0,64,26,32,58,6
2020-05-27,LB,Bulgaria,410,335,8,2,75,35,32,67,6
2020-05-28,LB,Bulgaria,402,333,11,3,69,29,29,58,8
2020-05-29,LB,Bulgaria,414,345,4,0,69,36,29,65,4
2020-05-30,LB,Bulgaria,407,357,2,0,50,25,23,48,2
2020-05-31,LB,Bulgaria,351,306,2,0,45,20,23,43,2
2020-06-01,LB,Bulgaria,364,288,10,1,76,32,34,66,9
2020-06-02,LB,Bulgaria,379,307,5,1,72,35,32,67,4
2020-06-03,LB,Bulgaria,416,329,8,0,87,37,42,79,8
2020-06-04,LB,Bulgaria,433,346,4,0,87,43,40,83,4
2020-06-05,LB,Bulgaria,465,380,4,0,85,42,39,81,4
2020-06-06,LB,Bulgaria,405,340,2,0,65,32,31,63,2
2020-06-07,LB,Bulgaria,415,346,4,0,69,32,33,65,4
2020-06-08,LB,Bulgaria,385,308,6,0,77,34,37,71,6
2020-06-09,LB,Bulgaria,388,300,6,1,88,41,41,82,5
2020-06-10,LB,Bulgaria,474,370,7,0,104,48,49,97,7
2020-06-11,LB,Bulgaria,505,420,14,1,85,36,35,71,13
2020-06-12,LB,Bulgaria,508,408,10,0,100,46,44,90,10
2020-06-13,LB,Bulgaria,476,420,2,0,56,28,26,54,2
2020-06-14,LB,Bulgaria,481,401,3,0,80,38,39,77,3
2020-06-15,LB,Bulgaria,532,437,9,0,95,42,44,86,9
2020-06-16,LB,Bulgaria,506,419,6,0,87,41,40,81,6
2020-06-17,LB,Bulgaria,571,467,7,1,104,48,49,97,6
2020-06-18,LB,Bulgaria,552,450,8,0,102,46,48,94,8
2020-06-19,LB,Bulgaria,620,522,6,0,98,47,45,92,6
2020-06-20,LB,Bulgaria,572,504,2,0,68,31,35,66,2
2020-06-21,LB,Bulgaria,588,501,4,0,87,41,42,83,4
2020-06-22,LB,Bulgaria,553,456,10,0,97,41,46,87,10
2020-06-23,LB,Bulgaria,503,399,14,0,104,43,47,90,14
2020-06-24,LB,Bulgaria,609,503,14,4,106,49,43,92,10
2020-06-25,LB,Bulgaria,631,531,16,1,100,43,41,84,15
2020-06-26,LB,Bulgaria,718,605,12,1,113,49,52,101,11
2020-06-27,LB,Bulgaria,656,567,2,0,89,44,43,87,2
2020-06-28,LB,Bulgaria,665,567,3,0,98,48,47,95,3
2020-06-29,LB,Bulgaria,602,491,13,0,111,48,50,98,13
2020-06-30,LB,Bulgaria,590,478,12,1,112,50,50,100,11
2020-07-01,LB,Bulgaria,897,736,10,2,161,75,76,151,8
2020-07-02,LB,Bulgaria,887,738,12,0,149,68,69,137,12
2020-07-03,LB,Bulgaria,990,808,10,0,182,88,84,172,10
2020-07-04,LB,Bulgaria,953,809,10,0,144,65,69,134,10
2020-07-05,LB,Bulgaria,940,785,9,0,155,74,72,146,9
2020-07-06,LB,Bulgaria,850,687,13,1,163,74,76,150,12
2020-07-07,LB,Bulgaria,813,638,10,1,175,84,81,165,9
2020-07-08,LB,Bulgaria,863,714,12,2,149,68,69,137,10
2020-07-09,LB,Bulgaria,843,680,15,0,163,74,74,148,15
2020-07-10,LB,Bulgaria,994,789,9,0,205,100,96,196,9
2020-07-11,LB,Bulgaria,986,835,5,0,151,72,74,146,5
2020-07-12,LB,Bulgaria,938,759,9,0,179,85,85,170,9
2020-07-13,LB,Bulgaria,838,672,14,0,166,74,78,152,14
2020-07-14,LB,Bulgaria,846,661,14,1,185,86,85,171,13
2020-07-15,LB,Bulgaria,1002,816,14,2,186,85,87,172,12
2020-07-16,LB,Bulgaria,1055,895,14,0,160,76,70,146,14
2020-07-17,LB,Bulgaria,1167,958,10,1,209,99,100,199,9
2020-07-18,LB,Bulgaria,1194,1028,6,0,166,79,81,160,6
2020-07-19,LB,Bulgaria,1130,956,11,0,174,81,82,163,11
2020-07-20,LB,Bulgaria,1014,828,18,2,186,84,84,168,16
2020-07-21,LB,Bulgaria,922,743,11,0,179,82,86,168,11
2020-07-22,LB,Bulgaria,986,844,13,3,142,65,64,129,10
2020-07-23,LB,Bulgaria,1062,890,15,3,172,79,78,157,12
2020-07-24,LB,Bulgaria,1161,941,13,2,220,104,103,207,11
2020-07-25,LB,Bulgaria,1228,1067,9,1,161,76,76,152,8
2020-07-26,LB,Bulgaria,1182,1009,11,0,173,82,80,162,11
2020-07-27,LB,Bulgaria,997,823,13,0,174,78,83,161,13
2020-07-28,LB,Bulgaria,948,773,18,2,175,80,77,157,16
2020-07-29,LB,Bulgaria,1026,860,17,1,166,72,77,149,16
2020-07-30,LB,Bulgaria,1057,882,19,2,175,79,77,156,17
2020-07-31,LB,Bulgaria,1207,996,12,1,211,99,100,199,11
2020-08-01,LB,Bulgaria,1375,1207,8,0,168,79,81,160,8
2020-08-02,LB,Bulgaria,1372,1181,10,2,191,91,90,181,8
2020-08-03,LB,Bulgaria,1149,981,13,1,168,77,78,155,12
2020-08-04,LB,Bulgaria,1145,966,17,3,179,80,82,162,14
2020-08-05,LB,Bulgaria,1247,1073,15,1,174,80,79,159,14
2020-08-06,LB,Bulgaria,1255,1066,19,5,189,84,86,170,14
2020-08-07,LB,Bulgaria,1379,1146,12,1,233,112,109,221,11
2020-08-08,LB,Bulgaria,1472,1309,7,0,163,77,79,156,7
2020-08-09,LB,Bulgaria,1389,1192,10,0,197,95,92,187,10
2020-08-10,LB,Bulgaria,1216,1043,11,0,173,78,84,162,11
2020-08-11,LB,Bulgaria,1181,990,13,2,191,90,88,178,11
2020-08-12,LB,Bulgaria,1240,1069,10,1,171,81,80,161,9
2020-08-13,LB,Bulgaria,1237,1066,11,2,171,79,81,160,9
2020-08-14,LB,Bulgaria,1400,1175,11,0,225,106,108,214,11
2020-08-15,LB,Bulgaria,1542,1354,12,0,188,90,86,176,12
2020-08-16,LB,Bulgaria,1450,1255,12,0,195,92,91,183,12
2020-08-17,LB,Bulgaria,1238,1070,12,0,168,79,77,156,12
2020-08-18,LB,Bulgaria,1196,1014,14,3,182,86,82,168,11
2020-08-19,LB,Bulgaria,1324,1157,11,1,167,78,78,156,10
2020-08-20,LB,Bulgaria,1286,1118,14,2,168,75,79,154,12
2020-08-21,LB,Bulgaria,1411,1190,14,2,221,104,103,207,12
2020-08-22,LB,Bulgaria,1556,1388,13,1,168,78,77,155,12
2020-08-23,LB,Bulgaria,1427,1226,10,0,201,97,94,191,10
2020-08-24,LB,Bulgaria,1232,1071,9,0,161,76,76,152,9
2020-08-25,LB,Bulgaria,1285,1093,13,1,192,89,90,179,12
2020-08-26,LB,Bulgaria,1296,1131,11,0,165,80,74,154,11
2020-08-27,LB,Bulgaria,1311,1129,9,1,182,85,88,173,8
2020-08-28,LB,Bulgaria,1421,1202,12,3,219,103,104,207,9
2020-08-29,LB,Bulgaria,1503,1340,12,1,163,73,78,151,11
2020-08-30,LB,Bulgaria,1501,1298,12,1,203,98,93,191,11
2020-08-31,LB,Bulgaria,1285,1121,11,0,164,76,77,153,11
2020-09-01,LB,Bulgaria,1248,1064,14,1,184,84,86,170,13
2020-09-02,LB,Bulgaria,1353,1209,11,1,144,67,66,133,10
2020-09-03,LB,Bulgaria,1266,1116,11,0,150,68,71,139,11
2020-09-04,LB,Bulgaria,1433,1204,12,0,229,111,106,217,12
2020-09-05,LB,Bulgaria,1548,1390,10,0,158,75,73,148,10
2020-09-06,LB,Bulgaria,1455,1281,7,0,174,83,84,167,7
2020-09-07,LB,Bulgaria,1247,1093,9,0,154,67,78,145,9
2020-09-08,LB,Bulgaria,1140,973,12,5,167,82,73,155,7
2020-09-09,LB,Bulgaria,1282,1128,15,3,154,66,73,139,12
2020-09-10,LB,Bulgaria,1262,1098,14,1,164,73,77,150,13
2020-09-11,LB,Bulgaria,1381,1152,10,2,229,112,107,219,8
2020-09-12,LB,Bulgaria,1514,1367,10,1,147,68,69,137,9
2020-09-13,LB,Bulgaria,1422,1239,10,1,183,88,85,173,9
2020-09-14,LB,Bulgaria,1197,1030,10,0,167,78,79,157,10
2020-09-15,LB,Bulgaria,1129,954,12,0,175,82,81,163,12
2020-09-16,LB,Bulgaria,1244,1113,7,0,131,62,62,124,7
2020-09-17,LB,Bulgaria,1275,1127,11,0,148,66,71,137,11
2020-09-18,LB,Bulgaria,1406,1189,12,0,217,103,102,205,12
2020-09-19,LB,Bulgaria,1484,1345,4,0,139,71,64,135,4
2020-09-20,LB,Bulgaria,1382,1241,5,0,141,67,69,136,5
2020-09-21,LB,Bulgaria,1206,1066,6,1,140,64,70,134,5
2020-09-22,LB,Bulgaria,1112,971,14,3,141,64,63,127,11
2020-09-23,LB,Bulgaria,1283,1146,13,0,137,65,59,124,13
2020-09-24,LB,Bulgaria,1243,1106,16,5,137,58,63,121,11
2020-09-25,LB,Bulgaria,1418,1220,19,4,198,91,88,179,15
2020-09-26,LB,Bulgaria,1584,1460,3,0,124,59,62,121,3
2020-09-27,LB,Bulgaria,1449,1316,10,1,133,60,63,123,9
2020-09-28,LB,Bulgaria,1160,1027,12,1,133,61,60,121,11
2020-09-29,LB,Bulgaria,1066,939,8,4,127,57,62,119,4
2020-09-30,LB,Bulgaria,1234,1116,12,2,118,53,53,106,10
2020-10-01,LB,Bulgaria,1183,1057,19,2,126,57,50,107,17
2020-10-02,LB,Bulgaria,1266,1103,13,0,163,76,74,150,13
2020-10-03,LB,Bulgaria,1457,1359,2,0,98,45,51,96,2
2020-10-04,LB,Bulgaria,1387,1256,8,0,131,61,62,123,8
2020-10-05,LB,Bulgaria,1142,997,9,1,145,68,68,136,8
2020-10-06,LB,Bulgaria,979,859,11,0,120,54,55,109,11
2020-10-07,LB,Bulgaria,1156,1046,5,0,110,53,52,105,5
2020-10-08,LB,Bulgaria,1143,1033,5,0,110,53,52,105,5
2020-10-09,LB,Bulgaria,1250,1109,11,1,141,66,64,130,10
2020-10-10,LB,Bulgaria,1495,1397,2,0,98,49,47,96,2
2020-10-11,LB,Bulgaria,1322,1201,9,0,121,55,57,112,9
2020-10-12,LB,Bulgaria,1048,919,7,0,129,60,62,122,7
2020-10-13,LB,Bulgaria,969,862,8,2,107,46,53,99,6
2020-10-14,LB,Bulgaria,1172,1045,13,2,127,56,58,114,11
2020-10-15,LB,Bulgaria,1049,930,19,5,119,51,49,100,14
2020-10-16,LB,Bulgaria,1230,1077,7,0,153,75,71,146,7
2020-10-17,LB,Bulgaria,1417,1311,3,0,106,50,53,103,3
2020-10-18,LB,Bulgaria,1272,1160,5,0,112,53,54,107,5
2020-10-19,LB,Bulgaria,990,837,18,6,153,69,66,135,12
2020-10-20,LB,Bulgaria,859,747,14,3,112,47,51,98,11
2020-10-21,LB,Bulgaria,1054,921,15,4,133,61,57,118,11
2020-10-22,LB,Bulgaria,1027,920,10,0,107,51,46,97,10
2020-10-23,LB,Bulgaria,1163,1005,6,0,158,74,78,152,6
2020-10-24,LB,Bulgaria,1376,1275,4,0,101,50,47,97,4
2020-10-25,LB,Bulgaria,1218,1097,4,0,121,58,59,117,4
2020-10-26,LB,Bulgaria,950,829,11,0,121,55,55,110,11
2020-10-27,LB,Bulgaria,800,696,12,1,104,46,46,92,11
2020-10-28,LB,Bulgaria,1012,898,5,1,114,56,53,109,4
2020-10-29,LB,Bulgaria,977,873,14,2,104,46,44,90,12
2020-10-30,LB,Bulgaria,1060,929,8,1,131,63,60,123,7
2020-10-31,LB,Bulgaria,1185,1106,2,0,79,38,39,77,2
2020-11-01,LB,Bulgaria,1153,1045,4,0,108,50,54,104,4
2020-11-02,LB,Bulgaria,817,717,5,1,100,48,47,95,4
2020-11-03,LB,Bulgaria,739,646,10,0,93,41,42,83,10
2020-11-04,LB,Bulgaria,915,812,7,3,103,49,47,96,4
2020-11-05,LB,Bulgaria,882,803,4,0,79,38,37,75,4
2020-11-06,LB,Bulgaria,960,839,11,1,121,55,55,110,10
2020-11-07,LB,Bulgaria,979,910,3,1,69,31,35,66,2
2020-11-08,LB,Bulgaria,1006,894,4,0,112,53,55,108,4
2020-11-09,LB,Bulgaria,789,688,8,2,101,46,47,93,6
2020-11-10,LB,Bulgaria,760,657,22,12,103,40,41,81,10
2020-11-11,LB,Bulgaria,837,748,8,0,89,42,39,81,8
2020-11-12,LB,Bulgaria,838,772,10,5,66,28,28,56,5
2020-11-13,LB,Bulgaria,871,769,7,0,102,49,46,95,7
2020-11-14,LB,Bulgaria,865,805,4,2,60,28,28,56,2
2020-11-15,LB,Bulgaria,942,851,5,0,91,43,43,86,5
2020-11-16,LB,Bulgaria,773,692,6,0,81,36,39,75,6
2020-11-17,LB,Bulgaria,657,586,9,1,71,30,32,62,8
2020-11-18,LB,Bulgaria,800,698,14,5,102,45,43,88,9
2020-11-19,LB,Bulgaria,780,708,12,1,72,28,32,60,11
2020-11-20,LB,Bulgaria,819,726,5,1,93,45,43,88,4
2020-11-21,LB,Bulgaria,773,725,2,0,48,24,22,46,2
2020-11-22,LB,Bulgaria,837,756,4,0,81,38,39,77,4
2020-11-23,LB,Bulgaria,688,620,10,1,68,28,30,58,9
2020-11-24,LB,Bulgaria,619,540,12,0,79,33,34,67,12
2020-11-25,LB,Bulgaria,771,680,4,0,91,42,45,87,4
2020-11-26,LB,Bulgaria,726,662,14,4,64,26,24,50,10
2020-11-27,LB,Bulgaria,816,715,10,4,101,48,43,91,6
2020-11-28,LB,Bulgaria,776,728,2,0,48,21,25,46,2
2020-11-29,LB,Bulgaria,825,747,2,0,78,39,37,76,2
2020-11-30,LB,Bulgaria,674,608,4,0,66,29,33,62,4
2020-12-01,LB,Bulgaria,628,560,6,1,68,30,32,62,5
2020-12-02,LB,Bulgaria,783,679,19,4,104,45,40,85,15
2020-12-03,LB,Bulgaria,756,672,9,1,84,35,40,75,8
2020-12-04,LB,Bulgaria,868,760,7,0,108,51,50,101,7
2020-12-05,LB,Bulgaria,868,794,4,1,74,34,36,70,3
2020-12-06,LB,Bulgaria,880,792,3,0,88,44,41,85,3
2020-12-07,LB,Bulgaria,693,615,3,0,78,37,38,75,3
2020-12-08,LB,Bulgaria,633,547,14,11,86,34,38,72,3
2020-12-09,LB,Bulgaria,786,694,8,4,92,43,41,84,4
2020-12-10,LB,Bulgaria,808,737,6,2,71,34,31,65,4
2020-12-11,LB,Bulgaria,890,757,6,1,133,63,64,127,5
2020-12-12,LB,Bulgaria,907,828,2,0,79,40,37,77,2
2020-12-13,LB,Bulgaria,918,821,5,0,97,44,48,92,5
2020-12-14,LB,Bulgaria,778,679,10,0,99,45,44,89,10
2020-12-15,LB,Bulgaria,745,651,15,1,94,39,40,79,14
2020-12-16,LB,Bulgaria,871,760,20,6,111,46,45,91,14
2020-12-17,LB,Bulgaria,939,818,10,0,121,54,57,111,10
2020-12-18,LB,Bulgaria,1066,908,14,4,158,71,73,144,10
2020-12-19,LB,Bulgaria,1118,993,5,0,125,58,62,120,5
2020-12-20,LB,Bulgaria,1054,916,4,0,138,68,66,134,4
2020-12-21,LB,Bulgaria,808,710,7,0,98,47,44,91,7
2020-12-22,LB,Bulgaria,754,648,7,0,106,50,49,99,7
2020-12-23,LB,Bulgaria,907,762,7,0,145,69,69,138,7
2020-12-24,LB,Bulgaria,765,681,4,0,84,40,40,80,4
2020-12-25,LB,Bulgaria,728,687,2,0,41,20,19,39,2
2020-12-26,LB,Bulgaria,887,832,2,0,55,28,25,53,2
2020-12-27,LB,Bulgaria,917,815,7,0,102,49,46,95,7
2020-12-28,LB,Bulgaria,777,682,6,0,95,45,44,89,6
2020-12-29,LB,Bulgaria,696,609,5,0,87,41,41,82,5
2020-12-30,LB,Bulgaria,861,764,9,1,97,43,45,88,8
2020-12-31,LB,Bulgaria,640,612,2,0,28,13,13,26,2
2020-01-01,LD,Croatia,1150,1062,17,0,88,36,35,71,17
2020-01-02,LD,Croatia,1387,1243,29,1,144,57,58,115,28
2020-01-03,LD,Croatia,1463,1323,19,1,140,61,60,121,18
2020-01-04,LD,Croatia,1528,1416,16,0,112,49,47,96,16
2020-01-05,LD,Croatia,1511,1397,12,0,114,50,52,102,12
2020-01-06,LD,Croatia,1407,1285,23,0,122,49,50,99,23
2020-01-07,LD,Croatia,1209,1081,24,1,128,51,53,104,23
2020-01-08,LD,Croatia,1251,1132,19,0,119,52,48,100,19
2020-01-09,LD,Croatia,1297,1160,26,1,137,57,54,111,25
2020-01-10,LD,Croatia,1421,1286,29,3,135,53,53,106,26
2020-01-11,LD,Croatia,1388,1287,22,4,101,40,39,79,18
2020-01-12,LD,Croatia,1442,1329,15,2,113,49,49,98,13
2020-01-13,LD,Croatia,1304,1181,16,1,123,53,54,107,15
2020-01-14,LD,Croatia,1146,1028,18,3,118,50,50,100,15
2020-01-15,LD,Croatia,1176,1047,16,1,129,55,58,113,15
2020-01-16,LD,Croatia,1213,1080,26,4,133,55,52,107,22
2020-01-17,LD,Croatia,1331,1203,20,1,128,51,57,108,19
2020-01-18,LD,Croatia,1308,1212,17,0,96,41,38,79,17
2020-01-19,LD,Croatia,1355,1240,16,0,115,51,48,99,16
2020-01-20,LD,Croatia,1266,1141,29,4,125,47,49,96,25
2020-01-21,LD,Croatia,1169,1042,27,2,127,52,48,100,25
2020-01-22,LD,Croatia,1156,1026,26,4,130,53,51,104,22
2020-01-23,LD,Croatia,1190,1057,26,6,133,52,55,107,20
2020-01-24,LD,Croatia,1343,1184,27,4,159,66,66,132,23
2020-01-25,LD,Croatia,1299,1198,18,0,101,41,42,83,18
2020-01-26,LD,Croatia,1318,1199,16,0,119,53,50,103,16
2020-01-27,LD,Croatia,1260,1122,31,2,138,53,54,107,29
2020-01-28,LD,Croatia,1124,989,26,3,135,54,55,109,23
2020-01-29,LD,Croatia,1152,1027,24,5,125,51,50,101,19
2020-01-30,LD,Croatia,1185,1050,28,3,135,52,55,107,25
2020-01-31,LD,Croatia,1452,1306,30,4,146,58,58,116,26
2020-02-01,LD,Croatia,1355,1243,19,0,112,46,47,93,19
2020-02-02,LD,Croatia,1329,1214,17,0,115,51,47,98,17
2020-02-03,LD,Croatia,1267,1134,31,4,133,50,52,102,27
2020-02-04,LD,Croatia,1133,1007,25,2,126,52,49,101,23
2020-02-05,LD,Croatia,1159,1040,22,2,119,48,49,97,20
2020-02-06,LD,Croatia,1184,1042,27,2,142,57,58,115,25
2020-02-07,LD,Croatia,1418,1269,29,0,149,59,61,120,29
2020-02-08,LD,Croatia,1355,1255,15,0,100,42,43,85,15
2020-02-09,LD,Croatia,1345,1228,19,1,117,48,50,98,18
2020-02-10,LD,Croatia,1221,1099,26,0,122,47,49,96,26
2020-02-11,LD,Croatia,1156,1017,32,5,139,54,53,107,27
2020-02-12,LD,Croatia,1182,1047,23,3,135,55,57,112,20
2020-02-13,LD,Croatia,1200,1050,23,0,150,65,62,127,23
2020-02-14,LD,Croatia,1393,1249,23,1,144,59,62,121,22
2020-02-15,LD,Croatia,1372,1259,16,0,113,50,47,97,16
2020-02-16,LD,Croatia,1421,1302,14,0,119,52,53,105,14
2020-02-17,LD,Croatia,1316,1173,25,0,143,60,58,118,25
2020-02-18,LD,Croatia,1239,1093,25,0,146,62,59,121,25
2020-02-19,LD,Croatia,1229,1099,21,0,130,52,57,109,21
2020-02-20,LD,Croatia,1280,1140,20,1,140,62,58,120,19
2020-02-21,LD,Croatia,1435,1288,31,3,147,56,60,116,28
2020-02-22,LD,Croatia,1442,1319,19,1,123,52,52,104,18
2020-02-23,LD,Croatia,1472,1344,15,0,128,55,58,113,15
2020-02-24,LD,Croatia,1354,1211,29,2,143,58,56,114,27
2020-02-25,LD,Croatia,1203,1049,25,0,154,62,67,129,25
2020-02-26,LD,Croatia,1216,1086,21,2,130,55,54,109,19
2020-02-27,LD,Croatia,1240,1103,23,0,137,58,56,114,23
2020-02-28,LD,Croatia,1416,1273,22,1,143,58,63,121,21
2020-02-29,LD,Croatia,1383,1270,13,0,113,53,47,100,13
2020-03-01,LD,Croatia,1370,1242,18,0,128,54,56,110,18
2020-03-02,LD,Croatia,1307,1164,29,1,143,56,58,114,28
2020-03-03,LD,Croatia,1181,1034,25,0,147,63,59,122,25
2020-03-04,LD,Croatia,1160,1012,21,0,148,60,67,127,21
2020-03-05,LD,Croatia,1188,1008,24,0,180,76,80,156,24
2020-03-06,LD,Croatia,1319,1160,20,0,159,74,65,139,20
2020-03-07,LD,Croatia,1239,1126,16,0,113,50,47,97,16
2020-03-08,LD,Croatia,1251,1121,14,0,130,59,57,116,14
2020-03-09,LD,Croatia,1066,931,27,0,135,53,55,108,27
2020-03-10,LD,Croatia,999,857,23,0,142,60,59,119,23
2020-03-11,LD,Croatia,978,855,22,1,123,49,52,101,21
2020-03-12,LD,Croatia,990,836,24,0,154,65,65,130,24
2020-03-13,LD,Croatia,1029,895,24,0,134,55,55,110,24
2020-03-14,LD,Croatia,939,829,15,0,110,50,45,95,15
2020-03-15,LD,Croatia,957,845,16,0,112,48,48,96,16
2020-03-16,LD,Croatia,865,751,28,1,114,43,43,86,27
2020-03-17,LD,Croatia,733,640,23,1,93,35,35,70,22
2020-03-18,LD,Croatia,747,653,21,2,94,36,37,73,19
2020-03-19,LD,Croatia,648,568,15,1,80,33,32,65,14
2020-03-20,LD,Croatia,637,565,18,1,72,27,27,54,17
2020-03-21,LD,Croatia,447,409,8,1,38,15,15,30,7
2020-03-22,LD,Croatia,346,308,4,0,38,17,17,34,4
2020-03-23,LD,Croatia,294,248,11,1,46,17,18,35,10
2020-03-24,LD,Croatia,253,215,4,0,38,17,17,34,4
2020-03-25,LD,Croatia,205,166,2,0,39,18,19,37,2
2020-03-26,LD,Croatia,186,159,0,0,27,14,13,27,0
2020-03-27,LD,Croatia,188,148,2,1,40,19,19,38,1
2020-03-28,LD,Croatia,164,146,0,0,18,9,9,18,0
2020-03-29,LD,Croatia,133,118,1,1,15,7,7,14,0
2020-03-30,LD,Croatia,132,102,0,0,30,15,15,30,0
2020-03-31,LD,Croatia,154,137,0,0,17,8,9,17,0
2020-04-01,LD,Croatia,160,136,0,0,24,12,12,24,0
2020-04-02,LD,Croatia,155,137,0,0,18,9,9,18,0
2020-04-03,LD,Croatia,165,136,0,0,29,15,14,29,0
2020-04-04,LD,Croatia,137,122,0,0,15,7,8,15,0
2020-04-05,LD,Croatia,126,120,0,0,6,3,3,6,0
2020-04-06,LD,Croatia,123,107,0,0,16,8,8,16,0
2020-04-07,LD,Croatia,125,111,2,0,14,6,6,12,2
2020-04-08,LD,Croatia,148,133,2,1,15,7,6,13,1
2020-04-09,LD,Croatia,146,130,0,0,16,8,8,16,0
2020-04-10,LD,Croatia,131,114,0,0,17,8,9,17,0
2020-04-11,LD,Croatia,107,105,0,0,2,1,1,2,0
2020-04-12,LD,Croatia,100,94,0,0,6,3,3,6,0
2020-04-13,LD,Croatia,114,106,0,0,8,4,4,8,0
2020-04-14,LD,Croatia,109,92,0,0,17,8,9,17,0
2020-04-15,LD,Croatia,138,124,0,0,14,7,7,14,0
2020-04-16,LD,Croatia,116,102,2,0,14,6,6,12,2
2020-04-17,LD,Croatia,132,118,0,0,14,7,7,14,0
2020-04-18,LD,Croatia,106,98,0,0,8,4,4,8,0
2020-04-19,LD,Croatia,94,88,0,0,6,3,3,6,0
2020-04-20,LD,Croatia,121,107,0,0,14,7,7,14,0
2020-04-21,LD,Croatia,135,114,1,1,21,10,10,20,0
2020-04-22,LD,Croatia,150,129,3,3,21,9,9,18,0
2020-04-23,LD,Croatia,167,152,2,0,15,7,6,13,2
2020-04-24,LD,Croatia,146,128,1,1,18,8,9,17,0
2020-04-25,LD,Croatia,125,119,0,0,6,3,3,6,0
2020-04-26,LD,Croatia,114,108,0,0,6,3,3,6,0
2020-04-27,LD,Croatia,137,123,0,0,14,7,7,14,0
2020-04-28,LD,Croatia,150,137,0,0,13,6,7,13,0
2020-04-29,LD,Croatia,163,150,0,0,13,7,6,13,0
2020-04-30,LD,Croatia,163,147,2,1,16,7,7,14,1
2020-05-01,LD,Croatia,160,154,0,0,6,3,3,6,0
2020-05-02,LD,Croatia,158,141,0,0,17,9,8,17,0
2020-05-03,LD,Croatia,128,123,1,0,5,2,2,4,1
2020-05-04,LD,Croatia,141,115,4,1,26,11,11,22,3
2020-05-05,LD,Croatia,138,129,1,1,9,4,4,8,0
2020-05-06,LD,Croatia,166,143,2,1,23,10,11,21,1
2020-05-07,LD,Croatia,169,153,2,2,16,7,7,14,0
2020-05-08,LD,Croatia,177,159,0,0,18,9,9,18,0
2020-05-09,LD,Croatia,164,153,0,0,11,6,5,11,0
2020-05-10,LD,Croatia,131,122,0,0,9,4,5,9,0
2020-05-11,LD,Croatia,170,143,9,0,27,8,10,18,9
2020-05-12,LD,Croatia,162,139,8,0,23,8,7,15,8
2020-05-13,LD,Croatia,173,141,11,2,32,11,10,21,9
2020-05-14,LD,Croatia,170,144,8,0,26,9,9,18,8
2020-05-15,LD,Croatia,198,164,11,3,34,9,14,23,8
2020-05-16,LD,Croatia,158,146,6,0,12,3,3,6,6
2020-05-17,LD,Croatia,158,128,11,3,30,10,9,19,8
2020-05-18,LD,Croatia,176,148,12,5,28,7,9,16,7
2020-05-19,LD,Croatia,160,132,16,6,28,6,6,12,10
2020-05-20,LD,Croatia,222,175,15,6,47,12,20,32,9
2020-05-21,LD,Croatia,212,176,9,0,36,13,14,27,9
2020-05-22,LD,Croatia,218,170,9,1,48,19,20,39,8
2020-05-23,LD,Croatia,204,170,9,0,34,12,13,25,9
2020-05-24,LD,Croatia,172,140,7,0,32,17,8,25,7
2020-05-25,LD,Croatia,184,139,14,5,45,16,15,31,9
2020-05-26,LD,Croatia,220,164,20,6,56,17,19,36,14
2020-05-27,LD,Croatia,247,180,14,3,67,27,26,53,11
2020-05-28,LD,Croatia,225,168,22,4,57,16,19,35,18
2020-05-29,LD,Croatia,211,153,10,1,58,18,30,48,9
2020-05-30,LD,Croatia,214,172,11,1,42,12,19,31,10
2020-05-31,LD,Croatia,193,156,10,1,37,12,15,27,9
2020-06-01,LD,Croatia,227,158,15,5,69,32,22,54,10
2020-06-02,LD,Croatia,231,165,15,3,66,27,24,51,12
2020-06-03,LD,Croatia,273,204,18,7,69,29,22,51,11
2020-06-04,LD,Croatia,257,193,11,1,64,26,27,53,10
2020-06-05,LD,Croatia,290,222,12,2,68,23,33,56,10
2020-06-06,LD,Croatia,289,227,15,0,62,20,27,47,15
2020-06-07,LD,Croatia,293,222,13,4,71,35,23,58,9
2020-06-08,LD,Croatia,266,202,13,0,64,27,24,51,13
2020-06-09,LD,Croatia,251,197,16,4,54,18,20,38,12
2020-06-10,LD,Croatia,304,216,19,5,88,27,42,69,14
2020-06-11,LD,Croatia,300,231,17,3,69,21,31,52,14
2020-06-12,LD,Croatia,330,246,15,0,84,28,41,69,15
2020-06-13,LD,Croatia,312,241,18,1,71,28,25,53,17
2020-06-14,LD,Croatia,330,244,14,1,86,44,28,72,13
2020-06-15,LD,Croatia,389,287,14,1,102,44,44,88,13
2020-06-16,LD,Croatia,379,265,19,5,114,48,47,95,14
2020-06-17,LD,Croatia,411,304,23,5,107,41,43,84,18
2020-06-18,LD,Croatia,418,322,21,5,96,37,38,75,16
2020-06-19,LD,Croatia,524,386,20,4,138,52,66,118,16
2020-06-20,LD,Croatia,509,366,15,2,143,59,69,128,13
2020-06-21,LD,Croatia,469,336,17,1,133,70,46,116,16
2020-06-22,LD,Croatia,477,345,24,0,132,53,55,108,24
2020-06-23,LD,Croatia,456,343,23,2,113,46,44,90,21
2020-06-24,LD,Croatia,500,376,23,3,124,50,51,101,20
2020-06-25,LD,Croatia,529,387,27,2,142,50,65,115,25
2020-06-26,LD,Croatia,622,451,25,2,171,67,79,146,23
2020-06-27,LD,Croatia,610,465,19,0,145,61,65,126,19
2020-06-28,LD,Croatia,617,478,21,0,139,65,53,118,21
2020-06-29,LD,Croatia,570,431,30,1,139,56,53,109,29
2020-06-30,LD,Croatia,558,429,24,1,129,52,53,105,23
2020-07-01,LD,Croatia,928,743,22,1,185,84,79,163,21
2020-07-02,LD,Croatia,963,796,30,6,167,62,75,137,24
2020-07-03,LD,Croatia,1103,905,25,5,198,82,91,173,20
2020-07-04,LD,Croatia,1220,981,14,0,239,110,115,225,14
2020-07-05,LD,Croatia,1156,906,21,0,250,123,106,229,21
2020-07-06,LD,Croatia,1034,812,31,2,222,96,95,191,29
2020-07-07,LD,Croatia,931,755,26,2,176,78,72,150,24
2020-07-08,LD,Croatia,977,779,27,3,198,85,86,171,24
2020-07-09,LD,Croatia,999,791,24,1,208,90,94,184,23
2020-07-10,LD,Croatia,1208,963,31,3,245,99,115,214,28
2020-07-11,LD,Croatia,1288,992,21,1,296,135,140,275,20
2020-07-12,LD,Croatia,1241,961,20,0,280,141,119,260,20
2020-07-13,LD,Croatia,1063,847,31,3,216,92,93,185,28
2020-07-14,LD,Croatia,925,728,32,3,197,83,82,165,29
2020-07-15,LD,Croatia,1059,826,32,5,233,98,103,201,27
2020-07-16,LD,Croatia,1036,790,29,0,246,103,114,217,29
2020-07-17,LD,Croatia,1232,951,39,3,281,115,127,242,36
2020-07-18,LD,Croatia,1451,1106,23,2,345,161,161,322,21
2020-07-19,LD,Croatia,1294,985,25,1,309,150,134,284,24
2020-07-20,LD,Croatia,1092,836,36,3,256,112,108,220,33
2020-07-21,LD,Croatia,1087,841,36,8,246,104,106,210,28
2020-07-22,LD,Croatia,1107,862,27,2,245,110,108,218,25
2020-07-23,LD,Croatia,1142,882,37,6,260,108,115,223,31
2020-07-24,LD,Croatia,1304,1039,37,5,265,110,118,228,32
2020-07-25,LD,Croatia,1613,1234,28,0,379,172,179,351,28
2020-07-26,LD,Croatia,1377,1076,20,0,301,148,133,281,20
2020-07-27,LD,Croatia,1154,885,38,8,269,114,117,231,30
2020-07-28,LD,Croatia,1146,884,33,4,262,115,114,229,29
2020-07-29,LD,Croatia,1170,914,29,6,256,114,113,227,23
2020-07-30,LD,Croatia,1151,881,29,1,270,113,128,241,28
2020-07-31,LD,Croatia,1390,1072,35,3,318,140,143,283,32
2020-08-01,LD,Croatia,1957,1491,31,0,466,213,222,435,31
2020-08-02,LD,Croatia,1706,1299,29,0,407,197,181,378,29
2020-08-03,LD,Croatia,1365,1078,37,9,287,132,118,250,28
2020-08-04,LD,Croatia,1335,1081,35,3,254,108,111,219,32
2020-08-05,LD,Croatia,1374,1089,23,0,285,129,133,262,23
2020-08-06,LD,Croatia,1322,1004,42,6,318,136,140,276,36
2020-08-07,LD,Croatia,1510,1165,40,1,345,146,159,305,39
2020-08-08,LD,Croatia,1916,1452,27,1,464,218,219,437,26
2020-08-09,LD,Croatia,1670,1297,25,0,373,181,167,348,25
2020-08-10,LD,Croatia,1408,1086,44,6,322,136,142,278,38
2020-08-11,LD,Croatia,1301,1040,26,1,261,118,117,235,25
2020-08-12,LD,Croatia,1359,1062,25,1,297,131,141,272,24
2020-08-13,LD,Croatia,1318,1021,43,6,297,130,124,254,37
2020-08-14,LD,Croatia,1546,1205,46,7,341,146,149,295,39
2020-08-15,LD,Croatia,1957,1494,32,1,463,217,214,431,31
2020-08-16,LD,Croatia,1752,1322,31,4,430,204,195,399,27
2020-08-17,LD,Croatia,1460,1154,44,7,306,139,123,262,37
2020-08-18,LD,Croatia,1279,1020,32,3,259,111,116,227,29
2020-08-19,LD,Croatia,1360,1053,33,7,307,135,139,274,26
2020-08-20,LD,Croatia,1370,1068,36,6,302,128,138,266,30
2020-08-21,LD,Croatia,1545,1204,39,1,341,151,151,302,38
2020-08-22,LD,Croatia,1931,1498,33,0,433,198,202,400,33
2020-08-23,LD,Croatia,1682,1295,30,0,387,188,169,357,30
2020-08-24,LD,Croatia,1360,1063,30,1,297,133,134,267,29
2020-08-25,LD,Croatia,1326,1050,27,2,276,122,127,249,25
2020-08-26,LD,Croatia,1368,1101,22,1,267,126,119,245,21
2020-08-27,LD,Croatia,1345,1062,32,2,283,124,127,251,30
2020-08-28,LD,Croatia,1564,1249,38,4,315,139,138,277,34
2020-08-29,LD,Croatia,1910,1501,31,0,409,193,185,378,31
2020-08-30,LD,Croatia,1653,1295,26,0,358,171,161,332,26
2020-08-31,LD,Croatia,1260,1033,34,2,227,98,95,193,32
2020-09-01,LD,Croatia,1202,975,30,2,227,99,98,197,28
2020-09-02,LD,Croatia,1184,1004,16,1,180,83,81,164,15
2020-09-03,LD,Croatia,1256,1011,32,0,245,99,114,213,32
2020-09-04,LD,Croatia,1387,1165,34,2,222,91,97,188,32
2020-09-05,LD,Croatia,1723,1395,27,0,328,146,155,301,27
2020-09-06,LD,Croatia,1499,1230,22,2,269,127,120,247,20
2020-09-07,LD,Croatia,1200,992,27,2,208,95,86,181,25
2020-09-08,LD,Croatia,1131,946,27,1,185,81,77,158,26
2020-09-09,LD,Croatia,1180,1014,23,3,166,70,73,143,20
2020-09-10,LD,Croatia,1162,964,30,2,198,82,86,168,28
2020-09-11,LD,Croatia,1302,1116,32,1,186,72,82,154,31
2020-09-12,LD,Croatia,1654,1340,27,2,314,144,143,287,25
2020-09-13,LD,Croatia,1472,1223,21,1,249,120,108,228,20
2020-09-14,LD,Croatia,1081,917,27,2,164,70,67,137,25
2020-09-15,LD,Croatia,1055,892,28,2,163,68,67,135,26
2020-09-16,LD,Croatia,1025,877,21,0,148,63,64,127,21
2020-09-17,LD,Croatia,983,824,28,2,159,64,67,131,26
2020-09-18,LD,Croatia,1215,1035,27,0,180,72,81,153,27
2020-09-19,LD,Croatia,1551,1285,18,0,266,123,125,248,18
2020-09-20,LD,Croatia,1376,1157,27,1,219,104,88,192,26
2020-09-21,LD,Croatia,993,850,30,0,143,59,54,113,30
2020-09-22,LD,Croatia,892,755,25,0,137,56,56,112,25
2020-09-23,LD,Croatia,985,858,20,0,127,55,52,107,20
2020-09-24,LD,Croatia,897,740,33,0,157,63,61,124,33
2020-09-25,LD,Croatia,1127,973,33,3,154,59,62,121,30
2020-09-26,LD,Croatia,1464,1257,16,0,207,97,94,191,16
2020-09-27,LD,Croatia,1211,1035,25,2,176,74,77,151,23
2020-09-28,LD,Croatia,923,795,31,3,128,51,46,97,28
2020-09-29,LD,Croatia,886,772,28,1,114,41,45,86,27
2020-09-30,LD,Croatia,954,841,18,1,113,46,49,95,17
2020-10-01,LD,Croatia,872,744,28,1,128,51,49,100,27
2020-10-02,LD,Croatia,1098,967,29,1,131,52,50,102,28
2020-10-03,LD,Croatia,1256,1099,15,0,157,69,73,142,15
2020-10-04,LD,Croatia,1084,949,23,0,135,60,52,112,23
2020-10-05,LD,Croatia,897,773,24,0,124,50,50,100,24
2020-10-06,LD,Croatia,748,662,22,1,86,31,33,64,21
2020-10-07,LD,Croatia,747,654,21,0,93,35,37,72,21
2020-10-08,LD,Croatia,791,677,28,3,114,41,45,86,25
2020-10-09,LD,Croatia,993,871,27,4,122,44,51,95,23
2020-10-10,LD,Croatia,1274,1150,15,2,124,57,52,109,13
2020-10-11,LD,Croatia,1144,1028,23,2,116,51,42,93,21
2020-10-12,LD,Croatia,859,764,26,0,95,36,33,69,26
2020-10-13,LD,Croatia,748,670,19,1,78,28,31,59,18
2020-10-14,LD,Croatia,789,693,18,1,96,39,39,78,17
2020-10-15,LD,Croatia,595,497,26,0,98,35,37,72,26
2020-10-16,LD,Croatia,1143,1020,25,0,123,45,53,98,25
2020-10-17,LD,Croatia,1307,1177,18,0,130,58,54,112,18
2020-10-18,LD,Croatia,1018,921,15,0,97,42,40,82,15
2020-10-19,LD,Croatia,853,754,23,2,99,38,38,76,21
2020-10-20,LD,Croatia,710,627,25,1,83,28,30,58,24
2020-10-21,LD,Croatia,756,653,20,2,103,41,42,83,18
2020-10-22,LD,Croatia,750,655,28,5,95,34,33,67,23
2020-10-23,LD,Croatia,942,830,25,3,112,45,42,87,22
2020-10-24,LD,Croatia,1250,1128,17,1,122,54,51,105,16
2020-10-25,LD,Croatia,961,885,11,0,76,32,33,65,11
2020-10-26,LD,Croatia,664,576,20,1,88,32,36,68,19
2020-10-27,LD,Croatia,610,538,19,3,72,28,25,53,16
2020-10-28,LD,Croatia,684,599,17,0,85,33,35,68,17
2020-10-29,LD,Croatia,691,613,22,6,78,23,33,56,16
2020-10-30,LD,Croatia,901,776,29,5,125,45,51,96,24
2020-10-31,LD,Croatia,980,900,12,0,80,35,33,68,12
2020-11-01,LD,Croatia,901,821,13,0,80,40,27,67,13
2020-11-02,LD,Croatia,622,539,24,1,83,31,28,59,23
2020-11-03,LD,Croatia,521,456,28,6,65,18,19,37,22
2020-11-04,LD,Croatia,519,433,19,1,86,31,36,67,18
2020-11-05,LD,Croatia,558,485,29,4,73,21,23,44,25
2020-11-06,LD,Croatia,655,553,26,0,102,36,40,76,26
2020-11-07,LD,Croatia,682,620,12,1,62,24,26,50,11
2020-11-08,LD,Croatia,708,625,16,0,83,38,29,67,16
2020-11-09,LD,Croatia,505,424,21,0,81,30,30,60,21
2020-11-10,LD,Croatia,439,378,23,1,61,19,19,38,22
2020-11-11,LD,Croatia,496,413,21,0,83,32,30,62,21
2020-11-12,LD,Croatia,467,404,21,1,63,21,21,42,20
2020-11-13,LD,Croatia,557,473,23,0,84,30,31,61,23
2020-11-14,LD,Croatia,516,457,12,0,59,24,23,47,12
2020-11-15,LD,Croatia,590,518,20,0,72,25,27,52,20
2020-11-16,LD,Croatia,441,358,24,0,83,28,31,59,24
2020-11-17,LD,Croatia,408,326,25,2,82,29,28,57,23
2020-11-18,LD,Croatia,438,371,19,0,67,27,21,48,19
2020-11-19,LD,Croatia,440,365,19,1,75,26,30,56,18
2020-11-20,LD,Croatia,482,403,27,4,79,27,25,52,23
2020-11-21,LD,Croatia,454,407,13,5,47,15,19,34,8
2020-11-22,LD,Croatia,498,432,22,5,66,22,22,44,17
2020-11-23,LD,Croatia,388,309,22,3,79,28,29,57,19
2020-11-24,LD,Croatia,340,292,21,3,48,14,13,27,18
2020-11-25,LD,Croatia,439,367,16,0,72,30,26,56,16
2020-11-26,LD,Croatia,360,302,20,0,58,17,21,38,20
2020-11-27,LD,Croatia,494,418,20,0,76,27,29,56,20
2020-11-28,LD,Croatia,408,369,9,1,39,15,15,30,8
2020-11-29,LD,Croatia,475,418,19,3,57,21,17,38,16
2020-11-30,LD,Croatia,404,331,22,2,73,25,26,51,20
2020-12-01,LD,Croatia,327,272,16,0,55,20,19,39,16
2020-12-02,LD,Croatia,426,360,16,0,66,26,24,50,16
2020-12-03,LD,Croatia,434,380,18,0,54,18,18,36,18
2020-12-04,LD,Croatia,513,440,17,1,73,29,27,56,16
2020-12-05,LD,Croatia,437,411,10,0,26,8,8,16,10
2020-12-06,LD,Croatia,479,427,17,0,52,17,18,35,17
2020-12-07,LD,Croatia,427,361,17,1,66,24,25,49,16
2020-12-08,LD,Croatia,334,293,15,0,41,13,13,26,15
2020-12-09,LD,Croatia,444,383,13,0,61,21,27,48,13
2020-12-10,LD,Croatia,481,416,19,1,65,25,21,46,18
2020-12-11,LD,Croatia,531,453,18,0,78,32,28,60,18
2020-12-12,LD,Croatia,524,486,10,0,38,13,15,28,10
2020-12-13,LD,Croatia,548,494,20,2,54,18,16,34,18
2020-12-14,LD,Croatia,509,442,19,0,67,25,23,48,19
2020-12-15,LD,Croatia,448,390,19,0,58,19,20,39,19
2020-12-16,LD,Croatia,542,463,17,0,79,30,32,62,17
2020-12-17,LD,Croatia,625,563,17,1,62,22,23,45,16
2020-12-18,LD,Croatia,789,698,19,0,91,37,35,72,19
2020-12-19,LD,Croatia,861,815,11,0,46,18,17,35,11
2020-12-20,LD,Croatia,800,736,15,0,64,23,26,49,15
2020-12-21,LD,Croatia,615,543,20,0,72,27,25,52,20
2020-12-22,LD,Croatia,576,521,21,3,55,18,16,34,18
2020-12-23,LD,Croatia,671,580,20,4,91,34,37,71,16
2020-12-24,LD,Croatia,562,512,15,1,50,18,17,35,14
2020-12-25,LD,Croatia,338,325,0,0,13,7,6,13,0
2020-12-26,LD,Croatia,512,484,9,0,28,9,10,19,9
2020-12-27,LD,Croatia,630,572,13,0,58,23,22,45,13
2020-12-28,LD,Croatia,517,452,27,4,65,20,18,38,23
2020-12-29,LD,Croatia,425,378,18,1,47,14,15,29,17
2020-12-30,LD,Croatia,539,470,20,3,69,22,27,49,17
2020-12-31,LD,Croatia,336,300,11,0,36,12,13,25,11
2020-01-01,LC,Cyprus,923,776,4,4,147,69,74,143,0
2020-01-02,LC,Cyprus,1146,989,5,5,157,78,74,152,0
2020-01-03,LC,Cyprus,1008,864,3,3,144,68,73,141,0
2020-01-04,LC,Cyprus,1125,941,1,1,184,92,91,183,0
2020-01-05,LC,Cyprus,1185,1015,2,2,170,86,82,168,0
2020-01-06,LC,Cyprus,1007,845,2,0,162,78,82,160,2
2020-01-07,LC,Cyprus,1009,858,6,6,151,70,75,145,0
2020-01-08,LC,Cyprus,1057,877,6,6,180,86,88,174,0
2020-01-09,LC,Cyprus,1183,1007,8,8,176,86,82,168,0
2020-01-10,LC,Cyprus,1027,846,7,7,181,82,92,174,0
2020-01-11,LC,Cyprus,1099,917,0,0,182,93,89,182,0
2020-01-12,LC,Cyprus,1224,1030,5,5,194,92,97,189,0
2020-01-13,LC,Cyprus,1023,853,7,7,170,82,81,163,0
2020-01-14,LC,Cyprus,1012,876,6,6,136,65,65,130,0
2020-01-15,LC,Cyprus,990,823,6,6,167,79,82,161,0
2020-01-16,LC,Cyprus,1078,949,0,0,129,66,63,129,0
2020-01-17,LC,Cyprus,975,823,5,5,152,73,74,147,0
2020-01-18,LC,Cyprus,1088,933,0,0,155,77,78,155,0
2020-01-19,LC,Cyprus,1196,1011,5,5,185,90,90,180,0
2020-01-20,LC,Cyprus,1041,885,5,5,156,75,76,151,0
2020-01-21,LC,Cyprus,979,851,4,4,128,61,63,124,0
2020-01-22,LC,Cyprus,1001,841,6,5,160,77,77,154,1
2020-01-23,LC,Cyprus,1107,971,9,8,136,66,61,127,1
2020-01-24,LC,Cyprus,971,821,4,4,150,73,73,146,0
2020-01-25,LC,Cyprus,996,857,0,0,139,70,69,139,0
2020-01-26,LC,Cyprus,1098,923,4,4,175,83,88,171,0
2020-01-27,LC,Cyprus,928,784,7,7,144,69,68,137,0
2020-01-28,LC,Cyprus,924,799,8,7,125,59,58,117,1
2020-01-29,LC,Cyprus,966,810,10,10,156,75,71,146,0
2020-01-30,LC,Cyprus,1057,913,9,9,144,66,69,135,0
2020-01-31,LC,Cyprus,993,839,6,6,154,77,71,148,0
2020-02-01,LC,Cyprus,1059,914,0,0,145,70,75,145,0
2020-02-02,LC,Cyprus,1151,990,6,6,161,79,76,155,0
2020-02-03,LC,Cyprus,965,814,8,8,151,71,72,143,0
2020-02-04,LC,Cyprus,943,817,8,7,126,58,60,118,1
2020-02-05,LC,Cyprus,887,736,3,3,151,77,71,148,0
2020-02-06,LC,Cyprus,1074,935,6,6,139,65,68,133,0
2020-02-07,LC,Cyprus,916,761,8,8,155,72,75,147,0
2020-02-08,LC,Cyprus,1024,865,1,0,159,81,77,158,1
2020-02-09,LC,Cyprus,1123,958,6,6,165,82,77,159,0
2020-02-10,LC,Cyprus,954,800,8,8,154,72,74,146,0
2020-02-11,LC,Cyprus,944,795,7,7,149,72,70,142,0
2020-02-12,LC,Cyprus,942,778,8,8,164,76,80,156,0
2020-02-13,LC,Cyprus,1068,912,9,9,156,75,72,147,0
2020-02-14,LC,Cyprus,941,779,7,7,162,74,81,155,0
2020-02-15,LC,Cyprus,1017,843,1,1,174,82,91,173,0
2020-02-16,LC,Cyprus,1142,955,1,1,187,101,85,186,0
2020-02-17,LC,Cyprus,982,830,7,7,152,73,72,145,0
2020-02-18,LC,Cyprus,936,796,6,6,140,70,64,134,0
2020-02-19,LC,Cyprus,981,826,7,7,155,73,75,148,0
2020-02-20,LC,Cyprus,1066,902,8,8,164,76,80,156,0
2020-02-21,LC,Cyprus,1002,841,5,5,161,80,76,156,0
2020-02-22,LC,Cyprus,1032,864,0,0,168,84,84,168,0
2020-02-23,LC,Cyprus,1114,943,6,5,171,84,81,165,1
2020-02-24,LC,Cyprus,955,802,5,5,153,74,74,148,0
2020-02-25,LC,Cyprus,978,837,7,7,141,70,64,134,0
2020-02-26,LC,Cyprus,940,762,7,7,178,82,89,171,0
2020-02-27,LC,Cyprus,1060,894,8,8,166,78,80,158,0
2020-02-28,LC,Cyprus,954,802,6,6,152,74,72,146,0
2020-02-29,LC,Cyprus,991,817,1,1,174,89,84,173,0
2020-03-01,LC,Cyprus,1098,906,6,6,192,94,92,186,0
2020-03-02,LC,Cyprus,932,782,4,4,150,70,76,146,0
2020-03-03,LC,Cyprus,918,766,7,7,152,77,68,145,0
2020-03-04,LC,Cyprus,966,772,9,9,194,91,94,185,0
2020-03-05,LC,Cyprus,1040,870,7,7,170,82,81,163,0
2020-03-06,LC,Cyprus,889,722,8,8,167,78,81,159,0
2020-03-07,LC,Cyprus,930,760,0,0,170,87,83,170,0
2020-03-08,LC,Cyprus,1002,816,4,4,186,90,92,182,0
2020-03-09,LC,Cyprus,792,633,4,4,159,78,77,155,0
2020-03-10,LC,Cyprus,780,631,6,6,149,71,72,143,0
2020-03-11,LC,Cyprus,803,618,6,6,185,89,90,179,0
2020-03-12,LC,Cyprus,759,591,11,8,168,72,85,157,3
2020-03-13,LC,Cyprus,747,579,7,6,168,85,76,161,1
2020-03-14,LC,Cyprus,757,581,0,0,176,89,87,176,0
2020-03-15,LC,Cyprus,764,606,5,5,158,78,75,153,0
2020-03-16,LC,Cyprus,677,527,6,6,150,75,69,144,0
2020-03-17,LC,Cyprus,533,447,6,6,86,42,38,80,0
2020-03-18,LC,Cyprus,555,458,5,5,97,45,47,92,0
2020-03-19,LC,Cyprus,417,340,6,5,77,37,34,71,1
2020-03-20,LC,Cyprus,342,277,5,5,65,32,28,60,0
2020-03-21,LC,Cyprus,274,217,0,0,57,28,29,57,0
2020-03-22,LC,Cyprus,199,177,5,5,22,8,9,17,0
2020-03-23,LC,Cyprus,149,125,7,7,24,9,8,17,0
2020-03-24,LC,Cyprus,160,135,5,5,25,10,10,20,0
2020-03-25,LC,Cyprus,153,122,6,6,31,12,13,25,0
2020-03-26,LC,Cyprus,154,120,8,8,34,13,13,26,0
2020-03-27,LC,Cyprus,129,109,5,5,20,8,7,15,0
2020-03-28,LC,Cyprus,119,103,0,0,16,7,9,16,0
2020-03-29,LC,Cyprus,104,85,4,4,19,8,7,15,0
2020-03-30,LC,Cyprus,98,72,7,7,26,9,10,19,0
2020-03-31,LC,Cyprus,100,79,4,4,21,9,8,17,0
2020-04-01,LC,Cyprus,127,102,5,5,25,10,10,20,0
2020-04-02,LC,Cyprus,110,89,6,6,21,7,8,15,0
2020-04-03,LC,Cyprus,104,77,5,5,27,12,10,22,0
2020-04-04,LC,Cyprus,76,70,0,0,6,2,4,6,0
2020-04-05,LC,Cyprus,96,84,3,3,12,5,4,9,0
2020-04-06,LC,Cyprus,122,94,7,7,28,10,11,21,0
2020-04-07,LC,Cyprus,146,117,7,7,29,12,10,22,0
2020-04-08,LC,Cyprus,135,107,5,5,28,11,12,23,0
2020-04-09,LC,Cyprus,127,102,6,6,25,10,9,19,0
2020-04-10,LC,Cyprus,117,89,4,4,28,11,13,24,0
2020-04-11,LC,Cyprus,106,99,0,0,7,4,3,7,0
2020-04-12,LC,Cyprus,111,96,1,1,15,7,7,14,0
2020-04-13,LC,Cyprus,127,93,7,7,34,13,14,27,0
2020-04-14,LC,Cyprus,115,89,5,5,26,11,10,21,0
2020-04-15,LC,Cyprus,125,103,6,6,22,8,8,16,0
2020-04-16,LC,Cyprus,135,100,4,4,35,15,16,31,0
2020-04-17,LC,Cyprus,118,84,6,6,34,15,13,28,0
2020-04-18,LC,Cyprus,118,104,1,1,14,7,6,13,0
2020-04-19,LC,Cyprus,97,85,4,4,12,4,4,8,0
2020-04-20,LC,Cyprus,116,100,6,6,16,5,5,10,0
2020-04-21,LC,Cyprus,114,94,5,5,20,8,7,15,0
2020-04-22,LC,Cyprus,147,126,7,7,21,6,8,14,0
2020-04-23,LC,Cyprus,133,97,5,5,36,15,16,31,0
2020-04-24,LC,Cyprus,119,88,4,4,31,14,13,27,0
2020-04-25,LC,Cyprus,103,85,1,1,18,8,9,17,0
2020-04-26,LC,Cyprus,106,87,5,5,19,9,5,14,0
2020-04-27,LC,Cyprus,157,129,6,6,28,10,12,22,0
2020-04-28,LC,Cyprus,167,130,6,6,37,14,17,31,0
2020-04-29,LC,Cyprus,153,117,5,5,36,17,14,31,0
2020-04-30,LC,Cyprus,162,125,5,5,37,15,17,32,0
2020-05-01,LC,Cyprus,151,131,4,4,20,8,8,16,0
2020-05-02,LC,Cyprus,143,119,2,2,24,12,10,22,0
2020-05-03,LC,Cyprus,121,110,4,4,11,3,4,7,0
2020-05-04,LC,Cyprus,135,107,6,6,28,12,10,22,0
2020-05-05,LC,Cyprus,171,142,6,6,29,10,13,23,0
2020-05-06,LC,Cyprus,199,163,6,6,36,16,14,30,0
2020-05-07,LC,Cyprus,180,142,5,5,38,17,16,33,0
2020-05-08,LC,Cyprus,183,151,6,6,32,13,13,26,0
2020-05-09,LC,Cyprus,127,108,2,2,19,8,9,17,0
2020-05-10,LC,Cyprus,125,102,5,5,23,9,9,18,0
2020-05-11,LC,Cyprus,148,116,6,6,32,12,14,26,0
2020-05-12,LC,Cyprus,146,124,6,6,22,7,9,16,0
2020-05-13,LC,Cyprus,179,155,5,5,24,8,11,19,0
2020-05-14,LC,Cyprus,191,159,6,6,32,13,13,26,0
2020-05-15,LC,Cyprus,183,153,6,6,30,13,11,24,0
2020-05-16,LC,Cyprus,157,138,1,1,19,8,10,18,0
2020-05-17,LC,Cyprus,160,137,4,4,23,11,8,19,0
2020-05-18,LC,Cyprus,166,132,6,6,34,13,15,28,0
2020-05-19,LC,Cyprus,192,157,5,5,35,15,15,30,0
2020-05-20,LC,Cyprus,189,156,5,5,33,14,14,28,0
2020-05-21,LC,Cyprus,186,148,6,4,38,15,17,32,2
2020-05-22,LC,Cyprus,166,134,3,3,32,16,13,29,0
2020-05-23,LC,Cyprus,141,124,1,1,17,8,8,16,0
2020-05-24,LC,Cyprus,161,139,5,5,22,9,8,17,0
2020-05-25,LC,Cyprus,139,109,6,6,30,11,13,24,0
2020-05-26,LC,Cyprus,163,135,4,4,28,13,11,24,0
2020-05-27,LC,Cyprus,172,136,5,5,36,14,17,31,0
2020-05-28,LC,Cyprus,176,128,5,4,48,23,20,43,1
2020-05-29,LC,Cyprus,135,106,4,4,29,12,13,25,0
2020-05-30,LC,Cyprus,150,137,0,0,13,5,8,13,0
2020-05-31,LC,Cyprus,140,124,4,4,16,8,4,12,0
2020-06-01,LC,Cyprus,155,120,6,6,35,14,15,29,0
2020-06-02,LC,Cyprus,148,113,6,6,35,14,15,29,0
2020-06-03,LC,Cyprus,177,131,6,6,46,20,20,40,0
2020-06-04,LC,Cyprus,171,139,5,4,32,12,15,27,1
2020-06-05,LC,Cyprus,161,120,8,8,41,14,19,33,0
2020-06-06,LC,Cyprus,165,133,1,1,32,17,14,31,0
2020-06-07,LC,Cyprus,139,108,5,5,31,15,11,26,0
2020-06-08,LC,Cyprus,143,118,6,6,25,8,11,19,0
2020-06-09,LC,Cyprus,188,141,6,6,47,21,20,41,0
2020-06-10,LC,Cyprus,215,152,6,6,63,25,32,57,0
2020-06-11,LC,Cyprus,198,140,6,6,58,24,28,52,0
2020-06-12,LC,Cyprus,193,137,6,6,56,29,21,50,0
2020-06-13,LC,Cyprus,172,145,1,0,27,11,15,26,1
2020-06-14,LC,Cyprus,174,136,4,4,38,19,15,34,0
2020-06-15,LC,Cyprus,178,129,5,5,49,23,21,44,0
2020-06-16,LC,Cyprus,175,128,7,7,47,22,18,40,0
2020-06-17,LC,Cyprus,196,144,8,6,52,19,25,44,2
2020-06-18,LC,Cyprus,198,136,6,5,62,26,30,56,1
2020-06-19,LC,Cyprus,211,158,8,8,53,26,19,45,0
2020-06-20,LC,Cyprus,174,129,1,1,45,19,25,44,0
2020-06-21,LC,Cyprus,194,130,4,4,64,30,30,60,0
2020-06-22,LC,Cyprus,214,148,7,7,66,30,29,59,0
2020-06-23,LC,Cyprus,171,125,6,6,46,21,19,40,0
2020-06-24,LC,Cyprus,181,120,6,6,61,27,28,55,0
2020-06-25,LC,Cyprus,221,147,5,5,74,31,38,69,0
2020-06-26,LC,Cyprus,202,123,5,5,79,37,37,74,0
2020-06-27,LC,Cyprus,169,122,2,2,47,21,24,45,0
2020-06-28,LC,Cyprus,189,133,5,4,56,29,22,51,1
2020-06-29,LC,Cyprus,213,149,7,5,64,28,29,57,2
2020-06-30,LC,Cyprus,187,130,6,6,57,26,25,51,0
2020-07-01,LC,Cyprus,263,179,5,5,84,40,39,79,0
2020-07-02,LC,Cyprus,280,178,6,6,102,47,49,96,0
2020-07-03,LC,Cyprus,272,161,5,5,111,53,53,106,0
2020-07-04,LC,Cyprus,243,162,1,1,81,38,42,80,0
2020-07-05,LC,Cyprus,295,187,4,4,108,53,51,104,0
2020-07-06,LC,Cyprus,279,159,6,6,120,54,60,114,0
2020-07-07,LC,Cyprus,271,181,6,6,90,44,40,84,0
2020-07-08,LC,Cyprus,281,173,5,5,108,52,51,103,0
2020-07-09,LC,Cyprus,269,168,7,7,101,45,49,94,0
2020-07-10,LC,Cyprus,312,182,6,6,130,63,61,124,0
2020-07-11,LC,Cyprus,268,161,4,3,107,51,52,103,1
2020-07-12,LC,Cyprus,284,180,4,4,104,51,49,100,0
2020-07-13,LC,Cyprus,275,165,6,6,110,54,50,104,0
2020-07-14,LC,Cyprus,262,173,6,5,89,41,42,83,1
2020-07-15,LC,Cyprus,322,217,8,8,105,48,49,97,0
2020-07-16,LC,Cyprus,329,223,6,6,106,51,49,100,0
2020-07-17,LC,Cyprus,313,185,4,4,128,61,63,124,0
2020-07-18,LC,Cyprus,331,212,0,0,119,58,61,119,0
2020-07-19,LC,Cyprus,340,219,4,4,121,58,59,117,0
2020-07-20,LC,Cyprus,307,189,7,7,118,56,55,111,0
2020-07-21,LC,Cyprus,310,200,6,6,110,53,51,104,0
2020-07-22,LC,Cyprus,352,241,6,6,111,53,52,105,0
2020-07-23,LC,Cyprus,367,234,6,6,133,62,65,127,0
2020-07-24,LC,Cyprus,312,193,5,5,119,58,56,114,0
2020-07-25,LC,Cyprus,346,212,3,2,134,66,65,131,1
2020-07-26,LC,Cyprus,341,217,5,4,124,58,61,119,1
2020-07-27,LC,Cyprus,317,200,7,6,117,54,56,110,1
2020-07-28,LC,Cyprus,323,211,6,5,112,51,55,106,1
2020-07-29,LC,Cyprus,345,229,5,5,116,57,54,111,0
2020-07-30,LC,Cyprus,350,230,5,5,120,59,56,115,0
2020-07-31,LC,Cyprus,326,206,5,5,120,60,55,115,0
2020-08-01,LC,Cyprus,389,242,2,2,147,72,73,145,0
2020-08-02,LC,Cyprus,371,228,4,4,143,71,68,139,0
2020-08-03,LC,Cyprus,352,217,5,5,135,66,64,130,0
2020-08-04,LC,Cyprus,345,222,6,6,123,58,59,117,0
2020-08-05,LC,Cyprus,400,249,7,7,151,70,74,144,0
2020-08-06,LC,Cyprus,460,311,7,7,149,71,71,142,0
2020-08-07,LC,Cyprus,388,258,6,5,130,62,62,124,1
2020-08-08,LC,Cyprus,423,282,4,4,141,70,67,137,0
2020-08-09,LC,Cyprus,409,263,5,5,146,70,71,141,0
2020-08-10,LC,Cyprus,361,242,5,5,119,57,57,114,0
2020-08-11,LC,Cyprus,391,267,7,7,124,56,61,117,0
2020-08-12,LC,Cyprus,397,255,6,6,142,68,68,136,0
2020-08-13,LC,Cyprus,424,278,7,7,146,71,68,139,0
2020-08-14,LC,Cyprus,348,221,5,4,127,63,59,122,1
2020-08-15,LC,Cyprus,397,264,2,2,133,65,66,131,0
2020-08-16,LC,Cyprus,410,258,4,4,152,70,78,148,0
2020-08-17,LC,Cyprus,398,266,6,6,132,62,64,126,0
2020-08-18,LC,Cyprus,393,260,5,5,133,66,62,128,0
2020-08-19,LC,Cyprus,431,274,4,4,157,75,78,153,0
2020-08-20,LC,Cyprus,409,275,7,7,134,61,66,127,0
2020-08-21,LC,Cyprus,393,262,6,5,131,67,58,125,1
2020-08-22,LC,Cyprus,418,267,0,0,151,78,73,151,0
2020-08-23,LC,Cyprus,437,283,6,6,154,70,78,148,0
2020-08-24,LC,Cyprus,380,257,6,6,123,61,56,117,0
2020-08-25,LC,Cyprus,379,250,10,8,129,57,62,119,2
2020-08-26,LC,Cyprus,419,261,9,9,158,77,72,149,0
2020-08-27,LC,Cyprus,460,345,6,6,115,55,54,109,0
2020-08-28,LC,Cyprus,400,258,3,2,142,67,72,139,1
2020-08-29,LC,Cyprus,418,276,0,0,142,72,70,142,0
2020-08-30,LC,Cyprus,451,299,4,4,152,73,75,148,0
2020-08-31,LC,Cyprus,423,296,5,5,127,61,61,122,0
2020-09-01,LC,Cyprus,369,256,7,7,113,53,53,106,0
2020-09-02,LC,Cyprus,433,283,6,6,150,72,72,144,0
2020-09-03,LC,Cyprus,435,324,6,5,111,52,53,105,1
2020-09-04,LC,Cyprus,421,286,7,7,135,63,65,128,0
2020-09-05,LC,Cyprus,457,291,0,0,166,85,81,166,0
2020-09-06,LC,Cyprus,503,331,4,4,172,85,83,168,0
2020-09-07,LC,Cyprus,408,289,5,5,119,58,56,114,0
2020-09-08,LC,Cyprus,383,278,7,7,105,53,45,98,0
2020-09-09,LC,Cyprus,427,275,7,7,152,72,73,145,0
2020-09-10,LC,Cyprus,436,321,3,3,115,52,60,112,0
2020-09-11,LC,Cyprus,410,273,5,5,137,65,67,132,0
2020-09-12,LC,Cyprus,418,252,0,0,166,84,82,166,0
2020-09-13,LC,Cyprus,453,298,6,6,155,75,74,149,0
2020-09-14,LC,Cyprus,385,271,5,5,114,57,52,109,0
2020-09-15,LC,Cyprus,378,271,6,6,107,45,56,101,0
2020-09-16,LC,Cyprus,465,296,4,4,169,85,80,165,0
2020-09-17,LC,Cyprus,466,345,3,3,121,59,59,118,0
2020-09-18,LC,Cyprus,410,289,4,4,121,61,56,117,0
2020-09-19,LC,Cyprus,413,263,0,0,150,74,76,150,0
2020-09-20,LC,Cyprus,466,301,6,6,165,79,80,159,0
2020-09-21,LC,Cyprus,408,287,8,8,121,57,56,113,0
2020-09-22,LC,Cyprus,355,261,4,4,94,46,44,90,0
2020-09-23,LC,Cyprus,433,281,7,6,152,72,73,145,1
2020-09-24,LC,Cyprus,429,328,2,2,101,45,54,99,0
2020-09-25,LC,Cyprus,440,311,5,5,129,67,57,124,0
2020-09-26,LC,Cyprus,433,290,0,0,143,69,74,143,0
2020-09-27,LC,Cyprus,408,250,5,4,158,77,76,153,1
2020-09-28,LC,Cyprus,279,173,7,7,106,48,51,99,0
2020-09-29,LC,Cyprus,404,301,8,8,103,45,50,95,0
2020-09-30,LC,Cyprus,439,286,7,6,153,75,71,146,1
2020-10-01,LC,Cyprus,481,357,5,5,124,64,55,119,0
2020-10-02,LC,Cyprus,405,282,5,5,123,58,60,118,0
2020-10-03,LC,Cyprus,446,304,2,1,142,67,73,140,1
2020-10-04,LC,Cyprus,466,323,5,5,143,73,65,138,0
2020-10-05,LC,Cyprus,371,270,6,5,101,49,46,95,1
2020-10-06,LC,Cyprus,338,262,7,7,76,34,35,69,0
2020-10-07,LC,Cyprus,418,285,5,5,133,60,68,128,0
2020-10-08,LC,Cyprus,440,332,5,5,108,53,50,103,0
2020-10-09,LC,Cyprus,416,311,5,5,105,49,51,100,0
2020-10-10,LC,Cyprus,504,339,3,3,165,82,80,162,0
2020-10-11,LC,Cyprus,506,367,4,4,139,63,72,135,0
2020-10-12,LC,Cyprus,369,282,6,6,87,44,37,81,0
2020-10-13,LC,Cyprus,380,306,5,5,74,33,36,69,0
2020-10-14,LC,Cyprus,437,304,8,6,133,62,63,125,2
2020-10-15,LC,Cyprus,401,303,8,7,98,49,41,90,1
2020-10-16,LC,Cyprus,451,314,7,6,137,64,66,130,1
2020-10-17,LC,Cyprus,485,305,0,0,180,86,94,180,0
2020-10-18,LC,Cyprus,493,333,5,5,160,76,79,155,0
2020-10-19,LC,Cyprus,396,296,6,6,100,50,44,94,0
2020-10-20,LC,Cyprus,356,282,8,8,74,29,37,66,0
2020-10-21,LC,Cyprus,439,309,6,6,130,63,61,124,0
2020-10-22,LC,Cyprus,485,376,7,6,109,49,53,102,1
2020-10-23,LC,Cyprus,449,318,4,4,131,66,61,127,0
2020-10-24,LC,Cyprus,504,340,2,1,164,78,84,162,1
2020-10-25,LC,Cyprus,536,378,7,6,158,79,72,151,1
2020-10-26,LC,Cyprus,405,292,5,5,113,55,53,108,0
2020-10-27,LC,Cyprus,385,313,8,8,72,31,33,64,0
2020-10-28,LC,Cyprus,430,313,6,6,117,56,55,111,0
2020-10-29,LC,Cyprus,480,382,7,7,98,42,49,91,0
2020-10-30,LC,Cyprus,471,316,9,9,155,76,70,146,0
2020-10-31,LC,Cyprus,527,370,0,0,157,86,71,157,0
2020-11-01,LC,Cyprus,529,396,5,5,133,63,65,128,0
2020-11-02,LC,Cyprus,365,288,6,6,77,36,35,71,0
2020-11-03,LC,Cyprus,361,299,6,5,62,25,31,56,1
2020-11-04,LC,Cyprus,417,322,8,7,95,41,46,87,1
2020-11-05,LC,Cyprus,436,355,6,6,81,40,35,75,0
2020-11-06,LC,Cyprus,387,289,6,6,98,46,46,92,0
2020-11-07,LC,Cyprus,432,333,0,0,99,49,50,99,0
2020-11-08,LC,Cyprus,464,349,4,4,115,55,56,111,0
2020-11-09,LC,Cyprus,345,278,6,6,67,31,30,61,0
2020-11-10,LC,Cyprus,393,342,7,7,51,21,23,44,0
2020-11-11,LC,Cyprus,394,327,3,3,67,31,33,64,0
2020-11-12,LC,Cyprus,427,345,7,7,82,36,39,75,0
2020-11-13,LC,Cyprus,361,269,9,8,92,46,37,83,1
2020-11-14,LC,Cyprus,378,313,1,0,65,30,34,64,1
2020-11-15,LC,Cyprus,399,328,4,4,71,37,30,67,0
2020-11-16,LC,Cyprus,334,275,6,6,59,25,28,53,0
2020-11-17,LC,Cyprus,344,295,9,8,49,20,20,40,1
2020-11-18,LC,Cyprus,340,296,7,7,44,19,18,37,0
2020-11-19,LC,Cyprus,376,308,5,4,68,29,34,63,1
2020-11-20,LC,Cyprus,347,268,6,6,79,36,37,73,0
2020-11-21,LC,Cyprus,331,286,0,0,45,24,21,45,0
2020-11-22,LC,Cyprus,373,325,4,4,48,23,21,44,0
2020-11-23,LC,Cyprus,318,268,4,4,50,25,21,46,0
2020-11-24,LC,Cyprus,348,292,5,5,56,26,25,51,0
2020-11-25,LC,Cyprus,363,305,7,7,58,25,26,51,0
2020-11-26,LC,Cyprus,364,305,7,7,59,24,28,52,0
2020-11-27,LC,Cyprus,335,273,6,6,62,31,25,56,0
2020-11-28,LC,Cyprus,344,308,1,1,36,16,19,35,0
2020-11-29,LC,Cyprus,381,328,4,4,53,25,24,49,0
2020-11-30,LC,Cyprus,330,275,3,3,55,27,25,52,0
2020-12-01,LC,Cyprus,348,306,6,6,42,16,20,36,0
2020-12-02,LC,Cyprus,348,290,8,6,58,25,25,50,2
2020-12-03,LC,Cyprus,411,354,5,5,57,27,25,52,0
2020-12-04,LC,Cyprus,365,292,5,5,73,35,33,68,0
2020-12-05,LC,Cyprus,344,311,0,0,33,15,18,33,0
2020-12-06,LC,Cyprus,377,312,5,5,65,32,28,60,0
2020-12-07,LC,Cyprus,353,291,7,7,62,28,27,55,0
2020-12-08,LC,Cyprus,339,293,8,8,46,15,23,38,0
2020-12-09,LC,Cyprus,361,305,5,5,56,28,23,51,0
2020-12-10,LC,Cyprus,405,345,10,8,60,26,24,50,2
2020-12-11,LC,Cyprus,381,302,6,6,79,34,39,73,0
2020-12-12,LC,Cyprus,352,306,1,1,46,22,23,45,0
2020-12-13,LC,Cyprus,394,328,4,4,66,30,32,62,0
2020-12-14,LC,Cyprus,354,295,4,2,59,32,23,55,2
2020-12-15,LC,Cyprus,399,336,7,6,63,25,31,56,1
2020-12-16,LC,Cyprus,383,317,6,6,66,30,30,60,0
2020-12-17,LC,Cyprus,434,353,7,7,81,37,37,74,0
2020-12-18,LC,Cyprus,425,329,6,6,96,45,45,90,0
2020-12-19,LC,Cyprus,444,372,1,1,72,35,36,71,0
2020-12-20,LC,Cyprus,462,371,5,5,91,44,42,86,0
2020-12-21,LC,Cyprus,386,313,7,6,73,33,33,66,1
2020-12-22,LC,Cyprus,375,314,5,5,61,31,25,56,0
2020-12-23,LC,Cyprus,435,346,7,7,89,41,41,82,0
2020-12-24,LC,Cyprus,347,295,6,6,52,24,22,46,0
2020-12-25,LC,Cyprus,292,255,6,6,37,17,14,31,0
2020-12-26,LC,Cyprus,368,304,1,1,64,31,32,63,0
2020-12-27,LC,Cyprus,397,340,5,5,57,25,27,52,0
2020-12-28,LC,Cyprus,369,307,5,5,62,28,29,57,0
2020-12-29,LC,Cyprus,346,287,7,7,59,26,26,52,0
2020-12-30,LC,Cyprus,416,344,6,6,72,35,31,66,0
2020-12-31,LC,Cyprus,288,258,6,6,30,14,10,24,0
2020-01-01,LK,Czech Republic,1643,1327,1,0,316,158,157,315,1
2020-01-02,LK,Czech Republic,2192,1724,26,18,468,218,224,442,8
2020-01-03,LK,Czech Republic,2166,1732,22,6,434,207,205,412,16
2020-01-04,LK,Czech Republic,1945,1615,13,4,330,160,157,317,9
2020-01-05,LK,Czech Republic,2046,1621,24,13,425,197,204,401,11
2020-01-06,LK,Czech Republic,2048,1619,20,6,429,202,207,409,14
2020-01-07,LK,Czech Republic,1744,1403,18,9,341,164,159,323,9
2020-01-08,LK,Czech Republic,1791,1449,19,9,342,161,162,323,10
2020-01-09,LK,Czech Republic,1850,1487,4,0,363,178,181,359,4
2020-01-10,LK,Czech Republic,2009,1588,25,16,421,200,196,396,9
2020-01-11,LK,Czech Republic,1702,1449,14,12,253,118,121,239,2
2020-01-12,LK,Czech Republic,1955,1573,23,13,382,179,180,359,10
2020-01-13,LK,Czech Republic,1878,1473,17,9,405,192,196,388,8
2020-01-14,LK,Czech Republic,1609,1280,31,14,329,151,147,298,17
2020-01-15,LK,Czech Republic,1763,1418,36,14,345,155,154,309,22
2020-01-16,LK,Czech Republic,1832,1407,33,15,425,196,196,392,18
2020-01-17,LK,Czech Republic,1992,1565,23,10,427,202,202,404,13
2020-01-18,LK,Czech Republic,1676,1430,0,0,246,125,121,246,0
2020-01-19,LK,Czech Republic,1827,1461,3,0,366,181,182,363,3
2020-01-20,LK,Czech Republic,1809,1432,19,11,377,182,176,358,8
2020-01-21,LK,Czech Republic,1616,1288,26,11,328,145,157,302,15
2020-01-22,LK,Czech Republic,1675,1335,22,5,340,162,156,318,17
2020-01-23,LK,Czech Republic,1806,1419,19,12,387,184,184,368,7
2020-01-24,LK,Czech Republic,1962,1541,17,4,421,204,200,404,13
2020-01-25,LK,Czech Republic,1584,1331,11,2,253,120,122,242,9
2020-01-26,LK,Czech Republic,1826,1465,7,1,361,175,179,354,6
2020-01-27,LK,Czech Republic,1858,1467,13,2,391,192,186,378,11
2020-01-28,LK,Czech Republic,1614,1293,14,6,321,150,157,307,8
2020-01-29,LK,Czech Republic,1698,1375,17,5,323,158,148,306,12
2020-01-30,LK,Czech Republic,1721,1347,21,12,374,178,175,353,9
2020-01-31,LK,Czech Republic,1933,1528,14,4,405,199,192,391,10
2020-02-01,LK,Czech Republic,1634,1374,8,7,260,125,127,252,1
2020-02-02,LK,Czech Republic,1809,1433,9,6,376,182,185,367,3
2020-02-03,LK,Czech Republic,1816,1435,15,12,381,179,187,366,3
2020-02-04,LK,Czech Republic,1635,1306,6,0,329,163,160,323,6
2020-02-05,LK,Czech Republic,1661,1329,12,4,332,159,161,320,8
2020-02-06,LK,Czech Republic,1769,1378,19,7,391,183,189,372,12
2020-02-07,LK,Czech Republic,1964,1550,18,8,414,200,196,396,10
2020-02-08,LK,Czech Republic,1734,1459,14,5,275,130,131,261,9
2020-02-09,LK,Czech Republic,1694,1345,9,5,349,168,172,340,4
2020-02-10,LK,Czech Republic,1604,1271,1,0,333,164,168,332,1
2020-02-11,LK,Czech Republic,1636,1316,7,2,320,156,157,313,5
2020-02-12,LK,Czech Republic,1710,1371,22,8,339,165,152,317,14
2020-02-13,LK,Czech Republic,1815,1400,16,6,415,197,202,399,10
2020-02-14,LK,Czech Republic,2046,1604,21,6,442,211,210,421,15
2020-02-15,LK,Czech Republic,1765,1474,10,3,291,142,139,281,7
2020-02-16,LK,Czech Republic,1797,1436,15,11,361,173,173,346,4
2020-02-17,LK,Czech Republic,1857,1476,13,8,381,185,183,368,5
2020-02-18,LK,Czech Republic,1685,1347,15,8,338,160,163,323,7
2020-02-19,LK,Czech Republic,1797,1401,27,14,396,184,185,369,13
2020-02-20,LK,Czech Republic,1865,1450,9,5,415,206,200,406,4
2020-02-21,LK,Czech Republic,1978,1552,11,5,426,211,204,415,6
2020-02-22,LK,Czech Republic,1846,1555,10,4,291,138,143,281,6
2020-02-23,LK,Czech Republic,1882,1488,6,3,394,193,195,388,3
2020-02-24,LK,Czech Republic,1979,1582,16,5,397,187,194,381,11
2020-02-25,LK,Czech Republic,1771,1413,17,7,358,169,172,341,10
2020-02-26,LK,Czech Republic,1808,1435,17,9,373,180,176,356,8
2020-02-27,LK,Czech Republic,1727,1320,12,6,407,197,198,395,6
2020-02-28,LK,Czech Republic,1917,1498,10,3,419,207,202,409,7
2020-02-29,LK,Czech Republic,1687,1419,5,4,268,130,133,263,1
2020-03-01,LK,Czech Republic,1822,1429,11,7,393,192,190,382,4
2020-03-02,LK,Czech Republic,1884,1489,19,10,395,188,188,376,9
2020-03-03,LK,Czech Republic,1656,1318,7,4,338,162,169,331,3
2020-03-04,LK,Czech Republic,1806,1427,13,6,379,185,181,366,7
2020-03-05,LK,Czech Republic,1800,1390,25,15,410,193,192,385,10
2020-03-06,LK,Czech Republic,1983,1554,11,0,429,211,207,418,11
2020-03-07,LK,Czech Republic,1704,1437,9,7,267,126,132,258,2
2020-03-08,LK,Czech Republic,1784,1393,12,4,391,190,189,379,8
2020-03-09,LK,Czech Republic,1820,1422,14,5,398,190,194,384,9
2020-03-10,LK,Czech Republic,1565,1238,16,7,327,151,160,311,9
2020-03-11,LK,Czech Republic,1535,1217,9,2,318,162,147,309,7
2020-03-12,LK,Czech Republic,1584,1217,14,2,367,174,179,353,12
2020-03-13,LK,Czech Republic,1686,1298,17,6,388,186,185,371,11
2020-03-14,LK,Czech Republic,1417,1190,22,10,227,100,105,205,12
2020-03-15,LK,Czech Republic,1255,993,16,4,262,120,126,246,12
2020-03-16,LK,Czech Republic,1138,980,9,4,158,75,74,149,5
2020-03-17,LK,Czech Republic,910,757,14,6,153,67,72,139,8
2020-03-18,LK,Czech Republic,880,723,17,8,157,72,68,140,9
2020-03-19,LK,Czech Republic,814,667,18,12,147,63,66,129,6
2020-03-20,LK,Czech Republic,760,658,15,9,102,44,43,87,6
2020-03-21,LK,Czech Republic,573,526,0,0,47,22,25,47,0
2020-03-22,LK,Czech Republic,516,443,8,1,73,33,32,65,7
2020-03-23,LK,Czech Republic,489,420,14,7,69,26,29,55,7
2020-03-24,LK,Czech Republic,411,343,18,5,68,22,28,50,13
2020-03-25,LK,Czech Republic,367,289,16,6,78,29,33,62,10
2020-03-26,LK,Czech Republic,360,297,9,4,63,25,29,54,5
2020-03-27,LK,Czech Republic,360,287,9,6,73,31,33,64,3
2020-03-28,LK,Czech Republic,271,226,11,3,45,16,18,34,8
2020-03-29,LK,Czech Republic,251,223,1,1,28,12,15,27,0
2020-03-30,LK,Czech Republic,279,246,4,2,33,16,13,29,2
2020-03-31,LK,Czech Republic,271,234,8,4,37,12,17,29,4
2020-04-01,LK,Czech Republic,262,200,28,10,62,13,21,34,18
2020-04-02,LK,Czech Republic,327,252,31,19,75,24,20,44,12
2020-04-03,LK,Czech Republic,304,243,14,6,61,23,24,47,8
2020-04-04,LK,Czech Republic,223,190,8,3,33,12,13,25,5
2020-04-05,LK,Czech Republic,230,188,9,4,42,14,19,33,5
2020-04-06,LK,Czech Republic,265,205,15,10,60,24,21,45,5
2020-04-07,LK,Czech Republic,259,209,16,10,50,17,17,34,6
2020-04-08,LK,Czech Republic,274,218,28,24,56,15,13,28,4
2020-04-09,LK,Czech Republic,288,222,24,15,66,21,21,42,9
2020-04-10,LK,Czech Republic,272,218,19,9,54,13,22,35,10
2020-04-11,LK,Czech Republic,218,197,6,2,21,9,6,15,4
2020-04-12,LK,Czech Republic,178,157,5,2,21,7,9,16,3
2020-04-13,LK,Czech Republic,178,154,4,2,24,10,10,20,2
2020-04-14,LK,Czech Republic,231,179,18,8,52,17,17,34,10
2020-04-15,LK,Czech Republic,270,206,26,17,64,21,17,38,9
2020-04-16,LK,Czech Republic,255,196,27,15,59,15,17,32,12
2020-04-17,LK,Czech Republic,258,208,14,7,50,17,19,36,7
2020-04-18,LK,Czech Republic,184,152,14,5,32,10,8,18,9
2020-04-19,LK,Czech Republic,187,162,8,4,25,9,8,17,4
2020-04-20,LK,Czech Republic,281,220,15,10,61,23,23,46,5
2020-04-21,LK,Czech Republic,275,223,23,8,52,15,14,29,15
2020-04-22,LK,Czech Republic,290,233,22,13,57,16,19,35,9
2020-04-23,LK,Czech Republic,257,192,28,8,65,18,19,37,20
2020-04-24,LK,Czech Republic,293,226,23,12,67,22,22,44,11
2020-04-25,LK,Czech Republic,217,181,14,9,36,11,11,22,5
2020-04-26,LK,Czech Republic,246,214,7,4,32,11,14,25,3
2020-04-27,LK,Czech Republic,290,224,27,14,66,22,17,39,13
2020-04-28,LK,Czech Republic,299,230,29,16,69,19,21,40,13
2020-04-29,LK,Czech Republic,298,235,20,9,63,23,20,43,11
2020-04-30,LK,Czech Republic,279,215,30,14,64,18,16,34,16
2020-05-01,LK,Czech Republic,296,251,14,7,45,16,15,31,7
2020-05-02,LK,Czech Republic,199,173,10,5,26,8,8,16,5
2020-05-03,LK,Czech Republic,223,200,4,0,23,10,9,19,4
2020-05-04,LK,Czech Republic,303,235,26,8,68,21,21,42,18
2020-05-05,LK,Czech Republic,322,271,19,10,51,14,18,32,9
2020-05-06,LK,Czech Republic,341,285,27,4,56,15,14,29,23
2020-05-07,LK,Czech Republic,326,249,28,13,77,27,22,49,15
2020-05-08,LK,Czech Republic,303,259,16,6,44,12,16,28,10
2020-05-09,LK,Czech Republic,235,206,5,1,29,13,11,24,4
2020-05-10,LK,Czech Republic,264,217,13,7,47,16,18,34,6
2020-05-11,LK,Czech Republic,277,246,4,4,31,16,11,27,0
2020-05-12,LK,Czech Republic,301,238,22,5,63,18,23,41,17
2020-05-13,LK,Czech Republic,313,259,21,13,54,14,19,33,8
2020-05-14,LK,Czech Republic,331,276,16,10,55,23,16,39,6
2020-05-15,LK,Czech Republic,363,284,24,9,79,28,27,55,15
2020-05-16,LK,Czech Republic,265,234,13,5,31,9,9,18,8
2020-05-17,LK,Czech Republic,285,231,10,2,54,20,24,44,8
2020-05-18,LK,Czech Republic,321,269,11,5,52,21,20,41,6
2020-05-19,LK,Czech Republic,317,253,17,8,64,22,25,47,9
2020-05-20,LK,Czech Republic,356,271,19,10,85,35,31,66,9
2020-05-21,LK,Czech Republic,365,270,38,15,95,30,27,57,23
2020-05-22,LK,Czech Republic,353,286,19,11,67,25,23,48,8
2020-05-23,LK,Czech Republic,275,236,8,6,39,15,16,31,2
2020-05-24,LK,Czech Republic,295,237,6,5,58,26,26,52,1
2020-05-25,LK,Czech Republic,329,266,14,8,63,23,26,49,6
2020-05-26,LK,Czech Republic,341,269,21,9,72,25,26,51,12
2020-05-27,LK,Czech Republic,354,287,31,15,67,18,18,36,16
2020-05-28,LK,Czech Republic,403,324,21,10,79,32,26,58,11
2020-05-29,LK,Czech Republic,397,323,27,11,74,21,26,47,16
2020-05-30,LK,Czech Republic,309,271,10,7,38,15,13,28,3
2020-05-31,LK,Czech Republic,268,224,10,6,44,17,17,34,4
2020-06-01,LK,Czech Republic,349,268,27,5,81,27,27,54,22
2020-06-02,LK,Czech Republic,374,301,30,6,73,21,22,43,24
2020-06-03,LK,Czech Republic,387,304,29,18,83,27,27,54,11
2020-06-04,LK,Czech Republic,410,315,32,13,95,33,30,63,19
2020-06-05,LK,Czech Republic,382,302,19,7,80,32,29,61,12
2020-06-06,LK,Czech Republic,300,253,8,6,47,23,16,39,2
2020-06-07,LK,Czech Republic,307,254,7,4,53,19,27,46,3
2020-06-08,LK,Czech Republic,378,292,18,8,86,34,34,68,10
2020-06-09,LK,Czech Republic,375,299,17,11,76,30,29,59,6
2020-06-10,LK,Czech Republic,393,326,19,13,67,22,26,48,6
2020-06-11,LK,Czech Republic,402,304,17,5,98,41,40,81,12
2020-06-12,LK,Czech Republic,465,350,21,9,115,51,43,94,12
2020-06-13,LK,Czech Republic,357,310,8,3,47,20,19,39,5
2020-06-14,LK,Czech Republic,377,325,4,0,52,22,26,48,4
2020-06-15,LK,Czech Republic,499,380,24,13,119,53,42,95,11
2020-06-16,LK,Czech Republic,513,402,18,6,111,50,43,93,12
2020-06-17,LK,Czech Republic,515,402,27,15,113,41,45,86,12
2020-06-18,LK,Czech Republic,502,388,16,6,114,51,47,98,10
2020-06-19,LK,Czech Republic,565,449,21,10,116,52,43,95,11
2020-06-20,LK,Czech Republic,440,392,1,0,48,24,23,47,1
2020-06-21,LK,Czech Republic,482,387,3,1,95,35,57,92,2
2020-06-22,LK,Czech Republic,555,418,31,15,137,55,51,106,16
2020-06-23,LK,Czech Republic,566,432,28,13,134,57,49,106,15
2020-06-24,LK,Czech Republic,578,446,26,7,132,50,56,106,19
2020-06-25,LK,Czech Republic,580,444,30,13,136,51,55,106,17
2020-06-26,LK,Czech Republic,653,514,13,2,139,64,62,126,11
2020-06-27,LK,Czech Republic,519,431,21,9,88,39,28,67,12
2020-06-28,LK,Czech Republic,563,439,12,5,124,46,66,112,7
2020-06-29,LK,Czech Republic,598,463,22,7,135,59,54,113,15
2020-06-30,LK,Czech Republic,625,491,20,10,134,58,56,114,10
2020-07-01,LK,Czech Republic,903,717,17,10,186,89,80,169,7
2020-07-02,LK,Czech Republic,874,658,23,12,216,98,95,193,11
2020-07-03,LK,Czech Republic,946,758,12,3,188,90,86,176,9
2020-07-04,LK,Czech Republic,802,674,10,0,128,63,55,118,10
2020-07-05,LK,Czech Republic,842,665,12,4,177,83,82,165,8
2020-07-06,LK,Czech Republic,841,662,9,3,179,82,88,170,6
2020-07-07,LK,Czech Republic,829,656,25,10,173,71,77,148,15
2020-07-08,LK,Czech Republic,843,646,30,12,197,87,80,167,18
2020-07-09,LK,Czech Republic,909,679,22,5,230,104,104,208,17
2020-07-10,LK,Czech Republic,957,754,19,6,203,92,92,184,13
2020-07-11,LK,Czech Republic,838,710,10,3,128,62,56,118,7
2020-07-12,LK,Czech Republic,942,746,15,5,196,82,99,181,10
2020-07-13,LK,Czech Republic,949,740,24,6,209,94,91,185,18
2020-07-14,LK,Czech Republic,873,671,44,10,202,76,82,158,34
2020-07-15,LK,Czech Republic,965,740,27,9,225,101,97,198,18
2020-07-16,LK,Czech Republic,1004,806,17,4,198,87,94,181,13
2020-07-17,LK,Czech Republic,1121,882,19,4,239,111,109,220,15
2020-07-18,LK,Czech Republic,974,843,7,2,131,69,55,124,5
2020-07-19,LK,Czech Republic,1006,814,11,3,192,83,98,181,8
2020-07-20,LK,Czech Republic,1020,807,19,8,213,94,100,194,11
2020-07-21,LK,Czech Republic,956,754,26,8,202,87,89,176,18
2020-07-22,LK,Czech Republic,969,749,32,10,220,98,90,188,22
2020-07-23,LK,Czech Republic,1046,826,32,17,220,95,93,188,15
2020-07-24,LK,Czech Republic,1143,874,30,9,269,118,121,239,21
2020-07-25,LK,Czech Republic,995,847,6,4,148,78,64,142,2
2020-07-26,LK,Czech Republic,1042,855,6,1,187,85,96,181,5
2020-07-27,LK,Czech Republic,1006,804,19,8,202,96,87,183,11
2020-07-28,LK,Czech Republic,924,752,21,8,172,72,79,151,13
2020-07-29,LK,Czech Republic,938,737,26,5,201,87,88,175,21
2020-07-30,LK,Czech Republic,1077,869,17,8,208,99,92,191,9
2020-07-31,LK,Czech Republic,1173,919,15,4,254,120,119,239,11
2020-08-01,LK,Czech Republic,1130,948,10,6,182,88,84,172,4
2020-08-02,LK,Czech Republic,1222,984,8,1,238,111,119,230,7
2020-08-03,LK,Czech Republic,1183,993,9,2,190,87,94,181,7
2020-08-04,LK,Czech Republic,1069,877,15,5,192,87,90,177,10
2020-08-05,LK,Czech Republic,1112,895,17,6,217,99,101,200,11
2020-08-06,LK,Czech Republic,1191,968,26,13,223,99,98,197,13
2020-08-07,LK,Czech Republic,1293,1058,18,8,235,112,105,217,10
2020-08-08,LK,Czech Republic,1217,1021,16,6,196,89,91,180,10
2020-08-09,LK,Czech Republic,1264,1031,13,3,233,101,119,220,10
2020-08-10,LK,Czech Republic,1191,970,15,5,221,111,95,206,10
2020-08-11,LK,Czech Republic,1057,867,21,12,190,81,88,169,9
2020-08-12,LK,Czech Republic,1122,929,38,20,193,79,76,155,18
2020-08-13,LK,Czech Republic,1206,991,24,10,215,102,89,191,14
2020-08-14,LK,Czech Republic,1261,1040,15,6,221,104,102,206,9
2020-08-15,LK,Czech Republic,1197,997,12,4,200,92,96,188,8
2020-08-16,LK,Czech Republic,1258,1028,11,8,230,106,113,219,3
2020-08-17,LK,Czech Republic,1175,953,18,6,222,102,102,204,12
2020-08-18,LK,Czech Republic,1025,847,15,7,178,78,85,163,8
2020-08-19,LK,Czech Republic,1069,857,27,13,212,96,89,185,14
2020-08-20,LK,Czech Republic,1170,943,30,8,227,102,95,197,22
2020-08-21,LK,Czech Republic,1285,1024,16,9,261,120,125,245,7
2020-08-22,LK,Czech Republic,1166,988,7,3,178,89,82,171,4
2020-08-23,LK,Czech Republic,1227,984,13,3,243,113,117,230,10
2020-08-24,LK,Czech Republic,1172,949,20,11,223,100,103,203,9
2020-08-25,LK,Czech Republic,1018,824,12,6,194,93,89,182,6
2020-08-26,LK,Czech Republic,1021,839,12,4,182,86,84,170,8
2020-08-27,LK,Czech Republic,1169,940,28,9,229,98,103,201,19
2020-08-28,LK,Czech Republic,1301,1043,18,6,258,123,117,240,12
2020-08-29,LK,Czech Republic,1187,1016,11,6,171,79,81,160,5
2020-08-30,LK,Czech Republic,1276,1027,20,4,249,107,122,229,16
2020-08-31,LK,Czech Republic,1244,1010,17,6,234,109,108,217,11
2020-09-01,LK,Czech Republic,1080,866,14,7,214,96,104,200,7
2020-09-02,LK,Czech Republic,1111,870,27,5,241,108,106,214,22
2020-09-03,LK,Czech Republic,1140,882,24,9,258,120,114,234,15
2020-09-04,LK,Czech Republic,1275,998,35,14,277,127,115,242,21
2020-09-05,LK,Czech Republic,1128,933,16,5,195,88,91,179,11
2020-09-06,LK,Czech Republic,1179,947,13,7,232,103,116,219,6
2020-09-07,LK,Czech Republic,1125,920,18,9,205,93,94,187,9
2020-09-08,LK,Czech Republic,961,767,23,8,194,87,84,171,15
2020-09-09,LK,Czech Republic,1019,816,19,8,203,93,91,184,11
2020-09-10,LK,Czech Republic,1116,882,16,6,234,116,102,218,10
2020-09-11,LK,Czech Republic,1279,1010,17,3,269,126,126,252,14
2020-09-12,LK,Czech Republic,1104,921,9,3,183,88,86,174,6
2020-09-13,LK,Czech Republic,1196,953,12,5,243,108,123,231,7
2020-09-14,LK,Czech Republic,1084,874,16,4,210,99,95,194,12
2020-09-15,LK,Czech Republic,946,739,18,9,207,98,91,189,9
2020-09-16,LK,Czech Republic,1006,806,17,6,200,93,90,183,11
2020-09-17,LK,Czech Republic,1143,902,30,11,241,102,109,211,19
2020-09-18,LK,Czech Republic,1267,1003,24,7,264,124,116,240,17
2020-09-19,LK,Czech Republic,1060,887,19,6,173,75,79,154,13
2020-09-20,LK,Czech Republic,1193,958,23,3,235,99,113,212,20
2020-09-21,LK,Czech Republic,1098,907,24,9,191,88,79,167,15
2020-09-22,LK,Czech Republic,937,774,13,7,163,75,75,150,6
2020-09-23,LK,Czech Republic,958,786,16,5,172,80,76,156,11
2020-09-24,LK,Czech Republic,1035,816,32,9,219,97,90,187,23
2020-09-25,LK,Czech Republic,1198,977,16,4,221,102,103,205,12
2020-09-26,LK,Czech Republic,1030,898,4,2,132,67,61,128,2
2020-09-27,LK,Czech Republic,1151,960,13,5,191,91,87,178,8
2020-09-28,LK,Czech Republic,1035,871,8,3,164,70,86,156,5
2020-09-29,LK,Czech Republic,856,693,13,3,163,77,73,150,10
2020-09-30,LK,Czech Republic,963,786,19,11,177,76,82,158,8
2020-10-01,LK,Czech Republic,1042,830,24,12,212,91,97,188,12
2020-10-02,LK,Czech Republic,1200,988,25,11,212,95,92,187,14
2020-10-03,LK,Czech Republic,1083,965,10,2,118,58,50,108,8
2020-10-04,LK,Czech Republic,1141,976,13,10,165,70,82,152,3
2020-10-05,LK,Czech Republic,997,854,12,10,143,66,65,131,2
2020-10-06,LK,Czech Republic,803,655,26,11,148,64,58,122,15
2020-10-07,LK,Czech Republic,890,725,26,14,165,68,71,139,12
2020-10-08,LK,Czech Republic,959,787,37,16,172,73,62,135,21
2020-10-09,LK,Czech Republic,1120,931,30,15,189,81,78,159,15
2020-10-10,LK,Czech Republic,1007,908,6,6,99,47,46,93,0
2020-10-11,LK,Czech Republic,1070,935,15,6,135,54,66,120,9
2020-10-12,LK,Czech Republic,975,817,26,12,158,67,65,132,14
2020-10-13,LK,Czech Republic,783,647,21,7,136,58,57,115,14
2020-10-14,LK,Czech Republic,815,681,7,3,134,66,61,127,4
2020-10-15,LK,Czech Republic,878,726,17,4,152,65,70,135,13
2020-10-16,LK,Czech Republic,1141,955,26,9,186,82,78,160,17
2020-10-17,LK,Czech Republic,943,842,7,6,101,44,50,94,1
2020-10-18,LK,Czech Republic,1068,918,19,11,150,62,69,131,8
2020-10-19,LK,Czech Republic,897,743,40,15,154,54,60,114,25
2020-10-20,LK,Czech Republic,720,601,26,10,119,45,48,93,16
2020-10-21,LK,Czech Republic,847,692,35,21,155,60,60,120,14
2020-10-22,LK,Czech Republic,926,752,40,20,174,68,66,134,20
2020-10-23,LK,Czech Republic,1025,848,30,15,177,83,64,147,15
2020-10-24,LK,Czech Republic,949,835,20,11,114,48,46,94,9
2020-10-25,LK,Czech Republic,931,825,5,4,106,45,56,101,1
2020-10-26,LK,Czech Republic,854,731,25,12,123,54,44,98,13
2020-10-27,LK,Czech Republic,689,553,27,15,136,53,56,109,12
2020-10-28,LK,Czech Republic,772,636,28,15,136,59,49,108,13
2020-10-29,LK,Czech Republic,789,661,33,16,128,48,47,95,17
2020-10-30,LK,Czech Republic,889,751,20,12,138,60,58,118,8
2020-10-31,LK,Czech Republic,821,714,18,13,107,43,46,89,5
2020-11-01,LK,Czech Republic,895,759,14,10,136,51,71,122,4
2020-11-02,LK,Czech Republic,765,607,36,24,158,63,59,122,12
2020-11-03,LK,Czech Republic,646,504,28,10,142,55,59,114,18
2020-11-04,LK,Czech Republic,723,590,26,14,133,59,48,107,12
2020-11-05,LK,Czech Republic,654,515,37,14,139,53,49,102,23
2020-11-06,LK,Czech Republic,781,648,35,18,133,47,51,98,17
2020-11-07,LK,Czech Republic,625,543,23,15,82,36,23,59,8
2020-11-08,LK,Czech Republic,743,634,10,5,109,43,56,99,5
2020-11-09,LK,Czech Republic,621,541,11,4,80,33,36,69,7
2020-11-10,LK,Czech Republic,505,413,7,0,92,40,45,85,7
2020-11-11,LK,Czech Republic,573,469,17,5,104,46,41,87,12
2020-11-12,LK,Czech Republic,619,497,37,18,122,42,43,85,19
2020-11-13,LK,Czech Republic,741,586,44,18,155,58,53,111,26
2020-11-14,LK,Czech Republic,552,455,16,11,97,41,40,81,5
2020-11-15,LK,Czech Republic,651,551,12,2,100,43,45,88,10
2020-11-16,LK,Czech Republic,608,504,24,8,104,44,36,80,16
2020-11-17,LK,Czech Republic,494,383,31,21,111,32,48,80,10
2020-11-18,LK,Czech Republic,609,465,31,12,144,57,56,113,19
2020-11-19,LK,Czech Republic,573,440,34,14,133,51,48,99,20
2020-11-20,LK,Czech Republic,647,526,32,9,121,40,49,89,23
2020-11-21,LK,Czech Republic,478,402,15,8,76,31,30,61,7
2020-11-22,LK,Czech Republic,588,497,19,13,91,34,38,72,6
2020-11-23,LK,Czech Republic,525,434,17,8,91,39,35,74,9
2020-11-24,LK,Czech Republic,448,352,15,3,96,39,42,81,12
2020-11-25,LK,Czech Republic,506,409,12,0,97,42,43,85,12
2020-11-26,LK,Czech Republic,515,396,17,4,119,48,54,102,13
2020-11-27,LK,Czech Republic,653,537,12,1,116,56,48,104,11
2020-11-28,LK,Czech Republic,455,396,7,3,59,26,26,52,4
2020-11-29,LK,Czech Republic,552,482,10,2,70,30,30,60,8
2020-11-30,LK,Czech Republic,530,421,20,6,109,44,45,89,14
2020-12-01,LK,Czech Republic,475,364,20,4,111,42,49,91,16
2020-12-02,LK,Czech Republic,591,452,40,13,139,54,45,99,27
2020-12-03,LK,Czech Republic,565,454,16,3,111,47,48,95,13
2020-12-04,LK,Czech Republic,663,534,21,8,129,53,55,108,13
2020-12-05,LK,Czech Republic,526,454,23,10,72,22,27,49,13
2020-12-06,LK,Czech Republic,621,537,9,4,84,36,39,75,5
2020-12-07,LK,Czech Republic,569,473,13,5,96,45,38,83,8
2020-12-08,LK,Czech Republic,524,403,26,14,121,52,43,95,12
2020-12-09,LK,Czech Republic,602,474,19,3,128,52,57,109,16
2020-12-10,LK,Czech Republic,632,484,28,4,148,56,64,120,24
2020-12-11,LK,Czech Republic,738,604,16,5,134,56,62,118,11
2020-12-12,LK,Czech Republic,596,534,5,0,62,26,31,57,5
2020-12-13,LK,Czech Republic,643,553,8,2,90,41,41,82,6
2020-12-14,LK,Czech Republic,605,498,27,16,107,47,33,80,11
2020-12-15,LK,Czech Republic,578,439,24,8,139,57,58,115,16
2020-12-16,LK,Czech Republic,685,536,14,5,149,64,71,135,9
2020-12-17,LK,Czech Republic,833,658,21,8,175,78,76,154,13
2020-12-18,LK,Czech Republic,986,799,11,2,187,86,90,176,9
2020-12-19,LK,Czech Republic,855,724,9,1,131,60,62,122,8
2020-12-20,LK,Czech Republic,838,717,6,0,121,56,59,115,6
2020-12-21,LK,Czech Republic,821,662,20,4,159,73,66,139,16
2020-12-22,LK,Czech Republic,665,546,14,3,119,48,57,105,11
2020-12-23,LK,Czech Republic,744,621,12,4,123,56,55,111,8
2020-12-24,LK,Czech Republic,468,422,3,0,46,21,22,43,3
2020-12-25,LK,Czech Republic,402,345,5,0,57,28,24,52,5
2020-12-26,LK,Czech Republic,545,438,15,2,107,52,40,92,13
2020-12-27,LK,Czech Republic,681,567,10,0,114,53,51,104,10
2020-12-28,LK,Czech Republic,617,501,20,10,116,46,50,96,10
2020-12-29,LK,Czech Republic,526,412,35,10,114,41,38,79,25
2020-12-30,LK,Czech Republic,636,513,26,13,123,49,48,97,13
2020-12-31,LK,Czech Republic,399,333,17,5,66,26,23,49,12
2020-01-01,EK,Denmark,1299,774,39,0,525,244,242,486,39
2020-01-02,EK,Denmark,1717,903,102,5,814,359,353,712,97
2020-01-03,EK,Denmark,1685,876,113,13,809,348,348,696,100
2020-01-04,EK,Denmark,1393,810,48,6,583,265,270,535,42
2020-01-05,EK,Denmark,1651,901,76,6,750,339,335,674,70
2020-01-06,EK,Denmark,1773,869,127,7,904,390,387,777,120
2020-01-07,EK,Denmark,1623,806,137,21,817,334,346,680,116
2020-01-08,EK,Denmark,1618,788,128,16,830,353,349,702,112
2020-01-09,EK,Denmark,1615,782,118,3,833,360,355,715,115
2020-01-10,EK,Denmark,1723,838,129,9,885,372,384,756,120
2020-01-11,EK,Denmark,1285,748,46,2,537,243,248,491,44
2020-01-12,EK,Denmark,1529,838,84,5,691,309,298,607,79
2020-01-13,EK,Denmark,1759,849,134,17,910,389,387,776,117
2020-01-14,EK,Denmark,1564,728,141,21,836,346,349,695,120
2020-01-15,EK,Denmark,1572,737,145,22,835,342,348,690,123
2020-01-16,EK,Denmark,1688,800,138,17,888,378,372,750,121
2020-01-17,EK,Denmark,1760,848,147,21,912,377,388,765,126
2020-01-18,EK,Denmark,1280,742,51,4,538,244,243,487,47
2020-01-19,EK,Denmark,1493,767,76,3,726,326,324,650,73
2020-01-20,EK,Denmark,1742,842,134,18,900,385,381,766,116
2020-01-21,EK,Denmark,1595,744,138,27,851,356,357,713,111
2020-01-22,EK,Denmark,1629,794,127,19,835,354,354,708,108
2020-01-23,EK,Denmark,1672,811,130,23,861,368,363,731,107
2020-01-24,EK,Denmark,1748,805,143,11,943,395,405,800,132
2020-01-25,EK,Denmark,1248,704,58,7,544,241,245,486,51
2020-01-26,EK,Denmark,1574,862,84,5,712,318,310,628,79
2020-01-27,EK,Denmark,1789,863,135,16,926,395,396,791,119
2020-01-28,EK,Denmark,1575,751,125,12,824,346,353,699,113
2020-01-29,EK,Denmark,1638,795,129,15,843,362,352,714,114
2020-01-30,EK,Denmark,1737,844,136,18,893,379,378,757,118
2020-01-31,EK,Denmark,1784,839,146,18,945,399,400,799,128
2020-02-01,EK,Denmark,1351,745,77,7,606,265,264,529,70
2020-02-02,EK,Denmark,1604,861,82,5,743,328,333,661,77
2020-02-03,EK,Denmark,1829,891,148,9,938,397,393,790,139
2020-02-04,EK,Denmark,1571,745,116,7,826,354,356,710,109
2020-02-05,EK,Denmark,1648,777,131,25,871,372,368,740,106
2020-02-06,EK,Denmark,1693,755,136,23,938,396,406,802,113
2020-02-07,EK,Denmark,1768,779,150,16,989,417,422,839,134
2020-02-08,EK,Denmark,1502,805,68,4,697,319,310,629,64
2020-02-09,EK,Denmark,1396,741,54,2,655,301,300,601,52
2020-02-10,EK,Denmark,1657,832,99,6,825,369,357,726,93
2020-02-11,EK,Denmark,1521,758,85,3,763,337,341,678,82
2020-02-12,EK,Denmark,1624,812,95,3,812,361,356,717,92
2020-02-13,EK,Denmark,1663,795,97,18,868,384,387,771,79
2020-02-14,EK,Denmark,1762,831,102,9,931,414,415,829,93
2020-02-15,EK,Denmark,1492,783,62,5,709,321,326,647,57
2020-02-16,EK,Denmark,1612,841,75,4,771,346,350,696,71
2020-02-17,EK,Denmark,1736,826,105,4,910,406,399,805,101
2020-02-18,EK,Denmark,1597,750,126,13,847,358,363,721,113
2020-02-19,EK,Denmark,1644,778,109,9,866,381,376,757,100
2020-02-20,EK,Denmark,1715,791,137,18,924,392,395,787,119
2020-02-21,EK,Denmark,1805,862,123,16,943,407,413,820,107
2020-02-22,EK,Denmark,1455,813,48,1,642,295,299,594,47
2020-02-23,EK,Denmark,1616,835,101,7,781,342,338,680,94
2020-02-24,EK,Denmark,1767,795,146,15,972,412,414,826,131
2020-02-25,EK,Denmark,1640,776,125,8,864,371,368,739,117
2020-02-26,EK,Denmark,1704,830,128,10,874,372,374,746,118
2020-02-27,EK,Denmark,1761,839,119,14,922,402,401,803,105
2020-02-28,EK,Denmark,1832,875,129,8,957,409,419,828,121
2020-02-29,EK,Denmark,1456,824,55,2,632,287,290,577,53
2020-03-01,EK,Denmark,1686,901,77,1,785,357,351,708,76
2020-03-02,EK,Denmark,1843,873,146,8,970,411,413,824,138
2020-03-03,EK,Denmark,1656,784,118,7,872,377,377,754,111
2020-03-04,EK,Denmark,1681,822,128,14,859,369,362,731,114
2020-03-05,EK,Denmark,1753,808,139,19,945,401,405,806,120
2020-03-06,EK,Denmark,1773,844,121,13,929,402,406,808,108
2020-03-07,EK,Denmark,1372,758,56,5,614,280,278,558,51
2020-03-08,EK,Denmark,1643,854,82,3,789,353,354,707,79
2020-03-09,EK,Denmark,1750,834,137,8,916,391,388,779,129
2020-03-10,EK,Denmark,1553,714,133,6,839,352,354,706,127
2020-03-11,EK,Denmark,1578,752,123,15,826,349,354,703,108
2020-03-12,EK,Denmark,1588,753,109,3,835,364,362,726,106
2020-03-13,EK,Denmark,1657,824,106,9,833,361,366,727,97
2020-03-14,EK,Denmark,1257,722,54,11,535,243,238,481,43
2020-03-15,EK,Denmark,1357,723,66,1,634,281,287,568,65
2020-03-16,EK,Denmark,1236,676,81,8,560,238,241,479,73
2020-03-17,EK,Denmark,941,525,69,7,416,171,176,347,62
2020-03-18,EK,Denmark,836,508,55,8,328,137,136,273,47
2020-03-19,EK,Denmark,781,459,37,4,322,146,139,285,33
2020-03-20,EK,Denmark,726,465,39,9,261,108,114,222,30
2020-03-21,EK,Denmark,597,426,19,6,171,74,78,152,13
2020-03-22,EK,Denmark,445,294,18,3,151,68,65,133,15
2020-03-23,EK,Denmark,379,257,29,10,122,45,48,93,19
2020-03-24,EK,Denmark,379,247,34,8,132,49,49,98,26
2020-03-25,EK,Denmark,351,226,25,7,125,49,51,100,18
2020-03-26,EK,Denmark,347,217,28,14,130,49,53,102,14
2020-03-27,EK,Denmark,330,209,23,5,121,48,50,98,18
2020-03-28,EK,Denmark,222,149,19,2,73,29,25,54,17
2020-03-29,EK,Denmark,204,140,15,2,64,21,28,49,13
2020-03-30,EK,Denmark,232,137,30,5,95,33,32,65,25
2020-03-31,EK,Denmark,260,141,25,7,119,49,45,94,18
2020-04-01,EK,Denmark,264,131,45,6,133,46,42,88,39
2020-04-02,EK,Denmark,239,135,24,2,104,39,41,80,22
2020-04-03,EK,Denmark,238,138,31,6,100,34,35,69,25
2020-04-04,EK,Denmark,154,104,15,5,50,17,18,35,10
2020-04-05,EK,Denmark,176,110,17,5,66,23,26,49,12
2020-04-06,EK,Denmark,201,110,21,11,91,38,32,70,10
2020-04-07,EK,Denmark,243,140,25,10,103,37,41,78,15
2020-04-08,EK,Denmark,235,132,22,12,103,41,40,81,10
2020-04-09,EK,Denmark,199,109,17,4,90,38,35,73,13
2020-04-10,EK,Denmark,152,101,16,8,51,17,18,35,8
2020-04-11,EK,Denmark,149,106,13,4,43,14,16,30,9
2020-04-12,EK,Denmark,129,96,7,0,33,13,13,26,7
2020-04-13,EK,Denmark,144,96,14,3,48,15,19,34,11
2020-04-14,EK,Denmark,211,127,21,11,84,32,31,63,10
2020-04-15,EK,Denmark,225,124,22,7,101,39,40,79,15
2020-04-16,EK,Denmark,226,130,30,15,96,32,34,66,15
2020-04-17,EK,Denmark,217,128,23,9,89,36,30,66,14
2020-04-18,EK,Denmark,140,98,11,4,42,15,16,31,7
2020-04-19,EK,Denmark,162,109,13,1,53,17,23,40,12
2020-04-20,EK,Denmark,213,121,27,11,92,39,26,65,16
2020-04-21,EK,Denmark,233,127,34,16,106,35,37,72,18
2020-04-22,EK,Denmark,267,149,35,16,118,41,42,83,19
2020-04-23,EK,Denmark,274,160,33,15,114,38,43,81,18
2020-04-24,EK,Denmark,260,130,57,17,130,38,35,73,40
2020-04-25,EK,Denmark,188,142,13,0,46,14,19,33,13
2020-04-26,EK,Denmark,206,142,15,3,64,25,24,49,12
2020-04-27,EK,Denmark,255,143,51,16,112,30,31,61,35
2020-04-28,EK,Denmark,249,150,27,9,99,34,38,72,18
2020-04-29,EK,Denmark,296,181,29,13,115,43,43,86,16
2020-04-30,EK,Denmark,271,162,39,10,109,35,35,70,29
2020-05-01,EK,Denmark,239,144,40,10,95,29,26,55,30
2020-05-02,EK,Denmark,203,160,13,2,43,15,15,30,11
2020-05-03,EK,Denmark,217,166,13,3,51,19,19,38,10
2020-05-04,EK,Denmark,276,173,34,10,103,36,33,69,24
2020-05-05,EK,Denmark,293,175,38,22,118,42,38,80,16
2020-05-06,EK,Denmark,312,178,34,13,134,49,51,100,21
2020-05-07,EK,Denmark,302,186,39,17,116,39,38,77,22
2020-05-08,EK,Denmark,265,178,16,5,87,33,38,71,11
2020-05-09,EK,Denmark,207,159,7,1,48,23,18,41,6
2020-05-10,EK,Denmark,237,173,13,0,64,23,28,51,13
2020-05-11,EK,Denmark,292,170,36,18,122,45,41,86,18
2020-05-12,EK,Denmark,330,194,43,19,136,48,45,93,24
2020-05-13,EK,Denmark,352,214,46,20,138,45,47,92,26
2020-05-14,EK,Denmark,313,182,44,25,131,45,42,87,19
2020-05-15,EK,Denmark,322,205,43,14,117,38,36,74,29
2020-05-16,EK,Denmark,257,194,5,0,63,27,31,58,5
2020-05-17,EK,Denmark,242,184,11,2,58,23,24,47,9
2020-05-18,EK,Denmark,329,197,55,22,132,38,39,77,33
2020-05-19,EK,Denmark,349,190,58,24,159,53,48,101,34
2020-05-20,EK,Denmark,377,219,57,23,158,49,52,101,34
2020-05-21,EK,Denmark,249,174,30,5,75,23,22,45,25
2020-05-22,EK,Denmark,309,196,35,12,113,39,39,78,23
2020-05-23,EK,Denmark,264,201,12,5,63,23,28,51,7
2020-05-24,EK,Denmark,269,198,23,3,71,23,25,48,20
2020-05-25,EK,Denmark,327,193,49,19,134,43,42,85,30
2020-05-26,EK,Denmark,349,216,40,14,133,46,47,93,26
2020-05-27,EK,Denmark,359,222,37,16,137,52,48,100,21
2020-05-28,EK,Denmark,338,214,39,15,124,42,43,85,24
2020-05-29,EK,Denmark,336,212,41,14,124,43,40,83,27
2020-05-30,EK,Denmark,243,184,16,5,59,22,21,43,11
2020-05-31,EK,Denmark,253,188,15,1,65,24,26,50,14
2020-06-01,EK,Denmark,273,188,20,9,85,33,32,65,11
2020-06-02,EK,Denmark,333,203,37,16,130,49,44,93,21
2020-06-03,EK,Denmark,385,238,43,19,147,54,50,104,24
2020-06-04,EK,Denmark,398,222,77,26,176,49,50,99,51
2020-06-05,EK,Denmark,359,232,51,18,127,38,38,76,33
2020-06-06,EK,Denmark,307,233,19,1,74,30,25,55,18
2020-06-07,EK,Denmark,278,196,24,4,82,26,32,58,20
2020-06-08,EK,Denmark,358,204,58,17,154,50,46,96,41
2020-06-09,EK,Denmark,344,183,46,19,161,56,59,115,27
2020-06-10,EK,Denmark,408,234,59,17,174,58,57,115,42
2020-06-11,EK,Denmark,361,189,74,23,172,48,50,98,51
2020-06-12,EK,Denmark,384,207,70,18,177,51,56,107,52
2020-06-13,EK,Denmark,259,179,19,6,80,31,30,61,13
2020-06-14,EK,Denmark,311,210,36,5,101,30,35,65,31
2020-06-15,EK,Denmark,444,221,58,26,223,86,79,165,32
2020-06-16,EK,Denmark,433,221,60,27,212,74,78,152,33
2020-06-17,EK,Denmark,449,222,62,28,227,84,81,165,34
2020-06-18,EK,Denmark,430,206,77,31,224,73,74,147,46
2020-06-19,EK,Denmark,431,215,79,23,216,65,72,137,56
2020-06-20,EK,Denmark,320,202,24,4,118,46,48,94,20
2020-06-21,EK,Denmark,367,202,41,8,165,62,62,124,33
2020-06-22,EK,Denmark,414,209,52,14,205,79,74,153,38
2020-06-23,EK,Denmark,412,187,57,22,225,83,85,168,35
2020-06-24,EK,Denmark,443,206,63,22,237,88,86,174,41
2020-06-25,EK,Denmark,431,198,77,18,233,75,81,156,59
2020-06-26,EK,Denmark,451,229,62,21,222,81,79,160,41
2020-06-27,EK,Denmark,312,179,15,0,133,61,57,118,15
2020-06-28,EK,Denmark,376,200,42,9,176,66,68,134,33
2020-06-29,EK,Denmark,490,214,71,15,276,105,100,205,56
2020-06-30,EK,Denmark,483,215,64,13,268,100,104,204,51
2020-07-01,EK,Denmark,660,311,77,21,349,136,136,272,56
2020-07-02,EK,Denmark,600,254,76,16,346,135,135,270,60
2020-07-03,EK,Denmark,636,296,68,20,340,133,139,272,48
2020-07-04,EK,Denmark,541,290,46,9,251,104,101,205,37
2020-07-05,EK,Denmark,595,301,59,4,294,118,117,235,55
2020-07-06,EK,Denmark,581,258,70,5,323,131,122,253,65
2020-07-07,EK,Denmark,619,293,70,14,326,126,130,256,56
2020-07-08,EK,Denmark,690,306,92,26,384,147,145,292,66
2020-07-09,EK,Denmark,596,258,80,20,338,127,131,258,60
2020-07-10,EK,Denmark,636,300,67,11,336,131,138,269,56
2020-07-11,EK,Denmark,587,314,54,9,273,108,111,219,45
2020-07-12,EK,Denmark,596,292,61,3,304,121,122,243,58
2020-07-13,EK,Denmark,627,283,76,8,344,136,132,268,68
2020-07-14,EK,Denmark,634,305,77,19,329,125,127,252,58
2020-07-15,EK,Denmark,665,325,66,11,340,137,137,274,55
2020-07-16,EK,Denmark,656,304,79,12,352,137,136,273,67
2020-07-17,EK,Denmark,675,326,66,10,349,139,144,283,56
2020-07-18,EK,Denmark,643,338,44,8,305,132,129,261,36
2020-07-19,EK,Denmark,655,331,57,4,324,134,133,267,53
2020-07-20,EK,Denmark,649,290,71,12,359,149,139,288,59
2020-07-21,EK,Denmark,654,297,70,15,357,141,146,287,55
2020-07-22,EK,Denmark,663,315,63,12,348,144,141,285,51
2020-07-23,EK,Denmark,650,305,80,17,345,132,133,265,63
2020-07-24,EK,Denmark,674,308,75,14,366,144,147,291,61
2020-07-25,EK,Denmark,657,334,52,7,323,133,138,271,45
2020-07-26,EK,Denmark,674,334,62,2,340,141,137,278,60
2020-07-27,EK,Denmark,667,300,83,20,367,147,137,284,63
2020-07-28,EK,Denmark,641,302,78,15,339,127,134,261,63
2020-07-29,EK,Denmark,646,313,62,7,333,139,132,271,55
2020-07-30,EK,Denmark,670,308,85,20,362,140,137,277,65
2020-07-31,EK,Denmark,693,315,79,20,378,149,150,299,59
2020-08-01,EK,Denmark,671,334,48,5,337,142,147,289,43
2020-08-02,EK,Denmark,675,342,64,5,333,135,134,269,59
2020-08-03,EK,Denmark,728,339,72,17,389,159,158,317,55
2020-08-04,EK,Denmark,710,314,74,21,396,159,163,322,53
2020-08-05,EK,Denmark,738,341,86,19,397,155,156,311,67
2020-08-06,EK,Denmark,711,334,77,20,377,151,149,300,57
2020-08-07,EK,Denmark,761,373,77,18,388,154,157,311,59
2020-08-08,EK,Denmark,681,348,39,4,333,146,148,294,35
2020-08-09,EK,Denmark,731,354,63,10,377,154,160,314,53
2020-08-10,EK,Denmark,745,340,78,15,405,166,161,327,63
2020-08-11,EK,Denmark,689,305,83,26,384,150,151,301,57
2020-08-12,EK,Denmark,683,332,81,21,351,138,132,270,60
2020-08-13,EK,Denmark,745,345,84,20,400,156,160,316,64
2020-08-14,EK,Denmark,803,373,94,20,430,165,171,336,74
2020-08-15,EK,Denmark,687,359,58,6,328,131,139,270,52
2020-08-16,EK,Denmark,735,373,67,2,362,149,146,295,65
2020-08-17,EK,Denmark,793,340,104,23,453,180,169,349,81
2020-08-18,EK,Denmark,715,311,102,24,404,147,155,302,78
2020-08-19,EK,Denmark,750,344,94,16,406,159,153,312,78
2020-08-20,EK,Denmark,770,330,116,20,440,163,161,324,96
2020-08-21,EK,Denmark,795,368,94,14,427,165,168,333,80
2020-08-22,EK,Denmark,614,337,41,3,277,117,119,236,38
2020-08-23,EK,Denmark,715,347,65,7,368,150,153,303,58
2020-08-24,EK,Denmark,809,354,106,19,455,177,172,349,87
2020-08-25,EK,Denmark,735,312,112,23,423,148,163,311,89
2020-08-26,EK,Denmark,768,381,107,12,387,140,140,280,95
2020-08-27,EK,Denmark,812,352,121,20,460,172,167,339,101
2020-08-28,EK,Denmark,811,381,96,14,430,166,168,334,82
2020-08-29,EK,Denmark,628,343,40,0,285,119,126,245,40
2020-08-30,EK,Denmark,731,356,69,7,375,156,150,306,62
2020-08-31,EK,Denmark,843,363,122,30,480,178,180,358,92
2020-09-01,EK,Denmark,770,348,96,24,422,162,164,326,72
2020-09-02,EK,Denmark,767,349,93,22,418,164,161,325,71
2020-09-03,EK,Denmark,805,322,123,31,483,180,180,360,92
2020-09-04,EK,Denmark,878,381,112,24,497,193,192,385,88
2020-09-05,EK,Denmark,638,339,54,15,299,122,123,245,39
2020-09-06,EK,Denmark,785,365,83,9,420,167,170,337,74
2020-09-07,EK,Denmark,805,338,104,23,467,182,181,363,81
2020-09-08,EK,Denmark,730,322,114,30,408,147,147,294,84
2020-09-09,EK,Denmark,791,348,137,30,443,154,152,306,107
2020-09-10,EK,Denmark,802,341,125,30,461,164,172,336,95
2020-09-11,EK,Denmark,882,388,117,24,494,188,189,377,93
2020-09-12,EK,Denmark,631,353,49,10,278,113,116,229,39
2020-09-13,EK,Denmark,764,365,75,15,399,163,161,324,60
2020-09-14,EK,Denmark,783,335,102,23,448,173,173,346,79
2020-09-15,EK,Denmark,705,308,101,26,397,142,154,296,75
2020-09-16,EK,Denmark,749,320,107,22,429,166,156,322,85
2020-09-17,EK,Denmark,781,335,120,35,446,163,163,326,85
2020-09-18,EK,Denmark,834,390,90,15,444,176,178,354,75
2020-09-19,EK,Denmark,593,330,45,9,263,110,108,218,36
2020-09-20,EK,Denmark,741,359,74,7,382,154,154,308,67
2020-09-21,EK,Denmark,777,333,109,20,444,169,166,335,89
2020-09-22,EK,Denmark,695,319,108,30,376,131,137,268,78
2020-09-23,EK,Denmark,758,353,108,33,405,150,147,297,75
2020-09-24,EK,Denmark,753,330,112,29,423,158,153,311,83
2020-09-25,EK,Denmark,886,431,94,14,455,178,183,361,80
2020-09-26,EK,Denmark,616,349,46,15,267,109,112,221,31
2020-09-27,EK,Denmark,744,364,76,15,380,150,154,304,61
2020-09-28,EK,Denmark,774,341,110,27,433,168,155,323,83
2020-09-29,EK,Denmark,702,316,110,41,386,131,145,276,69
2020-09-30,EK,Denmark,740,356,99,24,384,147,138,285,75
2020-10-01,EK,Denmark,678,287,98,22,391,148,145,293,76
2020-10-02,EK,Denmark,816,376,109,21,440,162,169,331,88
2020-10-03,EK,Denmark,566,316,40,10,250,105,105,210,30
2020-10-04,EK,Denmark,756,387,76,16,369,147,146,293,60
2020-10-05,EK,Denmark,717,325,100,31,392,149,143,292,69
2020-10-06,EK,Denmark,633,281,98,20,352,123,131,254,78
2020-10-07,EK,Denmark,706,341,99,24,365,133,133,266,75
2020-10-08,EK,Denmark,688,288,96,15,400,158,146,304,81
2020-10-09,EK,Denmark,845,383,114,22,462,167,181,348,92
2020-10-10,EK,Denmark,605,319,54,13,286,114,118,232,41
2020-10-11,EK,Denmark,701,326,68,11,375,157,150,307,57
2020-10-12,EK,Denmark,677,316,89,22,361,140,132,272,67
2020-10-13,EK,Denmark,610,302,71,14,308,116,121,237,57
2020-10-14,EK,Denmark,627,308,64,20,319,130,125,255,44
2020-10-15,EK,Denmark,678,307,89,14,371,141,141,282,75
2020-10-16,EK,Denmark,795,375,87,22,420,165,168,333,65
2020-10-17,EK,Denmark,633,354,57,12,279,108,114,222,45
2020-10-18,EK,Denmark,715,337,61,9,378,154,163,317,52
2020-10-19,EK,Denmark,689,313,89,22,376,147,140,287,67
2020-10-20,EK,Denmark,606,287,88,18,319,117,114,231,70
2020-10-21,EK,Denmark,641,315,92,11,326,116,118,234,81
2020-10-22,EK,Denmark,663,314,100,24,349,125,124,249,76
2020-10-23,EK,Denmark,758,351,116,23,407,140,151,291,93
2020-10-24,EK,Denmark,580,363,44,12,217,88,85,173,32
2020-10-25,EK,Denmark,681,353,77,10,328,129,122,251,67
2020-10-26,EK,Denmark,694,317,114,28,377,133,130,263,86
2020-10-27,EK,Denmark,579,260,99,15,319,106,114,220,84
2020-10-28,EK,Denmark,645,316,88,20,329,120,121,241,68
2020-10-29,EK,Denmark,653,302,100,28,351,127,124,251,72
2020-10-30,EK,Denmark,730,348,103,13,382,137,142,279,90
2020-10-31,EK,Denmark,517,316,43,7,201,80,78,158,36
2020-11-01,EK,Denmark,672,360,69,14,312,124,119,243,55
2020-11-02,EK,Denmark,645,332,78,3,313,120,115,235,75
2020-11-03,EK,Denmark,508,246,74,12,262,94,94,188,62
2020-11-04,EK,Denmark,572,274,93,23,298,105,100,205,70
2020-11-05,EK,Denmark,629,307,102,23,322,110,110,220,79
2020-11-06,EK,Denmark,703,336,112,21,367,127,128,255,91
2020-11-07,EK,Denmark,461,285,46,9,176,64,66,130,37
2020-11-08,EK,Denmark,558,312,57,2,246,94,95,189,55
2020-11-09,EK,Denmark,634,313,119,24,321,103,99,202,95
2020-11-10,EK,Denmark,505,225,105,29,280,88,87,175,76
2020-11-11,EK,Denmark,543,248,111,38,295,91,93,184,73
2020-11-12,EK,Denmark,588,291,112,34,297,91,94,185,78
2020-11-13,EK,Denmark,620,312,107,24,308,93,108,201,83
2020-11-14,EK,Denmark,396,254,41,13,142,55,46,101,28
2020-11-15,EK,Denmark,513,311,53,7,202,74,75,149,46
2020-11-16,EK,Denmark,545,300,81,13,245,87,77,164,68
2020-11-17,EK,Denmark,491,236,90,27,255,82,83,165,63
2020-11-18,EK,Denmark,523,244,109,28,279,83,87,170,81
2020-11-19,EK,Denmark,518,286,67,11,232,84,81,165,56
2020-11-20,EK,Denmark,570,297,95,25,273,84,94,178,70
2020-11-21,EK,Denmark,382,262,42,6,120,40,38,78,36
2020-11-22,EK,Denmark,427,251,48,6,176,62,66,128,42
2020-11-23,EK,Denmark,532,291,87,23,241,78,76,154,64
2020-11-24,EK,Denmark,483,242,105,24,241,71,65,136,81
2020-11-25,EK,Denmark,517,244,115,35,273,79,79,158,80
2020-11-26,EK,Denmark,517,268,98,25,249,75,76,151,73
2020-11-27,EK,Denmark,553,299,83,18,254,83,88,171,65
2020-11-28,EK,Denmark,380,261,30,2,119,46,43,89,28
2020-11-29,EK,Denmark,467,283,50,3,184,66,68,134,47
2020-11-30,EK,Denmark,523,280,76,13,243,87,80,167,63
2020-12-01,EK,Denmark,447,214,79,13,233,78,76,154,66
2020-12-02,EK,Denmark,469,227,80,10,242,81,81,162,70
2020-12-03,EK,Denmark,500,279,70,11,221,74,77,151,59
2020-12-04,EK,Denmark,572,322,75,13,250,81,94,175,62
2020-12-05,EK,Denmark,385,251,43,10,134,51,40,91,33
2020-12-06,EK,Denmark,496,296,67,5,200,66,67,133,62
2020-12-07,EK,Denmark,544,284,89,22,260,88,83,171,67
2020-12-08,EK,Denmark,510,251,96,23,259,86,77,163,73
2020-12-09,EK,Denmark,551,283,77,19,268,94,97,191,58
2020-12-10,EK,Denmark,545,304,73,8,241,84,84,168,65
2020-12-11,EK,Denmark,598,352,59,4,246,91,96,187,55
2020-12-12,EK,Denmark,428,296,33,1,132,52,47,99,32
2020-12-13,EK,Denmark,515,330,53,3,185,62,70,132,50
2020-12-14,EK,Denmark,563,289,91,15,274,96,87,183,76
2020-12-15,EK,Denmark,502,263,83,16,239,76,80,156,67
2020-12-16,EK,Denmark,611,317,99,27,294,96,99,195,72
2020-12-17,EK,Denmark,676,345,108,14,331,111,112,223,94
2020-12-18,EK,Denmark,755,374,99,15,381,137,145,282,84
2020-12-19,EK,Denmark,620,396,40,3,224,92,92,184,37
2020-12-20,EK,Denmark,662,379,59,3,283,108,116,224,56
2020-12-21,EK,Denmark,605,324,71,7,281,108,102,210,64
2020-12-22,EK,Denmark,586,280,101,8,306,102,103,205,93
2020-12-23,EK,Denmark,590,312,68,3,278,104,106,210,65
2020-12-24,EK,Denmark,273,178,27,1,95,35,33,68,26
2020-12-25,EK,Denmark,247,171,28,0,76,24,24,48,28
2020-12-26,EK,Denmark,397,238,32,0,159,67,60,127,32
2020-12-27,EK,Denmark,529,293,53,1,236,89,94,183,52
2020-12-28,EK,Denmark,528,293,53,3,235,95,87,182,50
2020-12-29,EK,Denmark,434,236,45,0,198,77,76,153,45
2020-12-30,EK,Denmark,523,275,71,1,248,90,87,177,70
2020-12-31,EK,Denmark,261,183,26,2,78,26,26,52,24
2020-01-01,EE,Estonia,480,391,10,2,89,37,42,79,8
2020-01-02,EE,Estonia,569,439,11,3,130,61,58,119,8
2020-01-03,EE,Estonia,549,443,9,1,106,50,47,97,8
2020-01-04,EE,Estonia,492,419,5,1,73,36,32,68,4
2020-01-05,EE,Estonia,499,411,8,4,88,39,41,80,4
2020-01-06,EE,Estonia,514,397,8,0,117,52,57,109,8
2020-01-07,EE,Estonia,498,387,11,3,111,53,47,100,8
2020-01-08,EE,Estonia,543,434,11,3,109,48,50,98,8
2020-01-09,EE,Estonia,513,384,16,6,129,57,56,113,10
2020-01-10,EE,Estonia,500,389,8,2,111,52,51,103,6
2020-01-11,EE,Estonia,539,467,5,1,72,35,32,67,4
2020-01-12,EE,Estonia,496,416,6,2,80,34,40,74,4
2020-01-13,EE,Estonia,490,371,10,2,119,55,54,109,8
2020-01-14,EE,Estonia,491,380,14,2,111,48,49,97,12
2020-01-15,EE,Estonia,498,391,8,0,107,49,50,99,8
2020-01-16,EE,Estonia,491,370,11,3,121,55,55,110,8
2020-01-17,EE,Estonia,569,447,17,7,122,52,53,105,10
2020-01-18,EE,Estonia,479,408,5,1,71,34,32,66,4
2020-01-19,EE,Estonia,444,356,7,1,88,39,42,81,6
2020-01-20,EE,Estonia,523,407,12,2,116,53,51,104,10
2020-01-21,EE,Estonia,510,397,11,3,113,52,50,102,8
2020-01-22,EE,Estonia,486,375,11,3,111,51,49,100,8
2020-01-23,EE,Estonia,536,416,10,2,120,54,56,110,8
2020-01-24,EE,Estonia,549,437,12,4,112,51,49,100,8
2020-01-25,EE,Estonia,455,380,11,7,75,33,31,64,4
2020-01-26,EE,Estonia,495,410,5,1,85,37,43,80,4
2020-01-27,EE,Estonia,472,349,8,0,123,58,57,115,8
2020-01-28,EE,Estonia,446,338,9,1,108,51,48,99,8
2020-01-29,EE,Estonia,477,372,8,2,105,48,49,97,6
2020-01-30,EE,Estonia,544,427,9,1,117,52,56,108,8
2020-01-31,EE,Estonia,518,404,11,0,114,51,52,103,11
2020-02-01,EE,Estonia,432,362,4,0,70,34,32,66,4
2020-02-02,EE,Estonia,458,367,7,0,91,41,43,84,7
2020-02-03,EE,Estonia,488,365,14,5,123,53,56,109,9
2020-02-04,EE,Estonia,445,328,14,6,117,52,51,103,8
2020-02-05,EE,Estonia,446,335,13,5,111,48,50,98,8
2020-02-06,EE,Estonia,491,367,13,4,124,57,54,111,9
2020-02-07,EE,Estonia,519,392,16,3,127,56,55,111,13
2020-02-08,EE,Estonia,458,388,5,1,70,33,32,65,4
2020-02-09,EE,Estonia,461,373,7,1,88,39,42,81,6
2020-02-10,EE,Estonia,436,322,9,1,114,53,52,105,8
2020-02-11,EE,Estonia,441,327,11,1,114,51,52,103,10
2020-02-12,EE,Estonia,474,351,12,4,123,54,57,111,8
2020-02-13,EE,Estonia,506,378,12,4,128,57,59,116,8
2020-02-14,EE,Estonia,514,396,14,4,118,54,50,104,10
2020-02-15,EE,Estonia,427,349,7,3,78,37,34,71,4
2020-02-16,EE,Estonia,479,392,4,0,87,38,45,83,4
2020-02-17,EE,Estonia,447,318,8,0,129,60,61,121,8
2020-02-18,EE,Estonia,446,319,11,3,127,59,57,116,8
2020-02-19,EE,Estonia,452,337,9,1,115,52,54,106,8
2020-02-20,EE,Estonia,539,400,11,3,139,67,61,128,8
2020-02-21,EE,Estonia,541,418,9,1,123,58,56,114,8
2020-02-22,EE,Estonia,440,365,4,0,75,37,34,71,4
2020-02-23,EE,Estonia,440,349,4,0,91,43,44,87,4
2020-02-24,EE,Estonia,465,349,11,2,116,53,52,105,9
2020-02-25,EE,Estonia,476,358,13,2,118,52,53,105,11
2020-02-26,EE,Estonia,447,341,8,0,106,48,50,98,8
2020-02-27,EE,Estonia,494,368,10,2,126,58,58,116,8
2020-02-28,EE,Estonia,532,415,12,4,117,53,52,105,8
2020-02-29,EE,Estonia,446,366,7,3,80,38,35,73,4
2020-03-01,EE,Estonia,477,381,7,3,96,41,48,89,4
2020-03-02,EE,Estonia,493,364,12,3,129,58,59,117,9
2020-03-03,EE,Estonia,459,334,11,2,125,56,58,114,9
2020-03-04,EE,Estonia,467,347,9,1,120,54,57,111,8
2020-03-05,EE,Estonia,492,363,9,1,129,60,60,120,8
2020-03-06,EE,Estonia,528,399,18,8,129,56,55,111,10
2020-03-07,EE,Estonia,457,374,7,3,83,41,35,76,4
2020-03-08,EE,Estonia,489,397,9,3,92,40,43,83,6
2020-03-09,EE,Estonia,484,358,15,7,126,55,56,111,8
2020-03-10,EE,Estonia,480,355,12,2,125,58,55,113,10
2020-03-11,EE,Estonia,482,366,11,3,116,52,53,105,8
2020-03-12,EE,Estonia,469,344,12,4,125,56,57,113,8
2020-03-13,EE,Estonia,441,324,13,5,117,53,51,104,8
2020-03-14,EE,Estonia,392,314,6,2,78,36,36,72,4
2020-03-15,EE,Estonia,421,342,6,2,79,36,37,73,4
2020-03-16,EE,Estonia,349,245,9,1,104,51,44,95,8
2020-03-17,EE,Estonia,292,247,9,1,45,19,17,36,8
2020-03-18,EE,Estonia,277,235,4,0,42,16,22,38,4
2020-03-19,EE,Estonia,222,187,2,2,35,17,16,33,0
2020-03-20,EE,Estonia,209,184,1,0,25,13,11,24,1
2020-03-21,EE,Estonia,172,152,1,1,20,9,10,19,0
2020-03-22,EE,Estonia,178,159,2,2,19,8,9,17,0
2020-03-23,EE,Estonia,183,155,1,1,28,14,13,27,0
2020-03-24,EE,Estonia,159,133,1,1,26,13,12,25,0
2020-03-25,EE,Estonia,161,141,2,1,20,9,9,18,1
2020-03-26,EE,Estonia,120,101,1,1,19,8,10,18,0
2020-03-27,EE,Estonia,156,135,1,1,21,10,10,20,0
2020-03-28,EE,Estonia,120,113,1,1,7,3,3,6,0
2020-03-29,EE,Estonia,107,102,1,1,5,2,2,4,0
2020-03-30,EE,Estonia,99,87,1,1,12,5,6,11,0
2020-03-31,EE,Estonia,101,90,1,1,11,5,5,10,0
2020-04-01,EE,Estonia,99,83,1,1,16,8,7,15,0
2020-04-02,EE,Estonia,103,85,1,1,18,8,9,17,0
2020-04-03,EE,Estonia,106,92,1,1,14,6,7,13,0
2020-04-04,EE,Estonia,104,97,1,1,7,3,3,6,0
2020-04-05,EE,Estonia,99,96,1,1,3,1,1,2,0
2020-04-06,EE,Estonia,108,93,1,1,15,6,8,14,0
2020-04-07,EE,Estonia,94,75,1,1,19,10,8,18,0
2020-04-08,EE,Estonia,125,110,2,2,15,6,7,13,0
2020-04-09,EE,Estonia,118,99,2,2,19,9,8,17,0
2020-04-10,EE,Estonia,114,113,1,1,1,0,0,0,0
2020-04-11,EE,Estonia,111,105,1,1,6,3,2,5,0
2020-04-12,EE,Estonia,110,105,1,1,5,2,2,4,0
2020-04-13,EE,Estonia,104,92,1,1,12,5,6,11,0
2020-04-14,EE,Estonia,107,88,0,0,19,9,10,19,0
2020-04-15,EE,Estonia,131,114,0,0,17,8,9,17,0
2020-04-16,EE,Estonia,123,101,1,1,22,11,10,21,0
2020-04-17,EE,Estonia,116,101,1,1,15,7,7,14,0
2020-04-18,EE,Estonia,111,99,1,1,12,5,6,11,0
2020-04-19,EE,Estonia,112,106,3,3,6,1,2,3,0
2020-04-20,EE,Estonia,121,95,2,2,26,13,11,24,0
2020-04-21,EE,Estonia,129,108,3,3,21,9,9,18,0
2020-04-22,EE,Estonia,135,115,3,3,20,9,8,17,0
2020-04-23,EE,Estonia,141,118,5,5,23,9,9,18,0
2020-04-24,EE,Estonia,147,134,2,2,13,5,6,11,0
2020-04-25,EE,Estonia,128,120,1,1,8,4,3,7,0
2020-04-26,EE,Estonia,144,133,2,2,11,2,7,9,0
2020-04-27,EE,Estonia,151,134,1,1,17,8,8,16,0
2020-04-28,EE,Estonia,142,124,1,1,18,9,8,17,0
2020-04-29,EE,Estonia,165,143,2,2,22,10,10,20,0
2020-04-30,EE,Estonia,155,134,0,0,21,10,11,21,0
2020-05-01,EE,Estonia,156,151,3,3,5,1,1,2,0
2020-05-02,EE,Estonia,136,128,1,1,8,3,4,7,0
2020-05-03,EE,Estonia,152,147,1,1,5,2,2,4,0
2020-05-04,EE,Estonia,156,138,2,2,18,10,6,16,0
2020-05-05,EE,Estonia,159,130,2,2,29,14,13,27,0
2020-05-06,EE,Estonia,179,155,2,2,24,10,12,22,0
2020-05-07,EE,Estonia,174,150,4,4,24,9,11,20,0
2020-05-08,EE,Estonia,161,147,3,3,14,5,6,11,0
2020-05-09,EE,Estonia,134,122,6,2,12,2,4,6,4
2020-05-10,EE,Estonia,144,140,4,0,4,0,0,0,4
2020-05-11,EE,Estonia,185,162,9,1,23,7,7,14,8
2020-05-12,EE,Estonia,181,151,8,2,30,11,11,22,6
2020-05-13,EE,Estonia,207,184,11,3,23,6,6,12,8
2020-05-14,EE,Estonia,199,168,10,2,31,10,11,21,8
2020-05-15,EE,Estonia,212,183,10,2,29,9,10,19,8
2020-05-16,EE,Estonia,182,165,4,0,17,6,7,13,4
2020-05-17,EE,Estonia,193,182,5,1,11,3,3,6,4
2020-05-18,EE,Estonia,196,155,10,2,41,16,15,31,8
2020-05-19,EE,Estonia,199,166,9,1,33,11,13,24,8
2020-05-20,EE,Estonia,217,175,12,4,42,15,15,30,8
2020-05-21,EE,Estonia,220,176,18,8,44,13,13,26,10
2020-05-22,EE,Estonia,230,194,12,4,36,12,12,24,8
2020-05-23,EE,Estonia,200,181,4,0,19,7,8,15,4
2020-05-24,EE,Estonia,188,168,4,0,20,8,8,16,4
2020-05-25,EE,Estonia,210,167,10,2,43,17,16,33,8
2020-05-26,EE,Estonia,204,162,14,4,42,16,12,28,10
2020-05-27,EE,Estonia,211,165,10,2,46,18,18,36,8
2020-05-28,EE,Estonia,211,167,10,2,44,16,18,34,8
2020-05-29,EE,Estonia,213,180,12,3,33,11,10,21,9
2020-05-30,EE,Estonia,173,153,5,1,20,7,8,15,4
2020-05-31,EE,Estonia,192,169,5,1,23,10,8,18,4
2020-06-01,EE,Estonia,187,150,12,4,37,12,13,25,8
2020-06-02,EE,Estonia,199,150,13,5,49,18,18,36,8
2020-06-03,EE,Estonia,202,164,13,5,38,13,12,25,8
2020-06-04,EE,Estonia,226,175,13,4,51,20,18,38,9
2020-06-05,EE,Estonia,216,175,14,2,41,13,14,27,12
2020-06-06,EE,Estonia,191,167,10,6,24,7,7,14,4
2020-06-07,EE,Estonia,174,145,7,1,29,12,10,22,6
2020-06-08,EE,Estonia,204,161,14,5,43,15,14,29,9
2020-06-09,EE,Estonia,174,129,10,2,45,17,18,35,8
2020-06-10,EE,Estonia,206,165,14,6,41,13,14,27,8
2020-06-11,EE,Estonia,206,157,12,4,49,18,19,37,8
2020-06-12,EE,Estonia,201,161,10,2,40,15,15,30,8
2020-06-13,EE,Estonia,148,123,8,4,25,8,9,17,4
2020-06-14,EE,Estonia,188,159,7,3,29,11,11,22,4
2020-06-15,EE,Estonia,202,157,12,2,45,16,17,33,10
2020-06-16,EE,Estonia,194,152,11,3,42,16,15,31,8
2020-06-17,EE,Estonia,202,149,13,4,53,19,21,40,9
2020-06-18,EE,Estonia,221,167,10,4,54,22,22,44,6
2020-06-19,EE,Estonia,200,154,15,3,46,16,15,31,12
2020-06-20,EE,Estonia,174,150,6,2,24,9,9,18,4
2020-06-21,EE,Estonia,157,122,8,2,35,14,13,27,6
2020-06-22,EE,Estonia,218,165,12,3,53,19,22,41,9
2020-06-23,EE,Estonia,199,159,12,4,40,15,13,28,8
2020-06-24,EE,Estonia,212,172,12,2,40,14,14,28,10
2020-06-25,EE,Estonia,198,150,13,3,48,17,18,35,10
2020-06-26,EE,Estonia,207,153,15,3,54,19,20,39,12
2020-06-27,EE,Estonia,175,141,8,4,34,14,12,26,4
2020-06-28,EE,Estonia,169,137,9,3,32,12,11,23,6
2020-06-29,EE,Estonia,196,140,10,2,56,23,23,46,8
2020-06-30,EE,Estonia,200,146,12,4,54,20,22,42,8
2020-07-01,EE,Estonia,244,171,11,3,73,34,28,62,8
2020-07-02,EE,Estonia,218,158,10,2,60,25,25,50,8
2020-07-03,EE,Estonia,242,186,14,4,56,20,22,42,10
2020-07-04,EE,Estonia,205,150,9,3,55,22,24,46,6
2020-07-05,EE,Estonia,201,149,9,1,52,22,21,43,8
2020-07-06,EE,Estonia,193,149,10,2,44,16,18,34,8
2020-07-07,EE,Estonia,192,140,14,5,52,19,19,38,9
2020-07-08,EE,Estonia,227,166,10,2,61,25,26,51,8
2020-07-09,EE,Estonia,210,151,12,4,59,22,25,47,8
2020-07-10,EE,Estonia,225,172,15,5,53,19,19,38,10
2020-07-11,EE,Estonia,190,142,5,1,48,22,21,43,4
2020-07-12,EE,Estonia,185,132,14,5,53,21,18,39,9
2020-07-13,EE,Estonia,209,147,15,7,62,22,25,47,8
2020-07-14,EE,Estonia,196,136,14,5,60,22,24,46,9
2020-07-15,EE,Estonia,196,139,13,5,57,22,22,44,8
2020-07-16,EE,Estonia,225,163,13,5,62,26,23,49,8
2020-07-17,EE,Estonia,236,171,16,4,65,23,26,49,12
2020-07-18,EE,Estonia,218,164,8,2,54,23,23,46,6
2020-07-19,EE,Estonia,204,154,8,2,50,22,20,42,6
2020-07-20,EE,Estonia,212,154,10,2,58,23,25,48,8
2020-07-21,EE,Estonia,218,150,13,5,68,28,27,55,8
2020-07-22,EE,Estonia,234,181,11,3,53,21,21,42,8
2020-07-23,EE,Estonia,233,164,14,4,69,28,27,55,10
2020-07-24,EE,Estonia,234,179,15,3,55,20,20,40,12
2020-07-25,EE,Estonia,208,155,7,1,53,24,22,46,6
2020-07-26,EE,Estonia,219,165,10,2,54,21,23,44,8
2020-07-27,EE,Estonia,213,160,12,4,53,21,20,41,8
2020-07-28,EE,Estonia,215,158,10,2,57,23,24,47,8
2020-07-29,EE,Estonia,252,191,14,4,61,24,23,47,10
2020-07-30,EE,Estonia,214,150,11,3,64,26,27,53,8
2020-07-31,EE,Estonia,239,177,15,3,62,21,26,47,12
2020-08-01,EE,Estonia,254,206,8,4,48,19,21,40,4
2020-08-02,EE,Estonia,215,157,8,0,58,25,25,50,8
2020-08-03,EE,Estonia,224,163,14,3,61,22,25,47,11
2020-08-04,EE,Estonia,208,139,12,2,69,29,28,57,10
2020-08-05,EE,Estonia,233,176,11,3,57,24,22,46,8
2020-08-06,EE,Estonia,264,194,13,5,70,29,28,57,8
2020-08-07,EE,Estonia,246,184,13,3,62,24,25,49,10
2020-08-08,EE,Estonia,224,174,5,1,50,21,24,45,4
2020-08-09,EE,Estonia,249,188,8,2,61,28,25,53,6
2020-08-10,EE,Estonia,237,186,12,2,51,20,19,39,10
2020-08-11,EE,Estonia,241,179,12,4,62,24,26,50,8
2020-08-12,EE,Estonia,263,187,12,2,76,30,34,64,10
2020-08-13,EE,Estonia,246,188,12,3,58,23,23,46,9
2020-08-14,EE,Estonia,269,200,17,3,69,26,26,52,14
2020-08-15,EE,Estonia,256,203,4,0,53,25,24,49,4
2020-08-16,EE,Estonia,262,199,9,1,63,27,27,54,8
2020-08-17,EE,Estonia,248,189,12,4,59,25,22,47,8
2020-08-18,EE,Estonia,251,185,11,3,66,27,28,55,8
2020-08-19,EE,Estonia,254,185,16,3,69,27,26,53,13
2020-08-20,EE,Estonia,253,190,11,2,63,26,26,52,9
2020-08-21,EE,Estonia,261,203,16,2,58,22,20,42,14
2020-08-22,EE,Estonia,242,194,9,3,48,18,21,39,6
2020-08-23,EE,Estonia,253,195,13,1,58,23,22,45,12
2020-08-24,EE,Estonia,218,172,11,3,46,20,15,35,8
2020-08-25,EE,Estonia,225,163,14,4,62,24,24,48,10
2020-08-26,EE,Estonia,266,205,12,4,61,24,25,49,8
2020-08-27,EE,Estonia,272,194,11,3,78,33,34,67,8
2020-08-28,EE,Estonia,298,237,14,3,61,24,23,47,11
2020-08-29,EE,Estonia,224,179,6,0,45,18,21,39,6
2020-08-30,EE,Estonia,240,184,5,0,56,24,27,51,5
2020-08-31,EE,Estonia,231,183,11,3,48,19,18,37,8
2020-09-01,EE,Estonia,209,142,11,2,67,28,28,56,9
2020-09-02,EE,Estonia,251,189,11,3,62,26,25,51,8
2020-09-03,EE,Estonia,272,189,15,7,83,32,36,68,8
2020-09-04,EE,Estonia,261,190,16,4,71,28,27,55,12
2020-09-05,EE,Estonia,229,183,9,4,46,19,18,37,5
2020-09-06,EE,Estonia,237,175,9,3,62,29,24,53,6
2020-09-07,EE,Estonia,227,168,12,2,59,24,23,47,10
2020-09-08,EE,Estonia,221,149,14,6,72,29,29,58,8
2020-09-09,EE,Estonia,255,197,11,3,58,24,23,47,8
2020-09-10,EE,Estonia,221,159,9,1,62,25,28,53,8
2020-09-11,EE,Estonia,254,188,11,3,66,28,27,55,8
2020-09-12,EE,Estonia,216,167,12,4,49,19,18,37,8
2020-09-13,EE,Estonia,216,164,6,0,52,24,22,46,6
2020-09-14,EE,Estonia,229,168,15,5,61,24,22,46,10
2020-09-15,EE,Estonia,216,153,11,3,63,26,26,52,8
2020-09-16,EE,Estonia,243,190,10,4,53,23,20,43,6
2020-09-17,EE,Estonia,232,171,12,4,61,25,24,49,8
2020-09-18,EE,Estonia,270,207,16,6,63,24,23,47,10
2020-09-19,EE,Estonia,230,185,11,3,45,16,18,34,8
2020-09-20,EE,Estonia,242,189,12,6,53,20,21,41,6
2020-09-21,EE,Estonia,216,165,10,2,51,20,21,41,8
2020-09-22,EE,Estonia,220,157,17,8,63,24,22,46,9
2020-09-23,EE,Estonia,258,198,14,3,60,20,26,46,11
2020-09-24,EE,Estonia,250,183,17,5,67,27,23,50,12
2020-09-25,EE,Estonia,263,206,18,5,57,19,20,39,13
2020-09-26,EE,Estonia,211,177,8,4,34,12,14,26,4
2020-09-27,EE,Estonia,238,198,6,0,40,20,14,34,6
2020-09-28,EE,Estonia,238,184,14,4,54,18,22,40,10
2020-09-29,EE,Estonia,234,174,16,8,60,22,22,44,8
2020-09-30,EE,Estonia,241,189,14,7,52,17,21,38,7
2020-10-01,EE,Estonia,213,169,11,5,44,17,16,33,6
2020-10-02,EE,Estonia,245,194,16,8,51,16,19,35,8
2020-10-03,EE,Estonia,216,188,8,4,28,9,11,20,4
2020-10-04,EE,Estonia,197,155,6,2,42,21,15,36,4
2020-10-05,EE,Estonia,204,152,11,3,52,20,21,41,8
2020-10-06,EE,Estonia,179,124,22,14,55,15,18,33,8
2020-10-07,EE,Estonia,228,167,14,6,61,24,23,47,8
2020-10-08,EE,Estonia,218,159,17,9,59,24,18,42,8
2020-10-09,EE,Estonia,233,175,15,3,58,21,22,43,12
2020-10-10,EE,Estonia,197,163,8,4,34,13,13,26,4
2020-10-11,EE,Estonia,217,171,6,2,46,19,21,40,4
2020-10-12,EE,Estonia,225,174,13,4,51,20,18,38,9
2020-10-13,EE,Estonia,197,149,13,5,48,17,18,35,8
2020-10-14,EE,Estonia,240,186,15,4,54,20,19,39,11
2020-10-15,EE,Estonia,222,164,15,5,58,21,22,43,10
2020-10-16,EE,Estonia,244,192,13,3,52,20,19,39,10
2020-10-17,EE,Estonia,237,205,6,2,32,13,13,26,4
2020-10-18,EE,Estonia,215,155,5,1,60,26,29,55,4
2020-10-19,EE,Estonia,205,156,10,2,49,19,20,39,8
2020-10-20,EE,Estonia,210,164,12,3,46,18,16,34,9
2020-10-21,EE,Estonia,216,166,14,6,50,18,18,36,8
2020-10-22,EE,Estonia,228,183,10,2,45,19,16,35,8
2020-10-23,EE,Estonia,241,187,13,5,54,21,20,41,8
2020-10-24,EE,Estonia,221,187,6,2,34,13,15,28,4
2020-10-25,EE,Estonia,211,172,7,1,39,16,16,32,6
2020-10-26,EE,Estonia,220,166,16,5,54,20,18,38,11
2020-10-27,EE,Estonia,183,133,13,4,50,19,18,37,9
2020-10-28,EE,Estonia,236,183,11,3,53,21,21,42,8
2020-10-29,EE,Estonia,222,173,14,6,49,17,18,35,8
2020-10-30,EE,Estonia,219,178,5,1,41,19,17,36,4
2020-10-31,EE,Estonia,220,185,6,2,35,14,15,29,4
2020-11-01,EE,Estonia,201,158,11,7,43,15,17,32,4
2020-11-02,EE,Estonia,217,172,10,2,45,19,16,35,8
2020-11-03,EE,Estonia,208,153,9,1,55,23,23,46,8
2020-11-04,EE,Estonia,226,175,12,3,51,19,20,39,9
2020-11-05,EE,Estonia,253,196,11,3,57,23,23,46,8
2020-11-06,EE,Estonia,212,156,14,4,56,21,21,42,10
2020-11-07,EE,Estonia,223,189,9,4,34,12,13,25,5
2020-11-08,EE,Estonia,221,181,7,1,40,16,17,33,6
2020-11-09,EE,Estonia,222,172,10,2,50,21,19,40,8
2020-11-10,EE,Estonia,199,152,9,1,47,19,19,38,8
2020-11-11,EE,Estonia,226,178,10,2,48,20,18,38,8
2020-11-12,EE,Estonia,240,189,10,2,51,18,23,41,8
2020-11-13,EE,Estonia,245,189,11,3,56,24,21,45,8
2020-11-14,EE,Estonia,227,198,6,2,29,11,12,23,4
2020-11-15,EE,Estonia,206,178,4,0,28,12,12,24,4
2020-11-16,EE,Estonia,233,184,10,2,49,21,18,39,8
2020-11-17,EE,Estonia,224,175,11,3,49,20,18,38,8
2020-11-18,EE,Estonia,231,179,12,4,52,19,21,40,8
2020-11-19,EE,Estonia,232,176,9,1,56,22,25,47,8
2020-11-20,EE,Estonia,203,150,12,2,53,19,22,41,10
2020-11-21,EE,Estonia,200,167,8,1,33,12,13,25,7
2020-11-22,EE,Estonia,196,162,6,0,34,14,14,28,6
2020-11-23,EE,Estonia,229,172,11,3,57,23,23,46,8
2020-11-24,EE,Estonia,220,169,14,6,51,19,18,37,8
2020-11-25,EE,Estonia,242,189,15,5,53,19,19,38,10
2020-11-26,EE,Estonia,222,162,10,2,60,25,25,50,8
2020-11-27,EE,Estonia,204,151,15,5,53,18,20,38,10
2020-11-28,EE,Estonia,216,180,6,2,36,17,13,30,4
2020-11-29,EE,Estonia,217,183,7,1,34,12,15,27,6
2020-11-30,EE,Estonia,250,197,10,2,53,22,21,43,8
2020-12-01,EE,Estonia,213,157,12,3,56,21,23,44,9
2020-12-02,EE,Estonia,234,180,14,4,54,21,19,40,10
2020-12-03,EE,Estonia,246,201,9,1,45,18,18,36,8
2020-12-04,EE,Estonia,241,191,13,3,50,19,18,37,10
2020-12-05,EE,Estonia,222,176,12,8,46,17,17,34,4
2020-12-06,EE,Estonia,199,164,9,3,35,12,14,26,6
2020-12-07,EE,Estonia,259,196,15,4,63,25,23,48,11
2020-12-08,EE,Estonia,243,187,14,3,56,21,21,42,11
2020-12-09,EE,Estonia,245,192,14,6,53,17,22,39,8
2020-12-10,EE,Estonia,256,197,15,6,59,24,20,44,9
2020-12-11,EE,Estonia,239,197,10,0,42,16,16,32,10
2020-12-12,EE,Estonia,220,188,7,3,32,11,14,25,4
2020-12-13,EE,Estonia,238,210,4,0,28,11,13,24,4
2020-12-14,EE,Estonia,223,170,11,3,53,22,20,42,8
2020-12-15,EE,Estonia,202,160,10,2,42,17,15,32,8
2020-12-16,EE,Estonia,217,175,9,3,42,17,16,33,6
2020-12-17,EE,Estonia,259,204,11,3,55,22,22,44,8
2020-12-18,EE,Estonia,260,203,11,1,57,24,22,46,10
2020-12-19,EE,Estonia,252,214,4,0,38,17,17,34,4
2020-12-20,EE,Estonia,234,199,3,1,35,17,15,32,2
2020-12-21,EE,Estonia,247,190,9,1,57,23,25,48,8
2020-12-22,EE,Estonia,202,162,8,0,40,18,14,32,8
2020-12-23,EE,Estonia,241,198,12,2,43,16,15,31,10
2020-12-24,EE,Estonia,168,132,10,2,36,12,14,26,8
2020-12-25,EE,Estonia,150,125,8,0,25,8,9,17,8
2020-12-26,EE,Estonia,196,170,5,1,26,11,10,21,4
2020-12-27,EE,Estonia,215,169,11,4,46,17,18,35,7
2020-12-28,EE,Estonia,216,171,11,3,45,16,18,34,8
2020-12-29,EE,Estonia,173,130,11,2,43,17,15,32,9
2020-12-30,EE,Estonia,198,152,13,5,46,15,18,33,8
2020-12-31,EE,Estonia,162,128,10,0,34,13,11,24,10
2020-01-01,EF,Finland,578,136,93,0,442,178,171,349,93
2020-01-02,EF,Finland,778,211,117,2,567,226,224,450,115
2020-01-03,EF,Finland,732,172,128,1,560,214,218,432,127
2020-01-04,EF,Finland,622,117,102,1,505,203,200,403,101
2020-01-05,EF,Finland,738,188,107,0,550,224,219,443,107
2020-01-06,EF,Finland,731,197,101,1,534,216,217,433,100
2020-01-07,EF,Finland,787,181,156,0,606,225,225,450,156
2020-01-08,EF,Finland,775,160,157,2,615,228,230,458,155
2020-01-09,EF,Finland,788,179,161,0,609,224,224,448,161
2020-01-10,EF,Finland,808,200,161,1,608,221,226,447,160
2020-01-11,EF,Finland,592,118,92,1,474,192,190,382,91
2020-01-12,EF,Finland,695,148,109,2,547,217,221,438,107
2020-01-13,EF,Finland,821,187,173,1,634,233,228,461,172
2020-01-14,EF,Finland,751,155,157,0,596,217,222,439,157
2020-01-15,EF,Finland,743,149,152,1,594,222,220,442,151
2020-01-16,EF,Finland,791,185,163,1,606,221,222,443,162
2020-01-17,EF,Finland,810,213,157,2,597,220,220,440,155
2020-01-18,EF,Finland,576,117,93,2,459,182,184,366,91
2020-01-19,EF,Finland,723,177,117,1,546,214,215,429,116
2020-01-20,EF,Finland,798,184,159,2,614,227,228,455,157
2020-01-21,EF,Finland,767,154,169,3,613,222,222,444,166
2020-01-22,EF,Finland,749,152,157,2,597,219,221,440,155
2020-01-23,EF,Finland,832,192,187,2,640,227,226,453,185
2020-01-24,EF,Finland,802,188,166,0,614,223,225,448,166
2020-01-25,EF,Finland,589,119,102,2,470,184,184,368,100
2020-01-26,EF,Finland,731,162,118,5,569,227,224,451,113
2020-01-27,EF,Finland,823,182,176,6,641,235,230,465,170
2020-01-28,EF,Finland,783,178,170,2,605,218,217,435,168
2020-01-29,EF,Finland,807,191,172,1,616,221,223,444,171
2020-01-30,EF,Finland,860,214,183,2,646,234,229,463,181
2020-01-31,EF,Finland,812,206,160,1,606,219,227,446,159
2020-02-01,EF,Finland,577,111,96,0,466,185,185,370,96
2020-02-02,EF,Finland,724,164,118,0,560,220,222,442,118
2020-02-03,EF,Finland,807,166,169,1,641,237,235,472,168
2020-02-04,EF,Finland,753,138,175,0,615,217,223,440,175
2020-02-05,EF,Finland,773,152,179,0,621,222,220,442,179
2020-02-06,EF,Finland,807,154,192,2,653,231,230,461,190
2020-02-07,EF,Finland,784,168,169,3,616,221,226,447,166
2020-02-08,EF,Finland,610,144,99,0,466,187,180,367,99
2020-02-09,EF,Finland,711,180,117,1,531,208,206,414,116
2020-02-10,EF,Finland,786,159,176,2,627,223,228,451,174
2020-02-11,EF,Finland,794,182,177,0,612,216,219,435,177
2020-02-12,EF,Finland,815,181,179,7,634,226,229,455,172
2020-02-13,EF,Finland,815,175,175,0,640,234,231,465,175
2020-02-14,EF,Finland,812,178,183,0,634,227,224,451,183
2020-02-15,EF,Finland,630,133,110,0,497,191,196,387,110
2020-02-16,EF,Finland,706,142,119,2,564,222,223,445,117
2020-02-17,EF,Finland,792,160,181,2,632,226,225,451,179
2020-02-18,EF,Finland,781,178,171,1,603,214,218,432,170
2020-02-19,EF,Finland,800,163,179,6,637,230,228,458,173
2020-02-20,EF,Finland,829,196,179,1,633,230,224,454,178
2020-02-21,EF,Finland,790,196,155,1,594,214,225,439,154
2020-02-22,EF,Finland,627,122,118,5,505,194,193,387,113
2020-02-23,EF,Finland,727,160,122,2,567,223,222,445,120
2020-02-24,EF,Finland,802,175,169,1,627,233,225,458,168
2020-02-25,EF,Finland,778,170,165,0,608,220,223,443,165
2020-02-26,EF,Finland,783,179,166,2,604,216,222,438,164
2020-02-27,EF,Finland,827,181,186,1,646,235,225,460,185
2020-02-28,EF,Finland,820,204,170,0,616,222,224,446,170
2020-02-29,EF,Finland,620,129,104,0,491,189,198,387,104
2020-03-01,EF,Finland,753,185,130,1,568,221,217,438,129
2020-03-02,EF,Finland,826,183,169,2,643,236,238,474,167
2020-03-03,EF,Finland,797,171,182,1,626,222,222,444,181
2020-03-04,EF,Finland,761,162,162,1,599,215,222,437,161
2020-03-05,EF,Finland,847,188,186,0,659,243,230,473,186
2020-03-06,EF,Finland,811,186,174,0,625,225,226,451,174
2020-03-07,EF,Finland,637,143,113,2,494,190,191,381,111
2020-03-08,EF,Finland,757,201,124,0,556,215,217,432,124
2020-03-09,EF,Finland,820,176,174,0,644,238,232,470,174
2020-03-10,EF,Finland,786,155,183,1,631,221,227,448,182
2020-03-11,EF,Finland,800,180,175,3,620,220,225,445,172
2020-03-12,EF,Finland,801,174,169,0,627,233,225,458,169
2020-03-13,EF,Finland,771,164,171,0,607,213,223,436,171
2020-03-14,EF,Finland,571,140,97,0,431,167,167,334,97
2020-03-15,EF,Finland,659,175,115,1,484,184,185,369,114
2020-03-16,EF,Finland,645,164,158,0,481,161,162,323,158
2020-03-17,EF,Finland,486,132,97,1,354,127,130,257,96
2020-03-18,EF,Finland,441,131,82,4,310,119,109,228,78
2020-03-19,EF,Finland,389,122,74,0,267,95,98,193,74
2020-03-20,EF,Finland,333,105,67,1,228,80,81,161,66
2020-03-21,EF,Finland,286,88,50,1,198,75,73,148,49
2020-03-22,EF,Finland,256,115,44,0,141,48,49,97,44
2020-03-23,EF,Finland,254,104,58,0,150,48,44,92,58
2020-03-24,EF,Finland,238,81,58,1,157,50,49,99,57
2020-03-25,EF,Finland,240,90,59,6,150,46,45,91,53
2020-03-26,EF,Finland,206,64,52,0,142,44,46,90,52
2020-03-27,EF,Finland,217,71,56,2,146,46,44,90,54
2020-03-28,EF,Finland,131,50,28,0,81,25,28,53,28
2020-03-29,EF,Finland,114,42,25,1,72,23,24,47,24
2020-03-30,EF,Finland,137,41,30,0,96,34,32,66,30
2020-03-31,EF,Finland,146,49,38,1,97,29,30,59,37
2020-04-01,EF,Finland,129,45,19,0,84,33,32,65,19
2020-04-02,EF,Finland,132,53,25,0,79,26,28,54,25
2020-04-03,EF,Finland,147,48,30,0,99,34,35,69,30
2020-04-04,EF,Finland,58,22,5,0,36,16,15,31,5
2020-04-05,EF,Finland,80,40,6,0,40,16,18,34,6
2020-04-06,EF,Finland,130,41,25,0,89,34,30,64,25
2020-04-07,EF,Finland,137,52,20,4,85,33,32,65,16
2020-04-08,EF,Finland,131,42,29,0,89,30,30,60,29
2020-04-09,EF,Finland,121,37,24,1,84,33,27,60,23
2020-04-10,EF,Finland,75,32,6,0,43,18,19,37,6
2020-04-11,EF,Finland,54,24,6,0,30,11,13,24,6
2020-04-12,EF,Finland,72,32,6,0,40,17,17,34,6
2020-04-13,EF,Finland,79,30,6,0,49,21,22,43,6
2020-04-14,EF,Finland,120,41,21,0,79,29,29,58,21
2020-04-15,EF,Finland,139,51,36,0,88,27,25,52,36
2020-04-16,EF,Finland,127,35,28,0,92,32,32,64,28
2020-04-17,EF,Finland,141,43,39,0,98,30,29,59,39
2020-04-18,EF,Finland,75,30,7,0,45,17,21,38,7
2020-04-19,EF,Finland,90,43,9,0,47,19,19,38,9
2020-04-20,EF,Finland,150,62,28,4,88,30,30,60,24
2020-04-21,EF,Finland,134,47,30,2,87,29,28,57,28
2020-04-22,EF,Finland,139,56,32,2,83,26,25,51,30
2020-04-23,EF,Finland,134,42,24,2,92,35,33,68,22
2020-04-24,EF,Finland,138,52,31,1,86,27,28,55,30
2020-04-25,EF,Finland,75,38,6,0,37,15,16,31,6
2020-04-26,EF,Finland,94,49,6,0,45,19,20,39,6
2020-04-27,EF,Finland,133,49,25,0,84,29,30,59,25
2020-04-28,EF,Finland,137,43,30,0,94,33,31,64,30
2020-04-29,EF,Finland,143,46,38,10,97,30,29,59,28
2020-04-30,EF,Finland,128,42,25,0,86,31,30,61,25
2020-05-01,EF,Finland,95,45,6,0,50,23,21,44,6
2020-05-02,EF,Finland,67,30,6,0,37,14,17,31,6
2020-05-03,EF,Finland,91,45,9,0,46,17,20,37,9
2020-05-04,EF,Finland,131,45,24,0,86,31,31,62,24
2020-05-05,EF,Finland,120,48,18,0,72,27,27,54,18
2020-05-06,EF,Finland,138,47,29,2,91,32,30,62,27
2020-05-07,EF,Finland,131,48,23,0,83,28,32,60,23
2020-05-08,EF,Finland,134,55,21,0,79,31,27,58,21
2020-05-09,EF,Finland,91,45,13,1,46,15,18,33,12
2020-05-10,EF,Finland,104,57,8,1,47,18,21,39,7
2020-05-11,EF,Finland,124,48,18,2,76,31,27,58,16
2020-05-12,EF,Finland,159,59,32,2,100,33,35,68,30
2020-05-13,EF,Finland,162,55,39,3,107,37,31,68,36
2020-05-14,EF,Finland,171,72,30,0,99,33,36,69,30
2020-05-15,EF,Finland,174,72,37,0,102,35,30,65,37
2020-05-16,EF,Finland,102,44,10,0,58,22,26,48,10
2020-05-17,EF,Finland,107,55,10,2,52,20,22,42,8
2020-05-18,EF,Finland,180,63,48,3,117,36,33,69,45
2020-05-19,EF,Finland,169,58,37,0,111,37,37,74,37
2020-05-20,EF,Finland,169,63,34,0,106,36,36,72,34
2020-05-21,EF,Finland,128,52,16,0,76,30,30,60,16
2020-05-22,EF,Finland,162,62,28,1,100,40,32,72,27
2020-05-23,EF,Finland,121,54,17,0,67,22,28,50,17
2020-05-24,EF,Finland,135,76,10,0,59,22,27,49,10
2020-05-25,EF,Finland,162,66,24,0,96,38,34,72,24
2020-05-26,EF,Finland,170,76,27,0,94,32,35,67,27
2020-05-27,EF,Finland,159,64,26,0,95,38,31,69,26
2020-05-28,EF,Finland,160,57,36,0,103,33,34,67,36
2020-05-29,EF,Finland,180,77,25,0,103,41,37,78,25
2020-05-30,EF,Finland,102,37,18,6,65,20,27,47,12
2020-05-31,EF,Finland,126,66,9,0,60,25,26,51,9
2020-06-01,EF,Finland,180,62,43,0,118,38,37,75,43
2020-06-02,EF,Finland,186,64,40,0,122,39,43,82,40
2020-06-03,EF,Finland,196,71,45,1,125,44,36,80,44
2020-06-04,EF,Finland,189,66,44,9,123,38,41,79,35
2020-06-05,EF,Finland,194,68,31,1,126,48,47,95,30
2020-06-06,EF,Finland,108,41,12,0,67,26,29,55,12
2020-06-07,EF,Finland,148,82,13,1,66,25,28,53,12
2020-06-08,EF,Finland,198,74,41,1,124,43,40,83,40
2020-06-09,EF,Finland,209,76,53,5,133,39,41,80,48
2020-06-10,EF,Finland,209,73,44,3,136,49,43,92,41
2020-06-11,EF,Finland,185,65,39,4,120,39,42,81,35
2020-06-12,EF,Finland,231,70,59,7,161,51,51,102,52
2020-06-13,EF,Finland,131,58,24,11,73,23,26,49,13
2020-06-14,EF,Finland,168,69,31,6,99,31,37,68,25
2020-06-15,EF,Finland,200,63,49,5,137,45,43,88,44
2020-06-16,EF,Finland,211,60,56,4,151,45,50,95,52
2020-06-17,EF,Finland,227,71,50,5,156,58,48,106,45
2020-06-18,EF,Finland,196,70,36,1,126,44,46,90,35
2020-06-19,EF,Finland,162,64,16,4,98,44,38,82,12
2020-06-20,EF,Finland,114,47,13,1,67,25,29,54,12
2020-06-21,EF,Finland,155,66,17,3,89,34,38,72,14
2020-06-22,EF,Finland,215,70,45,3,145,52,48,100,42
2020-06-23,EF,Finland,209,60,55,7,149,46,48,94,48
2020-06-24,EF,Finland,211,59,46,3,152,53,53,106,43
2020-06-25,EF,Finland,208,60,55,1,148,48,45,93,54
2020-06-26,EF,Finland,226,65,54,3,161,55,52,107,51
2020-06-27,EF,Finland,128,42,13,2,86,34,39,73,11
2020-06-28,EF,Finland,135,55,14,2,80,33,33,66,12
2020-06-29,EF,Finland,179,59,28,1,120,48,44,92,27
2020-06-30,EF,Finland,195,58,33,1,137,49,55,104,32
2020-07-01,EF,Finland,242,70,40,2,172,67,65,132,38
2020-07-02,EF,Finland,246,67,52,0,179,63,64,127,52
2020-07-03,EF,Finland,228,69,27,1,159,67,65,132,26
2020-07-04,EF,Finland,170,46,23,0,124,50,51,101,23
2020-07-05,EF,Finland,190,67,23,0,123,48,52,100,23
2020-07-06,EF,Finland,219,71,33,4,148,59,56,115,29
2020-07-07,EF,Finland,233,68,41,3,165,60,64,124,38
2020-07-08,EF,Finland,229,68,36,1,161,63,62,125,35
2020-07-09,EF,Finland,221,73,35,1,148,59,54,113,34
2020-07-10,EF,Finland,242,82,31,0,160,64,65,129,31
2020-07-11,EF,Finland,170,49,23,2,121,48,50,98,21
2020-07-12,EF,Finland,201,68,33,2,133,48,52,100,31
2020-07-13,EF,Finland,241,81,34,2,160,65,61,126,32
2020-07-14,EF,Finland,244,83,34,1,161,63,64,127,33
2020-07-15,EF,Finland,259,84,37,2,175,69,69,138,35
2020-07-16,EF,Finland,236,73,31,1,163,65,67,132,30
2020-07-17,EF,Finland,250,70,42,4,180,72,66,138,38
2020-07-18,EF,Finland,189,56,25,3,133,53,55,108,22
2020-07-19,EF,Finland,204,67,25,0,137,53,59,112,25
2020-07-20,EF,Finland,236,60,42,4,176,66,68,134,38
2020-07-21,EF,Finland,237,64,40,1,173,68,65,133,39
2020-07-22,EF,Finland,267,84,48,1,183,65,70,135,47
2020-07-23,EF,Finland,235,71,37,0,164,65,62,127,37
2020-07-24,EF,Finland,250,75,39,0,175,69,67,136,39
2020-07-25,EF,Finland,189,45,27,0,144,59,58,117,27
2020-07-26,EF,Finland,214,68,27,1,146,57,62,119,26
2020-07-27,EF,Finland,231,68,38,0,163,62,63,125,38
2020-07-28,EF,Finland,234,70,37,1,164,66,61,127,36
2020-07-29,EF,Finland,270,85,44,1,185,71,70,141,43
2020-07-30,EF,Finland,258,80,41,1,178,70,67,137,40
2020-07-31,EF,Finland,266,71,55,0,195,69,71,140,55
2020-08-01,EF,Finland,229,54,25,0,175,73,77,150,25
2020-08-02,EF,Finland,266,81,34,0,185,75,76,151,34
2020-08-03,EF,Finland,273,63,61,0,210,77,72,149,61
2020-08-04,EF,Finland,287,70,59,0,217,78,80,158,59
2020-08-05,EF,Finland,281,63,62,2,218,79,77,156,60
2020-08-06,EF,Finland,294,69,64,1,225,83,78,161,63
2020-08-07,EF,Finland,302,74,56,0,228,87,85,172,56
2020-08-08,EF,Finland,232,56,29,0,176,73,74,147,29
2020-08-09,EF,Finland,270,68,42,0,202,76,84,160,42
2020-08-10,EF,Finland,280,60,66,2,220,76,78,154,64
2020-08-11,EF,Finland,275,61,60,0,214,79,75,154,60
2020-08-12,EF,Finland,290,63,67,4,227,80,80,160,63
2020-08-13,EF,Finland,277,57,71,2,220,74,75,149,69
2020-08-14,EF,Finland,306,68,66,2,238,87,85,172,64
2020-08-15,EF,Finland,218,47,28,0,171,68,75,143,28
2020-08-16,EF,Finland,275,75,41,1,200,79,80,159,40
2020-08-17,EF,Finland,324,75,84,0,249,82,83,165,84
2020-08-18,EF,Finland,285,63,69,0,222,79,74,153,69
2020-08-19,EF,Finland,282,74,61,2,208,75,72,147,59
2020-08-20,EF,Finland,304,70,81,2,234,78,75,153,79
2020-08-21,EF,Finland,323,74,86,1,249,81,82,163,85
2020-08-22,EF,Finland,197,44,27,0,153,60,66,126,27
2020-08-23,EF,Finland,266,79,44,0,187,71,72,143,44
2020-08-24,EF,Finland,295,72,77,1,223,73,73,146,76
2020-08-25,EF,Finland,258,72,61,0,186,63,62,125,61
2020-08-26,EF,Finland,299,84,71,3,215,72,72,144,68
2020-08-27,EF,Finland,305,78,78,0,227,74,75,149,78
2020-08-28,EF,Finland,336,86,79,0,250,84,87,171,79
2020-08-29,EF,Finland,202,53,38,0,149,53,58,111,38
2020-08-30,EF,Finland,270,78,41,1,192,76,75,151,40
2020-08-31,EF,Finland,305,71,76,8,234,80,78,158,68
2020-09-01,EF,Finland,267,73,73,10,194,62,59,121,63
2020-09-02,EF,Finland,287,89,74,10,198,62,62,124,64
2020-09-03,EF,Finland,266,75,74,6,191,61,56,117,68
2020-09-04,EF,Finland,296,88,72,0,208,68,68,136,72
2020-09-05,EF,Finland,180,45,27,1,135,52,56,108,26
2020-09-06,EF,Finland,237,78,39,0,159,58,62,120,39
2020-09-07,EF,Finland,269,80,69,0,189,61,59,120,69
2020-09-08,EF,Finland,275,80,81,1,195,59,55,114,80
2020-09-09,EF,Finland,294,82,90,0,212,62,60,122,90
2020-09-10,EF,Finland,276,80,76,1,196,60,60,120,75
2020-09-11,EF,Finland,294,77,77,0,217,71,69,140,77
2020-09-12,EF,Finland,169,47,29,0,122,45,48,93,29
2020-09-13,EF,Finland,234,86,38,1,148,53,57,110,37
2020-09-14,EF,Finland,258,81,64,2,177,58,55,113,62
2020-09-15,EF,Finland,249,82,62,1,167,52,53,105,61
2020-09-16,EF,Finland,255,79,59,0,176,59,58,117,59
2020-09-17,EF,Finland,253,93,53,0,160,54,53,107,53
2020-09-18,EF,Finland,290,86,80,1,204,63,61,124,79
2020-09-19,EF,Finland,185,57,34,1,128,45,49,94,33
2020-09-20,EF,Finland,230,68,43,0,162,60,59,119,43
2020-09-21,EF,Finland,250,75,67,2,175,56,52,108,65
2020-09-22,EF,Finland,235,67,60,2,168,55,53,108,58
2020-09-23,EF,Finland,300,93,84,1,207,62,61,123,83
2020-09-24,EF,Finland,276,76,81,0,200,60,59,119,81
2020-09-25,EF,Finland,269,76,72,0,193,62,59,121,72
2020-09-26,EF,Finland,186,61,30,0,125,46,49,95,30
2020-09-27,EF,Finland,239,79,44,0,160,53,63,116,44
2020-09-28,EF,Finland,267,75,77,0,192,57,58,115,77
2020-09-29,EF,Finland,249,73,70,1,176,56,50,106,69
2020-09-30,EF,Finland,260,74,78,4,186,55,53,108,74
2020-10-01,EF,Finland,245,82,63,2,163,52,48,100,61
2020-10-02,EF,Finland,258,81,55,1,177,58,64,122,54
2020-10-03,EF,Finland,162,48,31,1,114,39,44,83,30
2020-10-04,EF,Finland,198,69,40,0,129,42,47,89,40
2020-10-05,EF,Finland,235,66,61,1,169,55,53,108,60
2020-10-06,EF,Finland,212,65,52,1,147,50,45,95,51
2020-10-07,EF,Finland,265,97,56,0,168,54,58,112,56
2020-10-08,EF,Finland,246,80,56,2,166,54,56,110,54
2020-10-09,EF,Finland,293,97,77,1,196,62,57,119,76
2020-10-10,EF,Finland,196,67,28,0,129,51,50,101,28
2020-10-11,EF,Finland,224,87,45,1,137,42,50,92,44
2020-10-12,EF,Finland,249,80,53,0,169,59,57,116,53
2020-10-13,EF,Finland,233,75,62,0,158,47,49,96,62
2020-10-14,EF,Finland,253,84,64,1,169,55,50,105,63
2020-10-15,EF,Finland,258,87,66,1,171,53,52,105,65
2020-10-16,EF,Finland,274,94,68,2,180,58,54,112,66
2020-10-17,EF,Finland,169,56,25,0,113,43,45,88,25
2020-10-18,EF,Finland,214,77,47,0,137,42,48,90,47
2020-10-19,EF,Finland,250,80,65,1,170,56,49,105,64
2020-10-20,EF,Finland,235,73,73,0,162,44,45,89,73
2020-10-21,EF,Finland,253,86,56,1,167,58,53,111,55
2020-10-22,EF,Finland,250,91,66,0,159,48,45,93,66
2020-10-23,EF,Finland,268,85,73,3,183,55,55,110,70
2020-10-24,EF,Finland,170,58,26,0,112,44,42,86,26
2020-10-25,EF,Finland,197,67,40,0,130,41,49,90,40
2020-10-26,EF,Finland,260,92,67,1,168,49,52,101,66
2020-10-27,EF,Finland,246,87,64,1,159,49,46,95,63
2020-10-28,EF,Finland,260,88,64,4,172,57,51,108,60
2020-10-29,EF,Finland,260,100,67,5,160,49,44,93,62
2020-10-30,EF,Finland,277,104,72,4,173,52,49,101,68
2020-10-31,EF,Finland,187,66,31,1,121,44,46,90,30
2020-11-01,EF,Finland,222,95,36,1,127,43,48,91,35
2020-11-02,EF,Finland,276,100,58,0,176,58,60,118,58
2020-11-03,EF,Finland,268,110,63,2,158,51,44,95,61
2020-11-04,EF,Finland,267,92,63,0,175,55,57,112,63
2020-11-05,EF,Finland,295,106,78,3,189,57,54,111,75
2020-11-06,EF,Finland,290,112,71,2,178,54,53,107,69
2020-11-07,EF,Finland,203,75,34,0,128,45,49,94,34
2020-11-08,EF,Finland,223,89,36,0,134,45,53,98,36
2020-11-09,EF,Finland,277,100,61,0,177,60,56,116,61
2020-11-10,EF,Finland,215,79,49,0,136,48,39,87,49
2020-11-11,EF,Finland,250,92,53,3,158,52,53,105,50
2020-11-12,EF,Finland,262,89,71,0,173,51,51,102,71
2020-11-13,EF,Finland,265,95,69,2,170,50,51,101,67
2020-11-14,EF,Finland,167,49,31,1,118,42,45,87,30
2020-11-15,EF,Finland,220,82,35,0,138,47,56,103,35
2020-11-16,EF,Finland,278,90,68,1,188,63,57,120,67
2020-11-17,EF,Finland,256,90,74,1,166,48,44,92,73
2020-11-18,EF,Finland,271,87,68,0,184,59,57,116,68
2020-11-19,EF,Finland,238,67,60,2,171,58,53,111,58
2020-11-20,EF,Finland,270,96,70,4,174,51,53,104,66
2020-11-21,EF,Finland,181,62,31,0,119,43,45,88,31
2020-11-22,EF,Finland,223,85,42,1,138,46,50,96,41
2020-11-23,EF,Finland,247,79,60,0,168,56,52,108,60
2020-11-24,EF,Finland,226,73,63,0,153,48,42,90,63
2020-11-25,EF,Finland,259,86,56,0,173,61,56,117,56
2020-11-26,EF,Finland,241,69,76,1,172,48,48,96,75
2020-11-27,EF,Finland,273,102,58,0,171,55,58,113,58
2020-11-28,EF,Finland,160,47,26,0,113,42,45,87,26
2020-11-29,EF,Finland,233,102,37,0,131,45,49,94,37
2020-11-30,EF,Finland,240,69,52,2,171,59,60,119,50
2020-12-01,EF,Finland,219,76,52,0,143,48,43,91,52
2020-12-02,EF,Finland,267,86,72,1,181,56,53,109,71
2020-12-03,EF,Finland,255,84,69,1,171,48,54,102,68
2020-12-04,EF,Finland,254,89,56,1,165,54,55,109,55
2020-12-05,EF,Finland,179,63,33,1,116,42,41,83,32
2020-12-06,EF,Finland,230,102,41,0,128,42,45,87,41
2020-12-07,EF,Finland,279,88,71,0,191,60,60,120,71
2020-12-08,EF,Finland,216,65,58,0,151,50,43,93,58
2020-12-09,EF,Finland,275,81,79,0,194,60,55,115,79
2020-12-10,EF,Finland,253,75,68,0,178,58,52,110,68
2020-12-11,EF,Finland,243,74,65,1,169,50,54,104,64
2020-12-12,EF,Finland,176,60,31,0,116,41,44,85,31
2020-12-13,EF,Finland,204,74,37,0,130,44,49,93,37
2020-12-14,EF,Finland,250,76,59,0,174,58,57,115,59
2020-12-15,EF,Finland,217,72,55,1,145,48,42,90,54
2020-12-16,EF,Finland,239,81,47,0,158,55,56,111,47
2020-12-17,EF,Finland,266,81,58,0,185,65,62,127,58
2020-12-18,EF,Finland,285,97,55,0,188,66,67,133,55
2020-12-19,EF,Finland,222,79,39,4,143,51,53,104,35
2020-12-20,EF,Finland,254,101,39,3,153,54,60,114,36
2020-12-21,EF,Finland,294,105,65,4,189,60,64,124,61
2020-12-22,EF,Finland,258,98,65,1,160,48,47,95,64
2020-12-23,EF,Finland,254,94,51,2,160,55,54,109,49
2020-12-24,EF,Finland,143,72,19,0,71,27,25,52,19
2020-12-25,EF,Finland,115,71,15,0,44,12,17,29,15
2020-12-26,EF,Finland,182,69,34,1,113,40,39,79,33
2020-12-27,EF,Finland,214,77,46,0,137,48,43,91,46
2020-12-28,EF,Finland,214,75,33,0,139,53,53,106,33
2020-12-29,EF,Finland,182,77,33,0,105,35,37,72,33
2020-12-30,EF,Finland,230,93,34,1,137,52,51,103,33
2020-12-31,EF,Finland,140,58,26,1,82,28,28,56,25
2020-01-01,LF,France,6229,3350,556,0,2879,1168,1155,2323,556
2020-01-02,LF,France,7755,4105,807,2,3650,1418,1425,2843,805
2020-01-03,LF,France,8109,4280,865,6,3829,1491,1473,2964,859
2020-01-04,LF,France,8291,4693,670,9,3598,1462,1466,2928,661
2020-01-05,LF,France,8527,4632,780,4,3895,1553,1562,3115,776
2020-01-06,LF,France,8120,4125,1154,18,3995,1408,1433,2841,1136
2020-01-07,LF,France,7094,3531,1095,16,3563,1239,1229,2468,1079
2020-01-08,LF,France,6874,3281,1163,19,3593,1218,1212,2430,1144
2020-01-09,LF,France,6719,3168,1012,17,3551,1269,1270,2539,995
2020-01-10,LF,France,7889,3781,1247,19,4108,1441,1420,2861,1228
2020-01-11,LF,France,7050,3986,604,10,3064,1241,1219,2460,594
2020-01-12,LF,France,7573,4048,714,6,3525,1405,1406,2811,708
2020-01-13,LF,France,7359,3587,1205,17,3772,1275,1292,2567,1188
2020-01-14,LF,France,5823,2576,1042,23,3247,1094,1111,2205,1019
2020-01-15,LF,France,6173,2787,1091,17,3386,1147,1148,2295,1074
2020-01-16,LF,France,6865,3244,1100,12,3621,1252,1269,2521,1088
2020-01-17,LF,France,7722,3761,1169,14,3961,1404,1388,2792,1155
2020-01-18,LF,France,6749,3900,584,9,2849,1122,1143,2265,575
2020-01-19,LF,France,7493,3994,721,6,3499,1374,1404,2778,715
2020-01-20,LF,France,7455,3591,1220,22,3864,1307,1337,2644,1198
2020-01-21,LF,France,6621,3081,1169,13,3540,1201,1170,2371,1156
2020-01-22,LF,France,6560,2994,1254,10,3566,1175,1137,2312,1244
2020-01-23,LF,France,7177,3436,1260,18,3741,1231,1250,2481,1242
2020-01-24,LF,France,7480,3563,1124,17,3917,1404,1389,2793,1107
2020-01-25,LF,France,6620,3836,561,8,2784,1123,1100,2223,553
2020-01-26,LF,France,7404,3991,718,11,3413,1367,1328,2695,707
2020-01-27,LF,France,7425,3565,1242,25,3860,1292,1326,2618,1217
2020-01-28,LF,France,6302,2879,1196,17,3423,1105,1122,2227,1179
2020-01-29,LF,France,6223,2724,1141,19,3499,1190,1168,2358,1122
2020-01-30,LF,France,7183,3411,1264,26,3772,1255,1253,2508,1238
2020-01-31,LF,France,7982,3835,1284,14,4147,1439,1424,2863,1270
2020-02-01,LF,France,6949,4019,596,8,2930,1175,1159,2334,588
2020-02-02,LF,France,7506,4041,713,8,3465,1377,1375,2752,705
2020-02-03,LF,France,7427,3606,1196,20,3821,1306,1319,2625,1176
2020-02-04,LF,France,6631,3127,1166,25,3504,1164,1174,2338,1141
2020-02-05,LF,France,6842,3159,1236,11,3683,1234,1213,2447,1225
2020-02-06,LF,France,7113,3339,1107,18,3774,1314,1353,2667,1089
2020-02-07,LF,France,7422,3540,1057,16,3882,1419,1406,2825,1041
2020-02-08,LF,France,7286,4097,654,11,3189,1272,1263,2535,643
2020-02-09,LF,France,6659,3511,651,6,3148,1243,1254,2497,645
2020-02-10,LF,France,7193,3576,1042,14,3617,1293,1282,2575,1028
2020-02-11,LF,France,6845,3261,1140,23,3584,1216,1228,2444,1117
2020-02-12,LF,France,7093,3281,1258,15,3812,1289,1265,2554,1243
2020-02-13,LF,France,7681,3731,1171,21,3950,1387,1392,2779,1150
2020-02-14,LF,France,8678,4312,1249,17,4366,1546,1571,3117,1232
2020-02-15,LF,France,7928,4397,707,12,3531,1407,1417,2824,695
2020-02-16,LF,France,7892,4348,716,3,3544,1425,1403,2828,713
2020-02-17,LF,France,7857,3965,1086,10,3892,1403,1403,2806,1076
2020-02-18,LF,France,7245,3514,1149,20,3731,1299,1283,2582,1129
2020-02-19,LF,France,7138,3400,1157,20,3738,1300,1281,2581,1137
2020-02-20,LF,France,7234,3470,1075,14,3764,1336,1353,2689,1061
2020-02-21,LF,France,8644,4309,1193,12,4335,1571,1571,3142,1181
2020-02-22,LF,France,8159,4596,695,6,3563,1444,1424,2868,689
2020-02-23,LF,France,8390,4465,794,5,3925,1555,1576,3131,789
2020-02-24,LF,France,8145,4140,1140,20,4005,1423,1442,2865,1120
2020-02-25,LF,France,7399,3767,1081,23,3632,1279,1272,2551,1058
2020-02-26,LF,France,7139,3637,957,11,3502,1274,1271,2545,946
2020-02-27,LF,France,7631,3847,1070,19,3784,1355,1359,2714,1051
2020-02-28,LF,France,8509,4255,1235,29,4254,1513,1506,3019,1206
2020-02-29,LF,France,7742,4484,614,14,3258,1344,1300,2644,600
2020-03-01,LF,France,8108,4447,702,9,3661,1485,1474,2959,693
2020-03-02,LF,France,7868,4068,1008,13,3800,1375,1417,2792,995
2020-03-03,LF,France,7190,3539,1098,17,3651,1288,1265,2553,1081
2020-03-04,LF,France,7176,3398,1171,18,3778,1313,1294,2607,1153
2020-03-05,LF,France,7189,3527,1037,21,3662,1303,1322,2625,1016
2020-03-06,LF,France,7880,3906,1070,12,3974,1447,1457,2904,1058
2020-03-07,LF,France,7119,3953,567,10,3166,1309,1290,2599,557
2020-03-08,LF,France,7597,4059,689,3,3538,1429,1420,2849,686
2020-03-09,LF,France,7547,3676,1189,17,3871,1339,1343,2682,1172
2020-03-10,LF,France,6603,3073,1193,26,3530,1162,1175,2337,1167
2020-03-11,LF,France,6442,2788,1313,22,3654,1179,1162,2341,1291
2020-03-12,LF,France,6904,3195,1244,28,3709,1234,1231,2465,1216
2020-03-13,LF,France,7402,3453,1259,27,3949,1358,1332,2690,1232
2020-03-14,LF,France,6311,3620,550,2,2691,1083,1058,2141,548
2020-03-15,LF,France,6479,3539,720,2,2940,1109,1111,2220,718
2020-03-16,LF,France,5934,3037,845,10,2897,1004,1048,2052,835
2020-03-17,LF,France,4494,2475,586,8,2019,726,707,1433,578
2020-03-18,LF,France,4014,2302,493,2,1712,619,600,1219,491
2020-03-19,LF,France,3744,2199,436,6,1545,559,550,1109,430
2020-03-20,LF,France,3629,2094,366,4,1535,588,581,1169,362
2020-03-21,LF,France,2500,1634,144,1,866,359,363,722,143
2020-03-22,LF,France,2046,1186,148,1,860,361,351,712,147
2020-03-23,LF,France,1403,719,158,4,684,240,286,526,154
2020-03-24,LF,France,1292,603,171,7,689,254,264,518,164
2020-03-25,LF,France,1141,536,165,3,605,218,222,440,162
2020-03-26,LF,France,1131,561,135,3,570,214,221,435,132
2020-03-27,LF,France,1073,547,137,5,526,201,188,389,132
2020-03-28,LF,France,778,412,86,3,366,136,144,280,83
2020-03-29,LF,France,707,407,73,0,300,107,120,227,73
2020-03-30,LF,France,730,368,119,4,362,126,117,243,115
2020-03-31,LF,France,781,378,118,3,403,150,135,285,115
2020-04-01,LF,France,813,374,157,2,439,135,147,282,155
2020-04-02,LF,France,741,309,165,5,432,129,138,267,160
2020-04-03,LF,France,756,391,129,9,365,123,113,236,120
2020-04-04,LF,France,561,295,39,3,266,110,117,227,36
2020-04-05,LF,France,465,281,38,2,184,67,79,146,36
2020-04-06,LF,France,596,240,110,3,356,125,121,246,107
2020-04-07,LF,France,649,278,114,6,371,132,125,257,108
2020-04-08,LF,France,732,292,156,11,440,141,143,284,145
2020-04-09,LF,France,744,308,165,11,436,129,142,271,154
2020-04-10,LF,France,604,265,132,6,339,108,99,207,126
2020-04-11,LF,France,413,195,32,4,218,85,101,186,28
2020-04-12,LF,France,368,206,39,0,162,62,61,123,39
2020-04-13,LF,France,418,226,43,3,192,75,74,149,40
2020-04-14,LF,France,659,246,178,11,413,125,110,235,167
2020-04-15,LF,France,694,280,166,8,414,129,119,248,158
2020-04-16,LF,France,714,294,139,9,420,132,149,281,130
2020-04-17,LF,France,726,330,163,4,396,119,114,233,159
2020-04-18,LF,France,444,225,33,0,219,92,94,186,33
2020-04-19,LF,France,448,244,56,2,204,68,80,148,54
2020-04-20,LF,France,711,289,179,3,422,125,118,243,176
2020-04-21,LF,France,731,287,179,7,444,133,132,265,172
2020-04-22,LF,France,761,297,185,10,464,146,133,279,175
2020-04-23,LF,France,796,325,171,6,471,151,149,300,165
2020-04-24,LF,France,760,341,161,9,419,124,134,258,152
2020-04-25,LF,France,470,235,26,2,235,103,106,209,24
2020-04-26,LF,France,429,244,32,2,185,74,79,153,30
2020-04-27,LF,France,686,249,193,7,437,132,112,244,186
2020-04-28,LF,France,762,294,155,16,468,163,150,313,139
2020-04-29,LF,France,814,306,199,14,508,152,157,309,185
2020-04-30,LF,France,865,337,228,11,528,150,150,300,217
2020-05-01,LF,France,547,312,39,1,235,96,100,196,38
2020-05-02,LF,France,508,264,38,1,244,101,105,206,37
2020-05-03,LF,France,474,257,45,0,217,83,89,172,45
2020-05-04,LF,France,765,295,210,7,470,130,130,260,203
2020-05-05,LF,France,840,313,220,3,527,156,151,307,217
2020-05-06,LF,France,907,341,236,13,566,165,165,330,223
2020-05-07,LF,France,953,367,240,13,586,171,175,346,227
2020-05-08,LF,France,733,359,99,4,374,140,135,275,95
2020-05-09,LF,France,563,288,48,3,275,106,121,227,45
2020-05-10,LF,France,532,296,45,3,236,95,96,191,42
2020-05-11,LF,France,859,344,212,7,515,146,157,303,205
2020-05-12,LF,France,1081,352,352,19,729,196,181,377,333
2020-05-13,LF,France,1025,356,313,19,669,184,172,356,294
2020-05-14,LF,France,1089,363,326,12,726,200,200,400,314
2020-05-15,LF,France,1141,411,343,16,730,196,191,387,327
2020-05-16,LF,France,704,309,124,8,395,132,139,271,116
2020-05-17,LF,France,634,332,81,4,302,102,119,221,77
2020-05-18,LF,France,1042,354,355,26,688,171,162,333,329
2020-05-19,LF,France,1113,352,400,11,761,185,176,361,389
2020-05-20,LF,France,1298,437,436,27,861,212,213,425,409
2020-05-21,LF,France,983,423,213,5,560,171,176,347,208
2020-05-22,LF,France,1020,419,250,15,601,175,176,351,235
2020-05-23,LF,France,757,343,134,6,414,138,142,280,128
2020-05-24,LF,France,725,339,117,1,386,129,140,269,116
2020-05-25,LF,France,1103,349,425,16,754,169,160,329,409
2020-05-26,LF,France,1172,376,405,22,796,201,190,391,383
2020-05-27,LF,France,1267,423,394,27,844,223,227,450,367
2020-05-28,LF,France,1267,399,467,32,868,200,201,401,435
2020-05-29,LF,France,1303,471,419,18,832,207,206,413,401
2020-05-30,LF,France,756,317,132,10,439,145,162,307,122
2020-05-31,LF,France,741,334,113,7,407,153,141,294,106
2020-06-01,LF,France,922,423,185,10,499,155,159,314,175
2020-06-02,LF,France,1249,368,447,20,881,216,218,434,427
2020-06-03,LF,France,1388,476,481,22,912,216,215,431,459
2020-06-04,LF,France,1381,466,471,26,915,216,228,444,445
2020-06-05,LF,France,1483,544,458,26,939,247,234,481,432
2020-06-06,LF,France,1003,460,206,11,543,163,174,337,195
2020-06-07,LF,France,975,453,166,6,522,170,186,356,160
2020-06-08,LF,France,1406,456,500,19,950,222,228,450,481
2020-06-09,LF,France,1389,457,488,29,932,230,214,444,459
2020-06-10,LF,France,1488,460,544,21,1028,240,244,484,523
2020-06-11,LF,France,1482,448,528,24,1034,253,253,506,504
2020-06-12,LF,France,1499,482,525,21,1017,250,242,492,504
2020-06-13,LF,France,962,388,190,4,574,185,199,384,186
2020-06-14,LF,France,1111,459,281,4,652,183,188,371,277
2020-06-15,LF,France,1842,556,599,19,1286,324,363,687,580
2020-06-16,LF,France,1791,513,613,34,1278,331,334,665,579
2020-06-17,LF,France,1875,520,670,26,1355,345,340,685,644
2020-06-18,LF,France,2027,568,689,30,1459,375,395,770,659
2020-06-19,LF,France,2069,589,700,20,1480,385,395,780,680
2020-06-20,LF,France,1504,565,351,9,939,287,301,588,342
2020-06-21,LF,France,1741,768,380,6,973,318,275,593,374
2020-06-22,LF,France,2163,753,695,21,1410,353,362,715,674
2020-06-23,LF,France,2107,641,678,19,1466,413,375,788,659
2020-06-24,LF,France,2177,694,705,31,1483,378,400,778,674
2020-06-25,LF,France,2328,716,764,38,1612,408,440,848,726
2020-06-26,LF,France,2499,881,755,18,1618,431,432,863,737
2020-06-27,LF,France,1947,847,376,6,1100,358,366,724,370
2020-06-28,LF,France,1940,811,411,6,1129,374,344,718,405
2020-06-29,LF,France,2349,828,714,27,1521,402,405,807,687
2020-06-30,LF,France,2353,800,724,27,1553,422,407,829,697
2020-07-01,LF,France,3585,1570,780,21,2015,604,631,1235,759
2020-07-02,LF,France,3606,1567,862,25,2039,571,606,1177,837
2020-07-03,LF,France,4220,1835,973,20,2385,701,711,1412,953
2020-07-04,LF,France,3792,1993,596,9,1799,598,605,1203,587
2020-07-05,LF,France,3719,1895,635,6,1824,605,584,1189,629
2020-07-06,LF,France,3907,1636,913,13,2271,679,679,1358,900
2020-07-07,LF,France,3564,1552,849,28,2012,580,583,1163,821
2020-07-08,LF,France,3717,1631,861,27,2086,608,617,1225,834
2020-07-09,LF,France,3763,1621,830,23,2142,644,668,1312,807
2020-07-10,LF,France,4521,1911,1037,23,2610,774,799,1573,1014
2020-07-11,LF,France,4228,2184,684,7,2044,679,681,1360,677
2020-07-12,LF,France,3845,1996,563,6,1849,661,625,1286,557
2020-07-13,LF,France,3807,1817,607,16,1990,708,675,1383,591
2020-07-14,LF,France,3465,1670,593,18,1795,587,615,1202,575
2020-07-15,LF,France,4132,1822,849,16,2310,736,725,1461,833
2020-07-16,LF,France,4410,2030,860,28,2380,760,760,1520,832
2020-07-17,LF,France,4959,2260,1015,22,2699,835,849,1684,993
2020-07-18,LF,France,4796,2632,661,6,2164,750,753,1503,655
2020-07-19,LF,France,4604,2430,661,8,2174,756,757,1513,653
2020-07-20,LF,France,4643,2172,916,9,2471,784,771,1555,907
2020-07-21,LF,France,4223,1968,823,17,2255,716,716,1432,806
2020-07-22,LF,France,4434,1973,871,14,2461,785,805,1590,857
2020-07-23,LF,France,4638,2127,905,31,2511,789,817,1606,874
2020-07-24,LF,France,5221,2413,1006,13,2808,903,899,1802,993
2020-07-25,LF,France,5194,2813,698,7,2381,852,831,1683,691
2020-07-26,LF,France,4806,2580,643,1,2226,782,801,1583,642
2020-07-27,LF,France,4780,2270,879,18,2510,809,822,1631,861
2020-07-28,LF,France,4298,1982,813,18,2316,772,731,1503,795
2020-07-29,LF,France,4524,2055,829,15,2469,813,827,1640,814
2020-07-30,LF,France,4685,2179,833,18,2506,830,843,1673,815
2020-07-31,LF,France,5378,2522,974,20,2856,955,927,1882,954
2020-08-01,LF,France,6217,3430,843,0,2787,969,975,1944,843
2020-08-02,LF,France,5762,3184,725,1,2578,947,906,1853,724
2020-08-03,LF,France,5456,2876,792,13,2580,891,897,1788,779
2020-08-04,LF,France,4880,2539,736,10,2341,787,818,1605,726
2020-08-05,LF,France,4940,2490,748,21,2450,854,848,1702,727
2020-08-06,LF,France,5129,2638,776,20,2491,857,858,1715,756
2020-08-07,LF,France,5774,2943,853,18,2831,994,984,1978,835
2020-08-08,LF,France,5922,3275,741,7,2647,946,960,1906,734
2020-08-09,LF,France,5628,3122,694,1,2506,914,898,1812,693
2020-08-10,LF,France,5414,2766,803,20,2648,926,919,1845,783
2020-08-11,LF,France,4721,2424,711,26,2297,787,799,1586,685
2020-08-12,LF,France,4761,2386,676,14,2375,858,841,1699,662
2020-08-13,LF,France,4892,2510,710,15,2382,837,835,1672,695
2020-08-14,LF,France,5676,2834,873,21,2842,994,975,1969,852
2020-08-15,LF,France,5845,3247,752,7,2598,915,931,1846,745
2020-08-16,LF,France,5734,3178,710,4,2556,920,926,1846,706
2020-08-17,LF,France,5414,2788,813,10,2626,911,902,1813,803
2020-08-18,LF,France,4821,2474,756,18,2347,790,801,1591,738
2020-08-19,LF,France,4949,2495,804,22,2454,829,821,1650,782
2020-08-20,LF,France,5241,2603,844,16,2638,889,905,1794,828
2020-08-21,LF,France,5648,2815,908,17,2833,959,966,1925,891
2020-08-22,LF,France,5840,3211,779,7,2629,918,932,1850,772
2020-08-23,LF,France,5817,3101,821,7,2716,966,929,1895,814
2020-08-24,LF,France,5584,2742,959,10,2842,937,946,1883,949
2020-08-25,LF,France,4912,2382,900,18,2530,816,814,1630,882
2020-08-26,LF,France,5093,2408,968,23,2685,853,864,1717,945
2020-08-27,LF,France,5454,2619,1018,29,2835,907,910,1817,989
2020-08-28,LF,France,5842,2884,981,16,2958,1005,972,1977,965
2020-08-29,LF,France,5884,3189,823,10,2695,932,940,1872,813
2020-08-30,LF,France,5856,3126,821,6,2730,962,947,1909,815
2020-08-31,LF,France,5729,2753,1100,17,2976,943,933,1876,1083
2020-09-01,LF,France,4688,2220,971,19,2468,739,758,1497,952
2020-09-02,LF,France,4599,2126,1024,22,2473,736,713,1449,1002
2020-09-03,LF,France,4870,2323,1016,18,2547,759,772,1531,998
2020-09-04,LF,France,5380,2528,1069,24,2852,874,909,1783,1045
2020-09-05,LF,France,4988,2713,706,7,2275,786,783,1569,699
2020-09-06,LF,France,5080,2687,725,1,2393,848,820,1668,724
2020-09-07,LF,France,4935,2345,1022,13,2590,776,792,1568,1009
2020-09-08,LF,France,4340,1995,985,29,2345,676,684,1360,956
2020-09-09,LF,France,4454,2036,1005,22,2418,717,696,1413,983
2020-09-10,LF,France,4669,2145,1045,13,2524,731,748,1479,1032
2020-09-11,LF,France,5222,2438,1097,21,2784,854,833,1687,1076
2020-09-12,LF,France,4624,2489,710,5,2135,707,718,1425,705
2020-09-13,LF,France,4965,2549,797,6,2416,832,787,1619,791
2020-09-14,LF,France,4603,2153,1012,24,2450,701,737,1438,988
2020-09-15,LF,France,4108,1844,987,27,2264,634,643,1277,960
2020-09-16,LF,France,4167,1856,1032,20,2311,639,640,1279,1012
2020-09-17,LF,France,4383,1938,1056,30,2445,694,695,1389,1026
2020-09-18,LF,France,5014,2349,1048,26,2665,810,807,1617,1022
2020-09-19,LF,France,4340,2328,634,7,2012,690,688,1378,627
2020-09-20,LF,France,4583,2418,707,6,2165,741,717,1458,701
2020-09-21,LF,France,4431,2051,1029,28,2380,670,681,1351,1001
2020-09-22,LF,France,3869,1729,944,34,2140,597,599,1196,910
2020-09-23,LF,France,4065,1803,1059,33,2262,606,597,1203,1026
2020-09-24,LF,France,4272,1955,1009,26,2317,655,653,1308,983
2020-09-25,LF,France,4783,2273,949,28,2510,775,786,1561,921
2020-09-26,LF,France,4314,2337,649,5,1977,660,668,1328,644
2020-09-27,LF,France,4462,2385,708,2,2077,692,677,1369,706
2020-09-28,LF,France,4319,1995,1004,28,2324,665,655,1320,976
2020-09-29,LF,France,3863,1733,1010,30,2130,547,573,1120,980
2020-09-30,LF,France,4070,1752,1084,36,2318,615,619,1234,1048
2020-10-01,LF,France,3908,1651,1024,18,2257,628,605,1233,1006
2020-10-02,LF,France,4183,1989,823,17,2194,695,676,1371,806
2020-10-03,LF,France,3816,2044,531,10,1772,621,620,1241,521
2020-10-04,LF,France,3885,2054,603,4,1831,613,615,1228,599
2020-10-05,LF,France,3879,1719,941,23,2160,605,614,1219,918
2020-10-06,LF,France,3347,1399,936,35,1948,510,502,1012,901
2020-10-07,LF,France,3473,1422,955,28,2051,549,547,1096,927
2020-10-08,LF,France,3760,1605,1035,28,2155,556,564,1120,1007
2020-10-09,LF,France,4433,1970,1101,36,2463,689,673,1362,1065
2020-10-10,LF,France,3711,1976,529,7,1735,606,600,1206,522
2020-10-11,LF,France,3869,2011,621,4,1858,613,624,1237,617
2020-10-12,LF,France,3821,1668,938,21,2153,619,596,1215,917
2020-10-13,LF,France,3233,1304,941,25,1929,482,506,988,916
2020-10-14,LF,France,3433,1437,951,27,1996,532,513,1045,924
2020-10-15,LF,France,3583,1513,931,34,2070,558,581,1139,897
2020-10-16,LF,France,4496,1992,1042,29,2504,745,717,1462,1013
2020-10-17,LF,France,4053,2055,650,13,1998,676,672,1348,637
2020-10-18,LF,France,3883,1929,666,7,1954,641,647,1288,659
2020-10-19,LF,France,3730,1564,925,22,2166,618,623,1241,903
2020-10-20,LF,France,3043,1192,839,24,1851,506,506,1012,815
2020-10-21,LF,France,3114,1288,808,17,1826,511,507,1018,791
2020-10-22,LF,France,3419,1377,891,30,2042,581,570,1151,861
2020-10-23,LF,France,4064,1744,968,20,2320,694,658,1352,948
2020-10-24,LF,France,3883,1971,621,13,1912,660,631,1291,608
2020-10-25,LF,France,3668,1770,618,5,1898,630,650,1280,613
2020-10-26,LF,France,3430,1455,824,13,1975,569,582,1151,811
2020-10-27,LF,France,2909,1086,891,30,1823,470,462,932,861
2020-10-28,LF,France,3086,1192,849,22,1894,513,532,1045,827
2020-10-29,LF,France,3564,1324,1050,37,2240,598,592,1190,1013
2020-10-30,LF,France,3889,1691,824,21,2198,694,680,1374,803
2020-10-31,LF,France,3358,1756,454,6,1602,572,576,1148,448
2020-11-01,LF,France,3585,1738,602,0,1847,619,626,1245,602
2020-11-02,LF,France,3120,1387,712,25,1733,509,512,1021,687
2020-11-03,LF,France,2433,1015,610,21,1418,402,406,808,589
2020-11-04,LF,France,2730,1165,700,28,1565,440,425,865,672
2020-11-05,LF,France,2679,1097,705,31,1582,436,441,877,674
2020-11-06,LF,France,3201,1426,779,24,1775,513,483,996,755
2020-11-07,LF,France,2405,1370,258,7,1035,383,394,777,251
2020-11-08,LF,France,2540,1421,279,3,1119,420,420,840,276
2020-11-09,LF,France,2580,1124,656,25,1456,387,413,800,631
2020-11-10,LF,France,2128,790,605,33,1338,377,356,733,572
2020-11-11,LF,France,1917,877,276,11,1040,382,382,764,265
2020-11-12,LF,France,2396,937,665,31,1459,398,396,794,634
2020-11-13,LF,France,2642,1195,604,25,1447,431,412,843,579
2020-11-14,LF,France,2000,1058,247,11,942,340,355,695,236
2020-11-15,LF,France,2162,1158,198,12,1004,401,405,806,186
2020-11-16,LF,France,2319,971,586,22,1348,373,389,762,564
2020-11-17,LF,France,1932,707,535,30,1225,341,349,690,505
2020-11-18,LF,France,2219,809,608,29,1410,401,401,802,579
2020-11-19,LF,France,2273,837,662,23,1436,387,387,774,639
2020-11-20,LF,France,2453,1013,602,18,1440,432,406,838,584
2020-11-21,LF,France,1935,1023,257,8,912,328,327,655,249
2020-11-22,LF,France,1916,971,229,5,945,356,360,716,224
2020-11-23,LF,France,2192,829,633,25,1363,355,375,730,608
2020-11-24,LF,France,1853,629,620,24,1224,303,301,604,596
2020-11-25,LF,France,2134,714,649,34,1420,398,373,771,615
2020-11-26,LF,France,2145,796,617,25,1349,365,367,732,592
2020-11-27,LF,France,2439,978,615,14,1461,437,409,846,601
2020-11-28,LF,France,1756,916,229,4,840,297,314,611,225
2020-11-29,LF,France,1894,962,256,5,932,337,339,676,251
2020-11-30,LF,France,2322,895,653,18,1427,376,398,774,635
2020-12-01,LF,France,2029,722,588,23,1307,358,361,719,565
2020-12-02,LF,France,2305,874,648,11,1431,397,386,783,637
2020-12-03,LF,France,2332,895,610,18,1437,408,419,827,592
2020-12-04,LF,France,2540,1043,610,10,1497,457,430,887,600
2020-12-05,LF,France,1918,1064,185,4,854,330,339,669,181
2020-12-06,LF,France,1955,956,250,4,999,374,375,749,246
2020-12-07,LF,France,2143,865,574,15,1278,347,357,704,559
2020-12-08,LF,France,2050,797,503,24,1253,380,370,750,479
2020-12-09,LF,France,2318,892,584,17,1426,433,409,842,567
2020-12-10,LF,France,2511,1072,575,31,1439,442,422,864,544
2020-12-11,LF,France,2798,1209,585,19,1589,498,506,1004,566
2020-12-12,LF,France,2255,1232,219,10,1023,397,407,804,209
2020-12-13,LF,France,2272,1153,269,4,1119,438,412,850,265
2020-12-14,LF,France,2674,1071,735,22,1603,428,440,868,713
2020-12-15,LF,France,2563,930,734,33,1633,438,461,899,701
2020-12-16,LF,France,2922,1096,812,41,1826,508,506,1014,771
2020-12-17,LF,France,3504,1480,870,26,2024,574,580,1154,844
2020-12-18,LF,France,4348,1869,983,21,2479,758,738,1496,962
2020-12-19,LF,France,4118,2071,603,9,2047,719,725,1444,594
2020-12-20,LF,France,3833,1860,598,5,1973,689,686,1375,593
2020-12-21,LF,France,3341,1420,754,9,1921,574,593,1167,745
2020-12-22,LF,France,3170,1249,794,16,1921,563,564,1127,778
2020-12-23,LF,France,3547,1451,765,4,2096,666,665,1331,761
2020-12-24,LF,France,2612,1061,546,0,1551,500,505,1005,546
2020-12-25,LF,France,1644,626,331,0,1018,348,339,687,331
2020-12-26,LF,France,3212,1475,600,2,1737,587,550,1137,598
2020-12-27,LF,France,3412,1562,602,2,1850,623,625,1248,600
2020-12-28,LF,France,2950,1320,565,3,1630,527,538,1065,562
2020-12-29,LF,France,2589,1053,557,12,1536,483,496,979,545
2020-12-30,LF,France,2985,1209,647,9,1776,575,554,1129,638
2020-12-31,LF,France,1974,773,416,5,1201,401,384,785,411
2020-01-01,UG,Georgia,287,217,1,0,70,31,38,69,1
2020-01-02,UG,Georgia,369,264,0,0,105,52,53,105,0
2020-01-03,UG,Georgia,365,250,2,0,115,56,57,113,2
2020-01-04,UG,Georgia,367,259,0,0,108,55,53,108,0
2020-01-05,UG,Georgia,388,275,3,1,113,55,55,110,2
2020-01-06,UG,Georgia,369,279,2,0,90,43,45,88,2
2020-01-07,UG,Georgia,402,304,2,0,98,51,45,96,2
2020-01-08,UG,Georgia,405,306,1,1,99,48,50,98,0
2020-01-09,UG,Georgia,425,336,0,0,89,45,44,89,0
2020-01-10,UG,Georgia,406,303,2,0,103,50,51,101,2
2020-01-11,UG,Georgia,436,338,0,0,98,49,49,98,0
2020-01-12,UG,Georgia,410,298,2,0,112,55,55,110,2
2020-01-13,UG,Georgia,382,291,2,0,91,43,46,89,2
2020-01-14,UG,Georgia,372,260,3,0,112,57,52,109,3
2020-01-15,UG,Georgia,394,310,0,0,84,40,44,84,0
2020-01-16,UG,Georgia,379,291,0,0,88,45,43,88,0
2020-01-17,UG,Georgia,421,330,2,0,91,45,44,89,2
2020-01-18,UG,Georgia,427,331,0,0,96,45,51,96,0
2020-01-19,UG,Georgia,431,320,2,0,111,56,53,109,2
2020-01-20,UG,Georgia,394,301,4,0,93,45,44,89,4
2020-01-21,UG,Georgia,366,275,2,0,91,45,44,89,2
2020-01-22,UG,Georgia,383,299,1,1,84,41,42,83,0
2020-01-23,UG,Georgia,391,300,1,0,91,46,44,90,1
2020-01-24,UG,Georgia,413,320,2,0,93,44,47,91,2
2020-01-25,UG,Georgia,405,313,0,0,92,46,46,92,0
2020-01-26,UG,Georgia,416,307,4,0,109,53,52,105,4
2020-01-27,UG,Georgia,387,299,2,0,88,45,41,86,2
2020-01-28,UG,Georgia,371,285,2,0,86,43,41,84,2
2020-01-29,UG,Georgia,377,298,0,0,79,39,40,79,0
2020-01-30,UG,Georgia,353,275,0,0,78,38,40,78,0
2020-01-31,UG,Georgia,391,296,2,0,95,44,49,93,2
2020-02-01,UG,Georgia,393,302,0,0,91,46,45,91,0
2020-02-02,UG,Georgia,409,298,2,0,111,53,56,109,2
2020-02-03,UG,Georgia,381,300,3,1,81,42,36,78,2
2020-02-04,UG,Georgia,350,258,2,0,92,45,45,90,2
2020-02-05,UG,Georgia,332,253,0,0,79,36,43,79,0
2020-02-06,UG,Georgia,363,274,0,0,89,48,41,89,0
2020-02-07,UG,Georgia,378,287,2,0,91,43,46,89,2
2020-02-08,UG,Georgia,376,291,0,0,85,42,43,85,0
2020-02-09,UG,Georgia,361,260,0,0,101,51,50,101,0
2020-02-10,UG,Georgia,345,261,3,0,84,40,41,81,3
2020-02-11,UG,Georgia,349,248,2,0,101,53,46,99,2
2020-02-12,UG,Georgia,333,250,0,0,83,39,44,83,0
2020-02-13,UG,Georgia,353,264,1,1,89,43,45,88,0
2020-02-14,UG,Georgia,383,284,3,0,99,48,48,96,3
2020-02-15,UG,Georgia,380,292,2,0,88,46,40,86,2
2020-02-16,UG,Georgia,407,301,2,0,106,52,52,104,2
2020-02-17,UG,Georgia,357,277,2,0,80,39,39,78,2
2020-02-18,UG,Georgia,365,284,2,0,81,41,38,79,2
2020-02-19,UG,Georgia,378,295,0,0,83,40,43,83,0
2020-02-20,UG,Georgia,376,300,0,0,76,38,38,76,0
2020-02-21,UG,Georgia,432,327,5,1,105,48,52,100,4
2020-02-22,UG,Georgia,431,340,0,0,91,47,44,91,0
2020-02-23,UG,Georgia,411,306,4,0,105,51,50,101,4
2020-02-24,UG,Georgia,378,294,2,0,84,41,41,82,2
2020-02-25,UG,Georgia,374,289,2,0,85,43,40,83,2
2020-02-26,UG,Georgia,358,286,0,0,72,34,38,72,0
2020-02-27,UG,Georgia,371,290,1,0,81,40,40,80,1
2020-02-28,UG,Georgia,415,327,2,0,88,43,43,86,2
2020-02-29,UG,Georgia,416,327,0,0,89,43,46,89,0
2020-03-01,UG,Georgia,409,302,2,0,107,54,51,105,2
2020-03-02,UG,Georgia,388,303,2,0,85,41,42,83,2
2020-03-03,UG,Georgia,388,295,2,0,93,47,44,91,2
2020-03-04,UG,Georgia,343,269,0,0,74,36,38,74,0
2020-03-05,UG,Georgia,365,282,0,0,83,41,42,83,0
2020-03-06,UG,Georgia,393,302,2,0,91,43,46,89,2
2020-03-07,UG,Georgia,413,325,0,0,88,45,43,88,0
2020-03-08,UG,Georgia,391,300,2,0,91,45,44,89,2
2020-03-09,UG,Georgia,340,259,2,0,81,42,37,79,2
2020-03-10,UG,Georgia,349,260,2,0,89,45,42,87,2
2020-03-11,UG,Georgia,358,289,0,0,69,31,38,69,0
2020-03-12,UG,Georgia,341,266,0,0,75,38,37,75,0
2020-03-13,UG,Georgia,356,276,2,0,80,39,39,78,2
2020-03-14,UG,Georgia,376,299,0,0,77,40,37,77,0
2020-03-15,UG,Georgia,332,257,3,1,75,37,35,72,2
2020-03-16,UG,Georgia,294,246,2,0,48,24,22,46,2
2020-03-17,UG,Georgia,275,229,2,0,46,23,21,44,2
2020-03-18,UG,Georgia,255,221,5,1,34,16,13,29,4
2020-03-19,UG,Georgia,227,192,5,1,35,13,17,30,4
2020-03-20,UG,Georgia,226,198,3,0,28,15,10,25,3
2020-03-21,UG,Georgia,190,178,0,0,12,5,7,12,0
2020-03-22,UG,Georgia,174,154,2,0,20,10,8,18,2
2020-03-23,UG,Georgia,126,111,1,0,15,9,5,14,1
2020-03-24,UG,Georgia,132,115,0,0,17,9,8,17,0
2020-03-25,UG,Georgia,97,84,0,0,13,7,6,13,0
2020-03-26,UG,Georgia,119,107,0,0,12,5,7,12,0
2020-03-27,UG,Georgia,120,106,0,0,14,8,6,14,0
2020-03-28,UG,Georgia,119,111,0,0,8,4,4,8,0
2020-03-29,UG,Georgia,107,102,0,0,5,2,3,5,0
2020-03-30,UG,Georgia,74,70,0,0,4,2,2,4,0
2020-03-31,UG,Georgia,70,60,0,0,10,5,5,10,0
2020-04-01,UG,Georgia,61,58,0,0,3,2,1,3,0
2020-04-02,UG,Georgia,78,65,0,0,13,6,7,13,0
2020-04-03,UG,Georgia,63,55,0,0,8,3,5,8,0
2020-04-04,UG,Georgia,83,68,4,1,15,6,5,11,3
2020-04-05,UG,Georgia,66,59,0,0,7,3,4,7,0
2020-04-06,UG,Georgia,65,59,0,0,6,2,4,6,0
2020-04-07,UG,Georgia,80,70,0,0,10,6,4,10,0
2020-04-08,UG,Georgia,78,76,0,0,2,1,1,2,0
2020-04-09,UG,Georgia,82,72,0,0,10,5,5,10,0
2020-04-10,UG,Georgia,82,67,0,0,15,7,8,15,0
2020-04-11,UG,Georgia,89,84,0,0,5,3,2,5,0
2020-04-12,UG,Georgia,71,66,0,0,5,2,3,5,0
2020-04-13,UG,Georgia,65,56,0,0,9,4,5,9,0
2020-04-14,UG,Georgia,77,63,0,0,14,8,6,14,0
2020-04-15,UG,Georgia,70,64,0,0,6,2,4,6,0
2020-04-16,UG,Georgia,78,64,1,0,14,7,6,13,1
2020-04-17,UG,Georgia,67,61,0,0,6,1,5,6,0
2020-04-18,UG,Georgia,65,56,0,0,9,5,4,9,0
2020-04-19,UG,Georgia,77,60,0,0,17,5,12,17,0
2020-04-20,UG,Georgia,94,82,0,0,12,6,6,12,0
2020-04-21,UG,Georgia,83,68,0,0,15,9,6,15,0
2020-04-22,UG,Georgia,98,76,0,0,22,11,11,22,0
2020-04-23,UG,Georgia,108,92,0,0,16,8,8,16,0
2020-04-24,UG,Georgia,109,92,1,0,17,6,10,16,1
2020-04-25,UG,Georgia,91,84,0,0,7,5,2,7,0
2020-04-26,UG,Georgia,91,77,0,0,14,7,7,14,0
2020-04-27,UG,Georgia,114,94,1,0,20,9,10,19,1
2020-04-28,UG,Georgia,102,86,0,0,16,9,7,16,0
2020-04-29,UG,Georgia,117,99,0,0,18,10,8,18,0
2020-04-30,UG,Georgia,126,101,0,0,25,13,12,25,0
2020-05-01,UG,Georgia,111,98,0,0,13,8,5,13,0
2020-05-02,UG,Georgia,102,87,1,0,15,5,9,14,1
2020-05-03,UG,Georgia,101,82,0,0,19,8,11,19,0
2020-05-04,UG,Georgia,101,87,0,0,14,9,5,14,0
2020-05-05,UG,Georgia,101,79,0,0,22,10,12,22,0
2020-05-06,UG,Georgia,106,86,0,0,20,11,9,20,0
2020-05-07,UG,Georgia,123,103,0,0,20,9,11,20,0
2020-05-08,UG,Georgia,109,94,0,0,15,8,7,15,0
2020-05-09,UG,Georgia,115,106,0,0,9,5,4,9,0
2020-05-10,UG,Georgia,118,110,0,0,8,3,5,8,0
2020-05-11,UG,Georgia,118,106,0,0,12,5,7,12,0
2020-05-12,UG,Georgia,130,114,0,0,16,8,8,16,0
2020-05-13,UG,Georgia,119,108,0,0,11,6,5,11,0
2020-05-14,UG,Georgia,127,112,0,0,15,7,8,15,0
2020-05-15,UG,Georgia,125,107,2,0,18,10,6,16,2
2020-05-16,UG,Georgia,138,119,0,0,19,10,9,19,0
2020-05-17,UG,Georgia,109,96,0,0,13,5,8,13,0
2020-05-18,UG,Georgia,128,106,1,0,22,11,10,21,1
2020-05-19,UG,Georgia,116,103,0,0,13,7,6,13,0
2020-05-20,UG,Georgia,104,87,2,1,17,9,6,15,1
2020-05-21,UG,Georgia,109,101,0,0,8,4,4,8,0
2020-05-22,UG,Georgia,104,96,0,0,8,4,4,8,0
2020-05-23,UG,Georgia,127,114,0,0,13,6,7,13,0
2020-05-24,UG,Georgia,108,96,0,0,12,7,5,12,0
2020-05-25,UG,Georgia,121,101,1,1,20,8,11,19,0
2020-05-26,UG,Georgia,125,103,0,0,22,13,9,22,0
2020-05-27,UG,Georgia,107,87,0,0,20,8,12,20,0
2020-05-28,UG,Georgia,116,92,0,0,24,12,12,24,0
2020-05-29,UG,Georgia,110,97,0,0,13,6,7,13,0
2020-05-30,UG,Georgia,110,98,0,0,12,6,6,12,0
2020-05-31,UG,Georgia,96,82,2,0,14,5,7,12,2
2020-06-01,UG,Georgia,97,84,0,0,13,6,7,13,0
2020-06-02,UG,Georgia,109,94,0,0,15,7,8,15,0
2020-06-03,UG,Georgia,82,76,0,0,6,2,4,6,0
2020-06-04,UG,Georgia,124,94,0,0,30,15,15,30,0
2020-06-05,UG,Georgia,108,94,0,0,14,8,6,14,0
2020-06-06,UG,Georgia,113,90,2,0,23,11,10,21,2
2020-06-07,UG,Georgia,110,92,0,0,18,9,9,18,0
2020-06-08,UG,Georgia,103,88,0,0,15,4,11,15,0
2020-06-09,UG,Georgia,105,90,0,0,15,10,5,15,0
2020-06-10,UG,Georgia,100,88,0,0,12,7,5,12,0
2020-06-11,UG,Georgia,118,98,1,1,20,8,11,19,0
2020-06-12,UG,Georgia,115,98,1,1,17,11,5,16,0
2020-06-13,UG,Georgia,118,98,1,0,20,9,10,19,1
2020-06-14,UG,Georgia,99,88,0,0,11,5,6,11,0
2020-06-15,UG,Georgia,100,76,1,1,24,10,13,23,0
2020-06-16,UG,Georgia,99,83,0,0,16,8,8,16,0
2020-06-17,UG,Georgia,96,79,0,0,17,10,7,17,0
2020-06-18,UG,Georgia,121,101,0,0,20,10,10,20,0
2020-06-19,UG,Georgia,99,80,0,0,19,9,10,19,0
2020-06-20,UG,Georgia,109,87,0,0,22,11,11,22,0
2020-06-21,UG,Georgia,119,100,0,0,19,10,9,19,0
2020-06-22,UG,Georgia,104,84,1,0,20,10,9,19,1
2020-06-23,UG,Georgia,117,98,0,0,19,10,9,19,0
2020-06-24,UG,Georgia,108,87,0,0,21,10,11,21,0
2020-06-25,UG,Georgia,103,88,0,0,15,6,9,15,0
2020-06-26,UG,Georgia,112,92,5,3,20,10,5,15,2
2020-06-27,UG,Georgia,97,78,3,3,19,8,8,16,0
2020-06-28,UG,Georgia,102,89,0,0,13,7,6,13,0
2020-06-29,UG,Georgia,85,67,4,0,18,6,8,14,4
2020-06-30,UG,Georgia,103,84,0,0,19,10,9,19,0
2020-07-01,UG,Georgia,123,96,0,0,27,11,16,27,0
2020-07-02,UG,Georgia,110,89,0,0,21,12,9,21,0
2020-07-03,UG,Georgia,110,93,1,0,17,7,9,16,1
2020-07-04,UG,Georgia,105,82,0,0,23,12,11,23,0
2020-07-05,UG,Georgia,112,95,0,0,17,8,9,17,0
2020-07-06,UG,Georgia,74,62,0,0,12,5,7,12,0
2020-07-07,UG,Georgia,99,75,0,0,24,15,9,24,0
2020-07-08,UG,Georgia,87,76,0,0,11,4,7,11,0
2020-07-09,UG,Georgia,110,88,0,0,22,11,11,22,0
2020-07-10,UG,Georgia,107,87,0,0,20,10,10,20,0
2020-07-11,UG,Georgia,107,94,2,0,13,6,5,11,2
2020-07-12,UG,Georgia,84,69,1,0,15,7,7,14,1
2020-07-13,UG,Georgia,82,69,0,0,13,6,7,13,0
2020-07-14,UG,Georgia,122,99,0,0,23,13,10,23,0
2020-07-15,UG,Georgia,98,80,0,0,18,6,12,18,0
2020-07-16,UG,Georgia,155,136,0,0,19,10,9,19,0
2020-07-17,UG,Georgia,150,119,1,0,31,16,14,30,1
2020-07-18,UG,Georgia,120,110,0,0,10,5,5,10,0
2020-07-19,UG,Georgia,121,105,0,0,16,7,9,16,0
2020-07-20,UG,Georgia,103,87,0,0,16,9,7,16,0
2020-07-21,UG,Georgia,111,93,0,0,18,8,10,18,0
2020-07-22,UG,Georgia,105,75,1,0,30,13,16,29,1
2020-07-23,UG,Georgia,168,129,2,2,39,20,17,37,0
2020-07-24,UG,Georgia,115,95,2,0,20,9,9,18,2
2020-07-25,UG,Georgia,120,107,2,0,13,6,5,11,2
2020-07-26,UG,Georgia,127,110,2,0,17,9,6,15,2
2020-07-27,UG,Georgia,119,90,2,0,29,13,14,27,2
2020-07-28,UG,Georgia,134,110,0,0,24,13,11,24,0
2020-07-29,UG,Georgia,132,109,2,0,23,12,9,21,2
2020-07-30,UG,Georgia,145,128,0,0,17,7,10,17,0
2020-07-31,UG,Georgia,115,102,2,0,13,6,5,11,2
2020-08-01,UG,Georgia,134,119,0,0,15,6,9,15,0
2020-08-02,UG,Georgia,124,104,2,0,20,10,8,18,2
2020-08-03,UG,Georgia,113,87,2,0,26,11,13,24,2
2020-08-04,UG,Georgia,126,94,2,2,32,16,14,30,0
2020-08-05,UG,Georgia,111,94,2,0,17,6,9,15,2
2020-08-06,UG,Georgia,136,114,0,0,22,11,11,22,0
2020-08-07,UG,Georgia,119,90,2,0,29,15,12,27,2
2020-08-08,UG,Georgia,150,133,1,0,17,6,10,16,1
2020-08-09,UG,Georgia,122,103,2,0,19,8,9,17,2
2020-08-10,UG,Georgia,125,104,5,1,21,8,8,16,4
2020-08-11,UG,Georgia,122,103,0,0,19,11,8,19,0
2020-08-12,UG,Georgia,121,102,2,0,19,7,10,17,2
2020-08-13,UG,Georgia,145,129,2,0,16,7,7,14,2
2020-08-14,UG,Georgia,117,102,2,0,15,8,5,13,2
2020-08-15,UG,Georgia,140,123,0,0,17,8,9,17,0
2020-08-16,UG,Georgia,136,121,2,0,15,8,5,13,2
2020-08-17,UG,Georgia,135,106,3,1,29,12,14,26,2
2020-08-18,UG,Georgia,129,109,2,0,20,10,8,18,2
2020-08-19,UG,Georgia,110,86,2,0,24,8,14,22,2
2020-08-20,UG,Georgia,146,119,1,0,27,14,12,26,1
2020-08-21,UG,Georgia,137,114,2,0,23,12,9,21,2
2020-08-22,UG,Georgia,140,125,1,0,15,6,8,14,1
2020-08-23,UG,Georgia,127,110,2,0,17,9,6,15,2
2020-08-24,UG,Georgia,135,103,2,0,32,14,16,30,2
2020-08-25,UG,Georgia,139,112,0,0,27,13,14,27,0
2020-08-26,UG,Georgia,126,93,2,0,33,14,17,31,2
2020-08-27,UG,Georgia,163,137,2,0,26,13,11,24,2
2020-08-28,UG,Georgia,159,131,6,2,28,12,10,22,4
2020-08-29,UG,Georgia,150,134,0,0,16,7,9,16,0
2020-08-30,UG,Georgia,151,134,2,0,17,7,8,15,2
2020-08-31,UG,Georgia,143,118,2,0,25,12,11,23,2
2020-09-01,UG,Georgia,139,107,0,0,32,16,16,32,0
2020-09-02,UG,Georgia,154,130,0,0,24,11,13,24,0
2020-09-03,UG,Georgia,178,151,2,0,27,14,11,25,2
2020-09-04,UG,Georgia,163,134,2,0,29,15,12,27,2
2020-09-05,UG,Georgia,170,143,1,1,27,9,17,26,0
2020-09-06,UG,Georgia,179,152,2,0,27,14,11,25,2
2020-09-07,UG,Georgia,164,132,2,0,32,15,15,30,2
2020-09-08,UG,Georgia,159,130,0,0,29,17,12,29,0
2020-09-09,UG,Georgia,146,128,0,0,18,6,12,18,0
2020-09-10,UG,Georgia,183,159,2,0,24,11,11,22,2
2020-09-11,UG,Georgia,183,158,2,0,25,13,10,23,2
2020-09-12,UG,Georgia,156,140,0,0,16,8,8,16,0
2020-09-13,UG,Georgia,159,143,2,0,16,8,6,14,2
2020-09-14,UG,Georgia,132,113,2,0,19,7,10,17,2
2020-09-15,UG,Georgia,150,121,0,0,29,15,14,29,0
2020-09-16,UG,Georgia,165,136,0,0,29,13,16,29,0
2020-09-17,UG,Georgia,204,170,2,0,34,17,15,32,2
2020-09-18,UG,Georgia,186,167,3,0,19,9,7,16,3
2020-09-19,UG,Georgia,157,137,0,0,20,7,13,20,0
2020-09-20,UG,Georgia,162,136,2,0,26,15,9,24,2
2020-09-21,UG,Georgia,171,136,2,0,35,18,15,33,2
2020-09-22,UG,Georgia,158,129,0,0,29,15,14,29,0
2020-09-23,UG,Georgia,170,140,0,0,30,13,17,30,0
2020-09-24,UG,Georgia,209,180,2,0,29,14,13,27,2
2020-09-25,UG,Georgia,195,173,2,0,22,10,10,20,2
2020-09-26,UG,Georgia,169,151,0,0,18,7,11,18,0
2020-09-27,UG,Georgia,174,147,2,0,27,12,13,25,2
2020-09-28,UG,Georgia,130,103,3,1,27,15,9,24,2
2020-09-29,UG,Georgia,123,96,0,0,27,13,14,27,0
2020-09-30,UG,Georgia,134,104,0,0,30,12,18,30,0
2020-10-01,UG,Georgia,156,122,0,0,34,20,14,34,0
2020-10-02,UG,Georgia,119,102,2,0,17,7,8,15,2
2020-10-03,UG,Georgia,128,115,0,0,13,6,7,13,0
2020-10-04,UG,Georgia,136,117,2,0,19,8,9,17,2
2020-10-05,UG,Georgia,125,95,2,0,30,14,14,28,2
2020-10-06,UG,Georgia,116,100,0,0,16,8,8,16,0
2020-10-07,UG,Georgia,126,101,0,0,25,11,14,25,0
2020-10-08,UG,Georgia,124,109,0,0,15,10,5,15,0
2020-10-09,UG,Georgia,122,111,0,0,11,6,5,11,0
2020-10-10,UG,Georgia,126,100,0,0,26,13,13,26,0
2020-10-11,UG,Georgia,111,99,0,0,12,6,6,12,0
2020-10-12,UG,Georgia,102,88,0,0,14,8,6,14,0
2020-10-13,UG,Georgia,100,84,0,0,16,8,8,16,0
2020-10-14,UG,Georgia,101,78,0,0,23,8,15,23,0
2020-10-15,UG,Georgia,140,108,0,0,32,18,14,32,0
2020-10-16,UG,Georgia,111,92,0,0,19,9,10,19,0
2020-10-17,UG,Georgia,128,107,0,0,21,11,10,21,0
2020-10-18,UG,Georgia,110,94,0,0,16,8,8,16,0
2020-10-19,UG,Georgia,99,83,2,0,16,6,8,14,2
2020-10-20,UG,Georgia,104,79,0,0,25,13,12,25,0
2020-10-21,UG,Georgia,106,79,3,1,27,10,14,24,2
2020-10-22,UG,Georgia,121,94,0,0,27,15,12,27,0
2020-10-23,UG,Georgia,111,83,2,0,28,13,13,26,2
2020-10-24,UG,Georgia,129,107,0,0,22,13,9,22,0
2020-10-25,UG,Georgia,113,96,2,0,17,8,7,15,2
2020-10-26,UG,Georgia,123,105,2,0,18,8,8,16,2
2020-10-27,UG,Georgia,110,81,3,0,29,14,12,26,3
2020-10-28,UG,Georgia,114,93,0,0,21,9,12,21,0
2020-10-29,UG,Georgia,136,114,0,0,22,12,10,22,0
2020-10-30,UG,Georgia,136,112,2,0,24,10,12,22,2
2020-10-31,UG,Georgia,146,121,0,0,25,13,12,25,0
2020-11-01,UG,Georgia,135,107,3,1,28,12,13,25,2
2020-11-02,UG,Georgia,128,108,1,1,20,11,8,19,0
2020-11-03,UG,Georgia,107,83,0,0,24,13,11,24,0
2020-11-04,UG,Georgia,123,93,1,1,30,12,17,29,0
2020-11-05,UG,Georgia,151,114,0,0,37,20,17,37,0
2020-11-06,UG,Georgia,126,99,2,0,27,13,12,25,2
2020-11-07,UG,Georgia,151,129,0,0,22,9,13,22,0
2020-11-08,UG,Georgia,124,95,4,2,29,14,11,25,2
2020-11-09,UG,Georgia,114,91,2,2,23,9,12,21,0
2020-11-10,UG,Georgia,120,92,2,2,28,15,11,26,0
2020-11-11,UG,Georgia,117,92,1,1,25,10,14,24,0
2020-11-12,UG,Georgia,146,115,0,0,31,19,12,31,0
2020-11-13,UG,Georgia,118,96,2,0,22,9,11,20,2
2020-11-14,UG,Georgia,113,94,1,1,19,8,10,18,0
2020-11-15,UG,Georgia,108,90,4,0,18,8,6,14,4
2020-11-16,UG,Georgia,122,88,1,1,34,17,16,33,0
2020-11-17,UG,Georgia,115,87,1,1,28,13,14,27,0
2020-11-18,UG,Georgia,98,79,0,0,19,9,10,19,0
2020-11-19,UG,Georgia,131,99,0,0,32,17,15,32,0
2020-11-20,UG,Georgia,127,106,2,0,21,9,10,19,2
2020-11-21,UG,Georgia,112,97,0,0,15,7,8,15,0
2020-11-22,UG,Georgia,108,89,4,2,19,8,7,15,2
2020-11-23,UG,Georgia,98,80,1,1,18,9,8,17,0
2020-11-24,UG,Georgia,119,95,2,2,24,13,9,22,0
2020-11-25,UG,Georgia,118,86,0,0,32,12,20,32,0
2020-11-26,UG,Georgia,147,124,0,0,23,14,9,23,0
2020-11-27,UG,Georgia,121,99,3,1,22,7,12,19,2
2020-11-28,UG,Georgia,132,106,2,0,26,12,12,24,2
2020-11-29,UG,Georgia,126,105,4,0,21,10,7,17,4
2020-11-30,UG,Georgia,118,96,2,0,22,9,11,20,2
2020-12-01,UG,Georgia,129,98,2,0,31,15,14,29,2
2020-12-02,UG,Georgia,136,97,2,0,39,18,19,37,2
2020-12-03,UG,Georgia,144,109,2,0,35,17,16,33,2
2020-12-04,UG,Georgia,136,117,2,0,19,10,7,17,2
2020-12-05,UG,Georgia,156,131,3,1,25,8,14,22,2
2020-12-06,UG,Georgia,155,130,0,0,25,15,10,25,0
2020-12-07,UG,Georgia,125,103,2,0,22,9,11,20,2
2020-12-08,UG,Georgia,132,101,0,0,31,17,14,31,0
2020-12-09,UG,Georgia,133,106,0,0,27,9,18,27,0
2020-12-10,UG,Georgia,159,134,0,0,25,17,8,25,0
2020-12-11,UG,Georgia,148,122,3,1,26,9,14,23,2
2020-12-12,UG,Georgia,152,128,0,0,24,11,13,24,0
2020-12-13,UG,Georgia,152,133,0,0,19,13,6,19,0
2020-12-14,UG,Georgia,128,106,2,0,22,10,10,20,2
2020-12-15,UG,Georgia,127,107,0,0,20,9,11,20,0
2020-12-16,UG,Georgia,147,114,0,0,33,18,15,33,0
2020-12-17,UG,Georgia,168,142,0,0,26,12,14,26,0
2020-12-18,UG,Georgia,162,130,2,0,32,14,16,30,2
2020-12-19,UG,Georgia,148,128,0,0,20,10,10,20,0
2020-12-20,UG,Georgia,164,142,0,0,22,13,9,22,0
2020-12-21,UG,Georgia,141,113,2,0,28,11,15,26,2
2020-12-22,UG,Georgia,145,124,0,0,21,11,10,21,0
2020-12-23,UG,Georgia,133,105,0,0,28,12,16,28,0
2020-12-24,UG,Georgia,118,100,0,0,18,11,7,18,0
2020-12-25,UG,Georgia,140,115,2,0,25,11,12,23,2
2020-12-26,UG,Georgia,122,104,0,0,18,8,10,18,0
2020-12-27,UG,Georgia,138,110,1,1,28,15,12,27,0
2020-12-28,UG,Georgia,117,98,2,0,19,10,7,17,2
2020-12-29,UG,Georgia,139,114,0,0,25,11,14,25,0
2020-12-30,UG,Georgia,117,93,0,0,24,12,12,24,0
2020-12-31,UG,Georgia,107,100,0,0,7,6,1,7,0
2020-01-01,ED,Germany,5907,2826,329,1,3081,1412,1340,2752,328
2020-01-02,ED,Germany,7838,3371,647,7,4467,1941,1879,3820,640
2020-01-03,ED,Germany,8093,3372,638,13,4721,2045,2038,4083,625
2020-01-04,ED,Germany,7388,3309,434,6,4079,1845,1800,3645,428
2020-01-05,ED,Germany,8001,3473,528,5,4528,1981,2019,4000,523
2020-01-06,ED,Germany,8057,3285,768,10,4772,1985,2019,4004,758
2020-01-07,ED,Germany,7464,2904,843,18,4560,1874,1843,3717,825
2020-01-08,ED,Germany,7617,2879,885,15,4738,1924,1929,3853,870
2020-01-09,ED,Germany,7864,3030,934,22,4834,1948,1952,3900,912
2020-01-10,ED,Germany,8281,3192,878,24,5089,2104,2107,4211,854
2020-01-11,ED,Germany,6951,3006,557,15,3945,1714,1674,3388,542
2020-01-12,ED,Germany,7599,3233,581,8,4366,1875,1910,3785,573
2020-01-13,ED,Germany,7926,3001,912,14,4925,1993,2020,4013,898
2020-01-14,ED,Germany,7179,2657,946,17,4522,1775,1801,3576,929
2020-01-15,ED,Germany,7605,2764,1030,18,4841,1925,1886,3811,1012
2020-01-16,ED,Germany,7939,2923,1081,23,5016,1974,1961,3935,1058
2020-01-17,ED,Germany,8384,3155,978,25,5229,2123,2128,4251,953
2020-01-18,ED,Germany,6687,2886,511,14,3801,1658,1632,3290,497
2020-01-19,ED,Germany,7491,3148,587,3,4343,1871,1885,3756,584
2020-01-20,ED,Germany,8146,3199,907,18,4947,1992,2048,4040,889
2020-01-21,ED,Germany,7492,2720,1013,32,4772,1876,1883,3759,981
2020-01-22,ED,Germany,7558,2837,917,11,4721,1913,1891,3804,906
2020-01-23,ED,Germany,8005,3021,1035,21,4984,1982,1967,3949,1014
2020-01-24,ED,Germany,8593,3378,932,20,5215,2149,2134,4283,912
2020-01-25,ED,Germany,6711,2980,481,11,3731,1637,1613,3250,470
2020-01-26,ED,Germany,7466,3097,623,17,4369,1861,1885,3746,606
2020-01-27,ED,Germany,7966,3005,956,23,4961,1981,2024,4005,933
2020-01-28,ED,Germany,7071,2530,873,18,4541,1846,1822,3668,855
2020-01-29,ED,Germany,7561,2760,958,12,4801,1925,1918,3843,946
2020-01-30,ED,Germany,7805,2793,1048,27,5012,1982,1982,3964,1021
2020-01-31,ED,Germany,8437,3130,1014,26,5307,2162,2131,4293,988
2020-02-01,ED,Germany,6772,2923,497,3,3849,1698,1654,3352,494
2020-02-02,ED,Germany,7388,3061,592,8,4327,1850,1885,3735,584
2020-02-03,ED,Germany,8000,3022,941,23,4978,1983,2054,4037,918
2020-02-04,ED,Germany,7276,2607,909,21,4669,1884,1876,3760,888
2020-02-05,ED,Germany,7810,2828,1095,26,4982,1952,1935,3887,1069
2020-02-06,ED,Germany,8184,3033,1101,29,5151,2036,2014,4050,1072
2020-02-07,ED,Germany,8765,3394,1045,32,5371,2169,2157,4326,1013
2020-02-08,ED,Germany,7270,3151,654,9,4119,1746,1719,3465,645
2020-02-09,ED,Germany,6439,2746,402,7,3693,1644,1647,3291,395
2020-02-10,ED,Germany,6259,2939,312,4,3320,1477,1531,3008,308
2020-02-11,ED,Germany,7159,2554,835,12,4605,1879,1891,3770,823
2020-02-12,ED,Germany,7849,2858,951,15,4991,2024,2016,4040,936
2020-02-13,ED,Germany,8268,2935,1057,25,5333,2127,2149,4276,1032
2020-02-14,ED,Germany,8799,3373,980,17,5426,2235,2211,4446,963
2020-02-15,ED,Germany,7505,3260,607,13,4245,1848,1790,3638,594
2020-02-16,ED,Germany,7557,3073,606,10,4484,1932,1946,3878,596
2020-02-17,ED,Germany,8192,3055,953,17,5137,2071,2113,4184,936
2020-02-18,ED,Germany,7829,2751,1056,27,5078,2000,2022,4022,1029
2020-02-19,ED,Germany,8068,2892,1060,28,5176,2078,2038,4116,1032
2020-02-20,ED,Germany,8448,3148,1072,31,5300,2130,2098,4228,1041
2020-02-21,ED,Germany,8879,3310,1043,27,5569,2255,2271,4526,1016
2020-02-22,ED,Germany,7551,3298,539,13,4253,1899,1815,3714,526
2020-02-23,ED,Germany,7706,3222,585,12,4484,1945,1954,3899,573
2020-02-24,ED,Germany,8363,3134,940,25,5229,2107,2182,4289,915
2020-02-25,ED,Germany,7846,2758,982,27,5088,2033,2073,4106,955
2020-02-26,ED,Germany,8101,2893,978,19,5208,2128,2102,4230,959
2020-02-27,ED,Germany,8131,2950,943,26,5181,2137,2101,4238,917
2020-02-28,ED,Germany,8852,3322,1045,20,5530,2248,2237,4485,1025
2020-02-29,ED,Germany,7425,3233,535,10,4192,1833,1824,3657,525
2020-03-01,ED,Germany,7858,3188,630,10,4670,2008,2032,4040,620
2020-03-02,ED,Germany,8339,3088,991,22,5251,2125,2135,4260,969
2020-03-03,ED,Germany,7761,2757,999,37,5004,2003,2002,4005,962
2020-03-04,ED,Germany,8148,2940,1090,29,5208,2068,2050,4118,1061
2020-03-05,ED,Germany,8186,3016,971,36,5170,2104,2095,4199,935
2020-03-06,ED,Germany,8473,3256,877,23,5217,2151,2189,4340,854
2020-03-07,ED,Germany,7193,3214,538,15,3979,1741,1700,3441,523
2020-03-08,ED,Germany,7629,3252,608,5,4377,1867,1902,3769,603
2020-03-09,ED,Germany,7612,2983,809,32,4629,1891,1929,3820,777
2020-03-10,ED,Germany,6774,2574,785,28,4200,1707,1708,3415,757
2020-03-11,ED,Germany,7045,2643,891,43,4402,1755,1756,3511,848
2020-03-12,ED,Germany,7028,2634,788,28,4394,1814,1792,3606,760
2020-03-13,ED,Germany,7437,2936,767,28,4501,1859,1875,3734,739
2020-03-14,ED,Germany,6190,2664,519,20,3526,1492,1515,3007,499
2020-03-15,ED,Germany,6111,2439,576,9,3672,1521,1575,3096,567
2020-03-16,ED,Germany,5707,2161,681,23,3546,1426,1439,2865,658
2020-03-17,ED,Germany,4762,1711,689,36,3051,1190,1172,2362,653
2020-03-18,ED,Germany,4458,1605,593,33,2853,1111,1149,2260,560
2020-03-19,ED,Germany,3965,1484,453,29,2481,1013,1015,2028,424
2020-03-20,ED,Germany,3805,1390,357,24,2415,1020,1038,2058,333
2020-03-21,ED,Germany,2768,1240,142,5,1528,703,683,1386,137
2020-03-22,ED,Germany,2488,1009,143,5,1479,675,661,1336,138
2020-03-23,ED,Germany,1990,851,147,14,1139,476,516,992,133
2020-03-24,ED,Germany,1875,772,177,16,1103,467,459,926,161
2020-03-25,ED,Germany,1762,664,197,21,1098,450,451,901,176
2020-03-26,ED,Germany,1704,645,193,18,1059,430,436,866,175
2020-03-27,ED,Germany,1659,633,175,15,1026,411,440,851,160
2020-03-28,ED,Germany,1205,498,114,18,707,305,288,593,96
2020-03-29,ED,Germany,1161,495,79,7,666,302,285,587,72
2020-03-30,ED,Germany,1236,443,150,8,793,297,346,643,142
2020-03-31,ED,Germany,1349,471,170,10,878,354,354,708,160
2020-04-01,ED,Germany,1315,426,205,19,889,339,345,684,186
2020-04-02,ED,Germany,1356,476,190,19,880,351,339,690,171
2020-04-03,ED,Germany,1295,432,177,21,863,333,353,686,156
2020-04-04,ED,Germany,933,368,82,6,565,244,239,483,76
2020-04-05,ED,Germany,977,381,88,5,596,272,236,508,83
2020-04-06,ED,Germany,1098,344,164,17,754,277,313,590,147
2020-04-07,ED,Germany,1147,371,164,19,776,312,300,612,145
2020-04-08,ED,Germany,1278,402,183,22,876,352,341,693,161
2020-04-09,ED,Germany,1326,407,182,10,919,360,377,737,172
2020-04-10,ED,Germany,1001,355,77,4,646,286,283,569,73
2020-04-11,ED,Germany,832,345,71,4,487,216,200,416,67
2020-04-12,ED,Germany,765,360,52,3,405,176,177,353,49
2020-04-13,ED,Germany,771,319,60,6,452,181,211,392,54
2020-04-14,ED,Germany,1099,339,135,12,760,318,307,625,123
2020-04-15,ED,Germany,1262,414,189,13,848,331,328,659,176
2020-04-16,ED,Germany,1258,394,186,24,864,349,329,678,162
2020-04-17,ED,Germany,1238,396,179,17,842,322,341,663,162
2020-04-18,ED,Germany,809,330,75,4,479,215,189,404,71
2020-04-19,ED,Germany,916,375,98,4,541,227,216,443,94
2020-04-20,ED,Germany,1171,387,172,14,784,293,319,612,158
2020-04-21,ED,Germany,1237,413,170,17,824,326,328,654,153
2020-04-22,ED,Germany,1395,437,262,17,958,345,351,696,245
2020-04-23,ED,Germany,1432,445,250,16,987,372,365,737,234
2020-04-24,ED,Germany,1386,436,231,18,950,352,367,719,213
2020-04-25,ED,Germany,986,405,116,8,581,237,228,465,108
2020-04-26,ED,Germany,1024,415,116,6,609,260,233,493,110
2020-04-27,ED,Germany,1275,428,222,23,847,287,338,625,199
2020-04-28,ED,Germany,1408,484,210,21,924,360,354,714,189
2020-04-29,ED,Germany,1484,483,291,22,1001,358,352,710,269
2020-04-30,ED,Germany,1490,468,253,25,1022,385,384,769,228
2020-05-01,ED,Germany,1149,464,125,8,685,282,278,560,117
2020-05-02,ED,Germany,935,441,77,2,494,214,203,417,75
2020-05-03,ED,Germany,1136,455,159,12,681,268,254,522,147
2020-05-04,ED,Germany,1312,468,225,24,844,297,322,619,201
2020-05-05,ED,Germany,1477,487,273,19,990,359,358,717,254
2020-05-06,ED,Germany,1645,565,302,24,1080,394,384,778,278
2020-05-07,ED,Germany,1656,573,332,27,1083,369,382,751,305
2020-05-08,ED,Germany,1628,536,359,29,1092,370,363,733,330
2020-05-09,ED,Germany,1113,447,140,4,666,265,261,526,136
2020-05-10,ED,Germany,1150,534,111,2,616,260,245,505,109
2020-05-11,ED,Germany,1424,527,212,13,897,331,354,685,199
2020-05-12,ED,Germany,1585,540,284,25,1045,386,375,761,259
2020-05-13,ED,Germany,1704,564,360,26,1140,395,385,780,334
2020-05-14,ED,Germany,1767,585,392,41,1182,401,389,790,351
2020-05-15,ED,Germany,1735,606,334,19,1129,387,408,795,315
2020-05-16,ED,Germany,1263,532,217,17,731,271,243,514,200
2020-05-17,ED,Germany,1295,539,190,14,756,298,268,566,176
2020-05-18,ED,Germany,1611,541,329,32,1070,356,385,741,297
2020-05-19,ED,Germany,1708,570,356,29,1138,390,392,782,327
2020-05-20,ED,Germany,1942,632,416,22,1310,454,440,894,394
2020-05-21,ED,Germany,1589,613,239,13,976,380,357,737,226
2020-05-22,ED,Germany,1609,582,280,10,1027,365,382,747,270
2020-05-23,ED,Germany,1222,564,155,17,658,267,236,503,138
2020-05-24,ED,Germany,1433,599,264,14,834,284,286,570,250
2020-05-25,ED,Germany,1618,562,317,11,1056,352,387,739,306
2020-05-26,ED,Germany,1801,589,412,41,1212,404,396,800,371
2020-05-27,ED,Germany,1948,664,414,31,1284,442,428,870,383
2020-05-28,ED,Germany,1982,633,444,35,1349,438,467,905,409
2020-05-29,ED,Germany,1993,626,451,38,1367,479,437,916,413
2020-05-30,ED,Germany,1357,554,236,14,803,295,272,567,222
2020-05-31,ED,Germany,1300,572,176,6,728,278,274,552,170
2020-06-01,ED,Germany,1587,583,276,12,1004,339,389,728,264
2020-06-02,ED,Germany,1824,612,393,25,1212,416,403,819,368
2020-06-03,ED,Germany,2022,661,419,31,1361,482,460,942,388
2020-06-04,ED,Germany,1968,683,360,33,1285,470,455,925,327
2020-06-05,ED,Germany,1974,687,377,28,1287,451,459,910,349
2020-06-06,ED,Germany,1467,628,225,13,839,322,292,614,212
2020-06-07,ED,Germany,1518,625,224,16,893,342,327,669,208
2020-06-08,ED,Germany,1953,653,438,39,1300,410,452,862,399
2020-06-09,ED,Germany,1934,603,446,44,1331,439,446,885,402
2020-06-10,ED,Germany,2138,649,512,38,1489,511,466,977,474
2020-06-11,ED,Germany,1995,649,408,25,1346,485,453,938,383
2020-06-12,ED,Germany,2116,730,393,23,1386,490,503,993,370
2020-06-13,ED,Germany,1529,605,233,10,924,357,334,691,223
2020-06-14,ED,Germany,1678,643,229,10,1035,396,410,806,219
2020-06-15,ED,Germany,2371,806,387,31,1565,590,588,1178,356
2020-06-16,ED,Germany,2385,759,432,22,1626,595,599,1194,410
2020-06-17,ED,Germany,2512,772,431,29,1740,656,653,1309,402
2020-06-18,ED,Germany,2567,823,489,46,1744,643,612,1255,443
2020-06-19,ED,Germany,2664,885,467,39,1779,652,660,1312,428
2020-06-20,ED,Germany,1959,740,309,15,1219,471,439,910,294
2020-06-21,ED,Germany,2161,778,305,12,1383,530,548,1078,293
2020-06-22,ED,Germany,2557,812,435,28,1745,637,673,1310,407
2020-06-23,ED,Germany,2582,816,478,35,1766,648,640,1288,443
2020-06-24,ED,Germany,2753,863,494,27,1890,709,687,1396,467
2020-06-25,ED,Germany,2872,841,563,26,2031,737,731,1468,537
2020-06-26,ED,Germany,2931,931,479,34,2000,763,758,1521,445
2020-06-27,ED,Germany,2137,774,228,11,1363,593,542,1135,217
2020-06-28,ED,Germany,2336,795,258,6,1541,637,646,1283,252
2020-06-29,ED,Germany,2674,866,397,30,1808,685,726,1411,367
2020-06-30,ED,Germany,2759,883,499,33,1876,682,695,1377,466
2020-07-01,ED,Germany,3786,1315,520,30,2471,1013,938,1951,490
2020-07-02,ED,Germany,3763,1313,499,23,2450,982,969,1951,476
2020-07-03,ED,Germany,4047,1421,551,31,2626,1058,1017,2075,520
2020-07-04,ED,Germany,3377,1361,264,12,2016,886,866,1752,252
2020-07-05,ED,Germany,3497,1359,285,7,2138,917,936,1853,278
2020-07-06,ED,Germany,3681,1284,426,17,2397,956,1015,1971,409
2020-07-07,ED,Germany,3655,1295,556,37,2360,912,892,1804,519
2020-07-08,ED,Germany,3876,1328,571,29,2548,992,985,1977,542
2020-07-09,ED,Germany,3835,1389,508,29,2446,983,955,1938,479
2020-07-10,ED,Germany,4114,1512,493,23,2602,1049,1060,2109,470
2020-07-11,ED,Germany,3540,1425,297,23,2115,932,886,1818,274
2020-07-12,ED,Germany,3692,1442,320,7,2250,953,977,1930,313
2020-07-13,ED,Germany,3890,1399,496,32,2491,987,1008,1995,464
2020-07-14,ED,Germany,3735,1333,562,31,2402,923,917,1840,531
2020-07-15,ED,Germany,4106,1513,594,35,2593,1002,997,1999,559
2020-07-16,ED,Germany,4260,1582,573,27,2678,1066,1039,2105,546
2020-07-17,ED,Germany,4528,1741,552,30,2787,1120,1115,2235,522
2020-07-18,ED,Germany,3986,1729,266,4,2257,1001,990,1991,262
2020-07-19,ED,Germany,4014,1704,297,5,2310,1013,1000,2013,292
2020-07-20,ED,Germany,4196,1617,471,25,2579,1029,1079,2108,446
2020-07-21,ED,Germany,3962,1497,518,24,2465,980,967,1947,494
2020-07-22,ED,Germany,4210,1588,558,30,2622,1037,1027,2064,528
2020-07-23,ED,Germany,4239,1580,549,20,2659,1056,1054,2110,529
2020-07-24,ED,Germany,4589,1743,518,15,2846,1175,1153,2328,503
2020-07-25,ED,Germany,4185,1810,308,15,2375,1035,1032,2067,293
2020-07-26,ED,Germany,4123,1769,266,15,2354,1050,1038,2088,251
2020-07-27,ED,Germany,4141,1577,466,28,2564,1022,1076,2098,438
2020-07-28,ED,Germany,3894,1481,506,23,2413,953,954,1907,483
2020-07-29,ED,Germany,4219,1529,549,29,2690,1071,1070,2141,520
2020-07-30,ED,Germany,4315,1622,560,34,2693,1068,1065,2133,526
2020-07-31,ED,Germany,4679,1814,536,27,2865,1165,1164,2329,509
2020-08-01,ED,Germany,4661,2044,309,6,2617,1172,1136,2308,303
2020-08-02,ED,Germany,4709,2027,303,6,2682,1182,1197,2379,297
2020-08-03,ED,Germany,4765,1975,471,24,2790,1144,1175,2319,447
2020-08-04,ED,Germany,4516,1836,548,28,2680,1070,1062,2132,520
2020-08-05,ED,Germany,4834,1923,577,15,2911,1183,1151,2334,562
2020-08-06,ED,Germany,4762,1960,534,27,2802,1128,1140,2268,507
2020-08-07,ED,Germany,5270,2111,531,24,3159,1313,1315,2628,507
2020-08-08,ED,Germany,4811,2144,300,9,2667,1195,1172,2367,291
2020-08-09,ED,Germany,4957,2166,336,10,2791,1222,1233,2455,326
2020-08-10,ED,Germany,4883,2026,459,26,2857,1173,1225,2398,433
2020-08-11,ED,Germany,4406,1783,510,25,2623,1056,1057,2113,485
2020-08-12,ED,Germany,4660,1888,466,25,2772,1155,1151,2306,441
2020-08-13,ED,Germany,4762,1963,520,18,2799,1138,1141,2279,502
2020-08-14,ED,Germany,5143,2152,462,14,2991,1279,1250,2529,448
2020-08-15,ED,Germany,4784,2179,278,13,2605,1163,1164,2327,265
2020-08-16,ED,Germany,4929,2188,330,11,2741,1201,1210,2411,319
2020-08-17,ED,Germany,4842,2064,447,19,2778,1152,1179,2331,428
2020-08-18,ED,Germany,4431,1857,508,29,2574,1035,1031,2066,479
2020-08-19,ED,Germany,4845,1950,610,33,2895,1138,1147,2285,577
2020-08-20,ED,Germany,4896,2008,597,41,2888,1149,1142,2291,556
2020-08-21,ED,Germany,5324,2238,522,26,3086,1291,1273,2564,496
2020-08-22,ED,Germany,4669,2164,287,16,2505,1117,1101,2218,271
2020-08-23,ED,Germany,4924,2229,319,10,2695,1183,1193,2376,309
2020-08-24,ED,Germany,4922,2092,509,18,2830,1145,1176,2321,491
2020-08-25,ED,Germany,4510,1844,582,32,2666,1036,1048,2084,550
2020-08-26,ED,Germany,4615,1952,437,19,2663,1134,1092,2226,418
2020-08-27,ED,Germany,4984,2019,652,42,2965,1151,1162,2313,610
2020-08-28,ED,Germany,5321,2250,532,34,3071,1268,1271,2539,498
2020-08-29,ED,Germany,4752,2189,302,5,2563,1150,1111,2261,297
2020-08-30,ED,Germany,4926,2287,338,9,2639,1154,1147,2301,329
2020-08-31,ED,Germany,5082,2169,573,19,2913,1146,1194,2340,554
2020-09-01,ED,Germany,4642,1933,568,17,2709,1068,1073,2141,551
2020-09-02,ED,Germany,4926,1955,669,30,2971,1148,1154,2302,639
2020-09-03,ED,Germany,5002,1996,658,30,3006,1178,1170,2348,628
2020-09-04,ED,Germany,5542,2249,667,13,3293,1326,1300,2626,654
2020-09-05,ED,Germany,4756,2101,357,13,2655,1147,1151,2298,344
2020-09-06,ED,Germany,4987,2243,370,4,2744,1174,1200,2374,366
2020-09-07,ED,Germany,4943,2006,556,22,2937,1170,1211,2381,534
2020-09-08,ED,Germany,4436,1674,619,33,2762,1090,1053,2143,586
2020-09-09,ED,Germany,4822,1870,687,32,2952,1117,1148,2265,655
2020-09-10,ED,Germany,4868,1900,643,24,2968,1176,1149,2325,619
2020-09-11,ED,Germany,5422,2222,673,22,3200,1266,1261,2527,651
2020-09-12,ED,Germany,4511,2003,339,13,2508,1091,1078,2169,326
2020-09-13,ED,Germany,4889,2164,403,9,2725,1154,1168,2322,394
2020-09-14,ED,Germany,4809,1913,631,25,2896,1109,1156,2265,606
2020-09-15,ED,Germany,4440,1727,703,38,2713,996,1014,2010,665
2020-09-16,ED,Germany,4680,1872,646,23,2808,1092,1070,2162,623
2020-09-17,ED,Germany,4723,1855,675,20,2868,1096,1097,2193,655
2020-09-18,ED,Germany,5366,2192,688,31,3174,1241,1245,2486,657
2020-09-19,ED,Germany,4318,1959,336,8,2359,1016,1007,2023,328
2020-09-20,ED,Germany,4737,2097,408,7,2640,1118,1114,2232,401
2020-09-21,ED,Germany,4666,1865,596,28,2801,1085,1120,2205,568
2020-09-22,ED,Germany,4289,1616,678,40,2673,991,1004,1995,638
2020-09-23,ED,Germany,4618,1808,684,34,2810,1074,1052,2126,650
2020-09-24,ED,Germany,4566,1772,666,40,2794,1067,1061,2128,626
2020-09-25,ED,Germany,5229,2171,646,27,3058,1201,1211,2412,619
2020-09-26,ED,Germany,4246,1962,308,16,2284,1012,964,1976,292
2020-09-27,ED,Germany,4556,2016,355,7,2540,1091,1094,2185,348
2020-09-28,ED,Germany,4580,1881,560,29,2699,1045,1094,2139,531
2020-09-29,ED,Germany,4087,1589,568,39,2498,975,955,1930,529
2020-09-30,ED,Germany,4594,1723,732,34,2871,1072,1067,2139,698
2020-10-01,ED,Germany,4508,1735,657,29,2773,1054,1062,2116,628
2020-10-02,ED,Germany,5032,2055,640,29,2977,1154,1183,2337,611
2020-10-03,ED,Germany,4182,1906,310,8,2276,1005,961,1966,302
2020-10-04,ED,Germany,4378,1918,368,4,2460,1049,1043,2092,364
2020-10-05,ED,Germany,4303,1719,544,28,2584,1000,1040,2040,516
2020-10-06,ED,Germany,3707,1358,539,36,2349,911,899,1810,503
2020-10-07,ED,Germany,4109,1537,624,42,2572,981,967,1948,582
2020-10-08,ED,Germany,4199,1526,633,42,2673,1012,1028,2040,591
2020-10-09,ED,Germany,4814,1856,638,24,2958,1166,1154,2320,614
2020-10-10,ED,Germany,4139,1826,298,12,2313,1020,995,2015,286
2020-10-11,ED,Germany,4392,1875,369,11,2517,1083,1065,2148,358
2020-10-12,ED,Germany,4174,1588,518,19,2586,992,1076,2068,499
2020-10-13,ED,Germany,3693,1359,571,34,2334,901,862,1763,537
2020-10-14,ED,Germany,3969,1481,502,27,2488,990,996,1986,475
2020-10-15,ED,Germany,3881,1459,564,27,2422,935,923,1858,537
2020-10-16,ED,Germany,4882,1952,539,17,2930,1183,1208,2391,522
2020-10-17,ED,Germany,4115,1794,336,13,2321,1006,979,1985,323
2020-10-18,ED,Germany,4273,1826,396,11,2447,1023,1028,2051,385
2020-10-19,ED,Germany,3947,1473,515,15,2474,953,1006,1959,500
2020-10-20,ED,Germany,3518,1247,571,28,2271,865,835,1700,543
2020-10-21,ED,Germany,3817,1407,566,28,2410,930,914,1844,538
2020-10-22,ED,Germany,3948,1410,596,34,2538,980,962,1942,562
2020-10-23,ED,Germany,4595,1743,619,36,2852,1111,1122,2233,583
2020-10-24,ED,Germany,4122,1773,372,13,2349,991,986,1977,359
2020-10-25,ED,Germany,3995,1653,375,10,2342,987,980,1967,365
2020-10-26,ED,Germany,3756,1445,500,35,2311,897,914,1811,465
2020-10-27,ED,Germany,3301,1208,524,34,2093,796,773,1569,490
2020-10-28,ED,Germany,3659,1363,518,33,2296,897,881,1778,485
2020-10-29,ED,Germany,3709,1367,563,30,2342,884,895,1779,533
2020-10-30,ED,Germany,4307,1704,561,22,2603,1008,1034,2042,539
2020-10-31,ED,Germany,3702,1631,405,28,2071,839,827,1666,377
2020-11-01,ED,Germany,3761,1665,328,4,2096,895,873,1768,324
2020-11-02,ED,Germany,3445,1362,437,18,2083,803,843,1646,419
2020-11-03,ED,Germany,2966,1122,440,20,1844,697,707,1404,420
2020-11-04,ED,Germany,3182,1220,469,21,1962,757,736,1493,448
2020-11-05,ED,Germany,3220,1237,509,27,1983,729,745,1474,482
2020-11-06,ED,Germany,3783,1469,519,24,2314,903,892,1795,495
2020-11-07,ED,Germany,2931,1246,320,26,1685,685,680,1365,294
2020-11-08,ED,Germany,3243,1382,328,11,1861,769,764,1533,317
2020-11-09,ED,Germany,2899,1181,383,20,1718,655,680,1335,363
2020-11-10,ED,Germany,2521,995,334,17,1526,591,601,1192,317
2020-11-11,ED,Germany,2652,1036,385,23,1616,628,603,1231,362
2020-11-12,ED,Germany,2894,1125,433,38,1769,666,670,1336,395
2020-11-13,ED,Germany,3274,1222,509,39,2052,763,780,1543,470
2020-11-14,ED,Germany,2421,1060,235,16,1361,578,548,1126,219
2020-11-15,ED,Germany,2792,1223,281,9,1569,645,643,1288,272
2020-11-16,ED,Germany,2694,1057,377,21,1637,621,639,1260,356
2020-11-17,ED,Germany,2408,894,414,44,1514,564,536,1100,370
2020-11-18,ED,Germany,2773,945,530,34,1828,659,639,1298,496
2020-11-19,ED,Germany,2678,1010,392,26,1668,630,646,1276,366
2020-11-20,ED,Germany,2986,1093,446,25,1893,716,731,1447,421
2020-11-21,ED,Germany,2129,902,217,16,1227,515,495,1010,201
2020-11-22,ED,Germany,2374,1019,219,12,1355,565,571,1136,207
2020-11-23,ED,Germany,2469,940,372,22,1529,565,592,1157,350
2020-11-24,ED,Germany,2296,831,421,32,1465,526,518,1044,389
2020-11-25,ED,Germany,2589,905,459,36,1684,623,602,1225,423
2020-11-26,ED,Germany,2554,922,447,45,1632,590,595,1185,402
2020-11-27,ED,Germany,2954,1119,408,23,1835,710,717,1427,385
2020-11-28,ED,Germany,2105,913,229,14,1192,498,465,963,215
2020-11-29,ED,Germany,2466,1063,292,14,1403,547,564,1111,278
2020-11-30,ED,Germany,2566,948,399,30,1618,593,626,1219,369
2020-12-01,ED,Germany,2260,843,308,32,1417,551,558,1109,276
2020-12-02,ED,Germany,2614,965,376,26,1649,648,625,1273,350
2020-12-03,ED,Germany,2713,1036,442,27,1677,630,605,1235,415
2020-12-04,ED,Germany,3104,1174,477,19,1930,719,734,1453,458
2020-12-05,ED,Germany,2287,1025,231,14,1262,529,502,1031,217
2020-12-06,ED,Germany,2464,1160,170,6,1304,556,578,1134,164
2020-12-07,ED,Germany,2607,1015,376,31,1592,596,620,1216,345
2020-12-08,ED,Germany,2539,912,479,27,1627,581,567,1148,452
2020-12-09,ED,Germany,2733,1077,378,21,1656,638,640,1278,357
2020-12-10,ED,Germany,2955,1183,421,23,1772,686,665,1351,398
2020-12-11,ED,Germany,3363,1359,442,28,2004,776,786,1562,414
2020-12-12,ED,Germany,2503,1182,181,6,1321,587,553,1140,175
2020-12-13,ED,Germany,2739,1316,232,7,1423,593,598,1191,225
2020-12-14,ED,Germany,2835,1139,410,21,1696,625,661,1286,389
2020-12-15,ED,Germany,2797,1081,422,33,1716,651,643,1294,389
2020-12-16,ED,Germany,3130,1207,451,21,1923,748,724,1472,430
2020-12-17,ED,Germany,3634,1567,448,26,2067,815,804,1619,422
2020-12-18,ED,Germany,4293,1847,430,31,2446,1007,1009,2016,399
2020-12-19,ED,Germany,3724,1778,290,20,1946,849,807,1656,270
2020-12-20,ED,Germany,3565,1723,208,10,1842,810,824,1634,198
2020-12-21,ED,Germany,3325,1511,298,19,1814,744,772,1516,279
2020-12-22,ED,Germany,2841,1113,300,19,1728,725,703,1428,281
2020-12-23,ED,Germany,3343,1281,317,17,2062,862,883,1745,300
2020-12-24,ED,Germany,2137,991,108,3,1146,497,541,1038,105
2020-12-25,ED,Germany,1489,728,98,0,761,329,334,663,98
2020-12-26,ED,Germany,2269,1085,124,2,1184,569,491,1060,122
2020-12-27,ED,Germany,2778,1266,180,3,1512,666,666,1332,177
2020-12-28,ED,Germany,2608,1128,216,10,1480,627,637,1264,206
2020-12-29,ED,Germany,2323,968,194,8,1355,589,572,1161,186
2020-12-30,ED,Germany,2741,1155,233,11,1586,672,681,1353,222
2020-12-31,ED,Germany,1690,793,100,2,897,384,413,797,98
2020-01-01,LG,Greece,1367,850,180,2,517,168,169,337,178
2020-01-02,LG,Greece,1707,1043,235,9,664,216,213,429,226
2020-01-03,LG,Greece,1720,1026,253,3,694,218,223,441,250
2020-01-04,LG,Greece,1810,1186,232,6,624,199,193,392,226
2020-01-05,LG,Greece,1855,1217,237,2,638,205,196,401,235
2020-01-06,LG,Greece,1615,1002,218,3,613,195,200,395,215
2020-01-07,LG,Greece,1477,917,211,5,560,177,172,349,206
2020-01-08,LG,Greece,1628,1052,235,10,576,171,170,341,225
2020-01-09,LG,Greece,1677,1089,232,14,588,178,178,356,218
2020-01-10,LG,Greece,1715,1077,259,5,638,187,192,379,254
2020-01-11,LG,Greece,1698,1152,198,5,546,171,177,348,193
2020-01-12,LG,Greece,1781,1189,223,3,592,192,177,369,220
2020-01-13,LG,Greece,1550,956,247,15,594,167,180,347,232
2020-01-14,LG,Greece,1417,921,205,17,496,143,148,291,188
2020-01-15,LG,Greece,1507,973,225,18,534,156,153,309,207
2020-01-16,LG,Greece,1574,1010,233,21,564,165,166,331,212
2020-01-17,LG,Greece,1649,1030,258,8,619,178,183,361,250
2020-01-18,LG,Greece,1663,1145,203,7,518,158,157,315,196
2020-01-19,LG,Greece,1761,1181,231,6,580,178,171,349,225
2020-01-20,LG,Greece,1567,974,245,15,593,172,176,348,230
2020-01-21,LG,Greece,1370,881,199,18,489,146,144,290,181
2020-01-22,LG,Greece,1537,964,250,25,573,164,159,323,225
2020-01-23,LG,Greece,1559,1005,235,11,554,160,159,319,224
2020-01-24,LG,Greece,1620,981,274,10,639,179,186,365,264
2020-01-25,LG,Greece,1549,1070,195,8,479,144,140,284,187
2020-01-26,LG,Greece,1715,1139,230,7,576,176,170,346,223
2020-01-27,LG,Greece,1567,953,259,12,614,171,184,355,247
2020-01-28,LG,Greece,1431,889,226,22,542,161,155,316,204
2020-01-29,LG,Greece,1492,947,237,14,545,156,152,308,223
2020-01-30,LG,Greece,1564,993,235,15,571,166,170,336,220
2020-01-31,LG,Greece,1622,989,246,8,633,190,197,387,238
2020-02-01,LG,Greece,1609,1099,204,5,510,155,151,306,199
2020-02-02,LG,Greece,1725,1129,241,5,596,184,171,355,236
2020-02-03,LG,Greece,1508,931,241,10,577,163,173,336,231
2020-02-04,LG,Greece,1411,913,194,13,498,155,149,304,181
2020-02-05,LG,Greece,1414,906,204,13,508,148,156,304,191
2020-02-06,LG,Greece,1526,969,236,17,557,162,159,321,219
2020-02-07,LG,Greece,1576,975,242,7,601,182,177,359,235
2020-02-08,LG,Greece,1588,1087,194,10,501,150,157,307,184
2020-02-09,LG,Greece,1688,1114,226,8,574,178,170,348,218
2020-02-10,LG,Greece,1547,949,254,18,598,170,174,344,236
2020-02-11,LG,Greece,1446,923,203,12,523,162,158,320,191
2020-02-12,LG,Greece,1498,953,227,24,545,159,159,318,203
2020-02-13,LG,Greece,1548,973,238,16,575,170,167,337,222
2020-02-14,LG,Greece,1625,969,271,7,656,193,192,385,264
2020-02-15,LG,Greece,1631,1109,210,13,522,153,159,312,197
2020-02-16,LG,Greece,1710,1100,247,8,610,186,177,363,239
2020-02-17,LG,Greece,1566,938,273,21,628,173,182,355,252
2020-02-18,LG,Greece,1466,940,211,14,526,158,157,315,197
2020-02-19,LG,Greece,1546,957,264,31,589,163,162,325,233
2020-02-20,LG,Greece,1564,986,226,16,578,177,175,352,210
2020-02-21,LG,Greece,1684,1033,251,7,651,198,202,400,244
2020-02-22,LG,Greece,1683,1152,216,11,531,159,156,315,205
2020-02-23,LG,Greece,1770,1156,251,4,614,187,176,363,247
2020-02-24,LG,Greece,1610,982,270,20,628,175,183,358,250
2020-02-25,LG,Greece,1503,941,219,19,562,169,174,343,200
2020-02-26,LG,Greece,1588,997,238,24,591,176,177,353,214
2020-02-27,LG,Greece,1606,1020,246,21,586,169,171,340,225
2020-02-28,LG,Greece,1657,966,273,10,691,207,211,418,263
2020-02-29,LG,Greece,1687,1146,204,7,541,167,170,337,197
2020-03-01,LG,Greece,1768,1151,227,7,617,201,189,390,220
2020-03-02,LG,Greece,1537,907,249,3,630,185,196,381,246
2020-03-03,LG,Greece,1459,893,212,9,566,178,176,354,203
2020-03-04,LG,Greece,1477,890,233,24,587,175,179,354,209
2020-03-05,LG,Greece,1486,882,253,17,604,172,179,351,236
2020-03-06,LG,Greece,1561,868,284,8,693,201,208,409,276
2020-03-07,LG,Greece,1521,980,211,8,541,164,166,330,203
2020-03-08,LG,Greece,1623,1010,242,8,613,189,182,371,234
2020-03-09,LG,Greece,1362,759,251,14,603,176,176,352,237
2020-03-10,LG,Greece,1273,714,230,26,559,167,162,329,204
2020-03-11,LG,Greece,1301,739,236,17,562,162,164,326,219
2020-03-12,LG,Greece,1331,777,230,12,554,162,162,324,218
2020-03-13,LG,Greece,1458,812,281,18,646,181,184,365,263
2020-03-14,LG,Greece,1466,957,212,3,509,145,152,297,209
2020-03-15,LG,Greece,1444,896,227,5,548,165,156,321,222
2020-03-16,LG,Greece,1186,682,220,14,504,141,143,284,206
2020-03-17,LG,Greece,1015,577,186,14,438,122,130,252,172
2020-03-18,LG,Greece,1016,607,202,15,409,103,104,207,187
2020-03-19,LG,Greece,891,512,188,10,379,92,99,191,178
2020-03-20,LG,Greece,866,459,185,9,407,117,105,222,176
2020-03-21,LG,Greece,678,398,129,1,280,78,73,151,128
2020-03-22,LG,Greece,551,288,121,0,263,71,71,142,121
2020-03-23,LG,Greece,458,243,107,5,215,55,53,108,102
2020-03-24,LG,Greece,397,210,106,9,187,43,38,81,97
2020-03-25,LG,Greece,306,168,81,1,138,27,30,57,80
2020-03-26,LG,Greece,341,171,116,4,170,26,28,54,112
2020-03-27,LG,Greece,306,152,116,6,154,18,20,38,110
2020-03-28,LG,Greece,292,166,99,6,126,13,14,27,93
2020-03-29,LG,Greece,241,161,63,3,80,11,6,17,60
2020-03-30,LG,Greece,282,125,117,5,157,20,20,40,112
2020-03-31,LG,Greece,286,143,107,12,143,17,19,36,95
2020-04-01,LG,Greece,324,167,113,11,157,23,21,44,102
2020-04-02,LG,Greece,294,152,104,7,142,18,20,38,97
2020-04-03,LG,Greece,278,146,94,3,132,18,20,38,91
2020-04-04,LG,Greece,228,131,67,0,97,16,14,30,67
2020-04-05,LG,Greece,212,131,64,2,81,9,8,17,62
2020-04-06,LG,Greece,252,117,101,5,135,18,16,34,96
2020-04-07,LG,Greece,264,132,91,6,132,19,22,41,85
2020-04-08,LG,Greece,323,164,117,14,159,20,22,42,103
2020-04-09,LG,Greece,293,148,103,7,145,20,22,42,96
2020-04-10,LG,Greece,280,132,89,3,148,26,33,59,86
2020-04-11,LG,Greece,249,147,69,1,102,20,13,33,68
2020-04-12,LG,Greece,215,139,54,0,76,10,12,22,54
2020-04-13,LG,Greece,270,130,89,10,140,26,25,51,79
2020-04-14,LG,Greece,246,118,83,12,128,23,22,45,71
2020-04-15,LG,Greece,298,154,98,8,144,25,21,46,90
2020-04-16,LG,Greece,305,153,95,2,152,30,27,57,93
2020-04-17,LG,Greece,259,140,72,0,119,22,25,47,72
2020-04-18,LG,Greece,229,150,53,0,79,13,13,26,53
2020-04-19,LG,Greece,192,130,46,0,62,8,8,16,46
2020-04-20,LG,Greece,287,151,85,0,136,25,26,51,85
2020-04-21,LG,Greece,288,139,98,5,149,28,23,51,93
2020-04-22,LG,Greece,332,179,99,11,153,28,26,54,88
2020-04-23,LG,Greece,316,171,97,10,145,23,25,48,87
2020-04-24,LG,Greece,281,152,83,2,129,22,24,46,81
2020-04-25,LG,Greece,238,151,60,2,87,14,13,27,58
2020-04-26,LG,Greece,236,155,64,0,81,8,9,17,64
2020-04-27,LG,Greece,311,150,104,6,161,30,27,57,98
2020-04-28,LG,Greece,318,179,99,13,139,21,19,40,86
2020-04-29,LG,Greece,347,180,113,13,167,25,29,54,100
2020-04-30,LG,Greece,308,180,97,5,128,16,15,31,92
2020-05-01,LG,Greece,291,167,84,1,124,19,21,40,83
2020-05-02,LG,Greece,289,171,81,1,118,19,18,37,80
2020-05-03,LG,Greece,268,170,77,1,98,12,9,21,76
2020-05-04,LG,Greece,301,131,126,6,170,22,22,44,120
2020-05-05,LG,Greece,311,169,109,11,142,15,18,33,98
2020-05-06,LG,Greece,353,208,94,6,145,23,28,51,88
2020-05-07,LG,Greece,358,196,116,13,162,23,23,46,103
2020-05-08,LG,Greece,367,190,98,3,177,38,41,79,95
2020-05-09,LG,Greece,295,194,70,0,101,14,17,31,70
2020-05-10,LG,Greece,316,193,85,0,123,22,16,38,85
2020-05-11,LG,Greece,339,166,115,10,173,32,26,58,105
2020-05-12,LG,Greece,359,191,111,21,168,28,29,57,90
2020-05-13,LG,Greece,362,189,117,16,173,28,28,56,101
2020-05-14,LG,Greece,385,217,110,6,168,31,27,58,104
2020-05-15,LG,Greece,339,190,87,7,149,32,30,62,80
2020-05-16,LG,Greece,310,190,81,4,120,20,19,39,77
2020-05-17,LG,Greece,297,187,83,9,110,13,14,27,74
2020-05-18,LG,Greece,370,179,131,15,191,33,27,60,116
2020-05-19,LG,Greece,395,202,144,21,193,22,27,49,123
2020-05-20,LG,Greece,427,221,146,20,206,25,35,60,126
2020-05-21,LG,Greece,430,239,124,15,191,35,32,67,109
2020-05-22,LG,Greece,332,163,109,10,169,33,27,60,99
2020-05-23,LG,Greece,332,195,103,7,137,14,20,34,96
2020-05-24,LG,Greece,302,169,104,9,133,15,14,29,95
2020-05-25,LG,Greece,332,141,128,13,191,33,30,63,115
2020-05-26,LG,Greece,351,184,128,16,167,19,20,39,112
2020-05-27,LG,Greece,412,184,151,25,228,40,37,77,126
2020-05-28,LG,Greece,367,189,118,12,178,30,30,60,106
2020-05-29,LG,Greece,340,167,121,10,173,26,26,52,111
2020-05-30,LG,Greece,333,175,110,8,158,21,27,48,102
2020-05-31,LG,Greece,334,182,118,10,152,21,13,34,108
2020-06-01,LG,Greece,419,154,197,11,265,31,37,68,186
2020-06-02,LG,Greece,404,155,194,21,249,26,29,55,173
2020-06-03,LG,Greece,440,170,194,23,270,40,36,76,171
2020-06-04,LG,Greece,456,204,189,10,252,31,32,63,179
2020-06-05,LG,Greece,474,202,195,11,272,39,38,77,184
2020-06-06,LG,Greece,406,198,155,9,208,24,29,53,146
2020-06-07,LG,Greece,414,196,178,5,218,23,17,40,173
2020-06-08,LG,Greece,420,157,201,4,263,33,29,62,197
2020-06-09,LG,Greece,480,197,209,19,283,35,39,74,190
2020-06-10,LG,Greece,527,225,232,24,302,36,34,70,208
2020-06-11,LG,Greece,530,239,213,19,291,39,39,78,194
2020-06-12,LG,Greece,502,210,203,9,292,43,46,89,194
2020-06-13,LG,Greece,466,219,189,3,247,29,29,58,186
2020-06-14,LG,Greece,488,234,195,6,254,32,27,59,189
2020-06-15,LG,Greece,564,219,213,17,345,63,69,132,196
2020-06-16,LG,Greece,558,224,213,27,334,60,61,121,186
2020-06-17,LG,Greece,590,239,219,19,351,66,66,132,200
2020-06-18,LG,Greece,595,249,219,17,346,62,65,127,202
2020-06-19,LG,Greece,595,232,225,3,363,68,70,138,222
2020-06-20,LG,Greece,552,261,180,5,291,56,55,111,175
2020-06-21,LG,Greece,580,260,205,7,320,57,58,115,198
2020-06-22,LG,Greece,590,224,228,14,366,71,67,138,214
2020-06-23,LG,Greece,539,211,223,25,328,53,52,105,198
2020-06-24,LG,Greece,622,249,245,18,373,66,62,128,227
2020-06-25,LG,Greece,654,278,237,17,376,66,73,139,220
2020-06-26,LG,Greece,662,282,223,3,380,75,82,157,220
2020-06-27,LG,Greece,611,292,188,3,319,69,62,131,185
2020-06-28,LG,Greece,621,276,224,5,345,60,61,121,219
2020-06-29,LG,Greece,621,234,244,19,387,75,68,143,225
2020-06-30,LG,Greece,608,245,245,29,363,58,60,118,216
2020-07-01,LG,Greece,1057,327,297,16,730,206,227,433,281
2020-07-02,LG,Greece,1046,341,281,12,705,216,208,424,269
2020-07-03,LG,Greece,1180,364,290,11,816,261,265,526,279
2020-07-04,LG,Greece,1239,363,264,11,876,302,310,612,253
2020-07-05,LG,Greece,1200,362,297,10,838,270,271,541,287
2020-07-06,LG,Greece,1125,308,318,19,817,253,246,499,299
2020-07-07,LG,Greece,988,283,264,21,705,225,216,441,243
2020-07-08,LG,Greece,1118,325,303,30,793,237,253,490,273
2020-07-09,LG,Greece,1046,295,269,7,751,236,246,482,262
2020-07-10,LG,Greece,1237,364,285,7,873,297,291,588,278
2020-07-11,LG,Greece,1362,387,276,6,975,346,353,699,270
2020-07-12,LG,Greece,1261,345,301,5,916,312,303,615,296
2020-07-13,LG,Greece,1147,297,298,12,850,279,273,552,286
2020-07-14,LG,Greece,1057,277,270,16,780,257,253,510,254
2020-07-15,LG,Greece,1283,374,289,18,909,305,315,620,271
2020-07-16,LG,Greece,1302,367,290,13,935,321,324,645,277
2020-07-17,LG,Greece,1372,386,304,9,986,341,341,682,295
2020-07-18,LG,Greece,1661,453,286,11,1208,459,463,922,275
2020-07-19,LG,Greece,1561,435,300,7,1126,412,414,826,293
2020-07-20,LG,Greece,1349,355,302,9,994,347,345,692,293
2020-07-21,LG,Greece,1260,352,265,12,908,326,317,643,253
2020-07-22,LG,Greece,1394,401,270,11,993,358,365,723,259
2020-07-23,LG,Greece,1344,387,301,16,957,326,330,656,285
2020-07-24,LG,Greece,1511,416,332,9,1095,380,383,763,323
2020-07-25,LG,Greece,1828,487,294,9,1341,522,525,1047,285
2020-07-26,LG,Greece,1634,425,310,5,1209,452,447,899,305
2020-07-27,LG,Greece,1396,329,316,14,1067,377,374,751,302
2020-07-28,LG,Greece,1331,324,294,19,1007,351,362,713,275
2020-07-29,LG,Greece,1419,375,290,20,1044,378,376,754,270
2020-07-30,LG,Greece,1425,394,295,10,1031,369,367,736,285
2020-07-31,LG,Greece,1595,417,323,6,1178,426,429,855,317
2020-08-01,LG,Greece,2099,541,300,2,1558,622,636,1258,298
2020-08-02,LG,Greece,1900,468,303,0,1432,570,559,1129,303
2020-08-03,LG,Greece,1669,435,343,19,1234,447,444,891,324
2020-08-04,LG,Greece,1633,427,313,24,1206,448,445,893,289
2020-08-05,LG,Greece,1717,490,325,31,1227,453,449,902,294
2020-08-06,LG,Greece,1683,504,331,15,1179,422,426,848,316
2020-08-07,LG,Greece,1830,527,368,18,1303,462,473,935,350
2020-08-08,LG,Greece,2187,619,313,11,1568,621,634,1255,302
2020-08-09,LG,Greece,1925,510,340,5,1415,550,525,1075,335
2020-08-10,LG,Greece,1722,471,343,8,1251,450,458,908,335
2020-08-11,LG,Greece,1652,451,304,12,1201,451,446,897,292
2020-08-12,LG,Greece,1723,506,307,13,1217,452,458,910,294
2020-08-13,LG,Greece,1647,474,303,11,1173,431,439,870,292
2020-08-14,LG,Greece,1849,502,354,14,1347,489,504,993,340
2020-08-15,LG,Greece,2238,640,311,7,1598,646,641,1287,304
2020-08-16,LG,Greece,2014,547,346,5,1467,567,554,1121,341
2020-08-17,LG,Greece,1754,498,352,13,1256,456,448,904,339
2020-08-18,LG,Greece,1653,453,299,19,1200,450,451,901,280
2020-08-19,LG,Greece,1723,516,315,19,1207,444,448,892,296
2020-08-20,LG,Greece,1637,500,308,19,1137,416,413,829,289
2020-08-21,LG,Greece,1841,505,350,11,1336,487,499,986,339
2020-08-22,LG,Greece,2238,622,337,8,1616,643,636,1279,329
2020-08-23,LG,Greece,1989,532,334,6,1457,565,558,1123,328
2020-08-24,LG,Greece,1742,483,349,9,1259,451,459,910,340
2020-08-25,LG,Greece,1685,459,316,17,1226,462,448,910,299
2020-08-26,LG,Greece,1702,487,316,6,1215,447,452,899,310
2020-08-27,LG,Greece,1674,522,320,12,1152,416,416,832,308
2020-08-28,LG,Greece,1858,528,354,14,1330,481,495,976,340
2020-08-29,LG,Greece,2142,605,307,6,1537,617,613,1230,301
2020-08-30,LG,Greece,1987,550,340,6,1437,551,546,1097,334
2020-08-31,LG,Greece,1687,497,332,8,1190,434,424,858,324
2020-09-01,LG,Greece,1530,491,277,15,1039,381,381,762,262
2020-09-02,LG,Greece,1545,524,270,13,1021,380,371,751,257
2020-09-03,LG,Greece,1494,516,279,14,978,351,348,699,265
2020-09-04,LG,Greece,1724,578,315,10,1146,412,419,831,305
2020-09-05,LG,Greece,2031,652,285,9,1379,546,548,1094,276
2020-09-06,LG,Greece,1812,569,294,9,1243,477,472,949,285
2020-09-07,LG,Greece,1539,489,289,12,1050,385,376,761,277
2020-09-08,LG,Greece,1456,449,286,11,1007,358,363,721,275
2020-09-09,LG,Greece,1495,523,279,17,972,347,346,693,262
2020-09-10,LG,Greece,1463,520,289,6,943,327,327,654,283
2020-09-11,LG,Greece,1681,559,316,13,1122,398,408,806,303
2020-09-12,LG,Greece,1947,619,280,7,1328,520,528,1048,273
2020-09-13,LG,Greece,1773,562,291,5,1211,464,456,920,286
2020-09-14,LG,Greece,1489,497,290,12,992,355,347,702,278
2020-09-15,LG,Greece,1431,463,271,17,968,349,348,697,254
2020-09-16,LG,Greece,1499,551,256,28,948,343,349,692,228
2020-09-17,LG,Greece,1373,477,253,17,896,320,323,643,236
2020-09-18,LG,Greece,1540,532,245,8,1008,376,387,763,237
2020-09-19,LG,Greece,1914,630,269,9,1284,505,510,1015,260
2020-09-20,LG,Greece,1722,570,264,9,1152,450,438,888,255
2020-09-21,LG,Greece,1387,466,232,19,921,346,343,689,213
2020-09-22,LG,Greece,1230,410,214,22,820,308,298,606,192
2020-09-23,LG,Greece,1348,545,195,21,803,301,307,608,174
2020-09-24,LG,Greece,1286,459,249,20,827,283,295,578,229
2020-09-25,LG,Greece,1614,557,274,14,1057,385,398,783,260
2020-09-26,LG,Greece,1854,621,249,8,1233,490,494,984,241
2020-09-27,LG,Greece,1607,537,255,7,1070,417,398,815,248
2020-09-28,LG,Greece,1241,414,224,9,827,307,296,603,215
2020-09-29,LG,Greece,1226,450,221,15,776,277,278,555,206
2020-09-30,LG,Greece,1364,525,225,23,839,303,311,614,202
2020-10-01,LG,Greece,1271,516,238,14,755,260,257,517,224
2020-10-02,LG,Greece,1455,560,242,11,895,320,333,653,231
2020-10-03,LG,Greece,1724,656,219,8,1068,428,421,849,211
2020-10-04,LG,Greece,1548,568,238,9,980,376,366,742,229
2020-10-05,LG,Greece,1231,452,239,14,779,268,272,540,225
2020-10-06,LG,Greece,1102,446,218,27,656,223,215,438,191
2020-10-07,LG,Greece,1156,516,178,20,640,229,233,462,158
2020-10-08,LG,Greece,1104,467,182,9,637,227,228,455,173
2020-10-09,LG,Greece,1373,528,237,16,845,302,306,608,221
2020-10-10,LG,Greece,1710,650,196,5,1060,428,436,864,191
2020-10-11,LG,Greece,1514,582,208,3,932,368,356,724,205
2020-10-12,LG,Greece,1159,448,217,12,711,250,244,494,205
2020-10-13,LG,Greece,1026,428,184,5,598,210,204,414,179
2020-10-14,LG,Greece,1148,494,179,15,654,240,235,475,164
2020-10-15,LG,Greece,533,464,30,5,69,20,19,39,25
2020-10-16,LG,Greece,1536,515,223,5,1021,391,407,798,218
2020-10-17,LG,Greece,1680,658,186,4,1022,416,420,836,182
2020-10-18,LG,Greece,1359,538,174,0,821,326,321,647,174
2020-10-19,LG,Greece,1039,390,180,11,649,232,237,469,169
2020-10-20,LG,Greece,912,341,187,11,571,196,188,384,176
2020-10-21,LG,Greece,1017,449,170,10,568,188,210,398,160
2020-10-22,LG,Greece,1048,432,221,20,616,195,200,395,201
2020-10-23,LG,Greece,1293,488,229,13,805,283,293,576,216
2020-10-24,LG,Greece,1621,635,172,3,986,408,406,814,169
2020-10-25,LG,Greece,1283,511,195,4,772,295,282,577,191
2020-10-26,LG,Greece,965,398,204,21,567,186,177,363,183
2020-10-27,LG,Greece,808,354,156,11,454,149,149,298,145
2020-10-28,LG,Greece,903,441,159,5,462,150,153,303,154
2020-10-29,LG,Greece,947,423,198,20,524,164,162,326,178
2020-10-30,LG,Greece,1098,438,220,18,660,218,222,440,202
2020-10-31,LG,Greece,1263,535,170,7,728,285,273,558,163
2020-11-01,LG,Greece,1176,498,188,5,678,250,240,490,183
2020-11-02,LG,Greece,871,381,226,27,490,133,131,264,199
2020-11-03,LG,Greece,687,328,161,20,359,99,99,198,141
2020-11-04,LG,Greece,677,354,136,20,323,91,96,187,116
2020-11-05,LG,Greece,774,387,176,20,387,109,102,211,156
2020-11-06,LG,Greece,773,398,157,11,375,108,110,218,146
2020-11-07,LG,Greece,816,444,118,6,372,131,123,254,112
2020-11-08,LG,Greece,826,439,151,7,387,120,116,236,144
2020-11-09,LG,Greece,651,340,150,20,311,80,81,161,130
2020-11-10,LG,Greece,614,335,150,21,279,62,67,129,129
2020-11-11,LG,Greece,646,338,152,23,308,79,77,156,129
2020-11-12,LG,Greece,646,349,160,24,297,71,66,137,136
2020-11-13,LG,Greece,666,364,151,18,302,77,74,151,133
2020-11-14,LG,Greece,574,349,107,8,225,61,57,118,99
2020-11-15,LG,Greece,628,383,112,10,245,66,67,133,102
2020-11-16,LG,Greece,613,317,143,17,296,71,82,153,126
2020-11-17,LG,Greece,490,264,128,27,226,51,47,98,101
2020-11-18,LG,Greece,576,323,138,15,253,58,57,115,123
2020-11-19,LG,Greece,562,303,138,10,259,62,59,121,128
2020-11-20,LG,Greece,630,340,150,9,290,71,69,140,141
2020-11-21,LG,Greece,525,336,108,4,189,40,41,81,104
2020-11-22,LG,Greece,572,360,115,3,212,48,49,97,112
2020-11-23,LG,Greece,506,263,132,13,243,58,53,111,119
2020-11-24,LG,Greece,471,269,119,19,202,41,42,83,100
2020-11-25,LG,Greece,530,337,113,16,193,40,40,80,97
2020-11-26,LG,Greece,461,321,87,9,140,25,28,53,78
2020-11-27,LG,Greece,637,366,138,8,271,63,70,133,130
2020-11-28,LG,Greece,520,327,103,7,193,46,44,90,96
2020-11-29,LG,Greece,554,354,117,6,200,44,39,83,111
2020-11-30,LG,Greece,539,292,133,9,247,59,55,114,124
2020-12-01,LG,Greece,474,269,124,18,205,40,41,81,106
2020-12-02,LG,Greece,580,330,129,20,250,60,61,121,109
2020-12-03,LG,Greece,604,361,131,13,243,55,57,112,118
2020-12-04,LG,Greece,667,375,148,8,292,70,74,144,140
2020-12-05,LG,Greece,583,386,114,13,197,41,42,83,101
2020-12-06,LG,Greece,594,373,125,6,221,47,49,96,119
2020-12-07,LG,Greece,588,324,122,10,264,69,73,142,112
2020-12-08,LG,Greece,509,280,127,20,229,52,50,102,107
2020-12-09,LG,Greece,578,361,112,17,217,54,51,105,95
2020-12-10,LG,Greece,590,372,105,10,218,55,58,113,95
2020-12-11,LG,Greece,696,384,161,15,312,78,73,151,146
2020-12-12,LG,Greece,614,380,112,8,234,60,62,122,104
2020-12-13,LG,Greece,635,405,117,1,230,55,58,113,116
2020-12-14,LG,Greece,630,359,123,6,271,69,79,148,117
2020-12-15,LG,Greece,624,359,136,20,265,67,62,129,116
2020-12-16,LG,Greece,647,374,143,15,273,66,64,130,128
2020-12-17,LG,Greece,777,409,153,20,368,107,108,215,133
2020-12-18,LG,Greece,854,499,176,7,355,93,86,179,169
2020-12-19,LG,Greece,803,520,121,8,283,78,84,162,113
2020-12-20,LG,Greece,819,500,152,5,319,86,81,167,147
2020-12-21,LG,Greece,681,375,155,9,306,74,77,151,146
2020-12-22,LG,Greece,638,385,153,17,253,54,46,100,136
2020-12-23,LG,Greece,767,416,173,13,351,85,93,178,160
2020-12-24,LG,Greece,657,343,150,4,314,82,82,164,146
2020-12-25,LG,Greece,440,327,76,0,113,18,19,37,76
2020-12-26,LG,Greece,597,399,96,1,198,53,49,102,95
2020-12-27,LG,Greece,699,424,129,2,275,73,73,146,127
2020-12-28,LG,Greece,622,339,153,7,283,67,63,130,146
2020-12-29,LG,Greece,550,307,147,6,243,48,48,96,141
2020-12-30,LG,Greece,648,383,142,7,265,62,61,123,135
2020-12-31,LG,Greece,472,277,111,1,195,42,42,84,110
2020-01-01,LH,Hungary,1718,1416,0,0,302,151,151,302,0
2020-01-02,LH,Hungary,2088,1742,2,0,346,170,174,344,2
2020-01-03,LH,Hungary,2151,1773,0,0,378,188,190,378,0
2020-01-04,LH,Hungary,2086,1815,1,0,271,134,136,270,1
2020-01-05,LH,Hungary,2200,1856,4,0,344,168,172,340,4
2020-01-06,LH,Hungary,2057,1702,1,0,355,180,174,354,1
2020-01-07,LH,Hungary,1840,1520,4,0,320,155,161,316,4
2020-01-08,LH,Hungary,1789,1474,5,1,315,154,156,310,4
2020-01-09,LH,Hungary,1800,1477,4,2,323,163,156,319,2
2020-01-10,LH,Hungary,1909,1546,0,0,363,178,185,363,0
2020-01-11,LH,Hungary,1815,1553,0,0,262,134,128,262,0
2020-01-12,LH,Hungary,1960,1628,1,0,332,164,167,331,1
2020-01-13,LH,Hungary,1815,1458,0,0,357,181,176,357,0
2020-01-14,LH,Hungary,1689,1397,0,0,292,145,147,292,0
2020-01-15,LH,Hungary,1739,1425,2,1,314,154,158,312,1
2020-01-16,LH,Hungary,1732,1414,1,0,318,162,155,317,1
2020-01-17,LH,Hungary,1912,1548,0,0,364,182,182,364,0
2020-01-18,LH,Hungary,1761,1523,1,0,238,120,117,237,1
2020-01-19,LH,Hungary,1886,1561,0,0,325,162,163,325,0
2020-01-20,LH,Hungary,1839,1491,2,0,348,174,172,346,2
2020-01-21,LH,Hungary,1687,1389,2,0,298,149,147,296,2
2020-01-22,LH,Hungary,1809,1477,0,0,332,164,168,332,0
2020-01-23,LH,Hungary,1718,1396,8,2,322,159,155,314,6
2020-01-24,LH,Hungary,1906,1543,0,0,363,183,180,363,0
2020-01-25,LH,Hungary,1820,1573,3,0,247,122,122,244,3
2020-01-26,LH,Hungary,1882,1561,0,0,321,156,165,321,0
2020-01-27,LH,Hungary,1813,1469,0,0,344,174,170,344,0
2020-01-28,LH,Hungary,1714,1419,4,1,295,147,144,291,3
2020-01-29,LH,Hungary,1721,1415,1,0,306,150,155,305,1
2020-01-30,LH,Hungary,1681,1368,1,0,313,153,159,312,1
2020-01-31,LH,Hungary,1840,1454,1,0,386,193,192,385,1
2020-02-01,LH,Hungary,1767,1506,1,0,261,133,127,260,1
2020-02-02,LH,Hungary,1867,1525,1,0,342,169,172,341,1
2020-02-03,LH,Hungary,1780,1421,1,0,359,181,177,358,1
2020-02-04,LH,Hungary,1687,1387,2,0,300,145,153,298,2
2020-02-05,LH,Hungary,1703,1384,1,0,319,159,159,318,1
2020-02-06,LH,Hungary,1776,1449,5,0,327,161,161,322,5
2020-02-07,LH,Hungary,1910,1540,1,0,370,185,184,369,1
2020-02-08,LH,Hungary,1808,1539,1,0,269,135,133,268,1
2020-02-09,LH,Hungary,1774,1452,1,0,322,158,163,321,1
2020-02-10,LH,Hungary,1731,1407,1,0,324,165,158,323,1
2020-02-11,LH,Hungary,1640,1325,2,0,315,155,158,313,2
2020-02-12,LH,Hungary,1758,1421,2,1,337,163,172,335,1
2020-02-13,LH,Hungary,1804,1463,6,1,341,171,164,335,5
2020-02-14,LH,Hungary,1971,1594,3,0,377,189,185,374,3
2020-02-15,LH,Hungary,1830,1563,8,2,267,129,130,259,6
2020-02-16,LH,Hungary,1886,1560,1,0,326,162,163,325,1
2020-02-17,LH,Hungary,1841,1481,3,0,360,181,176,357,3
2020-02-18,LH,Hungary,1775,1466,0,0,309,156,153,309,0
2020-02-19,LH,Hungary,1802,1480,4,2,322,158,160,318,2
2020-02-20,LH,Hungary,1813,1483,6,1,330,164,160,324,5
2020-02-21,LH,Hungary,1955,1566,5,0,389,190,194,384,5
2020-02-22,LH,Hungary,1879,1605,2,0,274,136,136,272,2
2020-02-23,LH,Hungary,1873,1540,2,0,333,162,169,331,2
2020-02-24,LH,Hungary,1791,1430,1,0,361,178,182,360,1
2020-02-25,LH,Hungary,1770,1448,7,1,322,158,157,315,6
2020-02-26,LH,Hungary,1850,1518,5,1,332,163,164,327,4
2020-02-27,LH,Hungary,1814,1472,5,1,342,173,164,337,4
2020-02-28,LH,Hungary,1976,1573,0,0,403,202,201,403,0
2020-02-29,LH,Hungary,1869,1592,3,1,277,137,137,274,2
2020-03-01,LH,Hungary,1978,1630,4,1,348,171,173,344,3
2020-03-02,LH,Hungary,1914,1543,2,0,371,188,181,369,2
2020-03-03,LH,Hungary,1820,1511,1,0,309,150,158,308,1
2020-03-04,LH,Hungary,1941,1595,8,1,346,167,171,338,7
2020-03-05,LH,Hungary,1876,1533,2,1,343,174,167,341,1
2020-03-06,LH,Hungary,2045,1659,0,0,386,191,195,386,0
2020-03-07,LH,Hungary,1946,1688,0,0,258,130,128,258,0
2020-03-08,LH,Hungary,1925,1596,1,1,329,162,166,328,0
2020-03-09,LH,Hungary,1889,1558,2,1,331,169,160,329,1
2020-03-10,LH,Hungary,1695,1404,3,1,291,141,147,288,2
2020-03-11,LH,Hungary,1643,1344,4,1,299,147,148,295,3
2020-03-12,LH,Hungary,1639,1340,3,0,299,148,148,296,3
2020-03-13,LH,Hungary,1735,1410,0,0,325,164,161,325,0
2020-03-14,LH,Hungary,1699,1466,1,0,233,118,114,232,1
2020-03-15,LH,Hungary,1671,1397,1,0,274,134,139,273,1
2020-03-16,LH,Hungary,1454,1205,6,0,249,125,118,243,6
2020-03-17,LH,Hungary,1194,1005,0,0,189,93,96,189,0
2020-03-18,LH,Hungary,1181,1004,2,0,177,88,87,175,2
2020-03-19,LH,Hungary,1058,887,2,0,171,82,87,169,2
2020-03-20,LH,Hungary,1069,917,4,1,152,73,75,148,3
2020-03-21,LH,Hungary,829,721,0,0,108,55,53,108,0
2020-03-22,LH,Hungary,735,630,0,0,105,52,53,105,0
2020-03-23,LH,Hungary,635,526,0,0,109,56,53,109,0
2020-03-24,LH,Hungary,535,448,1,1,87,43,43,86,0
2020-03-25,LH,Hungary,432,357,1,0,75,37,37,74,1
2020-03-26,LH,Hungary,398,338,4,1,60,29,27,56,3
2020-03-27,LH,Hungary,384,324,1,1,60,30,29,59,0
2020-03-28,LH,Hungary,333,302,1,1,31,10,20,30,0
2020-03-29,LH,Hungary,323,291,0,0,32,16,16,32,0
2020-03-30,LH,Hungary,343,292,9,6,51,25,17,42,3
2020-03-31,LH,Hungary,346,299,1,1,47,24,22,46,0
2020-04-01,LH,Hungary,302,243,3,3,59,26,30,56,0
2020-04-02,LH,Hungary,338,291,6,5,47,22,19,41,1
2020-04-03,LH,Hungary,357,305,7,7,52,23,22,45,0
2020-04-04,LH,Hungary,290,261,0,0,29,11,18,29,0
2020-04-05,LH,Hungary,276,231,6,6,45,22,17,39,0
2020-04-06,LH,Hungary,255,215,4,4,40,19,17,36,0
2020-04-07,LH,Hungary,259,214,1,1,45,21,23,44,0
2020-04-08,LH,Hungary,296,238,7,5,58,24,27,51,2
2020-04-09,LH,Hungary,337,296,5,5,41,19,17,36,0
2020-04-10,LH,Hungary,329,284,0,0,45,23,22,45,0
2020-04-11,LH,Hungary,266,238,1,0,28,15,12,27,1
2020-04-12,LH,Hungary,209,185,0,0,24,11,13,24,0
2020-04-13,LH,Hungary,233,205,0,0,28,13,15,28,0
2020-04-14,LH,Hungary,237,192,0,0,45,24,21,45,0
2020-04-15,LH,Hungary,307,247,3,3,60,30,27,57,0
2020-04-16,LH,Hungary,310,263,4,0,47,21,22,43,4
2020-04-17,LH,Hungary,291,248,2,2,43,19,22,41,0
2020-04-18,LH,Hungary,234,214,5,4,20,6,9,15,1
2020-04-19,LH,Hungary,215,192,0,0,23,12,11,23,0
2020-04-20,LH,Hungary,300,264,1,1,36,18,17,35,0
2020-04-21,LH,Hungary,309,267,6,2,42,18,18,36,4
2020-04-22,LH,Hungary,319,280,0,0,39,21,18,39,0
2020-04-23,LH,Hungary,336,296,8,2,40,15,17,32,6
2020-04-24,LH,Hungary,331,273,3,0,58,25,30,55,3
2020-04-25,LH,Hungary,297,274,0,0,23,15,8,23,0
2020-04-26,LH,Hungary,273,246,0,0,27,13,14,27,0
2020-04-27,LH,Hungary,311,261,1,0,50,24,25,49,1
2020-04-28,LH,Hungary,325,279,8,1,46,18,20,38,7
2020-04-29,LH,Hungary,355,310,2,0,45,23,20,43,2
2020-04-30,LH,Hungary,323,279,7,1,44,21,16,37,6
2020-05-01,LH,Hungary,366,309,2,2,57,27,28,55,0
2020-05-02,LH,Hungary,279,264,0,0,15,8,7,15,0
2020-05-03,LH,Hungary,287,247,2,2,40,14,24,38,0
2020-05-04,LH,Hungary,371,317,2,1,54,26,26,52,1
2020-05-05,LH,Hungary,336,284,3,3,52,26,23,49,0
2020-05-06,LH,Hungary,381,336,0,0,45,22,23,45,0
2020-05-07,LH,Hungary,371,323,1,1,48,27,20,47,0
2020-05-08,LH,Hungary,379,317,0,0,62,32,30,62,0
2020-05-09,LH,Hungary,323,283,6,2,40,13,21,34,4
2020-05-10,LH,Hungary,316,282,0,0,34,17,17,34,0
2020-05-11,LH,Hungary,341,282,5,5,59,28,26,54,0
2020-05-12,LH,Hungary,330,281,3,2,49,24,22,46,1
2020-05-13,LH,Hungary,364,302,5,2,62,31,26,57,3
2020-05-14,LH,Hungary,394,342,6,1,52,25,21,46,5
2020-05-15,LH,Hungary,391,316,3,0,75,33,39,72,3
2020-05-16,LH,Hungary,352,323,2,1,29,14,13,27,1
2020-05-17,LH,Hungary,333,291,1,1,42,19,22,41,0
2020-05-18,LH,Hungary,368,313,3,1,55,26,26,52,2
2020-05-19,LH,Hungary,337,289,7,2,48,23,18,41,5
2020-05-20,LH,Hungary,381,333,7,2,48,20,21,41,5
2020-05-21,LH,Hungary,371,333,0,0,38,17,21,38,0
2020-05-22,LH,Hungary,383,323,1,1,60,32,27,59,0
2020-05-23,LH,Hungary,349,317,3,2,32,12,17,29,1
2020-05-24,LH,Hungary,339,298,2,2,41,18,21,39,0
2020-05-25,LH,Hungary,322,277,1,1,45,23,21,44,0
2020-05-26,LH,Hungary,367,321,5,4,46,19,22,41,1
2020-05-27,LH,Hungary,408,342,10,7,66,27,29,56,3
2020-05-28,LH,Hungary,439,367,10,3,72,34,28,62,7
2020-05-29,LH,Hungary,403,343,9,7,60,25,26,51,2
2020-05-30,LH,Hungary,369,335,3,3,34,16,15,31,0
2020-05-31,LH,Hungary,354,318,0,0,36,17,19,36,0
2020-06-01,LH,Hungary,350,306,2,2,44,22,20,42,0
2020-06-02,LH,Hungary,393,337,2,0,56,26,28,54,2
2020-06-03,LH,Hungary,455,382,5,5,73,35,33,68,0
2020-06-04,LH,Hungary,443,372,4,3,71,31,36,67,1
2020-06-05,LH,Hungary,464,379,3,0,85,41,41,82,3
2020-06-06,LH,Hungary,400,345,2,2,55,27,26,53,0
2020-06-07,LH,Hungary,426,359,0,0,67,34,33,67,0
2020-06-08,LH,Hungary,403,332,6,6,71,31,34,65,0
2020-06-09,LH,Hungary,430,346,4,1,84,40,40,80,3
2020-06-10,LH,Hungary,483,403,4,3,80,38,38,76,1
2020-06-11,LH,Hungary,485,401,6,4,84,39,39,78,2
2020-06-12,LH,Hungary,535,444,7,4,91,42,42,84,3
2020-06-13,LH,Hungary,482,423,2,1,59,25,32,57,1
2020-06-14,LH,Hungary,477,413,0,0,64,29,35,64,0
2020-06-15,LH,Hungary,581,480,5,3,101,50,46,96,2
2020-06-16,LH,Hungary,551,462,2,0,89,42,45,87,2
2020-06-17,LH,Hungary,627,530,5,0,97,45,47,92,5
2020-06-18,LH,Hungary,559,480,2,0,79,38,39,77,2
2020-06-19,LH,Hungary,661,540,7,5,121,61,53,114,2
2020-06-20,LH,Hungary,579,499,0,0,80,38,42,80,0
2020-06-21,LH,Hungary,603,519,0,0,84,41,43,84,0
2020-06-22,LH,Hungary,599,473,2,1,126,59,65,124,1
2020-06-23,LH,Hungary,572,460,6,0,112,50,56,106,6
2020-06-24,LH,Hungary,667,542,6,2,125,54,65,119,4
2020-06-25,LH,Hungary,645,543,4,2,102,48,50,98,2
2020-06-26,LH,Hungary,804,670,4,1,134,67,63,130,3
2020-06-27,LH,Hungary,690,592,0,0,98,46,52,98,0
2020-06-28,LH,Hungary,706,608,0,0,98,46,52,98,0
2020-06-29,LH,Hungary,676,567,1,0,109,56,52,108,1
2020-06-30,LH,Hungary,664,546,7,4,118,61,50,111,3
2020-07-01,LH,Hungary,984,813,5,4,171,82,84,166,1
2020-07-02,LH,Hungary,943,802,3,1,141,70,68,138,2
2020-07-03,LH,Hungary,1128,948,3,0,180,88,89,177,3
2020-07-04,LH,Hungary,1022,876,2,0,146,71,73,144,2
2020-07-05,LH,Hungary,1017,864,0,0,153,75,78,153,0
2020-07-06,LH,Hungary,1014,840,4,2,174,87,83,170,2
2020-07-07,LH,Hungary,942,794,2,0,148,70,76,146,2
2020-07-08,LH,Hungary,988,803,3,1,185,91,91,182,2
2020-07-09,LH,Hungary,961,793,3,1,168,83,82,165,2
2020-07-10,LH,Hungary,1152,956,4,3,196,96,96,192,1
2020-07-11,LH,Hungary,1169,1024,2,0,145,71,72,143,2
2020-07-12,LH,Hungary,1109,929,3,1,180,85,92,177,2
2020-07-13,LH,Hungary,1014,849,7,2,165,77,81,158,5
2020-07-14,LH,Hungary,1053,862,5,3,191,95,91,186,2
2020-07-15,LH,Hungary,1169,973,13,4,196,91,92,183,9
2020-07-16,LH,Hungary,1212,1041,4,1,171,81,86,167,3
2020-07-17,LH,Hungary,1350,1150,4,2,200,99,97,196,2
2020-07-18,LH,Hungary,1345,1198,0,0,147,73,74,147,0
2020-07-19,LH,Hungary,1301,1093,0,0,208,104,104,208,0
2020-07-20,LH,Hungary,1220,1037,3,1,183,94,86,180,2
2020-07-21,LH,Hungary,1090,917,3,0,173,85,85,170,3
2020-07-22,LH,Hungary,1119,971,3,2,148,73,72,145,1
2020-07-23,LH,Hungary,1192,1022,3,1,170,83,84,167,2
2020-07-24,LH,Hungary,1315,1153,2,1,162,79,81,160,1
2020-07-25,LH,Hungary,1308,1166,0,0,142,71,71,142,0
2020-07-26,LH,Hungary,1326,1150,1,0,176,84,91,175,1
2020-07-27,LH,Hungary,1163,1017,0,0,146,72,74,146,0
2020-07-28,LH,Hungary,1081,912,1,1,169,85,83,168,0
2020-07-29,LH,Hungary,1115,972,1,1,143,72,70,142,0
2020-07-30,LH,Hungary,1200,1029,7,5,171,82,82,164,2
2020-07-31,LH,Hungary,1377,1187,4,3,190,95,91,186,1
2020-08-01,LH,Hungary,1516,1349,0,0,167,83,84,167,0
2020-08-02,LH,Hungary,1518,1323,1,1,195,96,98,194,0
2020-08-03,LH,Hungary,1376,1199,4,2,177,87,86,173,2
2020-08-04,LH,Hungary,1277,1111,2,2,166,85,79,164,0
2020-08-05,LH,Hungary,1333,1145,8,2,188,90,90,180,6
2020-08-06,LH,Hungary,1346,1169,7,4,177,86,84,170,3
2020-08-07,LH,Hungary,1560,1369,2,2,191,92,97,189,0
2020-08-08,LH,Hungary,1622,1455,1,0,167,81,85,166,1
2020-08-09,LH,Hungary,1544,1354,1,0,190,97,92,189,1
2020-08-10,LH,Hungary,1407,1215,3,2,192,95,94,189,1
2020-08-11,LH,Hungary,1248,1087,4,0,161,78,79,157,4
2020-08-12,LH,Hungary,1349,1174,4,3,175,87,84,171,1
2020-08-13,LH,Hungary,1357,1179,6,3,178,85,87,172,3
2020-08-14,LH,Hungary,1588,1379,4,4,209,102,103,205,0
2020-08-15,LH,Hungary,1638,1464,3,1,174,86,85,171,2
2020-08-16,LH,Hungary,1535,1344,0,0,191,95,96,191,0
2020-08-17,LH,Hungary,1335,1140,2,0,195,98,95,193,2
2020-08-18,LH,Hungary,1278,1090,1,0,188,90,97,187,1
2020-08-19,LH,Hungary,1323,1141,0,0,182,93,89,182,0
2020-08-20,LH,Hungary,1298,1129,0,0,169,84,85,169,0
2020-08-21,LH,Hungary,1501,1313,0,0,188,94,94,188,0
2020-08-22,LH,Hungary,1640,1472,1,0,168,83,84,167,1
2020-08-23,LH,Hungary,1511,1316,0,0,195,98,97,195,0
2020-08-24,LH,Hungary,1361,1179,2,1,182,89,91,180,1
2020-08-25,LH,Hungary,1275,1081,5,1,194,95,94,189,4
2020-08-26,LH,Hungary,1284,1098,4,1,186,91,91,182,3
2020-08-27,LH,Hungary,1310,1124,4,0,186,90,92,182,4
2020-08-28,LH,Hungary,1533,1313,1,0,220,110,109,219,1
2020-08-29,LH,Hungary,1595,1418,1,1,177,88,88,176,0
2020-08-30,LH,Hungary,1581,1389,2,1,192,95,95,190,1
2020-08-31,LH,Hungary,1472,1268,5,1,204,102,97,199,4
2020-09-01,LH,Hungary,1276,1119,6,1,157,77,74,151,5
2020-09-02,LH,Hungary,1306,1151,2,1,155,76,77,153,1
2020-09-03,LH,Hungary,1263,1134,3,0,129,63,63,126,3
2020-09-04,LH,Hungary,1491,1304,3,3,187,93,91,184,0
2020-09-05,LH,Hungary,1558,1426,0,0,132,65,67,132,0
2020-09-06,LH,Hungary,1483,1317,0,0,166,81,85,166,0
2020-09-07,LH,Hungary,1289,1160,0,0,129,67,62,129,0
2020-09-08,LH,Hungary,1133,1042,1,1,91,41,49,90,0
2020-09-09,LH,Hungary,1180,1074,2,1,106,52,52,104,1
2020-09-10,LH,Hungary,1171,1068,6,4,103,50,47,97,2
2020-09-11,LH,Hungary,1433,1289,2,0,144,72,70,142,2
2020-09-12,LH,Hungary,1485,1405,4,0,80,36,40,76,4
2020-09-13,LH,Hungary,1385,1281,2,1,104,48,54,102,1
2020-09-14,LH,Hungary,1215,1103,1,1,112,57,54,111,0
2020-09-15,LH,Hungary,1093,1005,3,0,88,47,38,85,3
2020-09-16,LH,Hungary,1218,1107,8,2,111,51,52,103,6
2020-09-17,LH,Hungary,1215,1105,2,1,110,51,57,108,1
2020-09-18,LH,Hungary,1380,1273,2,0,107,55,50,105,2
2020-09-19,LH,Hungary,1439,1356,0,0,83,42,41,83,0
2020-09-20,LH,Hungary,1362,1272,4,0,90,40,46,86,4
2020-09-21,LH,Hungary,1209,1108,2,1,101,50,49,99,1
2020-09-22,LH,Hungary,1072,985,5,2,87,41,41,82,3
2020-09-23,LH,Hungary,1136,1041,4,1,95,42,49,91,3
2020-09-24,LH,Hungary,1148,1023,4,1,125,59,62,121,3
2020-09-25,LH,Hungary,1336,1222,1,0,114,63,50,113,1
2020-09-26,LH,Hungary,1403,1341,1,0,62,30,31,61,1
2020-09-27,LH,Hungary,1338,1235,0,0,103,45,58,103,0
2020-09-28,LH,Hungary,1146,1044,2,0,102,54,46,100,2
2020-09-29,LH,Hungary,1000,918,1,0,82,41,40,81,1
2020-09-30,LH,Hungary,1102,1022,2,0,80,37,41,78,2
2020-10-01,LH,Hungary,1056,978,0,0,78,40,38,78,0
2020-10-02,LH,Hungary,1282,1170,4,1,112,56,52,108,3
2020-10-03,LH,Hungary,1430,1372,1,0,58,28,29,57,1
2020-10-04,LH,Hungary,1298,1216,4,1,82,36,42,78,3
2020-10-05,LH,Hungary,1125,1033,6,1,92,42,44,86,5
2020-10-06,LH,Hungary,905,843,4,2,62,30,28,58,2
2020-10-07,LH,Hungary,1084,995,3,1,89,44,42,86,2
2020-10-08,LH,Hungary,1058,969,5,2,89,39,45,84,3
2020-10-09,LH,Hungary,1283,1169,4,1,114,59,51,110,3
2020-10-10,LH,Hungary,1394,1311,1,1,83,41,41,82,0
2020-10-11,LH,Hungary,1226,1148,0,0,78,33,45,78,0
2020-10-12,LH,Hungary,1076,984,1,0,92,45,46,91,1
2020-10-13,LH,Hungary,894,811,3,1,83,43,37,80,2
2020-10-14,LH,Hungary,1005,927,2,2,78,37,39,76,0
2020-10-15,LH,Hungary,917,831,6,0,86,42,38,80,6
2020-10-16,LH,Hungary,1243,1144,0,0,99,50,49,99,0
2020-10-17,LH,Hungary,1304,1235,0,0,69,35,34,69,0
2020-10-18,LH,Hungary,1211,1130,2,1,81,36,43,79,1
2020-10-19,LH,Hungary,997,903,6,2,94,45,43,88,4
2020-10-20,LH,Hungary,865,779,2,0,86,42,42,84,2
2020-10-21,LH,Hungary,972,864,6,4,108,47,55,102,2
2020-10-22,LH,Hungary,993,888,3,0,105,54,48,102,3
2020-10-23,LH,Hungary,1165,1076,1,1,89,45,43,88,0
2020-10-24,LH,Hungary,1276,1216,2,1,60,27,31,58,1
2020-10-25,LH,Hungary,1175,1083,4,3,92,42,46,88,1
2020-10-26,LH,Hungary,984,865,1,0,119,59,59,118,1
2020-10-27,LH,Hungary,775,696,4,1,79,36,39,75,3
2020-10-28,LH,Hungary,928,822,4,1,106,52,50,102,3
2020-10-29,LH,Hungary,886,801,1,0,85,44,40,84,1
2020-10-30,LH,Hungary,1022,911,3,2,111,57,51,108,1
2020-10-31,LH,Hungary,1113,1054,0,0,59,29,30,59,0
2020-11-01,LH,Hungary,1065,993,0,0,72,32,40,72,0
2020-11-02,LH,Hungary,817,715,4,0,102,51,47,98,4
2020-11-03,LH,Hungary,662,602,0,0,60,31,29,60,0
2020-11-04,LH,Hungary,802,690,2,0,112,51,59,110,2
2020-11-05,LH,Hungary,741,650,3,2,91,46,42,88,1
2020-11-06,LH,Hungary,910,795,1,0,115,58,56,114,1
2020-11-07,LH,Hungary,841,777,2,0,64,31,31,62,2
2020-11-08,LH,Hungary,887,811,3,0,76,34,39,73,3
2020-11-09,LH,Hungary,735,639,1,0,96,47,48,95,1
2020-11-10,LH,Hungary,615,549,0,0,66,33,33,66,0
2020-11-11,LH,Hungary,713,623,2,1,90,46,42,88,1
2020-11-12,LH,Hungary,673,602,2,2,71,34,35,69,0
2020-11-13,LH,Hungary,792,681,7,3,111,53,51,104,4
2020-11-14,LH,Hungary,725,685,0,0,40,21,19,40,0
2020-11-15,LH,Hungary,781,712,0,0,69,32,37,69,0
2020-11-16,LH,Hungary,687,596,1,1,91,46,44,90,0
2020-11-17,LH,Hungary,538,472,1,1,66,34,31,65,0
2020-11-18,LH,Hungary,669,588,5,2,81,37,39,76,3
2020-11-19,LH,Hungary,640,559,0,0,81,40,41,81,0
2020-11-20,LH,Hungary,720,637,7,1,83,41,35,76,6
2020-11-21,LH,Hungary,604,570,2,1,34,16,16,32,1
2020-11-22,LH,Hungary,687,628,0,0,59,24,35,59,0
2020-11-23,LH,Hungary,619,544,1,0,75,39,35,74,1
2020-11-24,LH,Hungary,503,444,1,0,59,27,31,58,1
2020-11-25,LH,Hungary,605,537,3,1,68,34,31,65,2
2020-11-26,LH,Hungary,561,498,2,1,63,29,32,61,1
2020-11-27,LH,Hungary,754,674,0,0,80,43,37,80,0
2020-11-28,LH,Hungary,629,599,1,0,30,14,15,29,1
2020-11-29,LH,Hungary,684,638,0,0,46,20,26,46,0
2020-11-30,LH,Hungary,600,525,3,0,75,38,34,72,3
2020-12-01,LH,Hungary,491,441,3,0,50,23,24,47,3
2020-12-02,LH,Hungary,647,560,1,0,87,44,42,86,1
2020-12-03,LH,Hungary,625,538,4,0,87,41,42,83,4
2020-12-04,LH,Hungary,776,695,3,0,81,41,37,78,3
2020-12-05,LH,Hungary,718,681,0,0,37,18,19,37,0
2020-12-06,LH,Hungary,761,696,2,0,65,27,36,63,2
2020-12-07,LH,Hungary,634,557,2,0,77,39,36,75,2
2020-12-08,LH,Hungary,562,488,7,0,74,30,37,67,7
2020-12-09,LH,Hungary,689,606,3,0,83,43,37,80,3
2020-12-10,LH,Hungary,651,579,1,0,72,38,33,71,1
2020-12-11,LH,Hungary,858,776,1,1,82,41,40,81,0
2020-12-12,LH,Hungary,765,707,4,1,58,28,26,54,3
2020-12-13,LH,Hungary,783,718,1,0,65,28,36,64,1
2020-12-14,LH,Hungary,742,651,10,1,91,42,39,81,9
2020-12-15,LH,Hungary,677,600,3,0,77,37,37,74,3
2020-12-16,LH,Hungary,795,704,2,0,91,46,43,89,2
2020-12-17,LH,Hungary,929,798,7,0,131,62,62,124,7
2020-12-18,LH,Hungary,1141,1018,3,0,123,60,60,120,3
2020-12-19,LH,Hungary,1091,1009,1,0,82,40,41,81,1
2020-12-20,LH,Hungary,1003,923,1,1,80,39,40,79,0
2020-12-21,LH,Hungary,900,784,5,1,116,58,53,111,4
2020-12-22,LH,Hungary,703,627,0,0,76,36,40,76,0
2020-12-23,LH,Hungary,862,769,1,0,93,45,47,92,1
2020-12-24,LH,Hungary,641,601,0,0,40,21,19,40,0
2020-12-25,LH,Hungary,556,528,0,0,28,13,15,28,0
2020-12-26,LH,Hungary,695,656,0,0,39,20,19,39,0
2020-12-27,LH,Hungary,775,716,0,0,59,27,32,59,0
2020-12-28,LH,Hungary,700,628,0,0,72,39,33,72,0
2020-12-29,LH,Hungary,549,498,1,1,51,26,24,50,0
2020-12-30,LH,Hungary,692,632,1,1,60,30,29,59,0
2020-12-31,LH,Hungary,498,464,0,0,34,18,16,34,0
2020-01-01,EI,Ireland,1113,515,11,4,598,294,293,587,7
2020-01-02,EI,Ireland,1412,639,15,3,773,376,382,758,12
2020-01-03,EI,Ireland,1509,716,24,8,793,384,385,769,16
2020-01-04,EI,Ireland,1462,800,15,7,662,322,325,647,8
2020-01-05,EI,Ireland,1636,871,14,6,765,376,375,751,8
2020-01-06,EI,Ireland,1338,588,24,10,750,365,361,726,14
2020-01-07,EI,Ireland,1333,698,14,4,635,308,313,621,10
2020-01-08,EI,Ireland,1214,625,23,12,589,286,280,566,11
2020-01-09,EI,Ireland,1298,621,21,10,677,328,328,656,11
2020-01-10,EI,Ireland,1338,611,19,7,727,350,358,708,12
2020-01-11,EI,Ireland,1180,609,16,3,571,277,278,555,13
2020-01-12,EI,Ireland,1309,607,18,9,702,341,343,684,9
2020-01-13,EI,Ireland,1111,464,10,1,647,321,316,637,9
2020-01-14,EI,Ireland,1147,606,25,14,541,256,260,516,11
2020-01-15,EI,Ireland,1133,589,21,9,544,262,261,523,12
2020-01-16,EI,Ireland,1270,629,23,11,641,308,310,618,12
2020-01-17,EI,Ireland,1290,546,21,11,744,359,364,723,10
2020-01-18,EI,Ireland,1109,554,14,3,555,267,274,541,11
2020-01-19,EI,Ireland,1320,609,22,12,711,343,346,689,10
2020-01-20,EI,Ireland,1322,633,16,3,689,343,330,673,13
2020-01-21,EI,Ireland,991,458,18,10,533,255,260,515,8
2020-01-22,EI,Ireland,1026,502,18,11,524,257,249,506,7
2020-01-23,EI,Ireland,1143,511,15,4,632,306,311,617,11
2020-01-24,EI,Ireland,1514,747,34,18,767,367,366,733,16
2020-01-25,EI,Ireland,1283,718,24,13,565,272,269,541,11
2020-01-26,EI,Ireland,1268,582,20,10,686,333,333,666,10
2020-01-27,EI,Ireland,1192,482,24,12,710,342,344,686,12
2020-01-28,EI,Ireland,1048,503,27,12,545,255,263,518,15
2020-01-29,EI,Ireland,1187,607,27,14,580,280,273,553,13
2020-01-30,EI,Ireland,1240,557,27,17,683,326,330,656,10
2020-01-31,EI,Ireland,1455,678,29,19,777,371,377,748,10
2020-02-01,EI,Ireland,1224,640,20,12,584,283,281,564,8
2020-02-02,EI,Ireland,1266,549,19,8,717,350,348,698,11
2020-02-03,EI,Ireland,1230,489,30,13,741,359,352,711,17
2020-02-04,EI,Ireland,1227,646,23,11,581,276,282,558,12
2020-02-05,EI,Ireland,1165,574,27,12,591,289,275,564,15
2020-02-06,EI,Ireland,1434,733,32,19,701,333,336,669,13
2020-02-07,EI,Ireland,1318,546,16,4,772,373,383,756,12
2020-02-08,EI,Ireland,1031,454,15,4,577,282,280,562,11
2020-02-09,EI,Ireland,934,344,8,0,590,290,292,582,8
2020-02-10,EI,Ireland,1186,444,17,8,742,366,359,725,9
2020-02-11,EI,Ireland,1091,498,20,13,593,284,289,573,7
2020-02-12,EI,Ireland,1130,506,35,21,624,298,291,589,14
2020-02-13,EI,Ireland,1387,667,31,17,720,345,344,689,14
2020-02-14,EI,Ireland,1404,625,23,13,779,377,379,756,10
2020-02-15,EI,Ireland,1090,518,11,1,572,282,279,561,10
2020-02-16,EI,Ireland,1217,527,9,3,690,339,342,681,6
2020-02-17,EI,Ireland,1313,555,19,10,758,372,367,739,9
2020-02-18,EI,Ireland,1107,491,27,16,616,296,293,589,11
2020-02-19,EI,Ireland,1203,579,21,10,624,301,302,603,11
2020-02-20,EI,Ireland,1230,516,22,11,714,344,348,692,11
2020-02-21,EI,Ireland,1544,769,15,3,775,381,379,760,12
2020-02-22,EI,Ireland,1126,538,13,7,588,289,286,575,6
2020-02-23,EI,Ireland,1295,571,19,7,724,350,355,705,12
2020-02-24,EI,Ireland,1349,594,21,7,755,366,368,734,14
2020-02-25,EI,Ireland,1193,568,23,7,625,296,306,602,16
2020-02-26,EI,Ireland,1184,545,28,9,639,311,300,611,19
2020-02-27,EI,Ireland,1295,583,20,5,712,342,350,692,15
2020-02-28,EI,Ireland,1439,648,15,3,791,389,387,776,12
2020-02-29,EI,Ireland,998,416,6,0,582,285,291,576,6
2020-03-01,EI,Ireland,1346,599,16,7,747,364,367,731,9
2020-03-02,EI,Ireland,1378,616,19,7,762,373,370,743,12
2020-03-03,EI,Ireland,1270,625,24,11,645,311,310,621,13
2020-03-04,EI,Ireland,1295,647,32,15,648,308,308,616,17
2020-03-05,EI,Ireland,1376,668,31,12,708,340,337,677,19
2020-03-06,EI,Ireland,1379,617,28,11,762,361,373,734,17
2020-03-07,EI,Ireland,1356,748,12,1,608,298,298,596,11
2020-03-08,EI,Ireland,1294,573,19,8,721,354,348,702,11
2020-03-09,EI,Ireland,1279,535,17,1,744,367,360,727,16
2020-03-10,EI,Ireland,1218,596,25,7,622,299,298,597,18
2020-03-11,EI,Ireland,1179,551,30,11,628,298,300,598,19
2020-03-12,EI,Ireland,1277,571,17,8,706,348,341,689,9
2020-03-13,EI,Ireland,1475,662,23,9,813,391,399,790,14
2020-03-14,EI,Ireland,1241,650,13,3,591,288,290,578,10
2020-03-15,EI,Ireland,1311,613,19,10,698,339,340,679,9
2020-03-16,EI,Ireland,1328,612,22,9,716,350,344,694,13
2020-03-17,EI,Ireland,1040,517,13,4,523,254,256,510,9
2020-03-18,EI,Ireland,978,438,25,12,540,259,256,515,13
2020-03-19,EI,Ireland,1007,453,19,6,554,262,273,535,13
2020-03-20,EI,Ireland,971,416,15,4,555,266,274,540,11
2020-03-21,EI,Ireland,694,346,18,9,348,163,167,330,9
2020-03-22,EI,Ireland,673,272,16,8,401,190,195,385,8
2020-03-23,EI,Ireland,695,308,24,11,387,183,180,363,13
2020-03-24,EI,Ireland,535,231,31,12,304,136,137,273,19
2020-03-25,EI,Ireland,467,249,19,9,218,100,99,199,10
2020-03-26,EI,Ireland,492,233,21,11,259,119,119,238,10
2020-03-27,EI,Ireland,446,202,19,8,244,112,113,225,11
2020-03-28,EI,Ireland,353,193,11,3,160,75,74,149,8
2020-03-29,EI,Ireland,308,130,9,0,178,83,86,169,9
2020-03-30,EI,Ireland,245,94,21,2,151,65,65,130,19
2020-03-31,EI,Ireland,207,100,11,2,107,48,48,96,9
2020-04-01,EI,Ireland,206,116,11,3,90,39,40,79,8
2020-04-02,EI,Ireland,236,140,10,0,96,43,43,86,10
2020-04-03,EI,Ireland,275,155,12,1,120,54,54,108,11
2020-04-04,EI,Ireland,213,120,5,0,93,46,42,88,5
2020-04-05,EI,Ireland,246,151,6,0,95,44,45,89,6
2020-04-06,EI,Ireland,223,116,15,1,107,46,46,92,14
2020-04-07,EI,Ireland,198,122,8,2,76,32,36,68,6
2020-04-08,EI,Ireland,227,162,8,0,65,27,30,57,8
2020-04-09,EI,Ireland,285,196,12,0,89,40,37,77,12
2020-04-10,EI,Ireland,254,165,14,1,89,39,36,75,13
2020-04-11,EI,Ireland,196,124,9,2,72,32,31,63,7
2020-04-12,EI,Ireland,199,140,7,1,59,24,28,52,6
2020-04-13,EI,Ireland,193,115,18,6,78,28,32,60,12
2020-04-14,EI,Ireland,170,105,11,4,65,29,25,54,7
2020-04-15,EI,Ireland,193,124,12,5,69,27,30,57,7
2020-04-16,EI,Ireland,266,176,16,5,90,41,33,74,11
2020-04-17,EI,Ireland,241,158,11,1,83,37,35,72,10
2020-04-18,EI,Ireland,200,136,5,1,64,30,29,59,4
2020-04-19,EI,Ireland,216,145,4,0,71,32,35,67,4
2020-04-20,EI,Ireland,237,137,12,3,100,43,45,88,9
2020-04-21,EI,Ireland,231,152,15,6,79,32,32,64,9
2020-04-22,EI,Ireland,236,155,6,0,81,39,36,75,6
2020-04-23,EI,Ireland,250,175,12,0,75,31,32,63,12
2020-04-24,EI,Ireland,261,164,13,5,97,42,42,84,8
2020-04-25,EI,Ireland,217,150,6,0,67,32,29,61,6
2020-04-26,EI,Ireland,220,151,6,0,69,30,33,63,6
2020-04-27,EI,Ireland,264,167,14,5,97,42,41,83,9
2020-04-28,EI,Ireland,182,118,13,2,64,26,25,51,11
2020-04-29,EI,Ireland,193,117,9,1,76,33,34,67,8
2020-04-30,EI,Ireland,207,139,7,2,68,31,30,61,5
2020-05-01,EI,Ireland,244,143,15,3,101,41,45,86,12
2020-05-02,EI,Ireland,236,164,8,2,72,33,31,64,6
2020-05-03,EI,Ireland,247,171,8,2,76,33,35,68,6
2020-05-04,EI,Ireland,242,161,8,2,81,40,33,73,6
2020-05-05,EI,Ireland,217,146,11,3,71,29,31,60,8
2020-05-06,EI,Ireland,212,131,10,1,81,35,36,71,9
2020-05-07,EI,Ireland,233,142,13,1,91,40,38,78,12
2020-05-08,EI,Ireland,258,162,10,2,96,42,44,86,8
2020-05-09,EI,Ireland,246,174,8,2,72,32,32,64,6
2020-05-10,EI,Ireland,238,159,9,2,79,35,35,70,7
2020-05-11,EI,Ireland,231,134,11,2,97,44,42,86,9
2020-05-12,EI,Ireland,224,148,11,3,76,33,32,65,8
2020-05-13,EI,Ireland,277,184,9,2,93,40,44,84,7
2020-05-14,EI,Ireland,295,208,9,2,87,40,38,78,7
2020-05-15,EI,Ireland,299,196,12,5,103,46,45,91,7
2020-05-16,EI,Ireland,267,184,6,0,83,39,38,77,6
2020-05-17,EI,Ireland,283,202,8,2,81,36,37,73,6
2020-05-18,EI,Ireland,272,174,10,1,98,44,44,88,9
2020-05-19,EI,Ireland,278,181,14,5,97,41,42,83,9
2020-05-20,EI,Ireland,271,183,12,3,88,37,39,76,9
2020-05-21,EI,Ireland,226,150,11,3,76,33,32,65,8
2020-05-22,EI,Ireland,242,127,6,0,115,51,58,109,6
2020-05-23,EI,Ireland,232,147,9,3,85,39,37,76,6
2020-05-24,EI,Ireland,301,206,7,1,95,44,44,88,6
2020-05-25,EI,Ireland,276,181,16,3,95,40,39,79,13
2020-05-26,EI,Ireland,274,177,10,1,97,43,44,87,9
2020-05-27,EI,Ireland,300,202,10,2,98,45,43,88,8
2020-05-28,EI,Ireland,313,224,14,4,89,39,36,75,10
2020-05-29,EI,Ireland,310,198,12,4,112,46,54,100,8
2020-05-30,EI,Ireland,257,173,6,0,84,40,38,78,6
2020-05-31,EI,Ireland,287,199,8,2,88,42,38,80,6
2020-06-01,EI,Ireland,275,175,12,3,100,43,45,88,9
2020-06-02,EI,Ireland,281,172,19,7,109,45,45,90,12
2020-06-03,EI,Ireland,304,209,11,1,95,42,42,84,10
2020-06-04,EI,Ireland,340,241,15,2,99,43,41,84,13
2020-06-05,EI,Ireland,318,200,15,4,118,49,54,103,11
2020-06-06,EI,Ireland,301,196,13,5,105,45,47,92,8
2020-06-07,EI,Ireland,324,225,9,3,99,45,45,90,6
2020-06-08,EI,Ireland,282,163,18,7,119,53,48,101,11
2020-06-09,EI,Ireland,281,192,21,10,89,32,36,68,11
2020-06-10,EI,Ireland,308,209,25,11,99,37,37,74,14
2020-06-11,EI,Ireland,345,239,24,14,106,41,41,82,10
2020-06-12,EI,Ireland,349,220,22,10,129,53,54,107,12
2020-06-13,EI,Ireland,308,211,14,6,97,43,40,83,8
2020-06-14,EI,Ireland,323,228,15,6,95,40,40,80,9
2020-06-15,EI,Ireland,354,218,25,14,136,57,54,111,11
2020-06-16,EI,Ireland,340,199,30,18,141,53,58,111,12
2020-06-17,EI,Ireland,328,204,41,25,124,42,41,83,16
2020-06-18,EI,Ireland,371,238,32,21,133,48,53,101,11
2020-06-19,EI,Ireland,329,187,26,13,142,58,58,116,13
2020-06-20,EI,Ireland,284,174,18,11,110,49,43,92,7
2020-06-21,EI,Ireland,288,167,24,15,121,47,50,97,9
2020-06-22,EI,Ireland,315,197,13,2,118,54,51,105,11
2020-06-23,EI,Ireland,336,222,24,7,114,44,46,90,17
2020-06-24,EI,Ireland,367,238,30,16,129,49,50,99,14
2020-06-25,EI,Ireland,394,262,33,19,132,48,51,99,14
2020-06-26,EI,Ireland,360,206,27,14,154,63,64,127,13
2020-06-27,EI,Ireland,215,95,16,8,120,50,54,104,8
2020-06-28,EI,Ireland,269,154,16,8,115,50,49,99,8
2020-06-29,EI,Ireland,331,199,27,12,132,55,50,105,15
2020-06-30,EI,Ireland,303,185,25,12,118,45,48,93,13
2020-07-01,EI,Ireland,522,244,38,24,278,115,125,240,14
2020-07-02,EI,Ireland,519,267,28,15,252,114,110,224,13
2020-07-03,EI,Ireland,493,208,15,5,285,134,136,270,10
2020-07-04,EI,Ireland,495,214,21,10,281,131,129,260,11
2020-07-05,EI,Ireland,455,176,15,7,279,133,131,264,8
2020-07-06,EI,Ireland,453,212,27,11,241,108,106,214,16
2020-07-07,EI,Ireland,455,233,22,11,222,99,101,200,11
2020-07-08,EI,Ireland,477,244,21,11,233,107,105,212,10
2020-07-09,EI,Ireland,522,276,30,19,246,106,110,216,11
2020-07-10,EI,Ireland,565,259,19,9,306,142,145,287,10
2020-07-11,EI,Ireland,515,243,10,2,272,131,131,262,8
2020-07-12,EI,Ireland,559,267,11,3,292,138,143,281,8
2020-07-13,EI,Ireland,521,262,24,11,259,123,112,235,13
2020-07-14,EI,Ireland,514,260,26,15,254,109,119,228,11
2020-07-15,EI,Ireland,533,273,30,19,260,116,114,230,11
2020-07-16,EI,Ireland,573,302,26,15,271,123,122,245,11
2020-07-17,EI,Ireland,591,280,22,11,311,144,145,289,11
2020-07-18,EI,Ireland,595,294,16,8,301,140,145,285,8
2020-07-19,EI,Ireland,579,277,15,6,302,144,143,287,9
2020-07-20,EI,Ireland,581,296,22,8,285,132,131,263,14
2020-07-21,EI,Ireland,525,274,19,6,251,115,117,232,13
2020-07-22,EI,Ireland,597,299,21,11,298,140,137,277,10
2020-07-23,EI,Ireland,575,302,21,11,273,127,125,252,10
2020-07-24,EI,Ireland,610,286,19,5,324,148,157,305,14
2020-07-25,EI,Ireland,519,210,15,7,309,150,144,294,8
2020-07-26,EI,Ireland,545,225,13,5,320,153,154,307,8
2020-07-27,EI,Ireland,531,258,21,7,273,129,123,252,14
2020-07-28,EI,Ireland,485,230,23,8,255,114,118,232,15
2020-07-29,EI,Ireland,562,282,21,11,280,134,125,259,10
2020-07-30,EI,Ireland,583,312,24,14,271,118,129,247,10
2020-07-31,EI,Ireland,581,241,22,9,340,159,159,318,13
2020-08-01,EI,Ireland,578,225,15,7,353,171,167,338,8
2020-08-02,EI,Ireland,650,275,10,2,375,182,183,365,8
2020-08-03,EI,Ireland,603,297,15,5,306,144,147,291,10
2020-08-04,EI,Ireland,597,293,20,11,304,143,141,284,9
2020-08-05,EI,Ireland,584,256,27,15,328,151,150,301,12
2020-08-06,EI,Ireland,648,335,22,9,313,144,147,291,13
2020-08-07,EI,Ireland,641,247,23,13,394,183,188,371,10
2020-08-08,EI,Ireland,688,332,21,4,356,170,165,335,17
2020-08-09,EI,Ireland,719,347,17,5,372,178,177,355,12
2020-08-10,EI,Ireland,698,345,20,5,353,165,168,333,15
2020-08-11,EI,Ireland,607,284,16,6,323,154,153,307,10
2020-08-12,EI,Ireland,691,342,18,5,349,164,167,331,13
2020-08-13,EI,Ireland,647,329,21,11,318,148,149,297,10
2020-08-14,EI,Ireland,704,334,24,9,370,174,172,346,15
2020-08-15,EI,Ireland,679,334,11,3,345,166,168,334,8
2020-08-16,EI,Ireland,634,253,14,5,381,186,181,367,9
2020-08-17,EI,Ireland,597,286,19,6,311,148,144,292,13
2020-08-18,EI,Ireland,518,214,18,7,304,143,143,286,11
2020-08-19,EI,Ireland,548,227,18,5,321,150,153,303,13
2020-08-20,EI,Ireland,488,183,16,7,305,145,144,289,9
2020-08-21,EI,Ireland,570,214,17,5,356,171,168,339,12
2020-08-22,EI,Ireland,528,197,16,7,331,156,159,315,9
2020-08-23,EI,Ireland,632,263,12,4,369,180,177,357,8
2020-08-24,EI,Ireland,543,242,19,8,301,140,142,282,11
2020-08-25,EI,Ireland,492,182,17,4,310,148,145,293,13
2020-08-26,EI,Ireland,537,220,20,7,317,148,149,297,13
2020-08-27,EI,Ireland,542,233,20,10,309,142,147,289,10
2020-08-28,EI,Ireland,636,270,21,7,366,174,171,345,14
2020-08-29,EI,Ireland,649,309,19,11,340,157,164,321,8
2020-08-30,EI,Ireland,686,308,16,8,378,183,179,362,8
2020-08-31,EI,Ireland,550,240,21,10,310,147,142,289,11
2020-09-01,EI,Ireland,558,261,28,13,297,130,139,269,15
2020-09-02,EI,Ireland,539,283,18,5,256,124,114,238,13
2020-09-03,EI,Ireland,618,334,31,14,284,126,127,253,17
2020-09-04,EI,Ireland,669,313,30,9,356,162,164,326,21
2020-09-05,EI,Ireland,628,333,22,9,295,134,139,273,13
2020-09-06,EI,Ireland,611,259,15,6,352,168,169,337,9
2020-09-07,EI,Ireland,514,245,19,8,269,132,118,250,11
2020-09-08,EI,Ireland,491,215,25,12,276,126,125,251,13
2020-09-09,EI,Ireland,536,272,21,11,264,122,121,243,10
2020-09-10,EI,Ireland,550,272,24,13,278,122,132,254,11
2020-09-11,EI,Ireland,626,265,21,9,361,167,173,340,12
2020-09-12,EI,Ireland,562,265,11,3,297,142,144,286,8
2020-09-13,EI,Ireland,691,346,12,3,345,168,165,333,9
2020-09-14,EI,Ireland,578,305,20,5,273,133,120,253,15
2020-09-15,EI,Ireland,602,324,19,4,278,128,131,259,15
2020-09-16,EI,Ireland,525,275,22,8,250,113,115,228,14
2020-09-17,EI,Ireland,610,354,17,5,256,118,121,239,12
2020-09-18,EI,Ireland,687,345,21,10,342,155,166,321,11
2020-09-19,EI,Ireland,549,272,14,6,277,133,130,263,8
2020-09-20,EI,Ireland,610,270,13,5,340,165,162,327,8
2020-09-21,EI,Ireland,592,326,16,5,266,130,120,250,11
2020-09-22,EI,Ireland,542,284,20,8,258,118,120,238,12
2020-09-23,EI,Ireland,510,260,20,9,250,114,116,230,11
2020-09-24,EI,Ireland,533,273,17,6,260,120,123,243,11
2020-09-25,EI,Ireland,597,265,24,12,332,154,154,308,12
2020-09-26,EI,Ireland,574,298,14,6,276,130,132,262,8
2020-09-27,EI,Ireland,634,295,14,6,339,163,162,325,8
2020-09-28,EI,Ireland,595,324,21,8,271,129,121,250,13
2020-09-29,EI,Ireland,537,273,18,7,264,120,126,246,11
2020-09-30,EI,Ireland,532,273,23,11,259,119,117,236,12
2020-10-01,EI,Ireland,540,313,23,13,227,103,101,204,10
2020-10-02,EI,Ireland,600,272,25,13,328,147,156,303,12
2020-10-03,EI,Ireland,510,274,19,9,236,108,109,217,10
2020-10-04,EI,Ireland,532,254,7,0,278,134,137,271,7
2020-10-05,EI,Ireland,519,271,19,8,248,118,111,229,11
2020-10-06,EI,Ireland,402,190,27,17,212,93,92,185,10
2020-10-07,EI,Ireland,429,230,22,11,199,90,87,177,11
2020-10-08,EI,Ireland,535,308,20,10,227,105,102,207,10
2020-10-09,EI,Ireland,593,291,22,12,302,138,142,280,10
2020-10-10,EI,Ireland,543,309,11,3,234,110,113,223,8
2020-10-11,EI,Ireland,604,328,12,4,276,133,131,264,8
2020-10-12,EI,Ireland,569,350,17,6,219,102,100,202,11
2020-10-13,EI,Ireland,491,292,27,17,199,86,86,172,10
2020-10-14,EI,Ireland,491,313,20,10,178,79,79,158,10
2020-10-15,EI,Ireland,528,337,13,3,191,89,89,178,10
2020-10-16,EI,Ireland,645,346,19,9,299,138,142,280,10
2020-10-17,EI,Ireland,558,337,20,11,221,101,100,201,9
2020-10-18,EI,Ireland,584,317,12,4,267,126,129,255,8
2020-10-19,EI,Ireland,523,310,13,2,213,103,97,200,11
2020-10-20,EI,Ireland,430,281,17,7,149,67,65,132,10
2020-10-21,EI,Ireland,410,227,34,23,183,75,74,149,11
2020-10-22,EI,Ireland,492,288,20,10,204,91,93,184,10
2020-10-23,EI,Ireland,559,294,22,12,265,119,124,243,10
2020-10-24,EI,Ireland,473,250,11,3,223,105,107,212,8
2020-10-25,EI,Ireland,527,269,11,3,258,125,122,247,8
2020-10-26,EI,Ireland,553,322,13,5,231,112,106,218,8
2020-10-27,EI,Ireland,333,170,27,17,163,71,65,136,10
2020-10-28,EI,Ireland,316,148,22,11,168,74,72,146,11
2020-10-29,EI,Ireland,507,310,13,2,197,90,94,184,11
2020-10-30,EI,Ireland,571,295,19,8,276,124,133,257,11
2020-10-31,EI,Ireland,426,228,9,2,198,96,93,189,7
2020-11-01,EI,Ireland,555,304,14,4,251,115,122,237,10
2020-11-02,EI,Ireland,519,284,19,7,235,115,101,216,12
2020-11-03,EI,Ireland,456,299,25,15,157,63,69,132,10
2020-11-04,EI,Ireland,406,236,22,12,170,75,73,148,10
2020-11-05,EI,Ireland,453,266,19,8,187,83,85,168,11
2020-11-06,EI,Ireland,580,332,23,13,248,110,115,225,10
2020-11-07,EI,Ireland,549,360,9,1,189,92,88,180,8
2020-11-08,EI,Ireland,571,346,13,3,225,105,107,212,10
2020-11-09,EI,Ireland,502,304,18,6,198,93,87,180,12
2020-11-10,EI,Ireland,424,284,27,17,140,56,57,113,10
2020-11-11,EI,Ireland,403,279,16,6,124,52,56,108,10
2020-11-12,EI,Ireland,480,320,23,8,160,69,68,137,15
2020-11-13,EI,Ireland,534,300,22,12,234,101,111,212,10
2020-11-14,EI,Ireland,383,264,9,0,119,57,53,110,9
2020-11-15,EI,Ireland,351,190,15,7,161,72,74,146,8
2020-11-16,EI,Ireland,460,294,17,7,166,79,70,149,10
2020-11-17,EI,Ireland,415,319,14,3,96,38,44,82,11
2020-11-18,EI,Ireland,349,239,25,12,110,43,42,85,13
2020-11-19,EI,Ireland,357,228,21,10,129,53,55,108,11
2020-11-20,EI,Ireland,472,321,30,16,151,56,65,121,14
2020-11-21,EI,Ireland,409,295,19,9,114,47,48,95,10
2020-11-22,EI,Ireland,499,361,20,7,138,59,59,118,13
2020-11-23,EI,Ireland,431,309,18,6,122,54,50,104,12
2020-11-24,EI,Ireland,378,268,17,7,110,47,46,93,10
2020-11-25,EI,Ireland,421,309,23,12,112,45,44,89,11
2020-11-26,EI,Ireland,454,335,21,9,119,48,50,98,12
2020-11-27,EI,Ireland,428,268,31,16,160,61,68,129,15
2020-11-28,EI,Ireland,402,296,9,1,106,50,47,97,8
2020-11-29,EI,Ireland,421,296,11,3,125,56,58,114,8
2020-11-30,EI,Ireland,383,239,24,14,144,65,55,120,10
2020-12-01,EI,Ireland,334,215,28,18,119,43,48,91,10
2020-12-02,EI,Ireland,386,256,25,13,130,53,52,105,12
2020-12-03,EI,Ireland,500,353,18,8,147,65,64,129,10
2020-12-04,EI,Ireland,486,312,22,11,174,74,78,152,11
2020-12-05,EI,Ireland,433,310,20,11,123,56,47,103,9
2020-12-06,EI,Ireland,465,313,16,8,152,67,69,136,8
2020-12-07,EI,Ireland,476,328,21,10,148,61,66,127,11
2020-12-08,EI,Ireland,460,342,28,17,118,47,43,90,11
2020-12-09,EI,Ireland,413,286,19,8,127,57,51,108,11
2020-12-10,EI,Ireland,480,326,24,10,154,63,67,130,14
2020-12-11,EI,Ireland,437,250,27,15,187,78,82,160,12
2020-12-12,EI,Ireland,434,303,24,13,131,54,53,107,11
2020-12-13,EI,Ireland,456,298,12,2,158,70,76,146,10
2020-12-14,EI,Ireland,458,286,24,14,172,77,71,148,10
2020-12-15,EI,Ireland,404,256,29,19,148,59,60,119,10
2020-12-16,EI,Ireland,422,278,27,17,144,57,60,117,10
2020-12-17,EI,Ireland,561,349,16,7,212,95,101,196,9
2020-12-18,EI,Ireland,595,280,26,12,315,146,143,289,14
2020-12-19,EI,Ireland,538,288,15,5,250,118,117,235,10
2020-12-20,EI,Ireland,630,364,14,3,266,123,129,252,11
2020-12-21,EI,Ireland,516,314,20,4,202,92,90,182,16
2020-12-22,EI,Ireland,546,362,27,15,184,75,82,157,12
2020-12-23,EI,Ireland,534,335,22,10,199,93,84,177,12
2020-12-24,EI,Ireland,455,286,15,5,169,78,76,154,10
2020-12-25,EI,Ireland,130,127,0,0,3,1,2,3,0
2020-12-26,EI,Ireland,330,199,6,1,131,62,63,125,5
2020-12-27,EI,Ireland,456,269,12,3,187,86,89,175,9
2020-12-28,EI,Ireland,420,254,8,0,166,82,76,158,8
2020-12-29,EI,Ireland,414,260,16,5,154,67,71,138,11
2020-12-30,EI,Ireland,407,265,18,7,142,62,62,124,11
2020-12-31,EI,Ireland,393,243,16,3,150,63,71,134,13
2020-01-01,LL,Israel,472,51,37,6,421,194,190,384,31
2020-01-02,LL,Israel,597,57,53,2,540,246,241,487,51
2020-01-03,LL,Israel,477,104,14,0,373,179,180,359,14
2020-01-04,LL,Israel,409,68,24,0,341,152,165,317,24
2020-01-05,LL,Israel,611,66,51,2,545,247,247,494,49
2020-01-06,LL,Israel,523,74,34,4,449,210,205,415,30
2020-01-07,LL,Israel,507,92,38,6,415,192,185,377,32
2020-01-08,LL,Israel,466,59,43,5,407,179,185,364,38
2020-01-09,LL,Israel,557,58,43,1,499,230,226,456,42
2020-01-10,LL,Israel,411,95,14,0,316,153,149,302,14
2020-01-11,LL,Israel,392,66,24,0,326,146,156,302,24
2020-01-12,LL,Israel,590,70,49,4,520,239,232,471,45
2020-01-13,LL,Israel,504,78,40,4,426,193,193,386,36
2020-01-14,LL,Israel,475,91,34,1,384,177,173,350,33
2020-01-15,LL,Israel,462,63,43,2,399,175,181,356,41
2020-01-16,LL,Israel,553,54,55,3,499,221,223,444,52
2020-01-17,LL,Israel,426,92,18,1,334,161,155,316,17
2020-01-18,LL,Israel,370,60,22,0,310,139,149,288,22
2020-01-19,LL,Israel,585,68,52,3,517,234,231,465,49
2020-01-20,LL,Israel,516,73,59,5,443,194,190,384,54
2020-01-21,LL,Israel,473,76,45,1,397,175,177,352,44
2020-01-22,LL,Israel,451,60,36,1,391,167,188,355,35
2020-01-23,LL,Israel,580,48,57,10,532,247,228,475,47
2020-01-24,LL,Israel,444,86,29,0,358,170,159,329,29
2020-01-25,LL,Israel,387,56,30,1,331,144,157,301,29
2020-01-26,LL,Israel,556,66,47,2,490,225,218,443,45
2020-01-27,LL,Israel,488,71,34,5,417,192,191,383,29
2020-01-28,LL,Israel,462,82,32,0,380,175,173,348,32
2020-01-29,LL,Israel,446,65,39,4,381,171,171,342,35
2020-01-30,LL,Israel,530,54,46,3,476,218,212,430,43
2020-01-31,LL,Israel,431,91,18,3,340,160,162,322,15
2020-02-01,LL,Israel,397,62,28,1,335,149,158,307,27
2020-02-02,LL,Israel,579,78,48,4,501,230,223,453,44
2020-02-03,LL,Israel,475,72,31,5,403,185,187,372,26
2020-02-04,LL,Israel,473,77,36,2,396,184,176,360,34
2020-02-05,LL,Israel,418,50,46,7,368,158,164,322,39
2020-02-06,LL,Israel,533,55,43,2,478,221,214,435,41
2020-02-07,LL,Israel,399,87,15,0,312,150,147,297,15
2020-02-08,LL,Israel,369,58,23,0,311,137,151,288,23
2020-02-09,LL,Israel,560,70,42,4,490,227,221,448,38
2020-02-10,LL,Israel,482,72,25,3,410,188,197,385,22
2020-02-11,LL,Israel,485,79,44,4,406,183,179,362,40
2020-02-12,LL,Israel,458,58,43,3,400,180,177,357,40
2020-02-13,LL,Israel,542,54,48,1,488,222,218,440,47
2020-02-14,LL,Israel,432,102,14,0,330,159,157,316,14
2020-02-15,LL,Israel,385,62,28,0,323,137,158,295,28
2020-02-16,LL,Israel,560,70,39,1,490,229,222,451,38
2020-02-17,LL,Israel,493,72,33,3,421,196,192,388,30
2020-02-18,LL,Israel,479,81,31,1,398,183,184,367,30
2020-02-19,LL,Israel,450,64,34,3,386,173,179,352,31
2020-02-20,LL,Israel,548,51,53,2,497,227,217,444,51
2020-02-21,LL,Israel,430,89,18,2,341,160,163,323,16
2020-02-22,LL,Israel,392,58,34,0,334,144,156,300,34
2020-02-23,LL,Israel,570,69,44,3,501,235,222,457,41
2020-02-24,LL,Israel,490,73,33,3,417,192,192,384,30
2020-02-25,LL,Israel,460,71,28,1,389,181,180,361,27
2020-02-26,LL,Israel,442,52,40,4,390,174,176,350,36
2020-02-27,LL,Israel,547,54,51,4,493,222,220,442,47
2020-02-28,LL,Israel,411,92,15,1,319,152,152,304,14
2020-02-29,LL,Israel,383,60,33,0,323,135,155,290,33
2020-03-01,LL,Israel,555,76,42,2,479,221,216,437,40
2020-03-02,LL,Israel,470,75,29,2,395,181,185,366,27
2020-03-03,LL,Israel,459,82,31,3,377,178,168,346,28
2020-03-04,LL,Israel,434,64,36,6,370,162,172,334,30
2020-03-05,LL,Israel,522,74,44,1,448,209,195,404,43
2020-03-06,LL,Israel,373,83,13,0,290,140,137,277,13
2020-03-07,LL,Israel,357,69,26,0,288,131,131,262,26
2020-03-08,LL,Israel,486,75,46,6,411,184,181,365,40
2020-03-09,LL,Israel,380,73,32,6,307,138,137,275,26
2020-03-10,LL,Israel,355,81,26,0,274,128,120,248,26
2020-03-11,LL,Israel,333,61,38,3,272,121,113,234,35
2020-03-12,LL,Israel,307,59,37,3,248,107,104,211,34
2020-03-13,LL,Israel,212,73,8,0,139,64,67,131,8
2020-03-14,LL,Israel,204,57,17,0,147,66,64,130,17
2020-03-15,LL,Israel,269,78,29,1,191,86,76,162,28
2020-03-16,LL,Israel,238,87,13,4,151,68,70,138,9
2020-03-17,LL,Israel,141,18,7,3,123,55,61,116,4
2020-03-18,LL,Israel,131,12,9,5,119,58,52,110,4
2020-03-19,LL,Israel,125,16,8,2,109,50,51,101,6
2020-03-20,LL,Israel,98,19,7,3,79,30,42,72,4
2020-03-21,LL,Israel,62,8,2,0,54,29,23,52,2
2020-03-22,LL,Israel,81,11,7,1,70,31,32,63,6
2020-03-23,LL,Israel,77,9,13,8,68,28,27,55,5
2020-03-24,LL,Israel,78,16,6,0,62,26,30,56,6
2020-03-25,LL,Israel,81,14,8,4,67,31,28,59,4
2020-03-26,LL,Israel,88,22,6,0,66,31,29,60,6
2020-03-27,LL,Israel,58,15,0,0,43,20,23,43,0
2020-03-28,LL,Israel,49,2,2,0,47,22,23,45,2
2020-03-29,LL,Israel,53,17,8,1,36,13,15,28,7
2020-03-30,LL,Israel,45,11,9,3,34,14,11,25,6
2020-03-31,LL,Israel,54,15,5,1,39,15,19,34,4
2020-04-01,LL,Israel,61,14,7,3,47,22,18,40,4
2020-04-02,LL,Israel,67,17,8,4,50,22,20,42,4
2020-04-03,LL,Israel,36,8,1,1,28,14,13,27,0
2020-04-04,LL,Israel,41,0,2,0,41,20,19,39,2
2020-04-05,LL,Israel,44,9,5,1,35,14,16,30,4
2020-04-06,LL,Israel,73,15,10,6,58,26,22,48,4
2020-04-07,LL,Israel,71,14,6,2,57,26,25,51,4
2020-04-08,LL,Israel,55,15,0,0,40,20,20,40,0
2020-04-09,LL,Israel,46,16,0,0,30,16,14,30,0
2020-04-10,LL,Israel,43,9,1,1,34,17,16,33,0
2020-04-11,LL,Israel,54,1,0,0,53,26,27,53,0
2020-04-12,LL,Israel,55,10,7,3,45,16,22,38,4
2020-04-13,LL,Israel,54,12,5,1,42,20,17,37,4
2020-04-14,LL,Israel,54,11,2,0,43,21,20,41,2
2020-04-15,LL,Israel,55,12,0,0,43,21,22,43,0
2020-04-16,LL,Israel,63,16,7,5,47,19,21,40,2
2020-04-17,LL,Israel,38,6,0,0,32,14,18,32,0
2020-04-18,LL,Israel,61,2,2,0,59,29,28,57,2
2020-04-19,LL,Israel,48,9,4,0,39,17,18,35,4
2020-04-20,LL,Israel,66,21,8,4,45,21,16,37,4
2020-04-21,LL,Israel,61,6,11,7,55,21,23,44,4
2020-04-22,LL,Israel,74,9,12,6,65,27,26,53,6
2020-04-23,LL,Israel,70,12,13,6,58,23,22,45,7
2020-04-24,LL,Israel,43,10,0,0,33,16,17,33,0
2020-04-25,LL,Israel,48,12,0,0,36,18,18,36,0
2020-04-26,LL,Israel,52,8,7,3,44,17,20,37,4
2020-04-27,LL,Israel,57,12,5,1,45,22,18,40,4
2020-04-28,LL,Israel,64,13,3,1,51,26,22,48,2
2020-04-29,LL,Israel,63,7,0,0,56,27,29,56,0
2020-04-30,LL,Israel,77,16,6,2,61,29,26,55,4
2020-05-01,LL,Israel,55,12,3,3,43,19,21,40,0
2020-05-02,LL,Israel,46,9,0,0,37,19,18,37,0
2020-05-03,LL,Israel,73,17,8,3,56,23,25,48,5
2020-05-04,LL,Israel,61,8,13,5,53,20,20,40,8
2020-05-05,LL,Israel,85,19,5,1,66,29,32,61,4
2020-05-06,LL,Israel,91,23,11,6,68,32,25,57,5
2020-05-07,LL,Israel,88,18,9,1,70,30,31,61,8
2020-05-08,LL,Israel,73,17,0,0,56,29,27,56,0
2020-05-09,LL,Israel,58,4,0,0,54,26,28,54,0
2020-05-10,LL,Israel,72,13,7,3,59,24,28,52,4
2020-05-11,LL,Israel,84,12,7,3,72,34,31,65,4
2020-05-12,LL,Israel,90,13,8,1,77,38,31,69,7
2020-05-13,LL,Israel,103,13,12,4,90,35,43,78,8
2020-05-14,LL,Israel,105,15,13,7,90,38,39,77,6
2020-05-15,LL,Israel,78,15,3,3,63,30,30,60,0
2020-05-16,LL,Israel,74,8,0,0,66,31,35,66,0
2020-05-17,LL,Israel,94,17,11,3,77,33,33,66,8
2020-05-18,LL,Israel,90,21,11,5,69,31,27,58,6
2020-05-19,LL,Israel,109,17,15,7,92,37,40,77,8
2020-05-20,LL,Israel,95,18,13,5,77,32,32,64,8
2020-05-21,LL,Israel,93,19,8,0,74,35,31,66,8
2020-05-22,LL,Israel,66,11,2,0,55,27,26,53,2
2020-05-23,LL,Israel,59,7,0,0,52,25,27,52,0
2020-05-24,LL,Israel,84,11,8,1,73,31,34,65,7
2020-05-25,LL,Israel,93,8,23,9,85,33,29,62,14
2020-05-26,LL,Israel,111,20,14,5,91,40,37,77,9
2020-05-27,LL,Israel,104,23,14,4,81,31,36,67,10
2020-05-28,LL,Israel,96,19,8,0,77,36,33,69,8
2020-05-29,LL,Israel,59,9,0,0,50,24,26,50,0
2020-05-30,LL,Israel,63,7,8,0,56,24,24,48,8
2020-05-31,LL,Israel,91,6,11,3,85,33,41,74,8
2020-06-01,LL,Israel,87,20,12,4,67,28,27,55,8
2020-06-02,LL,Israel,82,11,7,1,71,32,32,64,6
2020-06-03,LL,Israel,89,21,9,3,68,32,27,59,6
2020-06-04,LL,Israel,101,15,14,4,86,36,36,72,10
2020-06-05,LL,Israel,66,14,2,0,52,25,25,50,2
2020-06-06,LL,Israel,83,11,8,0,72,33,31,64,8
2020-06-07,LL,Israel,77,8,10,2,69,26,33,59,8
2020-06-08,LL,Israel,77,15,11,4,62,27,24,51,7
2020-06-09,LL,Israel,97,20,8,2,77,34,35,69,6
2020-06-10,LL,Israel,100,18,9,2,82,39,34,73,7
2020-06-11,LL,Israel,101,22,11,1,79,34,34,68,10
2020-06-12,LL,Israel,81,10,0,0,71,33,38,71,0
2020-06-13,LL,Israel,75,4,8,0,71,29,34,63,8
2020-06-14,LL,Israel,89,10,12,2,79,34,33,67,10
2020-06-15,LL,Israel,82,13,7,1,69,33,29,62,6
2020-06-16,LL,Israel,80,15,10,2,65,26,29,55,8
2020-06-17,LL,Israel,87,16,12,0,71,31,28,59,12
2020-06-18,LL,Israel,106,18,14,3,88,35,39,74,11
2020-06-19,LL,Israel,78,15,3,0,63,26,34,60,3
2020-06-20,LL,Israel,69,9,9,0,60,27,24,51,9
2020-06-21,LL,Israel,88,8,10,3,80,35,35,70,7
2020-06-22,LL,Israel,86,15,11,4,71,31,29,60,7
2020-06-23,LL,Israel,75,15,9,3,60,27,24,51,6
2020-06-24,LL,Israel,77,17,9,1,60,25,26,51,8
2020-06-25,LL,Israel,95,16,11,3,79,36,32,68,8
2020-06-26,LL,Israel,74,15,0,0,59,27,32,59,0
2020-06-27,LL,Israel,63,9,8,0,54,24,22,46,8
2020-06-28,LL,Israel,85,14,10,2,71,30,31,61,8
2020-06-29,LL,Israel,102,14,10,3,88,39,39,78,7
2020-06-30,LL,Israel,90,20,10,2,70,30,30,60,8
2020-07-01,LL,Israel,102,16,11,4,86,38,37,75,7
2020-07-02,LL,Israel,105,15,13,1,90,37,40,77,12
2020-07-03,LL,Israel,76,11,1,0,65,32,32,64,1
2020-07-04,LL,Israel,70,3,8,0,67,28,31,59,8
2020-07-05,LL,Israel,127,9,17,7,118,50,51,101,10
2020-07-06,LL,Israel,99,19,11,3,80,36,33,69,8
2020-07-07,LL,Israel,95,19,8,2,76,35,33,68,6
2020-07-08,LL,Israel,94,11,9,3,83,36,38,74,6
2020-07-09,LL,Israel,100,22,12,2,78,32,34,66,10
2020-07-10,LL,Israel,78,14,5,0,64,31,28,59,5
2020-07-11,LL,Israel,67,8,6,0,59,25,28,53,6
2020-07-12,LL,Israel,103,9,13,3,94,40,41,81,10
2020-07-13,LL,Israel,83,12,10,4,71,33,28,61,6
2020-07-14,LL,Israel,104,17,13,7,87,38,36,74,6
2020-07-15,LL,Israel,117,25,10,3,92,37,45,82,7
2020-07-16,LL,Israel,125,22,16,4,103,41,46,87,12
2020-07-17,LL,Israel,87,13,2,1,74,40,32,72,1
2020-07-18,LL,Israel,81,8,7,0,73,32,34,66,7
2020-07-19,LL,Israel,130,14,14,2,116,51,51,102,12
2020-07-20,LL,Israel,103,11,18,6,92,37,37,74,12
2020-07-21,LL,Israel,100,15,11,2,85,38,36,74,9
2020-07-22,LL,Israel,111,18,9,1,93,42,42,84,8
2020-07-23,LL,Israel,130,18,13,1,112,47,52,99,12
2020-07-24,LL,Israel,87,9,1,0,78,40,37,77,1
2020-07-25,LL,Israel,88,7,7,0,81,35,39,74,7
2020-07-26,LL,Israel,121,15,14,2,106,49,43,92,12
2020-07-27,LL,Israel,100,16,13,5,84,36,35,71,8
2020-07-28,LL,Israel,109,19,10,2,90,39,41,80,8
2020-07-29,LL,Israel,107,18,13,3,89,40,36,76,10
2020-07-30,LL,Israel,114,17,13,0,97,39,45,84,13
2020-07-31,LL,Israel,94,29,1,0,65,34,30,64,1
2020-08-01,LL,Israel,80,6,7,0,74,30,37,67,7
2020-08-02,LL,Israel,116,16,18,5,100,41,41,82,13
2020-08-03,LL,Israel,102,11,17,5,91,41,33,74,12
2020-08-04,LL,Israel,87,18,9,1,69,28,32,60,8
2020-08-05,LL,Israel,112,15,21,7,97,38,38,76,14
2020-08-06,LL,Israel,138,15,19,1,123,53,51,104,18
2020-08-07,LL,Israel,70,11,7,2,59,29,23,52,5
2020-08-08,LL,Israel,75,2,9,0,73,29,35,64,9
2020-08-09,LL,Israel,114,17,21,3,97,37,39,76,18
2020-08-10,LL,Israel,103,16,15,2,87,37,35,72,13
2020-08-11,LL,Israel,117,21,26,13,96,36,34,70,13
2020-08-12,LL,Israel,101,17,24,12,84,30,30,60,12
2020-08-13,LL,Israel,126,19,19,0,107,43,45,88,19
2020-08-14,LL,Israel,75,19,11,3,56,25,20,45,8
2020-08-15,LL,Israel,80,5,9,0,75,30,36,66,9
2020-08-16,LL,Israel,124,17,25,2,107,39,43,82,23
2020-08-17,LL,Israel,117,15,10,2,102,50,42,92,8
2020-08-18,LL,Israel,103,9,14,1,94,39,41,80,13
2020-08-19,LL,Israel,114,21,17,1,93,36,40,76,16
2020-08-20,LL,Israel,136,21,26,2,115,44,45,89,24
2020-08-21,LL,Israel,86,15,5,0,71,36,30,66,5
2020-08-22,LL,Israel,74,5,10,0,69,26,33,59,10
2020-08-23,LL,Israel,132,8,24,1,124,48,52,100,23
2020-08-24,LL,Israel,109,18,8,0,91,45,38,83,8
2020-08-25,LL,Israel,119,18,12,2,101,47,42,89,10
2020-08-26,LL,Israel,106,20,11,1,86,36,39,75,10
2020-08-27,LL,Israel,170,18,31,3,152,57,64,121,28
2020-08-28,LL,Israel,87,8,6,1,79,38,35,73,5
2020-08-29,LL,Israel,81,8,11,0,73,28,34,62,11
2020-08-30,LL,Israel,128,20,21,5,108,42,45,87,16
2020-08-31,LL,Israel,135,16,11,3,119,57,51,108,8
2020-09-01,LL,Israel,111,12,14,2,99,44,41,85,12
2020-09-02,LL,Israel,130,12,15,3,118,53,50,103,12
2020-09-03,LL,Israel,169,11,23,5,158,69,66,135,18
2020-09-04,LL,Israel,103,7,8,3,96,44,44,88,5
2020-09-05,LL,Israel,91,4,10,1,87,34,43,77,9
2020-09-06,LL,Israel,166,13,26,6,153,63,64,127,20
2020-09-07,LL,Israel,143,18,17,7,125,58,50,108,10
2020-09-08,LL,Israel,133,23,14,2,110,51,45,96,12
2020-09-09,LL,Israel,131,17,17,5,114,44,53,97,12
2020-09-10,LL,Israel,168,20,25,5,148,59,64,123,20
2020-09-11,LL,Israel,102,18,10,5,84,39,35,74,5
2020-09-12,LL,Israel,86,12,9,0,74,31,34,65,9
2020-09-13,LL,Israel,164,21,23,5,143,61,59,120,18
2020-09-14,LL,Israel,141,13,17,4,128,57,54,111,13
2020-09-15,LL,Israel,158,18,22,5,140,61,57,118,17
2020-09-16,LL,Israel,158,12,16,6,146,57,73,130,10
2020-09-17,LL,Israel,211,18,18,1,193,93,82,175,17
2020-09-18,LL,Israel,135,18,6,1,117,59,52,111,5
2020-09-19,LL,Israel,76,12,0,0,64,31,33,64,0
2020-09-20,LL,Israel,135,16,4,0,119,57,58,115,4
2020-09-21,LL,Israel,152,24,10,3,128,62,56,118,7
2020-09-22,LL,Israel,140,27,12,5,113,51,50,101,7
2020-09-23,LL,Israel,143,23,9,5,120,54,57,111,4
2020-09-24,LL,Israel,186,22,10,3,164,75,79,154,7
2020-09-25,LL,Israel,149,17,1,1,132,73,58,131,0
2020-09-26,LL,Israel,109,11,0,0,98,46,52,98,0
2020-09-27,LL,Israel,69,11,2,0,58,34,22,56,2
2020-09-28,LL,Israel,18,-1,0,0,19,2,17,19,0
2020-09-29,LL,Israel,163,26,5,1,137,67,65,132,4
2020-09-30,LL,Israel,146,20,7,3,126,62,57,119,4
2020-10-01,LL,Israel,192,20,5,1,172,83,84,167,4
2020-10-02,LL,Israel,127,20,3,3,107,56,48,104,0
2020-10-03,LL,Israel,117,27,0,0,90,41,49,90,0
2020-10-04,LL,Israel,163,19,4,0,144,67,73,140,4
2020-10-05,LL,Israel,126,23,5,1,103,49,49,98,4
2020-10-06,LL,Israel,116,25,4,0,91,47,40,87,4
2020-10-07,LL,Israel,124,13,5,1,111,49,57,106,4
2020-10-08,LL,Israel,165,23,4,0,142,68,70,138,4
2020-10-09,LL,Israel,128,18,0,0,110,55,55,110,0
2020-10-10,LL,Israel,134,19,0,0,115,54,61,115,0
2020-10-11,LL,Israel,191,26,11,7,165,74,80,154,4
2020-10-12,LL,Israel,147,19,8,3,128,65,55,120,5
2020-10-13,LL,Israel,153,31,6,2,122,61,55,116,4
2020-10-14,LL,Israel,147,23,21,6,124,52,51,103,15
2020-10-15,LL,Israel,154,33,6,2,121,59,56,115,4
2020-10-16,LL,Israel,146,22,3,1,124,56,65,121,2
2020-10-17,LL,Israel,103,15,2,0,88,42,44,86,2
2020-10-18,LL,Israel,153,16,7,3,137,63,67,130,4
2020-10-19,LL,Israel,140,18,12,5,122,58,52,110,7
2020-10-20,LL,Israel,147,21,7,1,126,61,58,119,6
2020-10-21,LL,Israel,145,16,15,4,129,53,61,114,11
2020-10-22,LL,Israel,197,40,14,4,157,76,67,143,10
2020-10-23,LL,Israel,113,15,5,1,98,44,49,93,4
2020-10-24,LL,Israel,112,23,3,0,89,44,42,86,3
2020-10-25,LL,Israel,181,19,15,5,162,73,74,147,10
2020-10-26,LL,Israel,154,26,10,2,128,61,57,118,8
2020-10-27,LL,Israel,155,25,14,6,130,60,56,116,8
2020-10-28,LL,Israel,161,23,21,9,138,55,62,117,12
2020-10-29,LL,Israel,210,25,16,6,185,84,85,169,10
2020-10-30,LL,Israel,132,30,8,2,102,52,42,94,6
2020-10-31,LL,Israel,120,23,4,0,97,47,46,93,4
2020-11-01,LL,Israel,199,26,17,2,173,77,79,156,15
2020-11-02,LL,Israel,151,21,21,5,130,56,53,109,16
2020-11-03,LL,Israel,159,20,19,5,139,61,59,120,14
2020-11-04,LL,Israel,148,23,18,4,125,49,58,107,14
2020-11-05,LL,Israel,192,27,26,3,165,69,70,139,23
2020-11-06,LL,Israel,115,27,7,1,88,45,36,81,6
2020-11-07,LL,Israel,140,22,13,0,118,51,54,105,13
2020-11-08,LL,Israel,187,25,31,2,162,64,67,131,29
2020-11-09,LL,Israel,131,28,21,4,103,41,41,82,17
2020-11-10,LL,Israel,163,31,24,2,132,56,52,108,22
2020-11-11,LL,Israel,142,31,20,5,111,44,47,91,15
2020-11-12,LL,Israel,175,32,18,3,143,63,62,125,15
2020-11-13,LL,Israel,98,27,7,0,71,30,34,64,7
2020-11-14,LL,Israel,92,13,2,0,79,39,38,77,2
2020-11-15,LL,Israel,170,33,21,0,137,61,55,116,21
2020-11-16,LL,Israel,172,29,38,4,143,51,54,105,34
2020-11-17,LL,Israel,161,34,30,4,127,50,47,97,26
2020-11-18,LL,Israel,161,26,43,5,135,45,47,92,38
2020-11-19,LL,Israel,168,24,29,2,144,56,59,115,27
2020-11-20,LL,Israel,95,26,6,0,69,34,29,63,6
2020-11-21,LL,Israel,109,26,6,0,83,37,40,77,6
2020-11-22,LL,Israel,161,27,31,3,134,54,49,103,28
2020-11-23,LL,Israel,166,34,40,7,132,45,47,92,33
2020-11-24,LL,Israel,171,31,33,2,140,55,52,107,31
2020-11-25,LL,Israel,150,25,23,0,125,53,49,102,23
2020-11-26,LL,Israel,159,31,25,1,128,50,53,103,24
2020-11-27,LL,Israel,106,37,8,1,69,30,31,61,7
2020-11-28,LL,Israel,107,21,12,2,86,37,37,74,10
2020-11-29,LL,Israel,169,31,34,5,138,48,56,104,29
2020-11-30,LL,Israel,175,30,30,6,145,58,57,115,24
2020-12-01,LL,Israel,165,23,34,3,142,56,52,108,31
2020-12-02,LL,Israel,184,22,51,5,162,51,60,111,46
2020-12-03,LL,Israel,227,30,42,12,197,82,73,155,30
2020-12-04,LL,Israel,125,32,10,0,93,43,40,83,10
2020-12-05,LL,Israel,121,25,12,0,96,41,43,84,12
2020-12-06,LL,Israel,189,26,33,4,163,66,64,130,29
2020-12-07,LL,Israel,173,33,32,6,140,53,55,108,26
2020-12-08,LL,Israel,192,33,45,3,159,60,54,114,42
2020-12-09,LL,Israel,198,20,41,7,178,62,75,137,34
2020-12-10,LL,Israel,207,19,35,5,188,82,71,153,30
2020-12-11,LL,Israel,140,41,10,1,99,43,46,89,9
2020-12-12,LL,Israel,129,23,11,0,106,48,47,95,11
2020-12-13,LL,Israel,193,29,33,1,164,63,68,131,32
2020-12-14,LL,Israel,184,31,36,4,153,62,55,117,32
2020-12-15,LL,Israel,191,33,21,1,158,68,69,137,20
2020-12-16,LL,Israel,159,20,16,0,139,58,65,123,16
2020-12-17,LL,Israel,210,38,29,0,172,75,68,143,29
2020-12-18,LL,Israel,139,38,12,2,101,46,43,89,10
2020-12-19,LL,Israel,162,31,18,1,131,50,63,113,17
2020-12-20,LL,Israel,192,26,31,5,166,69,66,135,26
2020-12-21,LL,Israel,208,32,41,2,176,68,67,135,39
2020-12-22,LL,Israel,193,24,28,4,169,72,69,141,24
2020-12-23,LL,Israel,197,21,26,1,176,68,82,150,25
2020-12-24,LL,Israel,162,26,27,3,136,58,51,109,24
2020-12-25,LL,Israel,95,20,17,1,75,29,29,58,16
2020-12-26,LL,Israel,106,25,13,2,81,37,31,68,11
2020-12-27,LL,Israel,133,19,28,1,114,39,47,86,27
2020-12-28,LL,Israel,135,31,28,7,104,35,41,76,21
2020-12-29,LL,Israel,116,17,18,3,99,44,37,81,15
2020-12-30,LL,Israel,128,13,25,2,115,43,47,90,23
2020-12-31,LL,Israel,115,22,24,0,93,37,32,69,24
2020-01-01,LI,Italy,3613,1049,571,4,2564,988,1005,1993,567
2020-01-02,LI,Italy,4475,1278,766,6,3197,1215,1216,2431,760
2020-01-03,LI,Italy,4556,1291,803,7,3265,1221,1241,2462,796
2020-01-04,LI,Italy,4381,1405,668,11,2976,1162,1146,2308,657
2020-01-05,LI,Italy,4736,1501,707,9,3235,1266,1262,2528,698
2020-01-06,LI,Italy,4509,1300,802,3,3209,1201,1206,2407,799
2020-01-07,LI,Italy,3956,1109,743,12,2847,1047,1057,2104,731
2020-01-08,LI,Italy,3903,1170,702,13,2733,1019,1012,2031,689
2020-01-09,LI,Italy,4147,1277,759,23,2870,1062,1049,2111,736
2020-01-10,LI,Italy,4437,1300,790,27,3137,1165,1182,2347,763
2020-01-11,LI,Italy,3787,1249,557,11,2538,1003,978,1981,546
2020-01-12,LI,Italy,4306,1410,658,13,2896,1104,1134,2238,645
2020-01-13,LI,Italy,4154,1217,751,9,2937,1101,1085,2186,742
2020-01-14,LI,Italy,2939,858,544,14,2081,768,769,1537,530
2020-01-15,LI,Italy,3728,1170,705,26,2558,925,928,1853,679
2020-01-16,LI,Italy,3914,1138,752,27,2776,1012,1012,2024,725
2020-01-17,LI,Italy,4301,1241,793,21,3060,1123,1144,2267,772
2020-01-18,LI,Italy,3674,1213,551,16,2461,962,948,1910,535
2020-01-19,LI,Italy,4278,1393,656,11,2885,1113,1116,2229,645
2020-01-20,LI,Italy,4183,1232,753,20,2951,1114,1084,2198,733
2020-01-21,LI,Italy,3540,1030,681,23,2510,903,926,1829,658
2020-01-22,LI,Italy,3633,1065,703,25,2568,930,935,1865,678
2020-01-23,LI,Italy,3884,1120,758,30,2764,1005,1001,2006,728
2020-01-24,LI,Italy,4409,1319,782,11,3090,1143,1165,2308,771
2020-01-25,LI,Italy,3689,1230,582,16,2459,953,924,1877,566
2020-01-26,LI,Italy,4154,1286,669,16,2868,1096,1103,2199,653
2020-01-27,LI,Italy,4101,1146,767,27,2955,1110,1078,2188,740
2020-01-28,LI,Italy,3469,981,691,16,2488,897,900,1797,675
2020-01-29,LI,Italy,3586,1042,713,24,2544,918,913,1831,689
2020-01-30,LI,Italy,3845,1069,752,29,2776,1010,1014,2024,723
2020-01-31,LI,Italy,4390,1272,787,18,3118,1153,1178,2331,769
2020-02-01,LI,Italy,3775,1281,556,12,2494,971,967,1938,544
2020-02-02,LI,Italy,4175,1303,657,16,2872,1106,1109,2215,641
2020-02-03,LI,Italy,4173,1200,773,35,2973,1108,1092,2200,738
2020-02-04,LI,Italy,3531,1014,674,18,2517,920,923,1843,656
2020-02-05,LI,Italy,3628,1053,659,20,2575,952,964,1916,639
2020-02-06,LI,Italy,4016,1190,756,26,2826,1040,1030,2070,730
2020-02-07,LI,Italy,4458,1354,770,23,3104,1160,1174,2334,747
2020-02-08,LI,Italy,3869,1289,550,10,2580,1031,999,2030,540
2020-02-09,LI,Italy,3980,1265,623,10,2715,1031,1061,2092,613
2020-02-10,LI,Italy,4075,1154,771,29,2921,1083,1067,2150,742
2020-02-11,LI,Italy,3723,1058,698,19,2665,988,979,1967,679
2020-02-12,LI,Italy,3764,1069,709,22,2695,989,997,1986,687
2020-02-13,LI,Italy,4097,1147,746,19,2950,1097,1107,2204,727
2020-02-14,LI,Italy,4576,1312,795,17,3264,1232,1237,2469,778
2020-02-15,LI,Italy,4108,1333,590,11,2775,1091,1094,2185,579
2020-02-16,LI,Italy,4343,1391,655,10,2952,1141,1156,2297,645
2020-02-17,LI,Italy,4428,1287,755,11,3141,1196,1190,2386,744
2020-02-18,LI,Italy,3928,1133,706,22,2795,1056,1033,2089,684
2020-02-19,LI,Italy,3943,1103,748,32,2840,1038,1054,2092,716
2020-02-20,LI,Italy,4300,1259,777,23,3041,1137,1127,2264,754
2020-02-21,LI,Italy,4691,1340,807,19,3351,1268,1276,2544,788
2020-02-22,LI,Italy,4254,1411,585,10,2843,1133,1125,2258,575
2020-02-23,LI,Italy,4560,1472,670,7,3088,1216,1202,2418,663
2020-02-24,LI,Italy,4439,1311,758,20,3128,1195,1175,2370,738
2020-02-25,LI,Italy,3611,1156,501,26,2455,967,987,1954,475
2020-02-26,LI,Italy,3878,1166,660,15,2712,1044,1008,2052,645
2020-02-27,LI,Italy,4038,1200,713,14,2838,1064,1061,2125,699
2020-02-28,LI,Italy,4456,1360,732,13,3096,1181,1183,2364,719
2020-02-29,LI,Italy,3971,1369,490,8,2602,1070,1042,2112,482
2020-03-01,LI,Italy,4178,1410,580,2,2768,1084,1104,2188,578
2020-03-02,LI,Italy,4074,1264,663,21,2810,1082,1065,2147,642
2020-03-03,LI,Italy,3490,1119,558,6,2371,902,911,1813,552
2020-03-04,LI,Italy,3482,1109,588,15,2373,899,886,1785,573
2020-03-05,LI,Italy,3629,1203,608,11,2426,911,907,1818,597
2020-03-06,LI,Italy,4035,1369,647,18,2666,1005,1014,2019,629
2020-03-07,LI,Italy,3625,1398,472,8,2227,886,869,1755,464
2020-03-08,LI,Italy,3727,1391,535,7,2336,903,898,1801,528
2020-03-09,LI,Italy,3204,1165,540,12,2039,757,742,1499,528
2020-03-10,LI,Italy,2513,1054,412,5,1459,524,523,1047,407
2020-03-11,LI,Italy,2123,1104,295,5,1019,363,361,724,290
2020-03-12,LI,Italy,2039,1116,214,12,923,357,352,709,202
2020-03-13,LI,Italy,2159,1249,216,7,910,349,345,694,209
2020-03-14,LI,Italy,1593,1239,93,3,354,135,126,261,90
2020-03-15,LI,Italy,1526,1193,93,2,333,116,124,240,91
2020-03-16,LI,Italy,1413,1024,118,17,389,135,136,271,101
2020-03-17,LI,Italy,1205,797,168,63,408,119,121,240,105
2020-03-18,LI,Italy,1099,712,130,15,387,122,135,257,115
2020-03-19,LI,Italy,1012,612,139,15,400,132,129,261,124
2020-03-20,LI,Italy,1012,643,121,25,369,126,122,248,96
2020-03-21,LI,Italy,646,388,106,36,258,80,72,152,70
2020-03-22,LI,Italy,555,315,70,8,240,76,94,170,62
2020-03-23,LI,Italy,561,247,115,16,314,100,99,199,99
2020-03-24,LI,Italy,561,226,147,46,335,92,96,188,101
2020-03-25,LI,Italy,503,177,133,33,326,97,96,193,100
2020-03-26,LI,Italy,481,175,121,15,306,94,91,185,106
2020-03-27,LI,Italy,469,183,94,10,286,99,93,192,84
2020-03-28,LI,Italy,378,148,114,36,230,57,59,116,78
2020-03-29,LI,Italy,355,134,92,19,221,60,69,129,73
2020-03-30,LI,Italy,400,127,130,36,273,73,70,143,94
2020-03-31,LI,Italy,394,135,124,19,259,64,71,135,105
2020-04-01,LI,Italy,456,157,148,31,299,77,74,151,117
2020-04-02,LI,Italy,418,122,139,32,296,79,78,157,107
2020-04-03,LI,Italy,437,159,112,12,278,84,82,166,100
2020-04-04,LI,Italy,352,140,101,11,212,57,54,111,90
2020-04-05,LI,Italy,311,113,89,3,198,52,57,109,86
2020-04-06,LI,Italy,351,95,125,19,256,69,62,131,106
2020-04-07,LI,Italy,412,128,148,32,284,65,71,136,116
2020-04-08,LI,Italy,437,139,152,29,298,73,73,146,123
2020-04-09,LI,Italy,438,155,151,29,283,67,65,132,122
2020-04-10,LI,Italy,385,134,102,11,251,74,75,149,91
2020-04-11,LI,Italy,326,125,94,8,201,51,56,107,86
2020-04-12,LI,Italy,213,114,29,2,99,37,33,70,27
2020-04-13,LI,Italy,281,136,61,10,145,41,43,84,51
2020-04-14,LI,Italy,353,113,115,19,240,61,64,125,96
2020-04-15,LI,Italy,442,146,140,22,296,82,74,156,118
2020-04-16,LI,Italy,409,130,132,26,279,69,78,147,106
2020-04-17,LI,Italy,439,142,132,21,297,81,84,165,111
2020-04-18,LI,Italy,284,119,63,12,165,49,53,102,51
2020-04-19,LI,Italy,263,86,70,8,177,49,58,107,62
2020-04-20,LI,Italy,419,139,119,19,280,81,80,161,100
2020-04-21,LI,Italy,404,126,129,20,278,73,76,149,109
2020-04-22,LI,Italy,441,158,132,22,283,76,75,151,110
2020-04-23,LI,Italy,460,168,137,24,292,77,78,155,113
2020-04-24,LI,Italy,451,152,122,24,299,85,92,177,98
2020-04-25,LI,Italy,328,138,79,18,190,56,55,111,61
2020-04-26,LI,Italy,311,113,89,6,198,52,57,109,83
2020-04-27,LI,Italy,397,120,120,27,277,82,75,157,93
2020-04-28,LI,Italy,444,153,141,21,291,75,75,150,120
2020-04-29,LI,Italy,526,187,167,30,339,86,86,172,137
2020-04-30,LI,Italy,443,158,114,27,285,88,83,171,87
2020-05-01,LI,Italy,343,170,70,10,173,48,55,103,60
2020-05-02,LI,Italy,315,151,53,11,164,56,55,111,42
2020-05-03,LI,Italy,338,142,77,11,196,55,64,119,66
2020-05-04,LI,Italy,425,122,145,15,303,81,77,158,130
2020-05-05,LI,Italy,469,164,155,28,305,74,76,150,127
2020-05-06,LI,Italy,487,185,139,36,302,82,81,163,103
2020-05-07,LI,Italy,509,185,158,29,324,84,82,166,129
2020-05-08,LI,Italy,495,184,149,26,311,75,87,162,123
2020-05-09,LI,Italy,406,180,91,16,226,69,66,135,75
2020-05-10,LI,Italy,368,159,87,4,209,59,63,122,83
2020-05-11,LI,Italy,507,160,176,35,347,88,83,171,141
2020-05-12,LI,Italy,548,211,168,21,337,85,84,169,147
2020-05-13,LI,Italy,517,201,154,20,316,84,78,162,134
2020-05-14,LI,Italy,507,166,181,33,341,80,80,160,148
2020-05-15,LI,Italy,611,233,185,41,378,95,98,193,144
2020-05-16,LI,Italy,429,173,108,17,256,71,77,148,91
2020-05-17,LI,Italy,405,173,97,10,232,64,71,135,87
2020-05-18,LI,Italy,526,154,187,32,372,96,89,185,155
2020-05-19,LI,Italy,509,188,155,26,321,88,78,166,129
2020-05-20,LI,Italy,631,258,170,36,373,98,105,203,134
2020-05-21,LI,Italy,616,222,188,34,394,100,106,206,154
2020-05-22,LI,Italy,535,192,149,20,343,99,95,194,129
2020-05-23,LI,Italy,446,198,106,17,248,70,72,142,89
2020-05-24,LI,Italy,403,157,87,10,246,76,83,159,77
2020-05-25,LI,Italy,541,166,187,27,375,97,91,188,160
2020-05-26,LI,Italy,591,221,188,31,370,90,92,182,157
2020-05-27,LI,Italy,658,242,191,32,416,111,114,225,159
2020-05-28,LI,Italy,601,203,194,47,398,103,101,204,147
2020-05-29,LI,Italy,610,245,155,20,365,103,107,210,135
2020-05-30,LI,Italy,415,176,84,9,239,77,78,155,75
2020-05-31,LI,Italy,401,171,86,11,230,69,75,144,75
2020-06-01,LI,Italy,556,205,126,31,351,120,105,225,95
2020-06-02,LI,Italy,508,230,120,15,278,81,77,158,105
2020-06-03,LI,Italy,782,201,236,38,581,158,187,345,198
2020-06-04,LI,Italy,763,222,228,39,541,150,163,313,189
2020-06-05,LI,Italy,814,239,231,37,575,170,174,344,194
2020-06-06,LI,Italy,647,244,150,10,403,130,123,253,140
2020-06-07,LI,Italy,647,226,163,9,421,130,128,258,154
2020-06-08,LI,Italy,707,198,221,28,509,142,146,288,193
2020-06-09,LI,Italy,770,236,245,39,534,148,141,289,206
2020-06-10,LI,Italy,799,261,229,24,538,149,160,309,205
2020-06-11,LI,Italy,807,247,246,28,560,151,163,314,218
2020-06-12,LI,Italy,821,256,220,27,565,167,178,345,193
2020-06-13,LI,Italy,653,242,147,21,411,135,129,264,126
2020-06-14,LI,Italy,695,259,173,17,436,141,122,263,156
2020-06-15,LI,Italy,1002,314,274,29,688,206,208,414,245
2020-06-16,LI,Italy,949,340,252,28,609,180,177,357,224
2020-06-17,LI,Italy,986,354,265,35,632,178,189,367,230
2020-06-18,LI,Italy,1100,358,315,43,742,212,215,427,272
2020-06-19,LI,Italy,1145,413,313,21,732,198,221,419,292
2020-06-20,LI,Italy,1029,433,240,12,596,171,185,356,228
2020-06-21,LI,Italy,1104,416,290,7,688,205,193,398,283
2020-06-22,LI,Italy,1209,366,377,29,843,238,228,466,348
2020-06-23,LI,Italy,1164,385,320,25,779,226,233,459,295
2020-06-24,LI,Italy,1177,392,308,19,785,244,233,477,289
2020-06-25,LI,Italy,1289,392,325,23,897,286,286,572,302
2020-06-26,LI,Italy,1431,504,376,17,927,263,288,551,359
2020-06-27,LI,Italy,1228,503,275,10,725,225,225,450,265
2020-06-28,LI,Italy,1290,508,308,12,782,243,231,474,296
2020-06-29,LI,Italy,1317,402,368,25,915,277,270,547,343
2020-06-30,LI,Italy,1274,424,328,20,850,271,251,522,308
2020-07-01,LI,Italy,2142,800,430,20,1342,446,466,912,410
2020-07-02,LI,Italy,2076,726,473,22,1350,435,442,877,451
2020-07-03,LI,Italy,2588,864,571,17,1724,572,581,1153,554
2020-07-04,LI,Italy,2517,1060,484,4,1457,481,492,973,480
2020-07-05,LI,Italy,2590,989,543,7,1601,527,531,1058,536
2020-07-06,LI,Italy,2383,838,515,21,1545,529,501,1030,494
2020-07-07,LI,Italy,1990,724,452,28,1266,408,406,814,424
2020-07-08,LI,Italy,2258,797,462,25,1461,488,511,999,437
2020-07-09,LI,Italy,2222,741,543,24,1481,468,470,938,519
2020-07-10,LI,Italy,2733,916,605,30,1817,603,609,1212,575
2020-07-11,LI,Italy,2676,1166,509,13,1510,496,505,1001,496
2020-07-12,LI,Italy,2677,1039,557,5,1638,541,540,1081,552
2020-07-13,LI,Italy,2505,849,578,21,1656,547,531,1078,557
2020-07-14,LI,Italy,2258,796,536,34,1462,471,455,926,502
2020-07-15,LI,Italy,2562,919,517,27,1643,550,576,1126,490
2020-07-16,LI,Italy,2566,921,581,21,1645,524,540,1064,560
2020-07-17,LI,Italy,2959,1006,612,16,1953,676,665,1341,596
2020-07-18,LI,Italy,3079,1349,538,18,1730,584,608,1192,520
2020-07-19,LI,Italy,3052,1238,572,12,1814,632,610,1242,560
2020-07-20,LI,Italy,2772,978,609,38,1794,602,583,1185,571
2020-07-21,LI,Italy,2481,933,537,39,1548,504,507,1011,498
2020-07-22,LI,Italy,2663,1005,532,46,1658,553,573,1126,486
2020-07-23,LI,Italy,2755,1028,644,42,1727,543,540,1083,602
2020-07-24,LI,Italy,3119,1098,657,17,2021,675,689,1364,640
2020-07-25,LI,Italy,3409,1533,569,14,1876,651,656,1307,555
2020-07-26,LI,Italy,3139,1200,624,6,1939,663,652,1315,618
2020-07-27,LI,Italy,2947,1065,631,35,1882,632,619,1251,596
2020-07-28,LI,Italy,2617,986,588,31,1631,519,524,1043,557
2020-07-29,LI,Italy,2800,1064,589,33,1736,571,576,1147,556
2020-07-30,LI,Italy,2827,1054,669,40,1773,549,555,1104,629
2020-07-31,LI,Italy,3340,1158,683,16,2182,744,755,1499,667
2020-08-01,LI,Italy,4017,1685,732,10,2332,791,809,1600,722
2020-08-02,LI,Italy,3876,1525,728,11,2351,816,807,1623,717
2020-08-03,LI,Italy,3394,1168,753,26,2226,745,728,1473,727
2020-08-04,LI,Italy,3016,1076,618,28,1940,655,667,1322,590
2020-08-05,LI,Italy,3219,1171,642,36,2048,703,703,1406,606
2020-08-06,LI,Italy,3284,1182,735,29,2102,672,695,1367,706
2020-08-07,LI,Italy,3659,1282,736,22,2377,824,817,1641,714
2020-08-08,LI,Italy,3962,1610,699,17,2352,818,835,1653,682
2020-08-09,LI,Italy,3794,1437,714,9,2357,834,809,1643,705
2020-08-10,LI,Italy,3348,1179,715,38,2169,726,728,1454,677
2020-08-11,LI,Italy,2972,1059,637,34,1913,642,634,1276,603
2020-08-12,LI,Italy,3131,1136,628,26,1995,683,684,1367,602
2020-08-13,LI,Italy,3168,1125,706,17,2043,654,683,1337,689
2020-08-14,LI,Italy,3621,1311,714,16,2310,804,792,1596,698
2020-08-15,LI,Italy,3917,1646,709,12,2271,780,782,1562,697
2020-08-16,LI,Italy,3946,1490,757,6,2456,855,844,1699,751
2020-08-17,LI,Italy,3480,1222,726,17,2258,764,768,1532,709
2020-08-18,LI,Italy,3050,1111,617,23,1939,665,657,1322,594
2020-08-19,LI,Italy,3149,1141,648,30,2008,672,688,1360,618
2020-08-20,LI,Italy,3283,1198,723,19,2085,677,685,1362,704
2020-08-21,LI,Italy,3628,1273,745,21,2355,800,810,1610,724
2020-08-22,LI,Italy,3927,1565,718,15,2362,818,826,1644,703
2020-08-23,LI,Italy,3950,1486,799,12,2464,841,824,1665,787
2020-08-24,LI,Italy,3406,1130,752,17,2276,769,755,1524,735
2020-08-25,LI,Italy,2996,1072,613,17,1924,654,657,1311,596
2020-08-26,LI,Italy,3107,1096,627,19,2011,690,694,1384,608
2020-08-27,LI,Italy,3352,1203,709,19,2149,709,731,1440,690
2020-08-28,LI,Italy,3615,1222,709,13,2393,842,842,1684,696
2020-08-29,LI,Italy,3884,1558,697,4,2326,803,826,1629,693
2020-08-30,LI,Italy,3976,1457,778,7,2519,882,859,1741,771
2020-08-31,LI,Italy,3382,1047,715,17,2335,820,800,1620,698
2020-09-01,LI,Italy,2773,967,629,15,1806,590,587,1177,614
2020-09-02,LI,Italy,2700,912,598,22,1788,584,606,1190,576
2020-09-03,LI,Italy,2994,972,735,16,2022,631,656,1287,719
2020-09-04,LI,Italy,3296,1056,702,22,2240,758,780,1538,680
2020-09-05,LI,Italy,3367,1345,615,15,2022,712,695,1407,600
2020-09-06,LI,Italy,3480,1210,701,14,2270,799,770,1569,687
2020-09-07,LI,Italy,3047,950,693,10,2097,714,690,1404,683
2020-09-08,LI,Italy,2622,902,627,18,1720,540,553,1093,609
2020-09-09,LI,Italy,2743,921,644,24,1822,587,591,1178,620
2020-09-10,LI,Italy,2902,905,724,21,1997,630,643,1273,703
2020-09-11,LI,Italy,3061,974,659,20,2087,691,737,1428,639
2020-09-12,LI,Italy,3083,1260,593,15,1823,610,620,1230,578
2020-09-13,LI,Italy,3338,1146,680,13,2192,769,743,1512,667
2020-09-14,LI,Italy,2764,811,663,15,1953,661,629,1290,648
2020-09-15,LI,Italy,2351,772,567,17,1579,505,507,1012,550
2020-09-16,LI,Italy,2374,788,548,24,1586,523,515,1038,524
2020-09-17,LI,Italy,2506,790,610,11,1716,540,566,1106,599
2020-09-18,LI,Italy,2998,918,638,13,2080,698,744,1442,625
2020-09-19,LI,Italy,2923,1179,586,18,1744,570,588,1158,568
2020-09-20,LI,Italy,3099,1009,633,14,2090,761,696,1457,619
2020-09-21,LI,Italy,2682,744,681,17,1938,641,616,1257,664
2020-09-22,LI,Italy,2190,699,528,11,1491,486,477,963,517
2020-09-23,LI,Italy,2264,712,553,24,1552,491,508,999,529
2020-09-24,LI,Italy,2539,755,661,32,1784,547,576,1123,629
2020-09-25,LI,Italy,2917,856,637,16,2061,718,706,1424,621
2020-09-26,LI,Italy,2868,1123,576,12,1745,580,589,1169,564
2020-09-27,LI,Italy,2947,980,603,16,1967,700,664,1364,587
2020-09-28,LI,Italy,2609,730,639,15,1879,624,616,1240,624
2020-09-29,LI,Italy,2195,648,566,20,1547,490,491,981,546
2020-09-30,LI,Italy,2344,733,567,20,1611,523,521,1044,547
2020-10-01,LI,Italy,2350,741,563,19,1609,518,528,1046,544
2020-10-02,LI,Italy,2600,763,573,10,1837,612,652,1264,563
2020-10-03,LI,Italy,2575,1037,490,10,1538,520,528,1048,480
2020-10-04,LI,Italy,2570,879,515,11,1691,611,565,1176,504
2020-10-05,LI,Italy,2336,666,590,11,1670,548,532,1080,579
2020-10-06,LI,Italy,1881,586,492,16,1295,401,402,803,476
2020-10-07,LI,Italy,1964,571,498,26,1393,442,453,895,472
2020-10-08,LI,Italy,2164,644,584,33,1520,455,481,936,551
2020-10-09,LI,Italy,2673,779,638,24,1894,609,647,1256,614
2020-10-10,LI,Italy,2474,941,511,22,1533,506,516,1022,489
2020-10-11,LI,Italy,2602,861,543,11,1741,620,578,1198,532
2020-10-12,LI,Italy,2361,676,623,10,1685,545,517,1062,613
2020-10-13,LI,Italy,1852,558,549,38,1294,379,366,745,511
2020-10-14,LI,Italy,1957,622,506,30,1335,409,420,829,476
2020-10-15,LI,Italy,2045,583,582,22,1462,434,446,880,560
2020-10-16,LI,Italy,2721,860,625,23,1861,612,624,1236,602
2020-10-17,LI,Italy,2483,966,495,10,1517,517,505,1022,485
2020-10-18,LI,Italy,2452,814,537,5,1638,564,537,1101,532
2020-10-19,LI,Italy,2270,664,618,25,1606,507,481,988,593
2020-10-20,LI,Italy,1740,543,519,44,1197,334,344,678,475
2020-10-21,LI,Italy,1858,633,491,28,1225,365,369,734,463
2020-10-22,LI,Italy,1984,612,567,23,1372,393,412,805,544
2020-10-23,LI,Italy,2392,727,593,25,1665,527,545,1072,568
2020-10-24,LI,Italy,2326,978,442,16,1348,449,457,906,426
2020-10-25,LI,Italy,2282,739,538,15,1543,505,500,1005,523
2020-10-26,LI,Italy,2026,547,594,17,1479,446,439,885,577
2020-10-27,LI,Italy,1626,494,493,17,1132,322,317,639,476
2020-10-28,LI,Italy,1776,561,495,27,1215,363,357,720,468
2020-10-29,LI,Italy,1886,583,545,32,1303,375,383,758,513
2020-10-30,LI,Italy,2293,698,626,28,1595,479,490,969,598
2020-10-31,LI,Italy,1993,809,435,11,1184,376,373,749,424
2020-11-01,LI,Italy,2194,737,534,9,1457,460,463,923,525
2020-11-02,LI,Italy,1947,537,603,32,1410,408,399,807,571
2020-11-03,LI,Italy,1480,426,485,33,1054,287,282,569,452
2020-11-04,LI,Italy,1556,477,473,27,1079,298,308,606,446
2020-11-05,LI,Italy,1574,464,501,28,1110,303,306,609,473
2020-11-06,LI,Italy,1898,519,575,21,1379,403,401,804,554
2020-11-07,LI,Italy,1435,565,388,9,870,241,241,482,379
2020-11-08,LI,Italy,1783,564,487,11,1219,367,365,732,476
2020-11-09,LI,Italy,1538,411,506,40,1127,316,305,621,466
2020-11-10,LI,Italy,1192,358,360,22,834,236,238,474,338
2020-11-11,LI,Italy,1274,398,363,21,876,255,258,513,342
2020-11-12,LI,Italy,1311,411,379,28,900,261,260,521,351
2020-11-13,LI,Italy,1624,466,501,26,1158,325,332,657,475
2020-11-14,LI,Italy,1118,432,295,9,686,197,194,391,286
2020-11-15,LI,Italy,1438,498,378,10,940,270,292,562,368
2020-11-16,LI,Italy,1303,379,428,28,924,259,237,496,400
2020-11-17,LI,Italy,1066,313,358,33,753,194,201,395,325
2020-11-18,LI,Italy,1152,404,314,31,748,216,218,434,283
2020-11-19,LI,Italy,1188,383,342,33,805,228,235,463,309
2020-11-20,LI,Italy,1387,419,423,16,968,273,272,545,407
2020-11-21,LI,Italy,1023,431,250,6,592,166,176,342,244
2020-11-22,LI,Italy,1119,439,289,13,680,199,192,391,276
2020-11-23,LI,Italy,1069,369,305,25,700,203,192,395,280
2020-11-24,LI,Italy,838,281,211,20,557,171,175,346,191
2020-11-25,LI,Italy,999,388,225,12,611,190,196,386,213
2020-11-26,LI,Italy,1052,370,266,23,682,208,208,416,243
2020-11-27,LI,Italy,1300,454,358,16,846,241,247,488,342
2020-11-28,LI,Italy,883,385,174,11,498,161,163,324,163
2020-11-29,LI,Italy,1091,421,265,4,670,198,207,405,261
2020-11-30,LI,Italy,1205,383,354,32,822,237,231,468,322
2020-12-01,LI,Italy,922,330,273,42,592,164,155,319,231
2020-12-02,LI,Italy,1072,416,245,21,656,202,209,411,224
2020-12-03,LI,Italy,1142,420,251,21,722,243,228,471,230
2020-12-04,LI,Italy,1393,425,427,26,968,271,270,541,401
2020-12-05,LI,Italy,1004,421,239,9,583,170,174,344,230
2020-12-06,LI,Italy,1150,441,308,9,709,193,208,401,299
2020-12-07,LI,Italy,1152,375,359,31,777,217,201,418,328
2020-12-08,LI,Italy,910,349,230,11,561,158,173,331,219
2020-12-09,LI,Italy,1214,498,294,23,716,205,217,422,271
2020-12-10,LI,Italy,1246,467,297,23,779,238,244,482,274
2020-12-11,LI,Italy,1492,510,394,20,982,294,294,588,374
2020-12-12,LI,Italy,1127,495,242,13,632,191,199,390,229
2020-12-13,LI,Italy,1302,516,323,13,786,224,239,463,310
2020-12-14,LI,Italy,1335,454,402,30,881,252,227,479,372
2020-12-15,LI,Italy,1177,434,299,33,743,228,216,444,266
2020-12-16,LI,Italy,1349,535,319,33,814,246,249,495,286
2020-12-17,LI,Italy,1646,570,446,30,1076,304,326,630,416
2020-12-18,LI,Italy,2351,786,605,14,1565,475,485,960,591
2020-12-19,LI,Italy,2126,818,526,9,1308,400,382,782,517
2020-12-20,LI,Italy,2069,717,534,5,1352,408,410,818,529
2020-12-21,LI,Italy,1746,585,536,25,1161,315,310,625,511
2020-12-22,LI,Italy,1651,555,528,13,1096,285,283,568,515
2020-12-23,LI,Italy,1926,634,569,11,1292,361,362,723,558
2020-12-24,LI,Italy,1397,489,463,7,908,227,218,445,456
2020-12-25,LI,Italy,714,420,104,0,294,101,89,190,104
2020-12-26,LI,Italy,1169,605,239,3,564,159,166,325,236
2020-12-27,LI,Italy,1695,628,446,5,1067,308,313,621,441
2020-12-28,LI,Italy,1547,551,444,7,996,268,284,552,437
2020-12-29,LI,Italy,1252,459,331,15,793,232,230,462,316
2020-12-30,LI,Italy,1472,556,369,11,916,282,265,547,358
2020-12-31,LI,Italy,884,373,235,6,511,137,139,276,229
2020-01-01,EV,Latvia,633,430,1,0,203,101,101,202,1
2020-01-02,EV,Latvia,772,527,2,1,245,122,121,243,1
2020-01-03,EV,Latvia,746,495,2,0,251,126,123,249,2
2020-01-04,EV,Latvia,709,520,2,1,189,95,92,187,1
2020-01-05,EV,Latvia,685,483,1,0,202,100,101,201,1
2020-01-06,EV,Latvia,701,465,2,0,236,115,119,234,2
2020-01-07,EV,Latvia,671,451,1,0,220,106,113,219,1
2020-01-08,EV,Latvia,694,481,1,0,213,109,103,212,1
2020-01-09,EV,Latvia,683,462,2,1,221,110,109,219,1
2020-01-10,EV,Latvia,701,463,1,0,238,120,117,237,1
2020-01-11,EV,Latvia,717,547,1,0,170,83,86,169,1
2020-01-12,EV,Latvia,694,495,2,1,199,102,95,197,1
2020-01-13,EV,Latvia,686,457,5,3,229,111,113,224,2
2020-01-14,EV,Latvia,652,454,5,4,198,95,98,193,1
2020-01-15,EV,Latvia,668,473,2,1,195,97,96,193,1
2020-01-16,EV,Latvia,675,464,3,2,211,101,107,208,1
2020-01-17,EV,Latvia,766,537,1,0,229,116,112,228,1
2020-01-18,EV,Latvia,638,473,1,0,165,79,85,164,1
2020-01-19,EV,Latvia,637,444,1,0,193,97,95,192,1
2020-01-20,EV,Latvia,703,484,5,3,219,108,106,214,2
2020-01-21,EV,Latvia,641,447,3,2,194,93,98,191,1
2020-01-22,EV,Latvia,642,445,5,4,197,97,95,192,1
2020-01-23,EV,Latvia,685,472,3,1,213,103,107,210,2
2020-01-24,EV,Latvia,734,488,3,2,246,121,122,243,1
2020-01-25,EV,Latvia,620,455,1,0,165,81,83,164,1
2020-01-26,EV,Latvia,668,477,2,1,191,95,94,189,1
2020-01-27,EV,Latvia,630,407,2,0,223,111,110,221,2
2020-01-28,EV,Latvia,574,382,1,0,192,98,93,191,1
2020-01-29,EV,Latvia,628,427,2,1,201,99,100,199,1
2020-01-30,EV,Latvia,685,474,2,1,211,104,105,209,1
2020-01-31,EV,Latvia,734,490,3,2,244,119,122,241,1
2020-02-01,EV,Latvia,645,460,1,0,185,91,93,184,1
2020-02-02,EV,Latvia,662,460,3,2,202,106,93,199,1
2020-02-03,EV,Latvia,645,428,2,0,217,106,109,215,2
2020-02-04,EV,Latvia,597,397,8,7,200,96,96,192,1
2020-02-05,EV,Latvia,615,413,5,4,202,99,98,197,1
2020-02-06,EV,Latvia,620,409,3,2,211,105,103,208,1
2020-02-07,EV,Latvia,707,475,2,1,232,115,115,230,1
2020-02-08,EV,Latvia,610,423,3,2,187,89,95,184,1
2020-02-09,EV,Latvia,598,412,2,1,186,95,89,184,1
2020-02-10,EV,Latvia,614,398,3,1,216,105,108,213,2
2020-02-11,EV,Latvia,581,396,4,3,185,89,92,181,1
2020-02-12,EV,Latvia,605,407,2,1,198,100,96,196,1
2020-02-13,EV,Latvia,671,448,3,2,223,109,111,220,1
2020-02-14,EV,Latvia,677,448,1,0,229,115,113,228,1
2020-02-15,EV,Latvia,608,433,1,0,175,86,88,174,1
2020-02-16,EV,Latvia,665,464,2,1,201,98,101,199,1
2020-02-17,EV,Latvia,631,416,2,0,215,108,105,213,2
2020-02-18,EV,Latvia,585,394,5,4,191,91,95,186,1
2020-02-19,EV,Latvia,591,387,5,4,204,101,98,199,1
2020-02-20,EV,Latvia,692,463,3,2,229,115,111,226,1
2020-02-21,EV,Latvia,682,456,2,1,226,115,109,224,1
2020-02-22,EV,Latvia,630,448,2,1,182,89,91,180,1
2020-02-23,EV,Latvia,642,446,1,0,196,99,96,195,1
2020-02-24,EV,Latvia,628,408,5,3,220,107,108,215,2
2020-02-25,EV,Latvia,611,414,3,2,197,96,98,194,1
2020-02-26,EV,Latvia,594,388,5,4,206,100,101,201,1
2020-02-27,EV,Latvia,645,427,2,1,218,108,108,216,1
2020-02-28,EV,Latvia,686,448,3,2,238,117,118,235,1
2020-02-29,EV,Latvia,645,462,1,0,183,92,90,182,1
2020-03-01,EV,Latvia,648,444,1,0,204,101,102,203,1
2020-03-02,EV,Latvia,640,413,7,5,227,109,111,220,2
2020-03-03,EV,Latvia,613,406,2,1,207,101,104,205,1
2020-03-04,EV,Latvia,637,421,2,1,216,108,106,214,1
2020-03-05,EV,Latvia,656,419,4,3,237,117,116,233,1
2020-03-06,EV,Latvia,696,461,2,1,235,116,117,233,1
2020-03-07,EV,Latvia,626,443,2,1,183,92,89,181,1
2020-03-08,EV,Latvia,661,456,2,1,205,101,102,203,1
2020-03-09,EV,Latvia,639,408,3,1,231,113,115,228,2
2020-03-10,EV,Latvia,636,419,2,1,217,106,109,215,1
2020-03-11,EV,Latvia,603,386,1,0,217,110,106,216,1
2020-03-12,EV,Latvia,635,407,2,0,228,112,114,226,2
2020-03-13,EV,Latvia,637,403,1,0,234,118,115,233,1
2020-03-14,EV,Latvia,553,374,3,2,179,86,90,176,1
2020-03-15,EV,Latvia,601,394,3,2,207,103,101,204,1
2020-03-16,EV,Latvia,517,267,4,3,250,120,126,246,1
2020-03-17,EV,Latvia,324,296,4,2,28,13,11,24,2
2020-03-18,EV,Latvia,307,289,0,0,18,9,9,18,0
2020-03-19,EV,Latvia,289,261,0,0,28,12,16,28,0
2020-03-20,EV,Latvia,267,241,3,1,26,11,12,23,2
2020-03-21,EV,Latvia,225,210,0,0,15,7,8,15,0
2020-03-22,EV,Latvia,193,178,1,1,15,7,7,14,0
2020-03-23,EV,Latvia,195,166,2,2,29,13,14,27,0
2020-03-24,EV,Latvia,179,162,0,0,17,8,9,17,0
2020-03-25,EV,Latvia,180,159,0,0,21,11,10,21,0
2020-03-26,EV,Latvia,172,146,1,1,26,12,13,25,0
2020-03-27,EV,Latvia,190,167,1,1,23,11,11,22,0
2020-03-28,EV,Latvia,134,129,0,0,5,2,3,5,0
2020-03-29,EV,Latvia,126,122,0,0,4,1,3,4,0
2020-03-30,EV,Latvia,123,99,0,0,24,12,12,24,0
2020-03-31,EV,Latvia,106,95,0,0,11,7,4,11,0
2020-04-01,EV,Latvia,106,97,0,0,9,5,4,9,0
2020-04-02,EV,Latvia,109,101,0,0,8,4,4,8,0
2020-04-03,EV,Latvia,128,113,0,0,15,8,7,15,0
2020-04-04,EV,Latvia,112,110,0,0,2,1,1,2,0
2020-04-05,EV,Latvia,111,108,0,0,3,1,2,3,0
2020-04-06,EV,Latvia,127,114,1,1,13,5,7,12,0
2020-04-07,EV,Latvia,112,95,0,0,17,9,8,17,0
2020-04-08,EV,Latvia,138,127,0,0,11,6,5,11,0
2020-04-09,EV,Latvia,141,117,1,1,24,12,11,23,0
2020-04-10,EV,Latvia,140,128,0,0,12,6,6,12,0
2020-04-11,EV,Latvia,127,124,0,0,3,1,2,3,0
2020-04-12,EV,Latvia,123,121,0,0,2,1,1,2,0
2020-04-13,EV,Latvia,117,115,0,0,2,1,1,2,0
2020-04-14,EV,Latvia,129,119,0,0,10,5,5,10,0
2020-04-15,EV,Latvia,154,137,0,0,17,8,9,17,0
2020-04-16,EV,Latvia,137,121,0,0,16,7,9,16,0
2020-04-17,EV,Latvia,148,131,1,1,17,8,8,16,0
2020-04-18,EV,Latvia,119,110,1,1,9,5,3,8,0
2020-04-19,EV,Latvia,125,123,0,0,2,1,1,2,0
2020-04-20,EV,Latvia,129,117,3,2,12,5,4,9,1
2020-04-21,EV,Latvia,130,119,1,1,11,4,6,10,0
2020-04-22,EV,Latvia,152,132,0,0,20,11,9,20,0
2020-04-23,EV,Latvia,167,148,1,1,19,9,9,18,0
2020-04-24,EV,Latvia,165,147,2,2,18,8,8,16,0
2020-04-25,EV,Latvia,147,141,0,0,6,3,3,6,0
2020-04-26,EV,Latvia,159,151,1,1,8,3,4,7,0
2020-04-27,EV,Latvia,174,158,0,0,16,9,7,16,0
2020-04-28,EV,Latvia,166,158,0,0,8,4,4,8,0
2020-04-29,EV,Latvia,204,182,0,0,22,11,11,22,0
2020-04-30,EV,Latvia,175,164,1,1,11,5,5,10,0
2020-05-01,EV,Latvia,173,165,0,0,8,4,4,8,0
2020-05-02,EV,Latvia,170,160,1,1,10,5,4,9,0
2020-05-03,EV,Latvia,187,182,0,0,5,2,3,5,0
2020-05-04,EV,Latvia,189,180,1,1,9,3,5,8,0
2020-05-05,EV,Latvia,181,166,2,2,15,6,7,13,0
2020-05-06,EV,Latvia,223,196,3,3,27,13,11,24,0
2020-05-07,EV,Latvia,202,182,2,2,20,10,8,18,0
2020-05-08,EV,Latvia,199,179,1,1,20,8,11,19,0
2020-05-09,EV,Latvia,173,165,1,1,8,4,3,7,0
2020-05-10,EV,Latvia,164,160,0,0,4,2,2,4,0
2020-05-11,EV,Latvia,200,182,0,0,18,9,9,18,0
2020-05-12,EV,Latvia,213,187,1,1,26,13,12,25,0
2020-05-13,EV,Latvia,237,221,0,0,16,9,7,16,0
2020-05-14,EV,Latvia,224,197,0,0,27,14,13,27,0
2020-05-15,EV,Latvia,232,216,2,1,16,8,6,14,1
2020-05-16,EV,Latvia,204,196,0,0,8,3,5,8,0
2020-05-17,EV,Latvia,216,204,0,0,12,7,5,12,0
2020-05-18,EV,Latvia,220,200,0,0,20,10,10,20,0
2020-05-19,EV,Latvia,224,198,3,3,26,12,11,23,0
2020-05-20,EV,Latvia,239,215,2,0,24,11,11,22,2
2020-05-21,EV,Latvia,227,202,1,1,25,12,12,24,0
2020-05-22,EV,Latvia,250,224,3,3,26,11,12,23,0
2020-05-23,EV,Latvia,224,202,0,0,22,10,12,22,0
2020-05-24,EV,Latvia,216,197,1,1,19,10,8,18,0
2020-05-25,EV,Latvia,235,201,2,2,34,17,15,32,0
2020-05-26,EV,Latvia,225,185,2,2,40,18,20,38,0
2020-05-27,EV,Latvia,247,207,3,1,40,19,18,37,2
2020-05-28,EV,Latvia,234,206,0,0,28,12,16,28,0
2020-05-29,EV,Latvia,239,210,1,1,29,15,13,28,0
2020-05-30,EV,Latvia,200,181,0,0,19,11,8,19,0
2020-05-31,EV,Latvia,217,192,0,0,25,12,13,25,0
2020-06-01,EV,Latvia,217,177,0,0,40,19,21,40,0
2020-06-02,EV,Latvia,211,180,1,1,31,17,13,30,0
2020-06-03,EV,Latvia,225,189,1,1,36,18,17,35,0
2020-06-04,EV,Latvia,244,206,3,3,38,17,18,35,0
2020-06-05,EV,Latvia,234,202,0,0,32,16,16,32,0
2020-06-06,EV,Latvia,230,204,0,0,26,12,14,26,0
2020-06-07,EV,Latvia,195,169,0,0,26,15,11,26,0
2020-06-08,EV,Latvia,225,187,0,0,38,18,20,38,0
2020-06-09,EV,Latvia,192,145,0,0,47,22,25,47,0
2020-06-10,EV,Latvia,248,196,1,1,52,24,27,51,0
2020-06-11,EV,Latvia,232,182,3,3,50,22,25,47,0
2020-06-12,EV,Latvia,234,187,3,3,47,26,18,44,0
2020-06-13,EV,Latvia,197,159,0,0,38,19,19,38,0
2020-06-14,EV,Latvia,234,184,0,0,50,27,23,50,0
2020-06-15,EV,Latvia,251,197,1,1,54,27,26,53,0
2020-06-16,EV,Latvia,221,171,0,0,50,22,28,50,0
2020-06-17,EV,Latvia,252,190,1,1,62,32,29,61,0
2020-06-18,EV,Latvia,253,192,2,2,61,28,31,59,0
2020-06-19,EV,Latvia,238,189,1,1,49,24,24,48,0
2020-06-20,EV,Latvia,218,166,2,2,52,28,22,50,0
2020-06-21,EV,Latvia,205,156,1,1,49,24,24,48,0
2020-06-22,EV,Latvia,269,201,1,1,68,34,33,67,0
2020-06-23,EV,Latvia,233,182,0,0,51,26,25,51,0
2020-06-24,EV,Latvia,263,213,0,0,50,24,26,50,0
2020-06-25,EV,Latvia,247,193,1,1,54,26,27,53,0
2020-06-26,EV,Latvia,257,194,0,0,63,31,32,63,0
2020-06-27,EV,Latvia,234,171,1,1,63,30,32,62,0
2020-06-28,EV,Latvia,239,174,0,0,65,32,33,65,0
2020-06-29,EV,Latvia,263,188,0,0,75,39,36,75,0
2020-06-30,EV,Latvia,237,172,0,0,65,33,32,65,0
2020-07-01,EV,Latvia,328,244,0,0,84,41,43,84,0
2020-07-02,EV,Latvia,305,219,1,1,86,44,41,85,0
2020-07-03,EV,Latvia,327,234,0,0,93,48,45,93,0
2020-07-04,EV,Latvia,298,215,2,2,83,39,42,81,0
2020-07-05,EV,Latvia,284,200,1,1,84,40,43,83,0
2020-07-06,EV,Latvia,290,191,1,1,99,50,48,98,0
2020-07-07,EV,Latvia,269,173,0,0,96,48,48,96,0
2020-07-08,EV,Latvia,309,217,1,1,92,46,45,91,0
2020-07-09,EV,Latvia,310,208,2,2,102,50,50,100,0
2020-07-10,EV,Latvia,327,231,0,0,96,47,49,96,0
2020-07-11,EV,Latvia,273,198,1,1,75,36,38,74,0
2020-07-12,EV,Latvia,276,188,1,1,88,45,42,87,0
2020-07-13,EV,Latvia,302,206,4,3,96,47,45,92,1
2020-07-14,EV,Latvia,288,184,1,0,104,52,51,103,1
2020-07-15,EV,Latvia,313,194,2,1,119,59,58,117,1
2020-07-16,EV,Latvia,326,208,1,0,118,59,58,117,1
2020-07-17,EV,Latvia,325,213,2,1,112,52,58,110,1
2020-07-18,EV,Latvia,331,230,4,1,101,51,46,97,3
2020-07-19,EV,Latvia,312,193,4,3,119,55,60,115,1
2020-07-20,EV,Latvia,325,201,2,1,124,61,61,122,1
2020-07-21,EV,Latvia,315,204,1,1,111,57,53,110,0
2020-07-22,EV,Latvia,333,218,9,8,115,54,52,106,1
2020-07-23,EV,Latvia,350,226,1,0,124,62,61,123,1
2020-07-24,EV,Latvia,343,231,1,0,112,55,56,111,1
2020-07-25,EV,Latvia,316,216,2,1,100,49,49,98,1
2020-07-26,EV,Latvia,337,213,3,2,124,59,62,121,1
2020-07-27,EV,Latvia,307,189,2,0,118,58,58,116,2
2020-07-28,EV,Latvia,303,198,2,1,105,52,51,103,1
2020-07-29,EV,Latvia,338,217,1,1,121,60,60,120,0
2020-07-30,EV,Latvia,334,213,0,0,121,60,61,121,0
2020-07-31,EV,Latvia,357,231,1,0,126,61,64,125,1
2020-08-01,EV,Latvia,373,248,2,1,125,63,60,123,1
2020-08-02,EV,Latvia,358,228,3,2,130,64,63,127,1
2020-08-03,EV,Latvia,320,193,6,4,127,60,61,121,2
2020-08-04,EV,Latvia,322,199,2,1,123,60,61,121,1
2020-08-05,EV,Latvia,378,237,3,2,141,70,68,138,1
2020-08-06,EV,Latvia,382,246,3,2,136,65,68,133,1
2020-08-07,EV,Latvia,345,225,2,2,120,61,57,118,0
2020-08-08,EV,Latvia,336,219,1,1,117,56,60,116,0
2020-08-09,EV,Latvia,370,251,2,1,119,60,57,117,1
2020-08-10,EV,Latvia,329,215,5,3,114,55,54,109,2
2020-08-11,EV,Latvia,350,227,3,2,123,57,63,120,1
2020-08-12,EV,Latvia,372,247,2,1,125,64,59,123,1
2020-08-13,EV,Latvia,375,261,1,1,114,55,58,113,0
2020-08-14,EV,Latvia,398,265,1,0,133,63,69,132,1
2020-08-15,EV,Latvia,399,288,6,3,111,53,52,105,3
2020-08-16,EV,Latvia,390,270,3,2,120,60,57,117,1
2020-08-17,EV,Latvia,360,243,1,0,117,60,56,116,1
2020-08-18,EV,Latvia,353,261,2,0,92,43,47,90,2
2020-08-19,EV,Latvia,364,244,6,3,120,58,56,114,3
2020-08-20,EV,Latvia,381,253,3,2,128,61,64,125,1
2020-08-21,EV,Latvia,372,258,3,2,114,56,55,111,1
2020-08-22,EV,Latvia,372,269,1,0,103,50,52,102,1
2020-08-23,EV,Latvia,362,248,2,0,114,58,54,112,2
2020-08-24,EV,Latvia,313,210,2,1,103,52,49,101,1
2020-08-25,EV,Latvia,316,229,1,1,87,41,45,86,0
2020-08-26,EV,Latvia,364,257,2,1,107,52,53,105,1
2020-08-27,EV,Latvia,373,269,2,1,104,53,49,102,1
2020-08-28,EV,Latvia,375,263,3,2,112,54,55,109,1
2020-08-29,EV,Latvia,351,262,2,1,89,41,46,87,1
2020-08-30,EV,Latvia,367,267,4,3,100,51,45,96,1
2020-08-31,EV,Latvia,334,241,2,1,93,45,46,91,1
2020-09-01,EV,Latvia,315,216,1,1,99,47,51,98,0
2020-09-02,EV,Latvia,337,249,1,0,88,44,43,87,1
2020-09-03,EV,Latvia,374,267,5,3,107,49,53,102,2
2020-09-04,EV,Latvia,358,250,3,1,108,53,52,105,2
2020-09-05,EV,Latvia,365,252,5,4,113,54,54,108,1
2020-09-06,EV,Latvia,377,255,1,0,122,61,60,121,1
2020-09-07,EV,Latvia,359,225,1,0,134,67,66,133,1
2020-09-08,EV,Latvia,316,217,0,0,99,49,50,99,0
2020-09-09,EV,Latvia,363,245,4,3,118,56,58,114,1
2020-09-10,EV,Latvia,373,244,4,3,129,61,64,125,1
2020-09-11,EV,Latvia,392,259,2,1,133,68,63,131,1
2020-09-12,EV,Latvia,344,244,4,3,100,49,47,96,1
2020-09-13,EV,Latvia,374,248,1,0,126,65,60,125,1
2020-09-14,EV,Latvia,348,221,2,1,127,62,63,125,1
2020-09-15,EV,Latvia,313,212,2,2,101,47,52,99,0
2020-09-16,EV,Latvia,340,237,5,4,103,47,51,98,1
2020-09-17,EV,Latvia,348,232,2,1,116,53,61,114,1
2020-09-18,EV,Latvia,411,261,3,2,150,78,69,147,1
2020-09-19,EV,Latvia,347,247,2,1,100,50,48,98,1
2020-09-20,EV,Latvia,379,257,4,3,122,60,58,118,1
2020-09-21,EV,Latvia,325,213,1,0,112,53,58,111,1
2020-09-22,EV,Latvia,300,211,1,1,89,43,45,88,0
2020-09-23,EV,Latvia,331,225,7,6,106,50,49,99,1
2020-09-24,EV,Latvia,334,231,1,0,103,50,52,102,1
2020-09-25,EV,Latvia,405,274,1,0,131,65,65,130,1
2020-09-26,EV,Latvia,310,226,2,1,84,40,42,82,1
2020-09-27,EV,Latvia,359,246,5,4,113,55,53,108,1
2020-09-28,EV,Latvia,352,232,4,3,120,58,58,116,1
2020-09-29,EV,Latvia,329,237,4,4,92,42,46,88,0
2020-09-30,EV,Latvia,337,231,4,3,106,53,49,102,1
2020-10-01,EV,Latvia,305,219,2,1,86,41,43,84,1
2020-10-02,EV,Latvia,373,257,3,1,116,60,53,113,2
2020-10-03,EV,Latvia,301,233,2,1,68,33,33,66,1
2020-10-04,EV,Latvia,307,221,1,1,86,43,42,85,0
2020-10-05,EV,Latvia,309,207,1,1,102,51,50,101,0
2020-10-06,EV,Latvia,252,177,2,2,75,37,36,73,0
2020-10-07,EV,Latvia,289,206,4,4,83,40,39,79,0
2020-10-08,EV,Latvia,297,206,1,1,91,44,46,90,0
2020-10-09,EV,Latvia,336,228,1,1,108,56,51,107,0
2020-10-10,EV,Latvia,296,216,0,0,80,37,43,80,0
2020-10-11,EV,Latvia,316,224,2,2,92,48,42,90,0
2020-10-12,EV,Latvia,316,223,0,0,93,45,48,93,0
2020-10-13,EV,Latvia,274,200,1,1,74,39,34,73,0
2020-10-14,EV,Latvia,311,229,2,2,82,40,40,80,0
2020-10-15,EV,Latvia,305,229,1,1,76,35,40,75,0
2020-10-16,EV,Latvia,367,257,0,0,110,55,55,110,0
2020-10-17,EV,Latvia,341,250,1,1,91,47,43,90,0
2020-10-18,EV,Latvia,316,234,1,1,82,41,40,81,0
2020-10-19,EV,Latvia,290,204,1,1,86,39,46,85,0
2020-10-20,EV,Latvia,278,218,0,0,60,31,29,60,0
2020-10-21,EV,Latvia,289,229,3,3,60,29,28,57,0
2020-10-22,EV,Latvia,314,235,1,1,79,39,39,78,0
2020-10-23,EV,Latvia,348,256,1,1,92,48,43,91,0
2020-10-24,EV,Latvia,333,266,0,0,67,34,33,67,0
2020-10-25,EV,Latvia,334,248,2,2,86,43,41,84,0
2020-10-26,EV,Latvia,290,203,0,0,87,41,46,87,0
2020-10-27,EV,Latvia,258,185,1,1,73,36,36,72,0
2020-10-28,EV,Latvia,302,229,0,0,73,38,35,73,0
2020-10-29,EV,Latvia,311,216,0,0,95,46,49,95,0
2020-10-30,EV,Latvia,331,248,2,2,83,41,40,81,0
2020-10-31,EV,Latvia,313,239,3,3,74,32,39,71,0
2020-11-01,EV,Latvia,315,226,3,3,89,45,41,86,0
2020-11-02,EV,Latvia,291,216,0,0,75,38,37,75,0
2020-11-03,EV,Latvia,257,186,2,2,71,33,36,69,0
2020-11-04,EV,Latvia,286,224,2,2,62,30,30,60,0
2020-11-05,EV,Latvia,321,252,2,2,69,33,34,67,0
2020-11-06,EV,Latvia,298,219,2,2,79,37,40,77,0
2020-11-07,EV,Latvia,309,239,0,0,70,35,35,70,0
2020-11-08,EV,Latvia,328,250,1,1,78,40,37,77,0
2020-11-09,EV,Latvia,295,215,2,2,80,40,38,78,0
2020-11-10,EV,Latvia,256,201,5,3,55,22,28,50,2
2020-11-11,EV,Latvia,275,217,5,5,58,27,26,53,0
2020-11-12,EV,Latvia,307,234,3,3,73,36,34,70,0
2020-11-13,EV,Latvia,314,233,2,2,81,37,42,79,0
2020-11-14,EV,Latvia,284,237,0,0,47,22,25,47,0
2020-11-15,EV,Latvia,296,223,1,0,73,36,36,72,1
2020-11-16,EV,Latvia,280,211,3,3,69,35,31,66,0
2020-11-17,EV,Latvia,244,199,2,2,45,21,22,43,0
2020-11-18,EV,Latvia,292,229,0,0,63,35,28,63,0
2020-11-19,EV,Latvia,296,229,0,0,67,35,32,67,0
2020-11-20,EV,Latvia,290,224,4,4,66,32,30,62,0
2020-11-21,EV,Latvia,258,216,2,2,42,19,21,40,0
2020-11-22,EV,Latvia,271,211,1,1,60,30,29,59,0
2020-11-23,EV,Latvia,294,217,4,4,77,36,37,73,0
2020-11-24,EV,Latvia,246,206,2,2,40,16,22,38,0
2020-11-25,EV,Latvia,294,242,4,3,52,25,23,48,1
2020-11-26,EV,Latvia,279,222,5,5,57,27,25,52,0
2020-11-27,EV,Latvia,288,227,5,5,61,29,27,56,0
2020-11-28,EV,Latvia,264,221,1,1,43,20,22,42,0
2020-11-29,EV,Latvia,270,214,0,0,56,28,28,56,0
2020-11-30,EV,Latvia,299,231,0,0,68,33,35,68,0
2020-12-01,EV,Latvia,239,198,0,0,41,19,22,41,0
2020-12-02,EV,Latvia,276,219,1,1,57,30,26,56,0
2020-12-03,EV,Latvia,314,247,0,0,67,34,33,67,0
2020-12-04,EV,Latvia,327,256,0,0,71,35,36,71,0
2020-12-05,EV,Latvia,259,212,0,0,47,23,24,47,0
2020-12-06,EV,Latvia,293,220,0,0,73,37,36,73,0
2020-12-07,EV,Latvia,297,226,0,0,71,35,36,71,0
2020-12-08,EV,Latvia,292,239,1,1,53,25,27,52,0
2020-12-09,EV,Latvia,288,238,0,0,50,23,27,50,0
2020-12-10,EV,Latvia,319,249,1,1,70,37,32,69,0
2020-12-11,EV,Latvia,329,255,0,0,74,36,38,74,0
2020-12-12,EV,Latvia,286,224,0,0,62,32,30,62,0
2020-12-13,EV,Latvia,354,281,0,0,73,35,38,73,0
2020-12-14,EV,Latvia,279,212,0,0,67,33,34,67,0
2020-12-15,EV,Latvia,275,206,2,2,69,34,33,67,0
2020-12-16,EV,Latvia,292,222,4,2,70,35,31,66,2
2020-12-17,EV,Latvia,348,261,3,3,87,41,43,84,0
2020-12-18,EV,Latvia,361,256,3,3,105,52,50,102,0
2020-12-19,EV,Latvia,383,298,0,0,85,44,41,85,0
2020-12-20,EV,Latvia,335,244,1,1,91,43,47,90,0
2020-12-21,EV,Latvia,319,251,1,1,68,35,32,67,0
2020-12-22,EV,Latvia,278,197,1,1,81,40,40,80,0
2020-12-23,EV,Latvia,332,235,1,1,97,48,48,96,0
2020-12-24,EV,Latvia,254,182,1,1,72,36,35,71,0
2020-12-25,EV,Latvia,211,167,0,0,44,24,20,44,0
2020-12-26,EV,Latvia,243,201,0,0,42,22,20,42,0
2020-12-27,EV,Latvia,303,218,0,0,85,42,43,85,0
2020-12-28,EV,Latvia,284,199,0,0,85,41,44,85,0
2020-12-29,EV,Latvia,227,177,0,0,50,25,25,50,0
2020-12-30,EV,Latvia,276,196,1,1,80,36,43,79,0
2020-12-31,EV,Latvia,215,169,0,0,46,23,23,46,0
2020-01-01,EY,Lithuania,620,497,1,1,123,60,62,122,0
2020-01-02,EY,Lithuania,797,612,3,2,185,91,91,182,1
2020-01-03,EY,Lithuania,765,606,3,2,159,80,76,156,1
2020-01-04,EY,Lithuania,740,589,2,2,151,77,72,149,0
2020-01-05,EY,Lithuania,739,600,0,0,139,67,72,139,0
2020-01-06,EY,Lithuania,726,567,0,0,159,79,80,159,0
2020-01-07,EY,Lithuania,707,534,1,0,173,85,87,172,1
2020-01-08,EY,Lithuania,732,581,2,2,151,75,74,149,0
2020-01-09,EY,Lithuania,722,571,7,7,151,71,73,144,0
2020-01-10,EY,Lithuania,730,575,1,1,155,79,75,154,0
2020-01-11,EY,Lithuania,716,567,5,5,149,74,70,144,0
2020-01-12,EY,Lithuania,761,627,0,0,134,64,70,134,0
2020-01-13,EY,Lithuania,727,557,6,3,170,82,82,164,3
2020-01-14,EY,Lithuania,671,507,2,2,164,81,81,162,0
2020-01-15,EY,Lithuania,719,564,3,3,155,78,74,152,0
2020-01-16,EY,Lithuania,687,538,5,4,149,70,74,144,1
2020-01-17,EY,Lithuania,724,557,6,5,167,82,79,161,1
2020-01-18,EY,Lithuania,675,531,3,3,144,72,69,141,0
2020-01-19,EY,Lithuania,721,586,2,1,135,65,68,133,1
2020-01-20,EY,Lithuania,709,549,4,2,160,77,79,156,2
2020-01-21,EY,Lithuania,667,504,2,1,163,81,80,161,1
2020-01-22,EY,Lithuania,686,537,6,6,149,69,74,143,0
2020-01-23,EY,Lithuania,714,558,9,7,156,75,72,147,2
2020-01-24,EY,Lithuania,732,568,2,2,164,83,79,162,0
2020-01-25,EY,Lithuania,661,520,3,3,141,71,67,138,0
2020-01-26,EY,Lithuania,684,547,1,0,137,65,71,136,1
2020-01-27,EY,Lithuania,664,504,1,0,160,80,79,159,1
2020-01-28,EY,Lithuania,646,488,1,0,158,77,80,157,1
2020-01-29,EY,Lithuania,684,526,4,4,158,79,75,154,0
2020-01-30,EY,Lithuania,684,535,5,4,149,71,73,144,1
2020-01-31,EY,Lithuania,717,555,4,3,162,78,80,158,1
2020-02-01,EY,Lithuania,663,518,2,2,145,74,69,143,0
2020-02-02,EY,Lithuania,699,564,0,0,135,66,69,135,0
2020-02-03,EY,Lithuania,667,504,5,3,163,78,80,158,2
2020-02-04,EY,Lithuania,661,489,5,5,172,84,83,167,0
2020-02-05,EY,Lithuania,661,509,6,6,152,74,72,146,0
2020-02-06,EY,Lithuania,675,521,10,5,154,72,72,144,5
2020-02-07,EY,Lithuania,677,512,6,5,165,80,79,159,1
2020-02-08,EY,Lithuania,659,511,3,3,148,75,70,145,0
2020-02-09,EY,Lithuania,643,511,1,0,132,63,68,131,1
2020-02-10,EY,Lithuania,689,528,5,2,161,79,77,156,3
2020-02-11,EY,Lithuania,659,477,4,4,182,89,89,178,0
2020-02-12,EY,Lithuania,657,500,5,3,157,77,75,152,2
2020-02-13,EY,Lithuania,694,539,2,2,155,76,77,153,0
2020-02-14,EY,Lithuania,705,541,4,2,164,81,79,160,2
2020-02-15,EY,Lithuania,688,536,5,2,152,74,73,147,3
2020-02-16,EY,Lithuania,691,557,1,1,134,64,69,133,0
2020-02-17,EY,Lithuania,662,502,2,0,160,78,80,158,2
2020-02-18,EY,Lithuania,642,470,6,5,172,83,83,166,1
2020-02-19,EY,Lithuania,665,499,7,5,166,80,79,159,2
2020-02-20,EY,Lithuania,726,557,10,5,169,78,81,159,5
2020-02-21,EY,Lithuania,682,521,6,1,161,78,77,155,5
2020-02-22,EY,Lithuania,704,545,6,1,159,78,75,153,5
2020-02-23,EY,Lithuania,686,549,1,1,137,67,69,136,0
2020-02-24,EY,Lithuania,697,533,4,4,164,80,80,160,0
2020-02-25,EY,Lithuania,663,485,3,3,178,83,92,175,0
2020-02-26,EY,Lithuania,651,483,6,6,168,85,77,162,0
2020-02-27,EY,Lithuania,683,531,2,2,152,73,77,150,0
2020-02-28,EY,Lithuania,720,563,5,3,157,77,75,152,2
2020-02-29,EY,Lithuania,714,562,4,4,152,75,73,148,0
2020-03-01,EY,Lithuania,670,534,2,0,136,66,68,134,2
2020-03-02,EY,Lithuania,669,505,6,5,164,79,79,158,1
2020-03-03,EY,Lithuania,688,513,4,3,175,85,86,171,1
2020-03-04,EY,Lithuania,684,524,7,6,160,78,75,153,1
2020-03-05,EY,Lithuania,699,534,10,10,165,77,78,155,0
2020-03-06,EY,Lithuania,724,557,6,6,167,81,80,161,0
2020-03-07,EY,Lithuania,689,541,0,0,148,75,73,148,0
2020-03-08,EY,Lithuania,700,559,1,0,141,68,72,140,1
2020-03-09,EY,Lithuania,689,522,4,4,167,82,81,163,0
2020-03-10,EY,Lithuania,707,518,5,4,189,91,93,184,1
2020-03-11,EY,Lithuania,669,528,3,3,141,70,68,138,0
2020-03-12,EY,Lithuania,667,519,1,1,148,72,75,147,0
2020-03-13,EY,Lithuania,644,498,1,0,146,72,73,145,1
2020-03-14,EY,Lithuania,601,466,1,1,135,68,66,134,0
2020-03-15,EY,Lithuania,593,464,2,2,129,64,63,127,0
2020-03-16,EY,Lithuania,509,398,7,5,111,52,52,104,2
2020-03-17,EY,Lithuania,375,280,5,4,95,46,44,90,1
2020-03-18,EY,Lithuania,351,280,4,3,71,32,35,67,1
2020-03-19,EY,Lithuania,300,240,4,3,60,27,29,56,1
2020-03-20,EY,Lithuania,305,254,3,2,51,22,26,48,1
2020-03-21,EY,Lithuania,278,235,3,3,43,18,22,40,0
2020-03-22,EY,Lithuania,254,214,2,1,40,19,19,38,1
2020-03-23,EY,Lithuania,234,182,6,5,52,22,24,46,1
2020-03-24,EY,Lithuania,210,170,2,1,40,19,19,38,1
2020-03-25,EY,Lithuania,213,184,7,3,29,12,10,22,4
2020-03-26,EY,Lithuania,213,177,9,4,36,12,15,27,5
2020-03-27,EY,Lithuania,233,189,10,6,44,18,16,34,4
2020-03-28,EY,Lithuania,164,145,8,8,19,6,5,11,0
2020-03-29,EY,Lithuania,163,146,2,2,17,8,7,15,0
2020-03-30,EY,Lithuania,164,135,7,6,29,12,10,22,1
2020-03-31,EY,Lithuania,144,116,5,4,28,11,12,23,1
2020-04-01,EY,Lithuania,158,123,8,8,35,14,13,27,0
2020-04-02,EY,Lithuania,140,111,4,1,29,11,14,25,3
2020-04-03,EY,Lithuania,141,113,2,2,28,13,13,26,0
2020-04-04,EY,Lithuania,107,99,4,4,8,2,2,4,0
2020-04-05,EY,Lithuania,104,99,0,0,5,2,3,5,0
2020-04-06,EY,Lithuania,141,109,7,7,32,13,12,25,0
2020-04-07,EY,Lithuania,134,105,3,3,29,13,13,26,0
2020-04-08,EY,Lithuania,139,109,7,7,30,11,12,23,0
2020-04-09,EY,Lithuania,164,136,5,5,28,12,11,23,0
2020-04-10,EY,Lithuania,135,113,9,8,22,6,7,13,1
2020-04-11,EY,Lithuania,131,106,5,5,25,10,10,20,0
2020-04-12,EY,Lithuania,117,110,0,0,7,3,4,7,0
2020-04-13,EY,Lithuania,114,98,5,4,16,6,5,11,1
2020-04-14,EY,Lithuania,137,116,5,5,21,8,8,16,0
2020-04-15,EY,Lithuania,159,136,4,4,23,10,9,19,0
2020-04-16,EY,Lithuania,148,127,4,4,21,7,10,17,0
2020-04-17,EY,Lithuania,161,129,7,6,32,15,10,25,1
2020-04-18,EY,Lithuania,122,106,5,5,16,4,7,11,0
2020-04-19,EY,Lithuania,119,104,1,1,15,5,9,14,0
2020-04-20,EY,Lithuania,141,107,5,5,34,17,12,29,0
2020-04-21,EY,Lithuania,141,105,7,7,36,14,15,29,0
2020-04-22,EY,Lithuania,152,126,4,4,26,11,11,22,0
2020-04-23,EY,Lithuania,185,151,5,5,34,15,14,29,0
2020-04-24,EY,Lithuania,172,137,6,5,35,14,15,29,1
2020-04-25,EY,Lithuania,139,122,6,6,17,4,7,11,0
2020-04-26,EY,Lithuania,140,130,1,1,10,6,3,9,0
2020-04-27,EY,Lithuania,168,132,5,4,36,15,16,31,1
2020-04-28,EY,Lithuania,180,140,7,7,40,16,17,33,0
2020-04-29,EY,Lithuania,211,175,6,6,36,13,17,30,0
2020-04-30,EY,Lithuania,199,163,2,2,36,17,17,34,0
2020-05-01,EY,Lithuania,159,147,1,1,12,5,6,11,0
2020-05-02,EY,Lithuania,144,136,0,0,8,4,4,8,0
2020-05-03,EY,Lithuania,146,139,1,1,7,4,2,6,0
2020-05-04,EY,Lithuania,161,131,6,6,30,11,13,24,0
2020-05-05,EY,Lithuania,176,146,9,6,30,10,11,21,3
2020-05-06,EY,Lithuania,197,170,10,6,27,9,8,17,4
2020-05-07,EY,Lithuania,193,155,12,10,38,12,14,26,2
2020-05-08,EY,Lithuania,207,167,11,10,40,15,14,29,1
2020-05-09,EY,Lithuania,174,162,4,4,12,4,4,8,0
2020-05-10,EY,Lithuania,154,147,3,3,7,2,2,4,0
2020-05-11,EY,Lithuania,192,152,11,9,40,14,15,29,2
2020-05-12,EY,Lithuania,209,171,12,11,38,12,14,26,1
2020-05-13,EY,Lithuania,217,183,10,10,34,12,12,24,0
2020-05-14,EY,Lithuania,220,184,16,13,36,10,10,20,3
2020-05-15,EY,Lithuania,221,177,14,10,44,14,16,30,4
2020-05-16,EY,Lithuania,185,171,4,4,14,6,4,10,0
2020-05-17,EY,Lithuania,158,145,5,5,13,3,5,8,0
2020-05-18,EY,Lithuania,219,174,7,7,45,21,17,38,0
2020-05-19,EY,Lithuania,212,171,7,7,41,18,16,34,0
2020-05-20,EY,Lithuania,231,183,17,14,48,16,15,31,3
2020-05-21,EY,Lithuania,218,173,15,11,45,13,17,30,4
2020-05-22,EY,Lithuania,218,171,11,4,47,18,18,36,7
2020-05-23,EY,Lithuania,181,163,9,9,18,5,4,9,0
2020-05-24,EY,Lithuania,163,143,1,1,20,7,12,19,0
2020-05-25,EY,Lithuania,205,162,15,12,43,13,15,28,3
2020-05-26,EY,Lithuania,188,145,14,11,43,15,14,29,3
2020-05-27,EY,Lithuania,237,190,14,14,47,15,18,33,0
2020-05-28,EY,Lithuania,209,164,13,13,45,17,15,32,0
2020-05-29,EY,Lithuania,214,158,19,11,56,17,20,37,8
2020-05-30,EY,Lithuania,174,154,11,11,20,5,4,9,0
2020-05-31,EY,Lithuania,177,157,6,5,20,6,8,14,1
2020-06-01,EY,Lithuania,203,153,13,13,50,18,19,37,0
2020-06-02,EY,Lithuania,200,162,14,10,38,12,12,24,4
2020-06-03,EY,Lithuania,219,165,15,13,54,20,19,39,2
2020-06-04,EY,Lithuania,205,156,17,15,49,16,16,32,2
2020-06-05,EY,Lithuania,217,155,12,8,62,24,26,50,4
2020-06-06,EY,Lithuania,196,162,14,8,34,9,11,20,6
2020-06-07,EY,Lithuania,173,157,4,4,16,6,6,12,0
2020-06-08,EY,Lithuania,211,154,15,7,57,24,18,42,8
2020-06-09,EY,Lithuania,202,151,7,6,51,20,24,44,1
2020-06-10,EY,Lithuania,228,169,15,9,59,20,24,44,6
2020-06-11,EY,Lithuania,234,176,15,10,58,23,20,43,5
2020-06-12,EY,Lithuania,237,178,23,15,59,17,19,36,8
2020-06-13,EY,Lithuania,199,164,11,8,35,12,12,24,3
2020-06-14,EY,Lithuania,204,180,2,1,24,13,9,22,1
2020-06-15,EY,Lithuania,248,180,12,7,68,28,28,56,5
2020-06-16,EY,Lithuania,232,161,12,10,71,31,28,59,2
2020-06-17,EY,Lithuania,251,188,13,8,63,26,24,50,5
2020-06-18,EY,Lithuania,236,175,13,4,61,20,28,48,9
2020-06-19,EY,Lithuania,251,186,11,7,65,29,25,54,4
2020-06-20,EY,Lithuania,212,171,12,10,41,14,15,29,2
2020-06-21,EY,Lithuania,205,167,1,1,38,18,19,37,0
2020-06-22,EY,Lithuania,258,194,7,6,64,26,31,57,1
2020-06-23,EY,Lithuania,253,184,10,9,69,30,29,59,1
2020-06-24,EY,Lithuania,249,198,10,10,51,20,21,41,0
2020-06-25,EY,Lithuania,256,181,19,16,75,27,29,56,3
2020-06-26,EY,Lithuania,252,183,11,9,69,31,27,58,2
2020-06-27,EY,Lithuania,223,176,10,9,47,17,20,37,1
2020-06-28,EY,Lithuania,234,186,4,1,48,20,24,44,3
2020-06-29,EY,Lithuania,260,188,7,7,72,34,31,65,0
2020-06-30,EY,Lithuania,258,180,14,9,78,32,32,64,5
2020-07-01,EY,Lithuania,348,247,14,11,101,45,42,87,3
2020-07-02,EY,Lithuania,328,223,11,8,105,49,45,94,3
2020-07-03,EY,Lithuania,335,236,13,11,99,45,41,86,2
2020-07-04,EY,Lithuania,343,248,6,6,95,42,47,89,0
2020-07-05,EY,Lithuania,281,215,2,1,66,32,32,64,1
2020-07-06,EY,Lithuania,302,230,13,10,72,29,30,59,3
2020-07-07,EY,Lithuania,337,218,19,13,119,52,48,100,6
2020-07-08,EY,Lithuania,326,242,12,11,84,36,36,72,1
2020-07-09,EY,Lithuania,360,264,13,13,96,41,42,83,0
2020-07-10,EY,Lithuania,337,246,7,5,91,40,44,84,2
2020-07-11,EY,Lithuania,331,243,8,7,88,39,41,80,1
2020-07-12,EY,Lithuania,314,237,3,3,77,38,36,74,0
2020-07-13,EY,Lithuania,321,233,16,14,88,35,37,72,2
2020-07-14,EY,Lithuania,358,244,13,12,114,53,48,101,1
2020-07-15,EY,Lithuania,361,272,17,16,89,33,39,72,1
2020-07-16,EY,Lithuania,381,278,17,15,103,44,42,86,2
2020-07-17,EY,Lithuania,350,252,13,9,98,43,42,85,4
2020-07-18,EY,Lithuania,349,259,12,11,90,38,40,78,1
2020-07-19,EY,Lithuania,339,266,0,0,73,37,36,73,0
2020-07-20,EY,Lithuania,340,247,15,13,93,40,38,78,2
2020-07-21,EY,Lithuania,355,244,16,12,111,46,49,95,4
2020-07-22,EY,Lithuania,361,274,12,12,87,39,36,75,0
2020-07-23,EY,Lithuania,401,291,18,12,110,44,48,92,6
2020-07-24,EY,Lithuania,383,279,17,16,104,44,43,87,1
2020-07-25,EY,Lithuania,376,278,12,11,98,43,43,86,1
2020-07-26,EY,Lithuania,362,292,2,0,70,32,36,68,2
2020-07-27,EY,Lithuania,335,247,18,17,88,36,34,70,1
2020-07-28,EY,Lithuania,344,234,15,11,110,48,47,95,4
2020-07-29,EY,Lithuania,366,276,16,10,90,38,36,74,6
2020-07-30,EY,Lithuania,386,281,11,8,105,46,48,94,3
2020-07-31,EY,Lithuania,395,284,17,15,111,45,49,94,2
2020-08-01,EY,Lithuania,417,307,8,8,110,52,50,102,0
2020-08-02,EY,Lithuania,405,320,7,4,85,39,39,78,3
2020-08-03,EY,Lithuania,369,265,16,14,104,45,43,88,2
2020-08-04,EY,Lithuania,410,285,18,14,125,53,54,107,4
2020-08-05,EY,Lithuania,407,312,13,12,95,40,42,82,1
2020-08-06,EY,Lithuania,421,298,14,13,123,57,52,109,1
2020-08-07,EY,Lithuania,396,291,16,14,105,43,46,89,2
2020-08-08,EY,Lithuania,404,304,8,8,100,46,46,92,0
2020-08-09,EY,Lithuania,395,308,4,2,87,43,40,83,2
2020-08-10,EY,Lithuania,379,283,9,8,96,45,42,87,1
2020-08-11,EY,Lithuania,410,296,13,11,114,49,52,101,2
2020-08-12,EY,Lithuania,415,317,13,13,98,44,41,85,0
2020-08-13,EY,Lithuania,422,298,15,12,124,54,55,109,3
2020-08-14,EY,Lithuania,450,337,16,11,113,48,49,97,5
2020-08-15,EY,Lithuania,442,329,12,10,113,53,48,101,2
2020-08-16,EY,Lithuania,435,340,2,0,95,46,47,93,2
2020-08-17,EY,Lithuania,436,314,16,12,122,52,54,106,4
2020-08-18,EY,Lithuania,438,299,17,17,139,60,62,122,0
2020-08-19,EY,Lithuania,425,313,26,23,112,43,43,86,3
2020-08-20,EY,Lithuania,470,321,23,18,149,62,64,126,5
2020-08-21,EY,Lithuania,435,312,21,17,123,51,51,102,4
2020-08-22,EY,Lithuania,442,327,15,13,115,53,47,100,2
2020-08-23,EY,Lithuania,398,308,3,3,90,41,46,87,0
2020-08-24,EY,Lithuania,384,267,13,9,117,52,52,104,4
2020-08-25,EY,Lithuania,395,254,18,18,141,63,60,123,0
2020-08-26,EY,Lithuania,402,294,12,11,108,49,47,96,1
2020-08-27,EY,Lithuania,420,288,11,9,132,60,61,121,2
2020-08-28,EY,Lithuania,411,303,15,12,108,45,48,93,3
2020-08-29,EY,Lithuania,413,313,6,6,100,49,45,94,0
2020-08-30,EY,Lithuania,393,295,0,0,98,48,50,98,0
2020-08-31,EY,Lithuania,396,287,4,4,109,51,54,105,0
2020-09-01,EY,Lithuania,378,261,6,5,117,58,53,111,1
2020-09-02,EY,Lithuania,390,276,8,8,114,52,54,106,0
2020-09-03,EY,Lithuania,417,281,8,8,136,61,67,128,0
2020-09-04,EY,Lithuania,407,287,8,5,120,57,55,112,3
2020-09-05,EY,Lithuania,381,279,10,10,102,47,45,92,0
2020-09-06,EY,Lithuania,384,294,4,3,90,43,43,86,1
2020-09-07,EY,Lithuania,377,267,14,13,110,47,49,96,1
2020-09-08,EY,Lithuania,366,253,11,10,113,52,50,102,1
2020-09-09,EY,Lithuania,380,286,12,12,94,41,41,82,0
2020-09-10,EY,Lithuania,432,309,12,10,123,54,57,111,2
2020-09-11,EY,Lithuania,407,291,9,9,116,54,53,107,0
2020-09-12,EY,Lithuania,378,270,14,14,108,49,45,94,0
2020-09-13,EY,Lithuania,419,320,1,0,99,49,49,98,1
2020-09-14,EY,Lithuania,378,274,17,14,104,41,46,87,3
2020-09-15,EY,Lithuania,364,248,15,10,116,51,50,101,5
2020-09-16,EY,Lithuania,384,289,16,14,95,39,40,79,2
2020-09-17,EY,Lithuania,362,264,3,2,98,48,47,95,1
2020-09-18,EY,Lithuania,420,301,13,12,119,52,54,106,1
2020-09-19,EY,Lithuania,371,279,12,10,92,41,39,80,2
2020-09-20,EY,Lithuania,394,323,2,2,71,33,36,69,0
2020-09-21,EY,Lithuania,364,278,16,14,86,35,35,70,2
2020-09-22,EY,Lithuania,343,245,19,15,98,39,40,79,4
2020-09-23,EY,Lithuania,362,270,15,13,92,36,41,77,2
2020-09-24,EY,Lithuania,380,270,14,13,110,48,48,96,1
2020-09-25,EY,Lithuania,412,297,14,7,115,50,51,101,7
2020-09-26,EY,Lithuania,350,264,15,10,86,38,33,71,5
2020-09-27,EY,Lithuania,377,299,4,0,78,37,37,74,4
2020-09-28,EY,Lithuania,368,293,3,1,75,36,36,72,2
2020-09-29,EY,Lithuania,355,276,6,6,79,38,35,73,0
2020-09-30,EY,Lithuania,365,304,10,10,61,25,26,51,0
2020-10-01,EY,Lithuania,350,271,5,2,79,37,37,74,3
2020-10-02,EY,Lithuania,395,298,12,7,97,39,46,85,5
2020-10-03,EY,Lithuania,331,265,6,6,66,32,28,60,0
2020-10-04,EY,Lithuania,357,289,4,3,68,32,32,64,1
2020-10-05,EY,Lithuania,341,270,10,7,71,29,32,61,3
2020-10-06,EY,Lithuania,293,219,4,4,74,36,34,70,0
2020-10-07,EY,Lithuania,318,254,6,5,64,30,28,58,1
2020-10-08,EY,Lithuania,333,251,5,4,82,38,39,77,1
2020-10-09,EY,Lithuania,375,284,7,6,91,42,42,84,1
2020-10-10,EY,Lithuania,326,257,1,1,69,36,32,68,0
2020-10-11,EY,Lithuania,348,286,0,0,62,29,33,62,0
2020-10-12,EY,Lithuania,354,274,6,6,80,37,37,74,0
2020-10-13,EY,Lithuania,288,224,4,4,64,29,31,60,0
2020-10-14,EY,Lithuania,345,279,7,6,66,30,29,59,1
2020-10-15,EY,Lithuania,338,260,9,5,78,36,33,69,4
2020-10-16,EY,Lithuania,391,307,5,2,84,37,42,79,3
2020-10-17,EY,Lithuania,348,287,5,5,61,29,27,56,0
2020-10-18,EY,Lithuania,377,295,1,1,82,40,41,81,0
2020-10-19,EY,Lithuania,325,262,6,4,63,30,27,57,2
2020-10-20,EY,Lithuania,315,245,7,6,70,34,29,63,1
2020-10-21,EY,Lithuania,320,266,4,4,54,24,26,50,0
2020-10-22,EY,Lithuania,354,279,4,4,75,37,34,71,0
2020-10-23,EY,Lithuania,372,293,5,4,79,36,38,74,1
2020-10-24,EY,Lithuania,348,280,6,4,68,32,30,62,2
2020-10-25,EY,Lithuania,353,295,0,0,58,28,30,58,0
2020-10-26,EY,Lithuania,359,281,3,3,78,39,36,75,0
2020-10-27,EY,Lithuania,311,252,3,3,59,29,27,56,0
2020-10-28,EY,Lithuania,353,292,4,4,61,29,28,57,0
2020-10-29,EY,Lithuania,342,282,2,2,60,30,28,58,0
2020-10-30,EY,Lithuania,371,287,5,3,84,38,41,79,2
2020-10-31,EY,Lithuania,345,284,3,3,61,31,27,58,0
2020-11-01,EY,Lithuania,357,293,0,0,64,27,37,64,0
2020-11-02,EY,Lithuania,355,275,5,3,80,36,39,75,2
2020-11-03,EY,Lithuania,307,252,2,2,55,30,23,53,0
2020-11-04,EY,Lithuania,333,284,4,3,49,21,24,45,1
2020-11-05,EY,Lithuania,344,290,6,5,54,24,24,48,1
2020-11-06,EY,Lithuania,355,275,8,8,80,36,36,72,0
2020-11-07,EY,Lithuania,353,300,3,3,53,25,25,50,0
2020-11-08,EY,Lithuania,348,293,8,4,55,22,25,47,4
2020-11-09,EY,Lithuania,349,276,8,7,73,33,32,65,1
2020-11-10,EY,Lithuania,284,237,8,7,47,21,18,39,1
2020-11-11,EY,Lithuania,335,281,8,4,54,21,25,46,4
2020-11-12,EY,Lithuania,370,308,10,9,62,26,26,52,1
2020-11-13,EY,Lithuania,338,260,9,9,78,35,34,69,0
2020-11-14,EY,Lithuania,294,268,0,0,26,15,11,26,0
2020-11-15,EY,Lithuania,332,296,1,1,36,15,20,35,0
2020-11-16,EY,Lithuania,338,273,2,2,65,33,30,63,0
2020-11-17,EY,Lithuania,269,236,1,1,33,16,16,32,0
2020-11-18,EY,Lithuania,314,272,1,1,42,19,22,41,0
2020-11-19,EY,Lithuania,358,300,5,5,58,28,25,53,0
2020-11-20,EY,Lithuania,333,265,9,8,68,31,28,59,1
2020-11-21,EY,Lithuania,295,270,4,4,25,12,9,21,0
2020-11-22,EY,Lithuania,302,275,0,0,27,12,15,27,0
2020-11-23,EY,Lithuania,341,278,7,7,63,28,28,56,0
2020-11-24,EY,Lithuania,272,227,5,5,45,22,18,40,0
2020-11-25,EY,Lithuania,303,261,7,7,42,16,19,35,0
2020-11-26,EY,Lithuania,332,289,1,1,43,22,20,42,0
2020-11-27,EY,Lithuania,344,274,6,5,70,28,36,64,1
2020-11-28,EY,Lithuania,279,262,4,4,17,8,5,13,0
2020-11-29,EY,Lithuania,283,257,0,0,26,14,12,26,0
2020-11-30,EY,Lithuania,312,257,2,1,55,28,25,53,1
2020-12-01,EY,Lithuania,260,218,8,8,42,19,15,34,0
2020-12-02,EY,Lithuania,283,230,6,6,53,23,24,47,0
2020-12-03,EY,Lithuania,331,275,4,4,56,26,26,52,0
2020-12-04,EY,Lithuania,353,300,7,7,53,22,24,46,0
2020-12-05,EY,Lithuania,303,269,3,3,34,17,14,31,0
2020-12-06,EY,Lithuania,340,301,0,0,39,19,20,39,0
2020-12-07,EY,Lithuania,327,273,4,4,54,24,26,50,0
2020-12-08,EY,Lithuania,304,259,4,4,45,22,19,41,0
2020-12-09,EY,Lithuania,320,273,10,9,47,16,21,37,1
2020-12-10,EY,Lithuania,333,281,6,6,52,26,20,46,0
2020-12-11,EY,Lithuania,361,292,2,0,69,30,37,67,2
2020-12-12,EY,Lithuania,297,258,4,4,39,19,16,35,0
2020-12-13,EY,Lithuania,358,315,2,1,43,18,23,41,1
2020-12-14,EY,Lithuania,312,267,1,0,45,21,23,44,1
2020-12-15,EY,Lithuania,317,267,8,7,50,23,19,42,1
2020-12-16,EY,Lithuania,325,288,0,0,37,18,19,37,0
2020-12-17,EY,Lithuania,375,313,6,6,62,30,26,56,0
2020-12-18,EY,Lithuania,416,327,0,0,89,43,46,89,0
2020-12-19,EY,Lithuania,385,311,0,0,74,41,33,74,0
2020-12-20,EY,Lithuania,382,319,2,1,63,27,34,61,1
2020-12-21,EY,Lithuania,362,303,0,0,59,31,28,59,0
2020-12-22,EY,Lithuania,297,235,1,1,62,32,29,61,0
2020-12-23,EY,Lithuania,362,290,8,7,72,32,32,64,1
2020-12-24,EY,Lithuania,278,244,1,1,34,15,18,33,0
2020-12-25,EY,Lithuania,227,213,0,0,14,8,6,14,0
2020-12-26,EY,Lithuania,282,246,0,0,36,18,18,36,0
2020-12-27,EY,Lithuania,323,278,3,2,45,21,21,42,1
2020-12-28,EY,Lithuania,327,270,10,8,57,25,22,47,2
2020-12-29,EY,Lithuania,283,233,5,4,50,22,23,45,1
2020-12-30,EY,Lithuania,334,293,5,5,41,17,19,36,0
2020-12-31,EY,Lithuania,263,234,1,0,29,15,13,28,1
2020-01-01,LM,Malta,317,208,0,0,109,56,53,109,0
2020-01-02,LM,Malta,351,200,0,0,151,76,75,151,0
2020-01-03,LM,Malta,338,191,0,0,147,73,74,147,0
2020-01-04,LM,Malta,305,156,2,2,149,75,72,147,0
2020-01-05,LM,Malta,332,181,0,0,151,75,76,151,0
2020-01-06,LM,Malta,322,178,1,1,144,69,74,143,0
2020-01-07,LM,Malta,321,191,1,1,130,66,63,129,0
2020-01-08,LM,Malta,314,200,2,2,114,56,56,112,0
2020-01-09,LM,Malta,320,203,1,1,117,59,57,116,0
2020-01-10,LM,Malta,353,206,0,0,147,76,71,147,0
2020-01-11,LM,Malta,283,164,2,2,119,59,58,117,0
2020-01-12,LM,Malta,308,180,0,0,128,66,62,128,0
2020-01-13,LM,Malta,314,179,1,1,135,66,68,134,0
2020-01-14,LM,Malta,305,210,1,1,95,47,47,94,0
2020-01-15,LM,Malta,300,191,2,2,109,55,52,107,0
2020-01-16,LM,Malta,301,195,2,2,106,52,52,104,0
2020-01-17,LM,Malta,317,176,1,1,141,69,71,140,0
2020-01-18,LM,Malta,301,163,0,0,138,71,67,138,0
2020-01-19,LM,Malta,303,173,0,0,130,65,65,130,0
2020-01-20,LM,Malta,308,176,1,1,132,65,66,131,0
2020-01-21,LM,Malta,275,172,2,2,103,51,50,101,0
2020-01-22,LM,Malta,297,178,2,2,119,58,59,117,0
2020-01-23,LM,Malta,283,172,0,0,111,59,52,111,0
2020-01-24,LM,Malta,323,184,1,1,139,69,69,138,0
2020-01-25,LM,Malta,273,159,1,1,114,58,55,113,0
2020-01-26,LM,Malta,307,177,0,0,130,65,65,130,0
2020-01-27,LM,Malta,293,172,0,0,121,61,60,121,0
2020-01-28,LM,Malta,276,169,2,2,107,52,53,105,0
2020-01-29,LM,Malta,287,183,1,1,104,53,50,103,0
2020-01-30,LM,Malta,293,190,2,2,103,53,48,101,0
2020-01-31,LM,Malta,315,182,0,0,133,67,66,133,0
2020-02-01,LM,Malta,293,174,1,1,119,60,58,118,0
2020-02-02,LM,Malta,307,171,0,0,136,69,67,136,0
2020-02-03,LM,Malta,309,182,2,2,127,62,63,125,0
2020-02-04,LM,Malta,311,197,0,0,114,59,55,114,0
2020-02-05,LM,Malta,319,209,0,0,110,55,55,110,0
2020-02-06,LM,Malta,312,200,1,1,112,58,53,111,0
2020-02-07,LM,Malta,316,176,0,0,140,71,69,140,0
2020-02-08,LM,Malta,272,144,2,2,128,64,62,126,0
2020-02-09,LM,Malta,268,155,0,0,113,57,56,113,0
2020-02-10,LM,Malta,298,156,2,2,142,70,70,140,0
2020-02-11,LM,Malta,288,174,0,0,114,58,56,114,0
2020-02-12,LM,Malta,295,179,0,0,116,59,57,116,0
2020-02-13,LM,Malta,303,189,0,0,114,59,55,114,0
2020-02-14,LM,Malta,302,174,0,0,128,65,63,128,0
2020-02-15,LM,Malta,271,138,0,0,133,69,64,133,0
2020-02-16,LM,Malta,291,157,0,0,134,66,68,134,0
2020-02-17,LM,Malta,298,176,2,2,122,59,61,120,0
2020-02-18,LM,Malta,284,174,3,3,110,55,52,107,0
2020-02-19,LM,Malta,299,186,0,0,113,56,57,113,0
2020-02-20,LM,Malta,305,187,1,1,118,60,57,117,0
2020-02-21,LM,Malta,303,159,6,6,144,68,70,138,0
2020-02-22,LM,Malta,313,166,3,3,147,71,73,144,0
2020-02-23,LM,Malta,319,175,1,1,144,72,71,143,0
2020-02-24,LM,Malta,306,173,1,1,133,66,66,132,0
2020-02-25,LM,Malta,304,185,2,2,119,58,59,117,0
2020-02-26,LM,Malta,305,190,0,0,115,58,57,115,0
2020-02-27,LM,Malta,292,183,2,2,109,52,55,107,0
2020-02-28,LM,Malta,317,166,2,2,151,76,73,149,0
2020-02-29,LM,Malta,295,150,2,2,145,71,72,143,0
2020-03-01,LM,Malta,311,182,0,0,129,66,63,129,0
2020-03-02,LM,Malta,315,172,2,2,143,70,71,141,0
2020-03-03,LM,Malta,286,174,1,1,112,57,54,111,0
2020-03-04,LM,Malta,291,179,2,2,112,55,55,110,0
2020-03-05,LM,Malta,289,172,0,0,117,59,58,117,0
2020-03-06,LM,Malta,337,194,2,2,143,71,70,141,0
2020-03-07,LM,Malta,309,168,1,1,141,69,71,140,0
2020-03-08,LM,Malta,303,173,2,2,130,63,65,128,0
2020-03-09,LM,Malta,275,152,0,0,123,61,62,123,0
2020-03-10,LM,Malta,241,150,0,0,91,45,46,91,0
2020-03-11,LM,Malta,239,137,0,0,102,52,50,102,0
2020-03-12,LM,Malta,224,145,0,0,79,42,37,79,0
2020-03-13,LM,Malta,244,163,0,0,81,41,40,81,0
2020-03-14,LM,Malta,208,115,0,0,93,47,46,93,0
2020-03-15,LM,Malta,196,129,1,1,67,34,32,66,0
2020-03-16,LM,Malta,189,100,1,1,89,44,44,88,0
2020-03-17,LM,Malta,142,75,0,0,67,35,32,67,0
2020-03-18,LM,Malta,144,67,0,0,77,38,39,77,0
2020-03-19,LM,Malta,124,56,0,0,68,33,35,68,0
2020-03-20,LM,Malta,116,53,0,0,63,32,31,63,0
2020-03-21,LM,Malta,37,30,0,0,7,4,3,7,0
2020-03-22,LM,Malta,35,28,0,0,7,4,3,7,0
2020-03-23,LM,Malta,66,31,3,3,35,16,16,32,0
2020-03-24,LM,Malta,61,29,5,5,32,13,14,27,0
2020-03-25,LM,Malta,35,16,0,0,19,8,11,19,0
2020-03-26,LM,Malta,48,28,0,0,20,11,9,20,0
2020-03-27,LM,Malta,47,21,2,2,26,11,13,24,0
2020-03-28,LM,Malta,38,23,3,3,15,5,7,12,0
2020-03-29,LM,Malta,35,26,0,0,9,5,4,9,0
2020-03-30,LM,Malta,35,20,0,0,15,6,9,15,0
2020-03-31,LM,Malta,41,24,0,0,17,8,9,17,0
2020-04-01,LM,Malta,44,24,2,2,20,9,9,18,0
2020-04-02,LM,Malta,40,22,1,1,18,9,8,17,0
2020-04-03,LM,Malta,50,26,1,1,24,11,12,23,0
2020-04-04,LM,Malta,23,21,0,0,2,1,1,2,0
2020-04-05,LM,Malta,25,19,0,0,6,3,3,6,0
2020-04-06,LM,Malta,37,24,0,0,13,7,6,13,0
2020-04-07,LM,Malta,51,35,0,0,16,7,9,16,0
2020-04-08,LM,Malta,43,29,0,0,14,8,6,14,0
2020-04-09,LM,Malta,59,32,1,1,27,14,12,26,0
2020-04-10,LM,Malta,48,32,1,1,16,7,8,15,0
2020-04-11,LM,Malta,35,24,1,1,11,6,4,10,0
2020-04-12,LM,Malta,33,26,0,0,7,3,4,7,0
2020-04-13,LM,Malta,39,21,0,0,18,9,9,18,0
2020-04-14,LM,Malta,45,27,1,1,18,8,9,17,0
2020-04-15,LM,Malta,53,31,5,5,22,9,8,17,0
2020-04-16,LM,Malta,49,33,2,2,16,7,7,14,0
2020-04-17,LM,Malta,48,35,0,0,13,7,6,13,0
2020-04-18,LM,Malta,37,31,0,0,6,1,5,6,0
2020-04-19,LM,Malta,35,30,1,1,5,2,2,4,0
2020-04-20,LM,Malta,53,33,0,0,20,9,11,20,0
2020-04-21,LM,Malta,56,37,1,1,19,10,8,18,0
2020-04-22,LM,Malta,56,35,1,1,21,11,9,20,0
2020-04-23,LM,Malta,63,43,1,1,20,11,8,19,0
2020-04-24,LM,Malta,50,30,0,0,20,10,10,20,0
2020-04-25,LM,Malta,32,26,0,0,6,2,4,6,0
2020-04-26,LM,Malta,31,25,0,0,6,4,2,6,0
2020-04-27,LM,Malta,38,28,0,0,10,5,5,10,0
2020-04-28,LM,Malta,62,42,2,2,20,9,9,18,0
2020-04-29,LM,Malta,58,33,2,2,25,11,12,23,0
2020-04-30,LM,Malta,57,37,0,0,20,10,10,20,0
2020-05-01,LM,Malta,50,33,0,0,17,7,10,17,0
2020-05-02,LM,Malta,33,25,0,0,8,4,4,8,0
2020-05-03,LM,Malta,33,29,0,0,4,2,2,4,0
2020-05-04,LM,Malta,43,27,1,1,16,8,7,15,0
2020-05-05,LM,Malta,65,46,1,1,19,10,8,18,0
2020-05-06,LM,Malta,76,51,2,2,25,11,12,23,0
2020-05-07,LM,Malta,70,47,0,0,23,12,11,23,0
2020-05-08,LM,Malta,65,43,0,0,22,11,11,22,0
2020-05-09,LM,Malta,47,41,1,1,6,3,2,5,0
2020-05-10,LM,Malta,40,36,1,1,4,1,2,3,0
2020-05-11,LM,Malta,51,29,4,4,22,9,9,18,0
2020-05-12,LM,Malta,76,52,0,0,24,11,13,24,0
2020-05-13,LM,Malta,63,48,0,0,15,9,6,15,0
2020-05-14,LM,Malta,59,45,0,0,14,8,6,14,0
2020-05-15,LM,Malta,71,47,0,0,24,11,13,24,0
2020-05-16,LM,Malta,47,41,0,0,6,3,3,6,0
2020-05-17,LM,Malta,50,43,0,0,7,3,4,7,0
2020-05-18,LM,Malta,62,42,0,0,20,10,10,20,0
2020-05-19,LM,Malta,76,51,3,3,25,12,10,22,0
2020-05-20,LM,Malta,89,54,1,1,35,17,17,34,0
2020-05-21,LM,Malta,78,58,1,1,20,10,9,19,0
2020-05-22,LM,Malta,52,37,1,1,15,7,7,14,0
2020-05-23,LM,Malta,51,31,1,1,20,9,10,19,0
2020-05-24,LM,Malta,51,32,2,2,19,8,9,17,0
2020-05-25,LM,Malta,51,33,1,1,18,8,9,17,0
2020-05-26,LM,Malta,63,49,0,0,14,7,7,14,0
2020-05-27,LM,Malta,71,48,0,0,23,11,12,23,0
2020-05-28,LM,Malta,65,45,0,0,20,9,11,20,0
2020-05-29,LM,Malta,89,52,0,0,37,20,17,37,0
2020-05-30,LM,Malta,49,42,0,0,7,3,4,7,0
2020-05-31,LM,Malta,50,39,0,0,11,5,6,11,0
2020-06-01,LM,Malta,63,46,1,1,17,10,6,16,0
2020-06-02,LM,Malta,68,48,0,0,20,9,11,20,0
2020-06-03,LM,Malta,60,38,1,1,22,12,9,21,0
2020-06-04,LM,Malta,53,35,1,1,18,9,8,17,0
2020-06-05,LM,Malta,75,57,0,0,18,10,8,18,0
2020-06-06,LM,Malta,52,43,2,2,9,3,4,7,0
2020-06-07,LM,Malta,52,43,1,1,9,2,6,8,0
2020-06-08,LM,Malta,67,49,0,0,18,10,8,18,0
2020-06-09,LM,Malta,64,47,0,0,17,8,9,17,0
2020-06-10,LM,Malta,81,47,1,1,34,14,19,33,0
2020-06-11,LM,Malta,68,47,1,1,21,13,7,20,0
2020-06-12,LM,Malta,76,48,1,1,28,14,13,27,0
2020-06-13,LM,Malta,51,41,0,0,10,5,5,10,0
2020-06-14,LM,Malta,50,46,1,1,4,2,1,3,0
2020-06-15,LM,Malta,76,58,0,0,18,9,9,18,0
2020-06-16,LM,Malta,63,44,0,0,19,9,10,19,0
2020-06-17,LM,Malta,78,59,1,1,19,9,9,18,0
2020-06-18,LM,Malta,64,48,1,1,16,8,7,15,0
2020-06-19,LM,Malta,82,60,4,4,22,8,10,18,0
2020-06-20,LM,Malta,54,43,1,1,11,5,5,10,0
2020-06-21,LM,Malta,60,54,0,0,6,4,2,6,0
2020-06-22,LM,Malta,83,63,1,1,20,9,10,19,0
2020-06-23,LM,Malta,75,59,1,1,16,8,7,15,0
2020-06-24,LM,Malta,82,58,1,1,24,12,11,23,0
2020-06-25,LM,Malta,86,62,1,1,24,13,10,23,0
2020-06-26,LM,Malta,69,52,0,0,17,9,8,17,0
2020-06-27,LM,Malta,60,49,2,2,11,4,5,9,0
2020-06-28,LM,Malta,69,60,0,0,9,5,4,9,0
2020-06-29,LM,Malta,68,49,0,0,19,10,9,19,0
2020-06-30,LM,Malta,72,50,1,1,22,10,11,21,0
2020-07-01,LM,Malta,132,83,2,2,49,21,26,47,0
2020-07-02,LM,Malta,118,73,2,2,45,23,20,43,0
2020-07-03,LM,Malta,138,77,1,1,61,29,31,60,0
2020-07-04,LM,Malta,133,69,1,1,64,35,28,63,0
2020-07-05,LM,Malta,125,81,0,0,44,20,24,44,0
2020-07-06,LM,Malta,112,48,0,0,64,33,31,64,0
2020-07-07,LM,Malta,97,52,0,0,45,21,24,45,0
2020-07-08,LM,Malta,121,70,2,2,51,25,24,49,0
2020-07-09,LM,Malta,102,60,1,1,42,21,20,41,0
2020-07-10,LM,Malta,132,61,1,1,71,33,37,70,0
2020-07-11,LM,Malta,144,79,0,0,65,33,32,65,0
2020-07-12,LM,Malta,132,77,1,1,55,25,29,54,0
2020-07-13,LM,Malta,104,46,3,3,58,28,27,55,0
2020-07-14,LM,Malta,95,45,0,0,50,23,27,50,0
2020-07-15,LM,Malta,131,73,3,3,58,29,26,55,0
2020-07-16,LM,Malta,134,66,1,1,68,34,33,67,0
2020-07-17,LM,Malta,153,71,0,0,82,42,40,82,0
2020-07-18,LM,Malta,168,83,1,1,85,41,43,84,0
2020-07-19,LM,Malta,162,87,0,0,75,38,37,75,0
2020-07-20,LM,Malta,163,76,1,1,87,43,43,86,0
2020-07-21,LM,Malta,134,62,2,2,72,32,38,70,0
2020-07-22,LM,Malta,151,85,1,1,66,33,32,65,0
2020-07-23,LM,Malta,152,76,1,1,76,40,35,75,0
2020-07-24,LM,Malta,152,61,1,1,91,48,42,90,0
2020-07-25,LM,Malta,191,104,0,0,87,44,43,87,0
2020-07-26,LM,Malta,173,89,0,0,84,40,44,84,0
2020-07-27,LM,Malta,157,58,0,0,99,51,48,99,0
2020-07-28,LM,Malta,141,72,0,0,69,31,38,69,0
2020-07-29,LM,Malta,157,79,0,0,78,42,36,78,0
2020-07-30,LM,Malta,164,86,1,1,78,39,38,77,0
2020-07-31,LM,Malta,163,63,1,1,100,51,48,99,0
2020-08-01,LM,Malta,212,97,1,1,115,56,58,114,0
2020-08-02,LM,Malta,188,84,0,0,104,51,53,104,0
2020-08-03,LM,Malta,162,53,1,1,109,55,53,108,0
2020-08-04,LM,Malta,152,64,1,1,88,43,44,87,0
2020-08-05,LM,Malta,161,75,0,0,86,43,43,86,0
2020-08-06,LM,Malta,194,85,1,1,109,55,53,108,0
2020-08-07,LM,Malta,195,82,0,0,113,57,56,113,0
2020-08-08,LM,Malta,225,112,1,1,113,55,57,112,0
2020-08-09,LM,Malta,202,102,0,0,100,50,50,100,0
2020-08-10,LM,Malta,185,75,1,1,110,55,54,109,0
2020-08-11,LM,Malta,169,78,4,4,91,41,46,87,0
2020-08-12,LM,Malta,165,86,0,0,79,38,41,79,0
2020-08-13,LM,Malta,181,80,3,3,101,52,46,98,0
2020-08-14,LM,Malta,204,83,3,3,121,59,59,118,0
2020-08-15,LM,Malta,231,117,1,1,114,58,55,113,0
2020-08-16,LM,Malta,231,120,0,0,111,55,56,111,0
2020-08-17,LM,Malta,199,88,0,0,111,55,56,111,0
2020-08-18,LM,Malta,177,76,2,2,101,50,49,99,0
2020-08-19,LM,Malta,165,76,2,2,89,44,43,87,0
2020-08-20,LM,Malta,180,76,1,1,104,53,50,103,0
2020-08-21,LM,Malta,216,91,4,4,125,61,60,121,0
2020-08-22,LM,Malta,205,92,0,0,113,56,57,113,0
2020-08-23,LM,Malta,217,101,1,1,116,56,59,115,0
2020-08-24,LM,Malta,164,56,1,1,108,54,53,107,0
2020-08-25,LM,Malta,164,69,2,2,95,45,48,93,0
2020-08-26,LM,Malta,156,82,1,1,74,39,34,73,0
2020-08-27,LM,Malta,184,83,2,2,101,49,50,99,0
2020-08-28,LM,Malta,186,74,2,2,112,56,54,110,0
2020-08-29,LM,Malta,209,98,3,3,111,54,54,108,0
2020-08-30,LM,Malta,195,94,1,1,101,49,51,100,0
2020-08-31,LM,Malta,174,64,3,3,110,54,53,107,0
2020-09-01,LM,Malta,163,75,1,1,88,44,43,87,0
2020-09-02,LM,Malta,155,81,1,1,74,37,36,73,0
2020-09-03,LM,Malta,182,96,1,1,86,42,43,85,0
2020-09-04,LM,Malta,190,82,0,0,108,52,56,108,0
2020-09-05,LM,Malta,197,110,1,1,87,43,43,86,0
2020-09-06,LM,Malta,190,93,1,1,97,48,48,96,0
2020-09-07,LM,Malta,168,69,1,1,99,49,49,98,0
2020-09-08,LM,Malta,152,75,1,1,77,37,39,76,0
2020-09-09,LM,Malta,159,74,1,1,85,40,44,84,0
2020-09-10,LM,Malta,189,98,0,0,91,48,43,91,0
2020-09-11,LM,Malta,185,87,2,2,98,50,46,96,0
2020-09-12,LM,Malta,191,110,0,0,81,41,40,81,0
2020-09-13,LM,Malta,176,89,0,0,87,44,43,87,0
2020-09-14,LM,Malta,145,56,0,0,89,44,45,89,0
2020-09-15,LM,Malta,158,84,0,0,74,37,37,74,0
2020-09-16,LM,Malta,149,72,2,2,77,37,38,75,0
2020-09-17,LM,Malta,161,76,1,1,85,43,41,84,0
2020-09-18,LM,Malta,178,83,1,1,95,48,46,94,0
2020-09-19,LM,Malta,188,113,0,0,75,39,36,75,0
2020-09-20,LM,Malta,180,96,1,1,84,39,44,83,0
2020-09-21,LM,Malta,160,73,2,2,87,42,43,85,0
2020-09-22,LM,Malta,153,80,1,1,73,35,37,72,0
2020-09-23,LM,Malta,141,63,1,1,78,38,39,77,0
2020-09-24,LM,Malta,164,75,2,2,89,46,41,87,0
2020-09-25,LM,Malta,189,88,3,3,101,50,48,98,0
2020-09-26,LM,Malta,174,88,0,0,86,43,43,86,0
2020-09-27,LM,Malta,170,92,0,0,78,40,38,78,0
2020-09-28,LM,Malta,151,60,1,1,91,44,46,90,0
2020-09-29,LM,Malta,149,74,1,1,75,36,38,74,0
2020-09-30,LM,Malta,157,79,1,1,78,36,41,77,0
2020-10-01,LM,Malta,165,86,2,2,79,42,35,77,0
2020-10-02,LM,Malta,166,84,1,1,82,41,40,81,0
2020-10-03,LM,Malta,165,96,0,0,69,37,32,69,0
2020-10-04,LM,Malta,167,88,0,0,79,38,41,79,0
2020-10-05,LM,Malta,150,71,1,1,79,40,38,78,0
2020-10-06,LM,Malta,156,91,1,1,65,31,33,64,0
2020-10-07,LM,Malta,150,96,0,0,54,29,25,54,0
2020-10-08,LM,Malta,155,86,0,0,69,36,33,69,0
2020-10-09,LM,Malta,175,89,0,0,86,41,45,86,0
2020-10-10,LM,Malta,166,97,0,0,69,37,32,69,0
2020-10-11,LM,Malta,161,81,0,0,80,39,41,80,0
2020-10-12,LM,Malta,153,74,1,1,79,38,40,78,0
2020-10-13,LM,Malta,142,83,0,0,59,30,29,59,0
2020-10-14,LM,Malta,137,76,2,2,61,30,29,59,0
2020-10-15,LM,Malta,160,88,1,1,72,37,34,71,0
2020-10-16,LM,Malta,180,95,2,2,85,42,41,83,0
2020-10-17,LM,Malta,166,84,1,1,82,41,40,81,0
2020-10-18,LM,Malta,160,77,1,1,83,40,42,82,0
2020-10-19,LM,Malta,137,71,1,1,66,31,34,65,0
2020-10-20,LM,Malta,131,82,2,2,49,24,23,47,0
2020-10-21,LM,Malta,156,99,2,2,57,27,28,55,0
2020-10-22,LM,Malta,122,75,1,1,47,24,22,46,0
2020-10-23,LM,Malta,158,82,0,0,76,37,39,76,0
2020-10-24,LM,Malta,145,83,4,4,62,29,29,58,0
2020-10-25,LM,Malta,142,73,0,0,69,35,34,69,0
2020-10-26,LM,Malta,155,79,0,0,76,37,39,76,0
2020-10-27,LM,Malta,114,75,0,0,39,19,20,39,0
2020-10-28,LM,Malta,138,74,1,1,64,32,31,63,0
2020-10-29,LM,Malta,106,66,0,0,40,20,20,40,0
2020-10-30,LM,Malta,154,74,0,0,80,40,40,80,0
2020-10-31,LM,Malta,147,88,0,0,59,30,29,59,0
2020-11-01,LM,Malta,142,78,0,0,64,33,31,64,0
2020-11-02,LM,Malta,147,86,0,0,61,31,30,61,0
2020-11-03,LM,Malta,99,75,0,0,24,12,12,24,0
2020-11-04,LM,Malta,132,79,0,0,53,26,27,53,0
2020-11-05,LM,Malta,114,71,2,2,43,20,21,41,0
2020-11-06,LM,Malta,150,76,2,2,74,37,35,72,0
2020-11-07,LM,Malta,109,66,1,1,43,19,23,42,0
2020-11-08,LM,Malta,133,78,0,0,55,29,26,55,0
2020-11-09,LM,Malta,145,84,2,2,61,31,28,59,0
2020-11-10,LM,Malta,127,88,1,1,39,16,22,38,0
2020-11-11,LM,Malta,117,71,2,2,46,24,20,44,0
2020-11-12,LM,Malta,107,75,1,1,32,13,18,31,0
2020-11-13,LM,Malta,156,86,1,1,70,37,32,69,0
2020-11-14,LM,Malta,113,76,0,0,37,18,19,37,0
2020-11-15,LM,Malta,135,75,1,1,60,27,32,59,0
2020-11-16,LM,Malta,134,78,1,1,56,27,28,55,0
2020-11-17,LM,Malta,94,60,0,0,34,18,16,34,0
2020-11-18,LM,Malta,129,83,0,0,46,24,22,46,0
2020-11-19,LM,Malta,112,82,1,1,30,14,15,29,0
2020-11-20,LM,Malta,143,86,0,0,57,27,30,57,0
2020-11-21,LM,Malta,94,70,0,0,24,15,9,24,0
2020-11-22,LM,Malta,104,63,0,0,41,20,21,41,0
2020-11-23,LM,Malta,106,57,0,0,49,22,27,49,0
2020-11-24,LM,Malta,94,68,1,1,26,14,11,25,0
2020-11-25,LM,Malta,116,70,1,1,46,22,23,45,0
2020-11-26,LM,Malta,107,78,2,2,29,15,12,27,0
2020-11-27,LM,Malta,166,104,2,2,62,30,30,60,0
2020-11-28,LM,Malta,109,84,0,0,25,11,14,25,0
2020-11-29,LM,Malta,100,63,0,0,37,20,17,37,0
2020-11-30,LM,Malta,113,71,2,2,42,21,19,40,0
2020-12-01,LM,Malta,92,68,1,1,24,11,12,23,0
2020-12-02,LM,Malta,133,87,1,1,46,24,21,45,0
2020-12-03,LM,Malta,112,78,0,0,34,17,17,34,0
2020-12-04,LM,Malta,147,84,1,1,63,34,28,62,0
2020-12-05,LM,Malta,99,77,1,1,22,9,12,21,0
2020-12-06,LM,Malta,122,81,0,0,41,20,21,41,0
2020-12-07,LM,Malta,124,80,1,1,44,22,21,43,0
2020-12-08,LM,Malta,94,76,0,0,18,9,9,18,0
2020-12-09,LM,Malta,125,79,0,0,46,22,24,46,0
2020-12-10,LM,Malta,126,87,0,0,39,19,20,39,0
2020-12-11,LM,Malta,153,84,0,0,69,37,32,69,0
2020-12-12,LM,Malta,97,85,0,0,12,6,6,12,0
2020-12-13,LM,Malta,108,78,0,0,30,14,16,30,0
2020-12-14,LM,Malta,138,86,0,0,52,27,25,52,0
2020-12-15,LM,Malta,116,89,1,1,27,13,13,26,0
2020-12-16,LM,Malta,131,78,2,2,53,25,26,51,0
2020-12-17,LM,Malta,129,87,1,1,42,23,18,41,0
2020-12-18,LM,Malta,177,97,1,1,80,41,38,79,0
2020-12-19,LM,Malta,133,85,0,0,48,24,24,48,0
2020-12-20,LM,Malta,131,79,0,0,52,27,25,52,0
2020-12-21,LM,Malta,154,83,0,0,71,33,38,71,0
2020-12-22,LM,Malta,116,79,1,1,37,20,16,36,0
2020-12-23,LM,Malta,128,86,2,2,42,20,20,40,0
2020-12-24,LM,Malta,110,70,1,1,40,21,18,39,0
2020-12-25,LM,Malta,81,73,0,0,8,4,4,8,0
2020-12-26,LM,Malta,104,67,2,2,37,18,17,35,0
2020-12-27,LM,Malta,132,82,0,0,50,23,27,50,0
2020-12-28,LM,Malta,142,83,2,2,59,28,29,57,0
2020-12-29,LM,Malta,102,65,4,4,37,17,16,33,0
2020-12-30,LM,Malta,136,79,3,3,57,28,26,54,0
2020-12-31,LM,Malta,92,69,2,2,23,11,10,21,0
2020-01-01,LU,Moldova,79,39,0,0,40,20,20,40,0
2020-01-02,LU,Moldova,117,56,0,0,61,30,31,61,0
2020-01-03,LU,Moldova,121,53,0,0,68,34,34,68,0
2020-01-04,LU,Moldova,140,72,1,1,68,34,33,67,0
2020-01-05,LU,Moldova,130,62,0,0,68,34,34,68,0
2020-01-06,LU,Moldova,95,33,1,1,62,31,30,61,0
2020-01-07,LU,Moldova,115,57,0,0,58,30,28,58,0
2020-01-08,LU,Moldova,120,59,0,0,61,29,32,61,0
2020-01-09,LU,Moldova,119,51,0,0,68,34,34,68,0
2020-01-10,LU,Moldova,124,49,0,0,75,38,37,75,0
2020-01-11,LU,Moldova,147,74,0,0,73,37,36,73,0
2020-01-12,LU,Moldova,131,62,0,0,69,34,35,69,0
2020-01-13,LU,Moldova,106,49,0,0,57,28,29,57,0
2020-01-14,LU,Moldova,129,67,0,0,62,32,30,62,0
2020-01-15,LU,Moldova,114,55,0,0,59,28,31,59,0
2020-01-16,LU,Moldova,94,46,0,0,48,24,24,48,0
2020-01-17,LU,Moldova,109,46,0,0,63,33,30,63,0
2020-01-18,LU,Moldova,124,63,0,0,61,29,32,61,0
2020-01-19,LU,Moldova,123,62,0,0,61,30,31,61,0
2020-01-20,LU,Moldova,95,40,0,0,55,28,27,55,0
2020-01-21,LU,Moldova,117,58,0,0,59,30,29,59,0
2020-01-22,LU,Moldova,104,52,0,0,52,25,27,52,0
2020-01-23,LU,Moldova,87,42,0,0,45,23,22,45,0
2020-01-24,LU,Moldova,116,55,0,0,61,31,30,61,0
2020-01-25,LU,Moldova,118,58,0,0,60,30,30,60,0
2020-01-26,LU,Moldova,124,62,0,0,62,31,31,62,0
2020-01-27,LU,Moldova,98,42,0,0,56,28,28,56,0
2020-01-28,LU,Moldova,114,55,0,0,59,29,30,59,0
2020-01-29,LU,Moldova,119,67,0,0,52,25,27,52,0
2020-01-30,LU,Moldova,93,49,0,0,44,22,22,44,0
2020-01-31,LU,Moldova,102,42,0,0,60,31,29,60,0
2020-02-01,LU,Moldova,121,64,0,0,57,28,29,57,0
2020-02-02,LU,Moldova,128,64,0,0,64,31,33,64,0
2020-02-03,LU,Moldova,98,40,0,0,58,29,29,58,0
2020-02-04,LU,Moldova,119,60,0,0,59,30,29,59,0
2020-02-05,LU,Moldova,105,54,0,0,51,25,26,51,0
2020-02-06,LU,Moldova,82,39,0,0,43,21,22,43,0
2020-02-07,LU,Moldova,111,45,0,0,66,34,32,66,0
2020-02-08,LU,Moldova,115,57,0,0,58,29,29,58,0
2020-02-09,LU,Moldova,122,65,0,0,57,29,28,57,0
2020-02-10,LU,Moldova,103,44,1,1,59,28,30,58,0
2020-02-11,LU,Moldova,130,74,0,0,56,29,27,56,0
2020-02-12,LU,Moldova,109,57,0,0,52,25,27,52,0
2020-02-13,LU,Moldova,102,57,0,0,45,22,23,45,0
2020-02-14,LU,Moldova,116,51,0,0,65,33,32,65,0
2020-02-15,LU,Moldova,131,73,0,0,58,29,29,58,0
2020-02-16,LU,Moldova,124,64,0,0,60,30,30,60,0
2020-02-17,LU,Moldova,105,49,0,0,56,28,28,56,0
2020-02-18,LU,Moldova,119,63,0,0,56,29,27,56,0
2020-02-19,LU,Moldova,114,58,0,0,56,27,29,56,0
2020-02-20,LU,Moldova,105,56,0,0,49,25,24,49,0
2020-02-21,LU,Moldova,122,57,0,0,65,33,32,65,0
2020-02-22,LU,Moldova,132,71,0,0,61,30,31,61,0
2020-02-23,LU,Moldova,118,62,0,0,56,28,28,56,0
2020-02-24,LU,Moldova,106,49,0,0,57,28,29,57,0
2020-02-25,LU,Moldova,123,64,0,0,59,30,29,59,0
2020-02-26,LU,Moldova,109,52,0,0,57,29,28,57,0
2020-02-27,LU,Moldova,100,54,0,0,46,23,23,46,0
2020-02-28,LU,Moldova,113,52,0,0,61,31,30,61,0
2020-02-29,LU,Moldova,127,69,0,0,58,29,29,58,0
2020-03-01,LU,Moldova,128,69,0,0,59,29,30,59,0
2020-03-02,LU,Moldova,99,41,0,0,58,28,30,58,0
2020-03-03,LU,Moldova,126,66,0,0,60,30,30,60,0
2020-03-04,LU,Moldova,123,65,1,1,58,28,29,57,0
2020-03-05,LU,Moldova,108,58,2,2,50,24,24,48,0
2020-03-06,LU,Moldova,128,64,0,0,64,33,31,64,0
2020-03-07,LU,Moldova,125,68,0,0,57,28,29,57,0
2020-03-08,LU,Moldova,119,69,0,0,50,25,25,50,0
2020-03-09,LU,Moldova,100,45,0,0,55,27,28,55,0
2020-03-10,LU,Moldova,111,54,0,0,57,29,28,57,0
2020-03-11,LU,Moldova,122,77,0,0,45,22,23,45,0
2020-03-12,LU,Moldova,94,53,0,0,41,21,20,41,0
2020-03-13,LU,Moldova,109,59,0,0,50,26,24,50,0
2020-03-14,LU,Moldova,113,67,0,0,46,22,24,46,0
2020-03-15,LU,Moldova,111,64,0,0,47,24,23,47,0
2020-03-16,LU,Moldova,81,47,0,0,34,16,18,34,0
2020-03-17,LU,Moldova,42,38,0,0,4,3,1,4,0
2020-03-18,LU,Moldova,42,26,0,0,16,8,8,16,0
2020-03-19,LU,Moldova,24,18,1,1,6,3,2,5,0
2020-03-20,LU,Moldova,22,18,1,1,4,2,1,3,0
2020-03-21,LU,Moldova,28,20,0,0,8,4,4,8,0
2020-03-22,LU,Moldova,31,29,0,0,2,1,1,2,0
2020-03-23,LU,Moldova,8,4,0,0,4,2,2,4,0
2020-03-24,LU,Moldova,20,16,0,0,4,2,2,4,0
2020-03-25,LU,Moldova,18,12,0,0,6,3,3,6,0
2020-03-26,LU,Moldova,21,15,0,0,6,3,3,6,0
2020-03-27,LU,Moldova,21,13,0,0,8,4,4,8,0
2020-03-28,LU,Moldova,10,4,0,0,6,3,3,6,0
2020-03-29,LU,Moldova,8,8,0,0,0,0,0,0,0
2020-03-30,LU,Moldova,5,1,0,0,4,2,2,4,0
2020-03-31,LU,Moldova,12,6,0,0,6,3,3,6,0
2020-04-01,LU,Moldova,14,8,0,0,6,3,3,6,0
2020-04-02,LU,Moldova,10,6,0,0,4,2,2,4,0
2020-04-03,LU,Moldova,15,9,0,0,6,3,3,6,0
2020-04-04,LU,Moldova,10,6,0,0,4,2,2,4,0
2020-04-05,LU,Moldova,5,3,0,0,2,1,1,2,0
2020-04-06,LU,Moldova,12,7,0,0,5,2,3,5,0
2020-04-07,LU,Moldova,8,3,0,0,5,3,2,5,0
2020-04-08,LU,Moldova,11,5,0,0,6,3,3,6,0
2020-04-09,LU,Moldova,10,4,0,0,6,3,3,6,0
2020-04-10,LU,Moldova,15,7,0,0,8,4,4,8,0
2020-04-11,LU,Moldova,5,1,0,0,4,2,2,4,0
2020-04-12,LU,Moldova,8,6,0,0,2,1,1,2,0
2020-04-13,LU,Moldova,5,1,0,0,4,2,2,4,0
2020-04-14,LU,Moldova,11,3,0,0,8,3,5,8,0
2020-04-15,LU,Moldova,13,7,0,0,6,3,3,6,0
2020-04-16,LU,Moldova,12,5,0,0,7,4,3,7,0
2020-04-17,LU,Moldova,12,5,0,0,7,3,4,7,0
2020-04-18,LU,Moldova,20,6,0,0,14,8,6,14,0
2020-04-19,LU,Moldova,5,4,0,0,1,0,1,1,0
2020-04-20,LU,Moldova,4,3,0,0,1,1,0,1,0
2020-04-21,LU,Moldova,6,2,0,0,4,2,2,4,0
2020-04-22,LU,Moldova,11,5,0,0,6,3,3,6,0
2020-04-23,LU,Moldova,13,1,0,0,12,6,6,12,0
2020-04-24,LU,Moldova,13,5,0,0,8,4,4,8,0
2020-04-25,LU,Moldova,10,4,0,0,6,3,3,6,0
2020-04-26,LU,Moldova,9,5,0,0,4,2,2,4,0
2020-04-27,LU,Moldova,21,12,0,0,9,4,5,9,0
2020-04-28,LU,Moldova,15,9,0,0,6,3,3,6,0
2020-04-29,LU,Moldova,17,13,0,0,4,2,2,4,0
2020-04-30,LU,Moldova,21,9,0,0,12,6,6,12,0
2020-05-01,LU,Moldova,17,7,0,0,10,5,5,10,0
2020-05-02,LU,Moldova,6,2,0,0,4,2,2,4,0
2020-05-03,LU,Moldova,17,10,0,0,7,4,3,7,0
2020-05-04,LU,Moldova,12,6,0,0,6,3,3,6,0
2020-05-05,LU,Moldova,7,3,0,0,4,2,2,4,0
2020-05-06,LU,Moldova,7,3,0,0,4,2,2,4,0
2020-05-07,LU,Moldova,10,2,0,0,8,4,4,8,0
2020-05-08,LU,Moldova,13,7,0,0,6,3,3,6,0
2020-05-09,LU,Moldova,8,4,0,0,4,2,2,4,0
2020-05-10,LU,Moldova,16,10,0,0,6,3,3,6,0
2020-05-11,LU,Moldova,5,2,0,0,3,1,2,3,0
2020-05-12,LU,Moldova,16,8,0,0,8,4,4,8,0
2020-05-13,LU,Moldova,7,3,2,2,4,1,1,2,0
2020-05-14,LU,Moldova,19,10,0,0,9,5,4,9,0
2020-05-15,LU,Moldova,15,7,0,0,8,4,4,8,0
2020-05-16,LU,Moldova,10,5,0,0,5,2,3,5,0
2020-05-17,LU,Moldova,17,8,2,2,9,3,4,7,0
2020-05-18,LU,Moldova,10,4,0,0,6,3,3,6,0
2020-05-19,LU,Moldova,12,8,0,0,4,2,2,4,0
2020-05-20,LU,Moldova,13,11,0,0,2,1,1,2,0
2020-05-21,LU,Moldova,10,7,0,0,3,2,1,3,0
2020-05-22,LU,Moldova,17,9,0,0,8,4,4,8,0
2020-05-23,LU,Moldova,6,2,0,0,4,2,2,4,0
2020-05-24,LU,Moldova,12,4,0,0,8,4,4,8,0
2020-05-25,LU,Moldova,9,5,0,0,4,2,2,4,0
2020-05-26,LU,Moldova,10,4,0,0,6,3,3,6,0
2020-05-27,LU,Moldova,20,16,0,0,4,2,2,4,0
2020-05-28,LU,Moldova,14,10,0,0,4,2,2,4,0
2020-05-29,LU,Moldova,26,18,0,0,8,4,4,8,0
2020-05-30,LU,Moldova,14,10,0,0,4,2,2,4,0
2020-05-31,LU,Moldova,13,9,0,0,4,2,2,4,0
2020-06-01,LU,Moldova,7,3,0,0,4,2,2,4,0
2020-06-02,LU,Moldova,14,8,0,0,6,3,3,6,0
2020-06-03,LU,Moldova,18,8,0,0,10,5,5,10,0
2020-06-04,LU,Moldova,16,12,0,0,4,2,2,4,0
2020-06-05,LU,Moldova,26,14,0,0,12,5,7,12,0
2020-06-06,LU,Moldova,9,3,0,0,6,3,3,6,0
2020-06-07,LU,Moldova,20,10,0,0,10,5,5,10,0
2020-06-08,LU,Moldova,11,4,0,0,7,3,4,7,0
2020-06-09,LU,Moldova,15,8,0,0,7,4,3,7,0
2020-06-10,LU,Moldova,14,6,0,0,8,4,4,8,0
2020-06-11,LU,Moldova,15,7,0,0,8,4,4,8,0
2020-06-12,LU,Moldova,20,8,0,0,12,6,6,12,0
2020-06-13,LU,Moldova,9,3,0,0,6,3,3,6,0
2020-06-14,LU,Moldova,13,5,0,0,8,4,4,8,0
2020-06-15,LU,Moldova,38,10,0,0,28,13,15,28,0
2020-06-16,LU,Moldova,42,15,0,0,27,13,14,27,0
2020-06-17,LU,Moldova,45,19,0,0,26,14,12,26,0
2020-06-18,LU,Moldova,29,15,0,0,14,7,7,14,0
2020-06-19,LU,Moldova,40,16,0,0,24,12,12,24,0
2020-06-20,LU,Moldova,36,14,1,1,22,11,10,21,0
2020-06-21,LU,Moldova,31,11,0,0,20,10,10,20,0
2020-06-22,LU,Moldova,32,18,0,0,14,7,7,14,0
2020-06-23,LU,Moldova,38,14,0,0,24,12,12,24,0
2020-06-24,LU,Moldova,35,17,0,0,18,9,9,18,0
2020-06-25,LU,Moldova,37,19,0,0,18,9,9,18,0
2020-06-26,LU,Moldova,44,20,0,0,24,12,12,24,0
2020-06-27,LU,Moldova,27,11,0,0,16,8,8,16,0
2020-06-28,LU,Moldova,31,11,0,0,20,10,10,20,0
2020-06-29,LU,Moldova,28,14,0,0,14,7,7,14,0
2020-06-30,LU,Moldova,33,15,0,0,18,9,9,18,0
2020-07-01,LU,Moldova,62,22,0,0,40,20,20,40,0
2020-07-02,LU,Moldova,73,28,0,0,45,22,23,45,0
2020-07-03,LU,Moldova,77,38,0,0,39,19,20,39,0
2020-07-04,LU,Moldova,64,32,0,0,32,16,16,32,0
2020-07-05,LU,Moldova,63,26,0,0,37,18,19,37,0
2020-07-06,LU,Moldova,59,34,0,0,25,13,12,25,0
2020-07-07,LU,Moldova,73,41,0,0,32,16,16,32,0
2020-07-08,LU,Moldova,52,28,0,0,24,12,12,24,0
2020-07-09,LU,Moldova,52,25,0,0,27,13,14,27,0
2020-07-10,LU,Moldova,65,40,0,0,25,13,12,25,0
2020-07-11,LU,Moldova,68,44,0,0,24,12,12,24,0
2020-07-12,LU,Moldova,55,34,0,0,21,10,11,21,0
2020-07-13,LU,Moldova,50,32,0,0,18,9,9,18,0
2020-07-14,LU,Moldova,68,39,0,0,29,15,14,29,0
2020-07-15,LU,Moldova,64,33,0,0,31,15,16,31,0
2020-07-16,LU,Moldova,58,29,0,0,29,15,14,29,0
2020-07-17,LU,Moldova,76,51,0,0,25,13,12,25,0
2020-07-18,LU,Moldova,76,45,0,0,31,15,16,31,0
2020-07-19,LU,Moldova,72,44,0,0,28,14,14,28,0
2020-07-20,LU,Moldova,61,39,0,0,22,10,12,22,0
2020-07-21,LU,Moldova,69,41,0,0,28,14,14,28,0
2020-07-22,LU,Moldova,52,32,0,0,20,10,10,20,0
2020-07-23,LU,Moldova,67,44,0,0,23,12,11,23,0
2020-07-24,LU,Moldova,66,38,0,0,28,14,14,28,0
2020-07-25,LU,Moldova,80,59,0,0,21,10,11,21,0
2020-07-26,LU,Moldova,68,37,0,0,31,16,15,31,0
2020-07-27,LU,Moldova,48,32,0,0,16,7,9,16,0
2020-07-28,LU,Moldova,87,57,0,0,30,16,14,30,0
2020-07-29,LU,Moldova,57,40,0,0,17,8,9,17,0
2020-07-30,LU,Moldova,56,30,0,0,26,13,13,26,0
2020-07-31,LU,Moldova,76,51,0,0,25,12,13,25,0
2020-08-01,LU,Moldova,75,43,0,0,32,16,16,32,0
2020-08-02,LU,Moldova,75,45,0,0,30,15,15,30,0
2020-08-03,LU,Moldova,64,43,0,0,21,10,11,21,0
2020-08-04,LU,Moldova,79,45,0,0,34,16,18,34,0
2020-08-05,LU,Moldova,71,44,0,0,27,15,12,27,0
2020-08-06,LU,Moldova,55,32,1,1,23,11,11,22,0
2020-08-07,LU,Moldova,86,55,0,0,31,15,16,31,0
2020-08-08,LU,Moldova,88,52,0,0,36,18,18,36,0
2020-08-09,LU,Moldova,72,49,0,0,23,12,11,23,0
2020-08-10,LU,Moldova,71,51,0,0,20,10,10,20,0
2020-08-11,LU,Moldova,87,48,0,0,39,20,19,39,0
2020-08-12,LU,Moldova,61,43,0,0,18,9,9,18,0
2020-08-13,LU,Moldova,71,46,0,0,25,13,12,25,0
2020-08-14,LU,Moldova,88,53,0,0,35,17,18,35,0
2020-08-15,LU,Moldova,90,50,0,0,40,20,20,40,0
2020-08-16,LU,Moldova,74,52,0,0,22,11,11,22,0
2020-08-17,LU,Moldova,60,41,0,0,19,9,10,19,0
2020-08-18,LU,Moldova,100,65,0,0,35,17,18,35,0
2020-08-19,LU,Moldova,63,40,0,0,23,12,11,23,0
2020-08-20,LU,Moldova,65,36,0,0,29,15,14,29,0
2020-08-21,LU,Moldova,79,44,0,0,35,17,18,35,0
2020-08-22,LU,Moldova,100,63,0,0,37,18,19,37,0
2020-08-23,LU,Moldova,70,44,0,0,26,14,12,26,0
2020-08-24,LU,Moldova,71,54,0,0,17,8,9,17,0
2020-08-25,LU,Moldova,94,57,0,0,37,20,17,37,0
2020-08-26,LU,Moldova,78,44,0,0,34,16,18,34,0
2020-08-27,LU,Moldova,68,38,0,0,30,15,15,30,0
2020-08-28,LU,Moldova,87,54,0,0,33,16,17,33,0
2020-08-29,LU,Moldova,94,53,0,0,41,21,20,41,0
2020-08-30,LU,Moldova,80,55,0,0,25,13,12,25,0
2020-08-31,LU,Moldova,68,46,0,0,22,10,12,22,0
2020-09-01,LU,Moldova,92,56,0,0,36,18,18,36,0
2020-09-02,LU,Moldova,59,38,0,0,21,11,10,21,0
2020-09-03,LU,Moldova,59,36,0,0,23,11,12,23,0
2020-09-04,LU,Moldova,82,52,0,0,30,15,15,30,0
2020-09-05,LU,Moldova,89,51,0,0,38,19,19,38,0
2020-09-06,LU,Moldova,65,38,0,0,27,14,13,27,0
2020-09-07,LU,Moldova,58,38,0,0,20,9,11,20,0
2020-09-08,LU,Moldova,100,60,0,0,40,20,20,40,0
2020-09-09,LU,Moldova,51,30,0,0,21,11,10,21,0
2020-09-10,LU,Moldova,65,40,0,0,25,13,12,25,0
2020-09-11,LU,Moldova,84,54,0,0,30,15,15,30,0
2020-09-12,LU,Moldova,93,56,0,0,37,18,19,37,0
2020-09-13,LU,Moldova,68,41,0,0,27,14,13,27,0
2020-09-14,LU,Moldova,83,64,0,0,19,9,10,19,0
2020-09-15,LU,Moldova,103,64,0,0,39,20,19,39,0
2020-09-16,LU,Moldova,65,40,0,0,25,12,13,25,0
2020-09-17,LU,Moldova,88,58,0,0,30,15,15,30,0
2020-09-18,LU,Moldova,80,45,0,0,35,17,18,35,0
2020-09-19,LU,Moldova,90,45,0,0,45,23,22,45,0
2020-09-20,LU,Moldova,65,37,0,0,28,15,13,28,0
2020-09-21,LU,Moldova,65,46,0,0,19,9,10,19,0
2020-09-22,LU,Moldova,81,42,0,0,39,19,20,39,0
2020-09-23,LU,Moldova,73,49,0,0,24,12,12,24,0
2020-09-24,LU,Moldova,72,45,0,0,27,14,13,27,0
2020-09-25,LU,Moldova,81,51,0,0,30,15,15,30,0
2020-09-26,LU,Moldova,80,42,0,0,38,19,19,38,0
2020-09-27,LU,Moldova,58,31,0,0,27,14,13,27,0
2020-09-28,LU,Moldova,56,35,0,0,21,9,12,21,0
2020-09-29,LU,Moldova,83,49,0,0,34,18,16,34,0
2020-09-30,LU,Moldova,58,34,0,0,24,13,11,24,0
2020-10-01,LU,Moldova,62,38,0,0,24,12,12,24,0
2020-10-02,LU,Moldova,76,39,0,0,37,18,19,37,0
2020-10-03,LU,Moldova,78,39,0,0,39,20,19,39,0
2020-10-04,LU,Moldova,60,31,0,0,29,15,14,29,0
2020-10-05,LU,Moldova,66,41,0,0,25,12,13,25,0
2020-10-06,LU,Moldova,56,30,0,0,26,14,12,26,0
2020-10-07,LU,Moldova,56,36,0,0,20,10,10,20,0
2020-10-08,LU,Moldova,59,41,0,0,18,9,9,18,0
2020-10-09,LU,Moldova,73,30,0,0,43,21,22,43,0
2020-10-10,LU,Moldova,81,48,0,0,33,17,16,33,0
2020-10-11,LU,Moldova,69,35,0,0,34,17,17,34,0
2020-10-12,LU,Moldova,66,36,1,1,30,13,16,29,0
2020-10-13,LU,Moldova,52,31,0,0,21,11,10,21,0
2020-10-14,LU,Moldova,56,35,0,0,21,11,10,21,0
2020-10-15,LU,Moldova,45,27,0,0,18,9,9,18,0
2020-10-16,LU,Moldova,65,36,0,0,29,14,15,29,0
2020-10-17,LU,Moldova,66,40,0,0,26,14,12,26,0
2020-10-18,LU,Moldova,68,37,1,1,31,15,15,30,0
2020-10-19,LU,Moldova,41,25,0,0,16,8,8,16,0
2020-10-20,LU,Moldova,51,31,0,0,20,10,10,20,0
2020-10-21,LU,Moldova,42,21,0,0,21,10,11,21,0
2020-10-22,LU,Moldova,48,29,0,0,19,9,10,19,0
2020-10-23,LU,Moldova,54,26,0,0,28,14,14,28,0
2020-10-24,LU,Moldova,62,31,0,0,31,15,16,31,0
2020-10-25,LU,Moldova,67,32,0,0,35,19,16,35,0
2020-10-26,LU,Moldova,45,25,0,0,20,10,10,20,0
2020-10-27,LU,Moldova,44,31,0,0,13,7,6,13,0
2020-10-28,LU,Moldova,55,34,0,0,21,11,10,21,0
2020-10-29,LU,Moldova,40,22,0,0,18,9,9,18,0
2020-10-30,LU,Moldova,74,49,0,0,25,12,13,25,0
2020-10-31,LU,Moldova,57,30,0,0,27,13,14,27,0
2020-11-01,LU,Moldova,69,45,0,0,24,12,12,24,0
2020-11-02,LU,Moldova,36,20,0,0,16,8,8,16,0
2020-11-03,LU,Moldova,32,22,0,0,10,6,4,10,0
2020-11-04,LU,Moldova,51,33,0,0,18,9,9,18,0
2020-11-05,LU,Moldova,44,28,0,0,16,8,8,16,0
2020-11-06,LU,Moldova,58,32,0,0,26,14,12,26,0
2020-11-07,LU,Moldova,51,33,0,0,18,8,10,18,0
2020-11-08,LU,Moldova,62,36,0,0,26,13,13,26,0
2020-11-09,LU,Moldova,49,28,0,0,21,10,11,21,0
2020-11-10,LU,Moldova,36,33,0,0,3,2,1,3,0
2020-11-11,LU,Moldova,39,25,0,0,14,7,7,14,0
2020-11-12,LU,Moldova,42,21,1,1,21,9,11,20,0
2020-11-13,LU,Moldova,39,25,0,0,14,8,6,14,0
2020-11-14,LU,Moldova,47,27,0,0,20,10,10,20,0
2020-11-15,LU,Moldova,49,26,0,0,23,11,12,23,0
2020-11-16,LU,Moldova,39,24,0,0,15,8,7,15,0
2020-11-17,LU,Moldova,31,22,0,0,9,5,4,9,0
2020-11-18,LU,Moldova,40,26,0,0,14,6,8,14,0
2020-11-19,LU,Moldova,34,21,0,0,13,6,7,13,0
2020-11-20,LU,Moldova,43,20,0,0,23,12,11,23,0
2020-11-21,LU,Moldova,35,22,0,0,13,6,7,13,0
2020-11-22,LU,Moldova,46,27,0,0,19,9,10,19,0
2020-11-23,LU,Moldova,46,25,0,0,21,11,10,21,0
2020-11-24,LU,Moldova,25,21,0,0,4,2,2,4,0
2020-11-25,LU,Moldova,42,26,0,0,16,8,8,16,0
2020-11-26,LU,Moldova,31,18,0,0,13,7,6,13,0
2020-11-27,LU,Moldova,34,14,0,0,20,11,9,20,0
2020-11-28,LU,Moldova,41,26,0,0,15,7,8,15,0
2020-11-29,LU,Moldova,41,22,0,0,19,9,10,19,0
2020-11-30,LU,Moldova,25,14,0,0,11,6,5,11,0
2020-12-01,LU,Moldova,39,31,0,0,8,4,4,8,0
2020-12-02,LU,Moldova,45,31,0,0,14,6,8,14,0
2020-12-03,LU,Moldova,41,25,0,0,16,9,7,16,0
2020-12-04,LU,Moldova,42,23,0,0,19,10,9,19,0
2020-12-05,LU,Moldova,39,20,0,0,19,8,11,19,0
2020-12-06,LU,Moldova,49,22,0,0,27,13,14,27,0
2020-12-07,LU,Moldova,37,23,0,0,14,8,6,14,0
2020-12-08,LU,Moldova,29,18,0,0,11,5,6,11,0
2020-12-09,LU,Moldova,50,30,0,0,20,10,10,20,0
2020-12-10,LU,Moldova,35,19,0,0,16,8,8,16,0
2020-12-11,LU,Moldova,50,26,0,0,24,13,11,24,0
2020-12-12,LU,Moldova,57,34,0,0,23,11,12,23,0
2020-12-13,LU,Moldova,47,24,0,0,23,11,12,23,0
2020-12-14,LU,Moldova,41,22,0,0,19,10,9,19,0
2020-12-15,LU,Moldova,51,36,0,0,15,8,7,15,0
2020-12-16,LU,Moldova,37,21,0,0,16,7,9,16,0
2020-12-17,LU,Moldova,51,21,0,0,30,15,15,30,0
2020-12-18,LU,Moldova,61,25,0,0,36,19,17,36,0
2020-12-19,LU,Moldova,67,33,0,0,34,17,17,34,0
2020-12-20,LU,Moldova,67,33,0,0,34,17,17,34,0
2020-12-21,LU,Moldova,48,23,0,0,25,12,13,25,0
2020-12-22,LU,Moldova,69,30,0,0,39,19,20,39,0
2020-12-23,LU,Moldova,62,28,0,0,34,17,17,34,0
2020-12-24,LU,Moldova,57,31,0,0,26,13,13,26,0
2020-12-25,LU,Moldova,51,22,0,0,29,14,15,29,0
2020-12-26,LU,Moldova,51,28,0,0,23,12,11,23,0
2020-12-27,LU,Moldova,58,25,0,0,33,16,17,33,0
2020-12-28,LU,Moldova,52,25,0,0,27,13,14,27,0
2020-12-29,LU,Moldova,51,29,0,0,22,11,11,22,0
2020-12-30,LU,Moldova,64,30,0,0,34,17,17,34,0
2020-12-31,LU,Moldova,28,14,0,0,14,7,7,14,0
2020-01-01,GM,Morocco,1167,604,86,0,563,241,236,477,86
2020-01-02,GM,Morocco,1276,658,84,2,618,273,261,534,82
2020-01-03,GM,Morocco,1369,737,109,2,632,265,258,523,107
2020-01-04,GM,Morocco,1808,1111,85,0,697,308,304,612,85
2020-01-05,GM,Morocco,1515,880,98,0,635,270,267,537,98
2020-01-06,GM,Morocco,1369,758,99,3,611,259,253,512,96
2020-01-07,GM,Morocco,1268,702,103,5,566,228,235,463,98
2020-01-08,GM,Morocco,1051,540,88,3,511,213,210,423,85
2020-01-09,GM,Morocco,1132,572,90,3,560,234,236,470,87
2020-01-10,GM,Morocco,1171,599,88,0,572,241,243,484,88
2020-01-11,GM,Morocco,1489,887,64,1,602,273,265,538,63
2020-01-12,GM,Morocco,1325,739,81,0,586,257,248,505,81
2020-01-13,GM,Morocco,1083,562,82,4,521,217,222,439,78
2020-01-14,GM,Morocco,971,492,108,9,479,186,185,371,99
2020-01-15,GM,Morocco,971,505,90,5,466,192,184,376,85
2020-01-16,GM,Morocco,1074,554,91,11,520,214,215,429,80
2020-01-17,GM,Morocco,1160,592,116,5,568,229,223,452,111
2020-01-18,GM,Morocco,1532,958,61,2,574,253,260,513,59
2020-01-19,GM,Morocco,1246,703,73,0,543,239,231,470,73
2020-01-20,GM,Morocco,1072,537,89,7,535,219,227,446,82
2020-01-21,GM,Morocco,983,513,88,5,470,191,191,382,83
2020-01-22,GM,Morocco,963,512,92,3,451,182,177,359,89
2020-01-23,GM,Morocco,1037,540,76,3,497,209,212,421,73
2020-01-24,GM,Morocco,1091,553,101,1,538,221,216,437,100
2020-01-25,GM,Morocco,1512,945,61,0,567,254,252,506,61
2020-01-26,GM,Morocco,1252,712,82,0,540,235,223,458,82
2020-01-27,GM,Morocco,1081,581,82,4,500,204,214,418,78
2020-01-28,GM,Morocco,966,522,82,3,444,181,181,362,79
2020-01-29,GM,Morocco,952,486,92,9,466,191,183,374,83
2020-01-30,GM,Morocco,1083,573,85,12,510,211,214,425,73
2020-01-31,GM,Morocco,1149,600,99,3,549,223,227,450,96
2020-02-01,GM,Morocco,1527,945,68,3,582,260,254,514,65
2020-02-02,GM,Morocco,1273,716,79,1,557,247,231,478,78
2020-02-03,GM,Morocco,1058,555,81,8,503,202,220,422,73
2020-02-04,GM,Morocco,1011,578,77,2,433,177,179,356,75
2020-02-05,GM,Morocco,1041,564,96,4,477,198,183,381,92
2020-02-06,GM,Morocco,1086,571,83,5,515,217,215,432,78
2020-02-07,GM,Morocco,1149,582,115,5,567,224,228,452,110
2020-02-08,GM,Morocco,1614,1009,78,5,605,265,262,527,73
2020-02-09,GM,Morocco,1248,705,79,3,543,236,228,464,76
2020-02-10,GM,Morocco,1081,548,90,2,533,213,230,443,88
2020-02-11,GM,Morocco,1053,594,70,1,459,194,195,389,69
2020-02-12,GM,Morocco,1019,551,80,5,468,204,184,388,75
2020-02-13,GM,Morocco,1117,589,79,3,528,226,223,449,76
2020-02-14,GM,Morocco,1209,640,87,3,569,243,239,482,84
2020-02-15,GM,Morocco,1569,974,63,0,595,262,270,532,63
2020-02-16,GM,Morocco,1313,759,76,0,554,246,232,478,76
2020-02-17,GM,Morocco,1119,600,73,5,519,215,231,446,68
2020-02-18,GM,Morocco,1106,626,78,0,480,202,200,402,78
2020-02-19,GM,Morocco,1073,576,88,1,497,206,203,409,87
2020-02-20,GM,Morocco,1133,586,73,3,547,237,237,474,70
2020-02-21,GM,Morocco,1199,641,86,0,558,241,231,472,86
2020-02-22,GM,Morocco,1575,944,76,3,631,274,281,555,73
2020-02-23,GM,Morocco,1063,502,71,0,561,252,238,490,71
2020-02-24,GM,Morocco,1259,725,84,1,534,223,227,450,83
2020-02-25,GM,Morocco,1318,832,85,1,486,202,199,401,84
2020-02-26,GM,Morocco,1124,637,95,1,487,199,193,392,94
2020-02-27,GM,Morocco,1147,616,82,2,531,222,227,449,80
2020-02-28,GM,Morocco,1196,630,106,0,566,233,227,460,106
2020-02-29,GM,Morocco,1651,1039,67,0,612,273,272,545,67
2020-03-01,GM,Morocco,1349,778,79,0,571,251,241,492,79
2020-03-02,GM,Morocco,1163,625,76,1,538,227,235,462,75
2020-03-03,GM,Morocco,1077,595,74,2,482,205,203,408,72
2020-03-04,GM,Morocco,1069,571,86,1,498,205,207,412,85
2020-03-05,GM,Morocco,1121,583,80,2,538,229,229,458,78
2020-03-06,GM,Morocco,1178,619,105,1,559,230,224,454,104
2020-03-07,GM,Morocco,1548,956,67,0,592,261,264,525,67
2020-03-08,GM,Morocco,1277,738,65,1,539,240,234,474,64
2020-03-09,GM,Morocco,1058,556,76,3,502,211,215,426,73
2020-03-10,GM,Morocco,1030,575,82,1,455,189,184,373,81
2020-03-11,GM,Morocco,1018,557,88,3,461,194,179,373,85
2020-03-12,GM,Morocco,1056,588,69,3,468,199,200,399,66
2020-03-13,GM,Morocco,1055,613,83,5,442,180,179,359,78
2020-03-14,GM,Morocco,1254,809,67,1,445,185,193,378,66
2020-03-15,GM,Morocco,1206,819,66,0,387,170,151,321,66
2020-03-16,GM,Morocco,950,631,63,0,319,130,126,256,63
2020-03-17,GM,Morocco,814,571,37,0,243,99,107,206,37
2020-03-18,GM,Morocco,774,525,48,1,249,101,100,201,47
2020-03-19,GM,Morocco,730,467,38,2,263,113,112,225,36
2020-03-20,GM,Morocco,588,446,42,1,142,50,50,100,41
2020-03-21,GM,Morocco,590,545,14,0,45,17,14,31,14
2020-03-22,GM,Morocco,290,279,3,0,11,4,4,8,3
2020-03-23,GM,Morocco,160,135,6,0,25,9,10,19,6
2020-03-24,GM,Morocco,142,126,4,0,16,6,6,12,4
2020-03-25,GM,Morocco,128,107,5,0,21,10,6,16,5
2020-03-26,GM,Morocco,103,85,9,1,18,4,5,9,8
2020-03-27,GM,Morocco,103,80,6,1,23,10,7,17,5
2020-03-28,GM,Morocco,85,77,0,0,8,3,5,8,0
2020-03-29,GM,Morocco,101,94,0,0,7,4,3,7,0
2020-03-30,GM,Morocco,69,55,4,3,14,5,5,10,1
2020-03-31,GM,Morocco,66,55,2,0,11,5,4,9,2
2020-04-01,GM,Morocco,58,43,2,0,15,7,6,13,2
2020-04-02,GM,Morocco,58,39,6,0,19,7,6,13,6
2020-04-03,GM,Morocco,64,41,5,0,23,9,9,18,5
2020-04-04,GM,Morocco,50,45,1,0,5,2,2,4,1
2020-04-05,GM,Morocco,55,46,1,1,9,4,4,8,0
2020-04-06,GM,Morocco,47,30,5,0,17,6,6,12,5
2020-04-07,GM,Morocco,73,39,15,1,34,10,9,19,14
2020-04-08,GM,Morocco,66,46,4,1,20,8,8,16,3
2020-04-09,GM,Morocco,61,36,8,1,25,9,8,17,7
2020-04-10,GM,Morocco,60,34,9,1,26,8,9,17,8
2020-04-11,GM,Morocco,39,23,7,1,16,4,5,9,6
2020-04-12,GM,Morocco,38,34,2,0,4,1,1,2,2
2020-04-13,GM,Morocco,44,27,6,4,17,6,5,11,2
2020-04-14,GM,Morocco,62,36,11,3,26,7,8,15,8
2020-04-15,GM,Morocco,40,22,9,4,18,5,4,9,5
2020-04-16,GM,Morocco,56,38,7,0,18,5,6,11,7
2020-04-17,GM,Morocco,67,41,13,1,26,7,6,13,12
2020-04-18,GM,Morocco,37,27,2,2,10,4,4,8,0
2020-04-19,GM,Morocco,58,45,1,1,13,6,6,12,0
2020-04-20,GM,Morocco,52,27,5,0,25,10,10,20,5
2020-04-21,GM,Morocco,59,37,9,0,22,8,5,13,9
2020-04-22,GM,Morocco,52,28,11,3,24,6,7,13,8
2020-04-23,GM,Morocco,61,39,6,0,22,7,9,16,6
2020-04-24,GM,Morocco,78,48,5,0,30,12,13,25,5
2020-04-25,GM,Morocco,35,29,0,0,6,3,3,6,0
2020-04-26,GM,Morocco,41,31,1,1,10,5,4,9,0
2020-04-27,GM,Morocco,51,34,6,1,17,5,6,11,5
2020-04-28,GM,Morocco,53,27,6,1,26,10,10,20,5
2020-04-29,GM,Morocco,44,28,4,2,16,6,6,12,2
2020-04-30,GM,Morocco,61,45,6,2,16,5,5,10,4
2020-05-01,GM,Morocco,58,43,7,2,15,4,4,8,5
2020-05-02,GM,Morocco,38,23,0,0,15,7,8,15,0
2020-05-03,GM,Morocco,51,47,0,0,4,3,1,4,0
2020-05-04,GM,Morocco,57,35,6,2,22,8,8,16,4
2020-05-05,GM,Morocco,71,33,13,2,38,13,12,25,11
2020-05-06,GM,Morocco,54,25,11,2,29,9,9,18,9
2020-05-07,GM,Morocco,54,29,3,1,25,11,11,22,2
2020-05-08,GM,Morocco,66,36,7,4,30,11,12,23,3
2020-05-09,GM,Morocco,31,24,0,0,7,3,4,7,0
2020-05-10,GM,Morocco,49,39,0,0,10,5,5,10,0
2020-05-11,GM,Morocco,66,47,4,2,19,8,7,15,2
2020-05-12,GM,Morocco,56,38,2,0,18,8,8,16,2
2020-05-13,GM,Morocco,61,35,1,0,26,12,13,25,1
2020-05-14,GM,Morocco,63,45,1,1,18,8,9,17,0
2020-05-15,GM,Morocco,71,44,6,1,27,11,10,21,5
2020-05-16,GM,Morocco,38,30,0,0,8,4,4,8,0
2020-05-17,GM,Morocco,43,37,0,0,6,3,3,6,0
2020-05-18,GM,Morocco,63,36,6,0,27,11,10,21,6
2020-05-19,GM,Morocco,65,39,11,1,26,7,8,15,10
2020-05-20,GM,Morocco,57,39,4,4,18,7,7,14,0
2020-05-21,GM,Morocco,87,54,5,3,33,14,14,28,2
2020-05-22,GM,Morocco,74,37,10,2,37,14,13,27,8
2020-05-23,GM,Morocco,42,26,4,2,16,7,5,12,2
2020-05-24,GM,Morocco,41,38,1,0,3,1,1,2,1
2020-05-25,GM,Morocco,45,36,1,0,9,5,3,8,1
2020-05-26,GM,Morocco,61,33,8,4,28,9,11,20,4
2020-05-27,GM,Morocco,67,37,5,3,30,12,13,25,2
2020-05-28,GM,Morocco,82,51,10,6,31,11,10,21,4
2020-05-29,GM,Morocco,82,50,14,8,32,9,9,18,6
2020-05-30,GM,Morocco,59,27,10,7,32,11,11,22,3
2020-05-31,GM,Morocco,41,39,0,0,2,1,1,2,0
2020-06-01,GM,Morocco,58,30,16,11,28,6,6,12,5
2020-06-02,GM,Morocco,64,33,13,7,31,9,9,18,6
2020-06-03,GM,Morocco,87,45,10,10,42,16,16,32,0
2020-06-04,GM,Morocco,68,33,17,9,35,9,9,18,8
2020-06-05,GM,Morocco,90,44,11,5,46,18,17,35,6
2020-06-06,GM,Morocco,64,31,15,6,33,11,7,18,9
2020-06-07,GM,Morocco,41,33,0,0,8,4,4,8,0
2020-06-08,GM,Morocco,83,35,22,19,48,14,12,26,3
2020-06-09,GM,Morocco,97,48,18,13,49,15,16,31,5
2020-06-10,GM,Morocco,95,50,13,6,45,16,16,32,7
2020-06-11,GM,Morocco,71,29,16,12,42,13,13,26,4
2020-06-12,GM,Morocco,108,46,14,0,62,24,24,48,14
2020-06-13,GM,Morocco,65,41,2,2,24,11,11,22,0
2020-06-14,GM,Morocco,83,55,0,0,28,14,14,28,0
2020-06-15,GM,Morocco,116,55,13,3,61,25,23,48,10
2020-06-16,GM,Morocco,102,41,19,3,61,20,22,42,16
2020-06-17,GM,Morocco,92,52,8,2,40,16,16,32,6
2020-06-18,GM,Morocco,85,56,6,1,29,11,12,23,5
2020-06-19,GM,Morocco,93,53,8,0,40,16,16,32,8
2020-06-20,GM,Morocco,72,42,10,0,30,9,11,20,10
2020-06-21,GM,Morocco,106,76,7,0,30,12,11,23,7
2020-06-22,GM,Morocco,116,75,9,0,41,16,16,32,9
2020-06-23,GM,Morocco,130,74,22,2,56,16,18,34,20
2020-06-24,GM,Morocco,137,95,14,2,42,14,14,28,12
2020-06-25,GM,Morocco,130,66,27,5,64,19,18,37,22
2020-06-26,GM,Morocco,160,86,37,2,74,19,18,37,35
2020-06-27,GM,Morocco,112,82,8,0,30,11,11,22,8
2020-06-28,GM,Morocco,135,96,24,0,39,8,7,15,24
2020-06-29,GM,Morocco,109,80,7,4,29,11,11,22,3
2020-06-30,GM,Morocco,125,86,20,4,39,10,9,19,16
2020-07-01,GM,Morocco,253,204,29,6,49,10,10,20,23
2020-07-02,GM,Morocco,221,168,28,10,53,14,11,25,18
2020-07-03,GM,Morocco,257,196,30,5,61,16,15,31,25
2020-07-04,GM,Morocco,271,241,12,4,30,9,9,18,8
2020-07-05,GM,Morocco,280,243,25,0,37,6,6,12,25
2020-07-06,GM,Morocco,232,184,26,4,48,11,11,22,22
2020-07-07,GM,Morocco,258,212,30,9,46,8,8,16,21
2020-07-08,GM,Morocco,260,207,24,4,53,15,14,29,20
2020-07-09,GM,Morocco,258,214,20,8,44,12,12,24,12
2020-07-10,GM,Morocco,285,208,46,4,77,15,16,31,42
2020-07-11,GM,Morocco,293,253,18,2,40,11,11,22,16
2020-07-12,GM,Morocco,294,263,24,0,31,3,4,7,24
2020-07-13,GM,Morocco,243,198,30,5,45,9,6,15,25
2020-07-14,GM,Morocco,247,208,27,2,39,6,6,12,25
2020-07-15,GM,Morocco,346,248,20,3,98,40,38,78,17
2020-07-16,GM,Morocco,359,259,22,2,100,38,40,78,20
2020-07-17,GM,Morocco,387,262,39,2,125,42,44,86,37
2020-07-18,GM,Morocco,422,305,21,0,117,48,48,96,21
2020-07-19,GM,Morocco,443,322,42,0,121,39,40,79,42
2020-07-20,GM,Morocco,366,258,34,0,108,37,37,74,34
2020-07-21,GM,Morocco,370,253,36,1,117,41,40,81,35
2020-07-22,GM,Morocco,374,258,28,3,116,45,43,88,25
2020-07-23,GM,Morocco,386,260,25,2,126,52,49,101,23
2020-07-24,GM,Morocco,436,278,55,4,158,51,52,103,51
2020-07-25,GM,Morocco,519,371,43,2,148,52,53,105,41
2020-07-26,GM,Morocco,498,346,52,2,152,48,52,100,50
2020-07-27,GM,Morocco,383,261,31,3,122,44,47,91,28
2020-07-28,GM,Morocco,407,267,38,4,140,53,49,102,34
2020-07-29,GM,Morocco,407,267,34,1,140,53,53,106,33
2020-07-30,GM,Morocco,422,290,25,0,132,55,52,107,25
2020-07-31,GM,Morocco,421,292,38,0,129,45,46,91,38
2020-08-01,GM,Morocco,591,474,29,2,117,44,44,88,27
2020-08-02,GM,Morocco,539,404,43,1,135,45,47,92,42
2020-08-03,GM,Morocco,455,353,28,2,102,37,37,74,26
2020-08-04,GM,Morocco,418,317,37,1,101,33,31,64,36
2020-08-05,GM,Morocco,462,333,38,3,129,46,45,91,35
2020-08-06,GM,Morocco,451,323,35,1,128,50,43,93,34
2020-08-07,GM,Morocco,476,332,41,0,144,50,53,103,41
2020-08-08,GM,Morocco,573,439,41,3,134,46,47,93,38
2020-08-09,GM,Morocco,493,377,35,0,116,39,42,81,35
2020-08-10,GM,Morocco,440,335,30,2,105,37,38,75,28
2020-08-11,GM,Morocco,403,297,39,4,106,33,34,67,35
2020-08-12,GM,Morocco,427,317,40,1,110,35,35,70,39
2020-08-13,GM,Morocco,426,312,34,2,114,40,40,80,32
2020-08-14,GM,Morocco,464,340,37,2,124,45,42,87,35
2020-08-15,GM,Morocco,550,442,28,2,108,40,40,80,26
2020-08-16,GM,Morocco,521,387,44,0,134,44,46,90,44
2020-08-17,GM,Morocco,424,329,25,3,95,35,35,70,22
2020-08-18,GM,Morocco,438,320,42,2,118,38,38,76,40
2020-08-19,GM,Morocco,435,316,32,3,119,44,43,87,29
2020-08-20,GM,Morocco,413,289,39,1,124,43,42,85,38
2020-08-21,GM,Morocco,458,320,46,0,138,48,44,92,46
2020-08-22,GM,Morocco,555,434,34,0,121,43,44,87,34
2020-08-23,GM,Morocco,509,369,44,0,140,48,48,96,44
2020-08-24,GM,Morocco,432,327,29,3,105,37,39,76,26
2020-08-25,GM,Morocco,411,308,34,1,103,35,34,69,33
2020-08-26,GM,Morocco,426,299,38,3,127,44,45,89,35
2020-08-27,GM,Morocco,412,291,31,0,121,47,43,90,31
2020-08-28,GM,Morocco,478,331,49,2,147,51,47,98,47
2020-08-29,GM,Morocco,580,438,30,2,142,56,56,112,28
2020-08-30,GM,Morocco,556,374,61,0,182,62,59,121,61
2020-08-31,GM,Morocco,440,325,40,3,115,38,37,75,37
2020-09-01,GM,Morocco,429,309,38,1,120,40,42,82,37
2020-09-02,GM,Morocco,439,299,45,2,140,47,48,95,43
2020-09-03,GM,Morocco,403,263,51,4,140,47,42,89,47
2020-09-04,GM,Morocco,420,285,38,3,135,47,50,97,35
2020-09-05,GM,Morocco,570,427,38,3,143,53,52,105,35
2020-09-06,GM,Morocco,497,340,52,0,157,53,52,105,52
2020-09-07,GM,Morocco,391,294,25,4,97,34,38,72,21
2020-09-08,GM,Morocco,374,266,42,3,108,33,33,66,39
2020-09-09,GM,Morocco,408,278,43,2,130,44,43,87,41
2020-09-10,GM,Morocco,384,260,28,1,124,48,48,96,27
2020-09-11,GM,Morocco,420,268,59,1,152,47,46,93,58
2020-09-12,GM,Morocco,479,355,31,0,124,45,48,93,31
2020-09-13,GM,Morocco,484,322,60,1,162,52,50,102,59
2020-09-14,GM,Morocco,357,247,33,3,110,38,39,77,30
2020-09-15,GM,Morocco,359,246,38,0,113,38,37,75,38
2020-09-16,GM,Morocco,356,219,43,1,137,46,48,94,42
2020-09-17,GM,Morocco,337,217,33,2,120,45,42,87,31
2020-09-18,GM,Morocco,388,231,55,5,157,53,49,102,50
2020-09-19,GM,Morocco,430,311,23,0,119,48,48,96,23
2020-09-20,GM,Morocco,446,278,52,0,168,57,59,116,52
2020-09-21,GM,Morocco,313,214,35,4,99,30,34,64,31
2020-09-22,GM,Morocco,334,211,46,2,123,40,37,77,44
2020-09-23,GM,Morocco,341,216,37,1,125,43,45,88,36
2020-09-24,GM,Morocco,327,196,35,1,131,48,48,96,34
2020-09-25,GM,Morocco,383,230,44,0,153,54,55,109,44
2020-09-26,GM,Morocco,461,317,42,0,144,53,49,102,42
2020-09-27,GM,Morocco,440,278,51,0,162,57,54,111,51
2020-09-28,GM,Morocco,298,202,27,0,96,34,35,69,27
2020-09-29,GM,Morocco,345,213,49,4,132,41,42,83,45
2020-09-30,GM,Morocco,353,210,42,1,143,51,50,101,41
2020-10-01,GM,Morocco,329,191,44,1,138,46,48,94,43
2020-10-02,GM,Morocco,398,227,63,1,171,55,53,108,62
2020-10-03,GM,Morocco,455,303,47,2,152,54,51,105,45
2020-10-04,GM,Morocco,438,281,51,0,157,54,52,106,51
2020-10-05,GM,Morocco,302,199,39,0,103,31,33,64,39
2020-10-06,GM,Morocco,297,183,43,0,114,35,36,71,43
2020-10-07,GM,Morocco,336,207,38,0,129,45,46,91,38
2020-10-08,GM,Morocco,321,187,49,0,134,43,42,85,49
2020-10-09,GM,Morocco,396,237,56,0,159,53,50,103,56
2020-10-10,GM,Morocco,450,313,26,0,137,56,55,111,26
2020-10-11,GM,Morocco,460,279,55,1,181,63,63,126,54
2020-10-12,GM,Morocco,312,193,33,1,119,42,44,86,32
2020-10-13,GM,Morocco,319,207,35,2,112,38,39,77,33
2020-10-14,GM,Morocco,348,197,45,3,151,53,53,106,42
2020-10-15,GM,Morocco,330,183,35,3,147,55,57,112,32
2020-10-16,GM,Morocco,439,248,54,3,191,70,67,137,51
2020-10-17,GM,Morocco,534,343,38,1,191,76,77,153,37
2020-10-18,GM,Morocco,501,294,55,0,207,78,74,152,55
2020-10-19,GM,Morocco,353,210,27,3,143,56,60,116,24
2020-10-20,GM,Morocco,282,165,33,2,117,42,42,84,31
2020-10-21,GM,Morocco,353,174,48,1,179,67,64,131,47
2020-10-22,GM,Morocco,342,168,51,4,174,62,61,123,47
2020-10-23,GM,Morocco,430,214,71,5,216,74,71,145,66
2020-10-24,GM,Morocco,552,370,34,1,182,74,74,148,33
2020-10-25,GM,Morocco,546,310,66,0,236,84,86,170,66
2020-10-26,GM,Morocco,373,225,29,1,148,61,58,119,28
2020-10-27,GM,Morocco,351,204,49,4,147,48,50,98,45
2020-10-28,GM,Morocco,340,181,38,1,159,63,58,121,37
2020-10-29,GM,Morocco,388,217,31,3,171,71,69,140,28
2020-10-30,GM,Morocco,508,277,62,1,231,85,84,169,61
2020-10-31,GM,Morocco,678,462,37,6,216,94,85,179,31
2020-11-01,GM,Morocco,561,331,61,0,230,85,84,169,61
2020-11-02,GM,Morocco,392,230,35,1,162,59,68,127,34
2020-11-03,GM,Morocco,314,194,35,1,120,44,41,85,34
2020-11-04,GM,Morocco,298,147,39,5,151,55,57,112,34
2020-11-05,GM,Morocco,315,170,37,6,145,55,53,108,31
2020-11-06,GM,Morocco,433,232,45,0,201,80,76,156,45
2020-11-07,GM,Morocco,627,442,38,0,185,76,71,147,38
2020-11-08,GM,Morocco,525,315,57,0,210,73,80,153,57
2020-11-09,GM,Morocco,375,231,42,2,144,52,50,102,40
2020-11-10,GM,Morocco,272,166,36,0,106,35,35,70,36
2020-11-11,GM,Morocco,300,152,35,5,148,58,55,113,30
2020-11-12,GM,Morocco,306,159,33,1,147,58,56,114,32
2020-11-13,GM,Morocco,440,216,62,3,224,81,81,162,59
2020-11-14,GM,Morocco,558,371,42,2,187,73,72,145,40
2020-11-15,GM,Morocco,507,273,61,2,234,83,90,173,59
2020-11-16,GM,Morocco,335,194,30,2,141,59,52,111,28
2020-11-17,GM,Morocco,275,135,52,5,140,44,44,88,47
2020-11-18,GM,Morocco,283,140,30,0,143,57,56,113,30
2020-11-19,GM,Morocco,266,144,30,3,122,47,45,92,27
2020-11-20,GM,Morocco,415,184,64,3,231,82,85,167,61
2020-11-21,GM,Morocco,504,315,40,1,189,76,73,149,39
2020-11-22,GM,Morocco,434,235,51,0,199,72,76,148,51
2020-11-23,GM,Morocco,317,183,42,4,134,46,46,92,38
2020-11-24,GM,Morocco,226,109,38,1,117,41,38,79,37
2020-11-25,GM,Morocco,266,130,33,0,136,51,52,103,33
2020-11-26,GM,Morocco,262,126,34,1,136,51,51,102,33
2020-11-27,GM,Morocco,397,178,60,3,219,80,79,159,57
2020-11-28,GM,Morocco,508,321,39,1,187,76,72,148,38
2020-11-29,GM,Morocco,435,221,53,0,214,80,81,161,53
2020-11-30,GM,Morocco,314,175,38,3,139,47,54,101,35
2020-12-01,GM,Morocco,263,145,38,3,118,42,38,80,35
2020-12-02,GM,Morocco,320,154,47,2,166,62,57,119,45
2020-12-03,GM,Morocco,332,184,37,5,148,55,56,111,32
2020-12-04,GM,Morocco,469,250,59,0,219,80,80,160,59
2020-12-05,GM,Morocco,590,390,32,1,200,87,81,168,31
2020-12-06,GM,Morocco,458,240,53,0,218,79,86,165,53
2020-12-07,GM,Morocco,327,182,37,2,145,53,55,108,35
2020-12-08,GM,Morocco,341,201,55,5,140,44,41,85,50
2020-12-09,GM,Morocco,331,162,39,5,169,67,63,130,34
2020-12-10,GM,Morocco,342,172,33,4,170,69,68,137,29
2020-12-11,GM,Morocco,486,209,71,3,277,104,102,206,68
2020-12-12,GM,Morocco,617,387,42,1,230,98,90,188,41
2020-12-13,GM,Morocco,524,289,60,1,235,86,89,175,59
2020-12-14,GM,Morocco,449,226,48,2,223,83,92,175,46
2020-12-15,GM,Morocco,391,185,47,4,206,86,73,159,43
2020-12-16,GM,Morocco,439,218,50,1,221,85,86,171,49
2020-12-17,GM,Morocco,540,274,58,4,266,107,101,208,54
2020-12-18,GM,Morocco,649,311,68,3,338,136,134,270,65
2020-12-19,GM,Morocco,975,626,50,0,349,150,149,299,50
2020-12-20,GM,Morocco,728,434,59,0,294,116,119,235,59
2020-12-21,GM,Morocco,566,306,48,3,260,104,108,212,45
2020-12-22,GM,Morocco,589,361,50,2,228,91,87,178,48
2020-12-23,GM,Morocco,598,338,55,1,260,103,102,205,54
2020-12-24,GM,Morocco,485,254,44,4,231,92,95,187,40
2020-12-25,GM,Morocco,464,181,72,0,283,104,107,211,72
2020-12-26,GM,Morocco,880,569,48,1,311,132,131,263,47
2020-12-27,GM,Morocco,713,426,70,0,287,107,110,217,70
2020-12-28,GM,Morocco,539,295,56,2,244,93,95,188,54
2020-12-29,GM,Morocco,501,290,53,4,211,79,79,158,49
2020-12-30,GM,Morocco,530,297,57,6,233,87,89,176,51
2020-12-31,GM,Morocco,445,213,55,1,232,89,88,177,54
2020-01-01,EH,Netherlands,2728,1441,6,2,1287,641,640,1281,4
2020-01-02,EH,Netherlands,3272,1742,30,1,1530,755,745,1500,29
2020-01-03,EH,Netherlands,3357,1781,48,6,1576,763,765,1528,42
2020-01-04,EH,Netherlands,2967,1644,15,2,1323,655,653,1308,13
2020-01-05,EH,Netherlands,3358,1828,22,7,1530,750,758,1508,15
2020-01-06,EH,Netherlands,3317,1746,47,10,1571,760,764,1524,37
2020-01-07,EH,Netherlands,3047,1607,51,8,1440,695,694,1389,43
2020-01-08,EH,Netherlands,2949,1494,45,8,1455,704,706,1410,37
2020-01-09,EH,Netherlands,3104,1571,67,13,1533,732,734,1466,54
2020-01-10,EH,Netherlands,3294,1731,40,6,1563,761,762,1523,34
2020-01-11,EH,Netherlands,2674,1450,24,7,1224,596,604,1200,17
2020-01-12,EH,Netherlands,3145,1668,23,3,1477,726,728,1454,20
2020-01-13,EH,Netherlands,3181,1645,54,11,1536,741,741,1482,43
2020-01-14,EH,Netherlands,2758,1412,55,14,1346,650,641,1291,41
2020-01-15,EH,Netherlands,2883,1466,50,16,1417,680,687,1367,34
2020-01-16,EH,Netherlands,3149,1588,65,13,1561,753,743,1496,52
2020-01-17,EH,Netherlands,3323,1774,55,13,1549,750,744,1494,42
2020-01-18,EH,Netherlands,2699,1513,16,4,1186,579,591,1170,12
2020-01-19,EH,Netherlands,3123,1676,27,3,1447,713,707,1420,24
2020-01-20,EH,Netherlands,3273,1778,51,7,1495,727,717,1444,44
2020-01-21,EH,Netherlands,2962,1579,47,4,1383,662,674,1336,43
2020-01-22,EH,Netherlands,2873,1512,31,6,1361,664,666,1330,25
2020-01-23,EH,Netherlands,3155,1622,57,5,1533,736,740,1476,52
2020-01-24,EH,Netherlands,3386,1844,52,12,1542,745,745,1490,40
2020-01-25,EH,Netherlands,2687,1508,11,3,1179,581,587,1168,8
2020-01-26,EH,Netherlands,3136,1679,22,5,1457,718,717,1435,17
2020-01-27,EH,Netherlands,3194,1662,61,19,1532,735,736,1471,42
2020-01-28,EH,Netherlands,2790,1412,67,20,1378,656,655,1311,47
2020-01-29,EH,Netherlands,2877,1459,51,13,1418,686,681,1367,38
2020-01-30,EH,Netherlands,3215,1625,80,21,1590,757,753,1510,59
2020-01-31,EH,Netherlands,3317,1782,34,9,1535,749,752,1501,25
2020-02-01,EH,Netherlands,2733,1542,5,2,1191,589,597,1186,3
2020-02-02,EH,Netherlands,3105,1664,12,3,1441,716,713,1429,9
2020-02-03,EH,Netherlands,3266,1698,52,15,1568,754,762,1516,37
2020-02-04,EH,Netherlands,2931,1537,51,11,1394,672,671,1343,40
2020-02-05,EH,Netherlands,3037,1558,79,19,1479,701,699,1400,60
2020-02-06,EH,Netherlands,3257,1657,64,13,1600,771,765,1536,51
2020-02-07,EH,Netherlands,3433,1847,73,22,1586,757,756,1513,51
2020-02-08,EH,Netherlands,2808,1579,13,6,1229,601,615,1216,7
2020-02-09,EH,Netherlands,2467,1347,4,2,1120,563,553,1116,2
2020-02-10,EH,Netherlands,2889,1669,28,10,1220,590,602,1192,18
2020-02-11,EH,Netherlands,2751,1463,40,11,1288,625,623,1248,29
2020-02-12,EH,Netherlands,3027,1544,68,23,1483,711,704,1415,45
2020-02-13,EH,Netherlands,3272,1675,67,15,1597,766,764,1530,52
2020-02-14,EH,Netherlands,3455,1822,64,20,1633,788,781,1569,44
2020-02-15,EH,Netherlands,2883,1550,21,10,1333,659,653,1312,11
2020-02-16,EH,Netherlands,3094,1646,7,4,1448,715,726,1441,3
2020-02-17,EH,Netherlands,3362,1734,64,22,1628,785,779,1564,42
2020-02-18,EH,Netherlands,3103,1577,69,22,1526,730,727,1457,47
2020-02-19,EH,Netherlands,3151,1584,65,20,1567,747,755,1502,45
2020-02-20,EH,Netherlands,3319,1712,61,15,1607,774,772,1546,46
2020-02-21,EH,Netherlands,3469,1815,57,24,1654,796,801,1597,33
2020-02-22,EH,Netherlands,2932,1582,23,11,1350,669,658,1327,12
2020-02-23,EH,Netherlands,3047,1722,22,6,1325,647,656,1303,16
2020-02-24,EH,Netherlands,3348,1761,55,15,1587,762,770,1532,40
2020-02-25,EH,Netherlands,3216,1666,72,21,1550,743,735,1478,51
2020-02-26,EH,Netherlands,3219,1684,70,18,1535,726,739,1465,52
2020-02-27,EH,Netherlands,3311,1699,34,10,1612,792,786,1578,24
2020-02-28,EH,Netherlands,3470,1824,69,17,1646,783,794,1577,52
2020-02-29,EH,Netherlands,2994,1629,21,7,1365,672,672,1344,14
2020-03-01,EH,Netherlands,3325,1804,14,4,1521,752,755,1507,10
2020-03-02,EH,Netherlands,3413,1773,65,31,1640,782,793,1575,34
2020-03-03,EH,Netherlands,3150,1593,64,19,1557,746,747,1493,45
2020-03-04,EH,Netherlands,3276,1703,72,26,1573,749,752,1501,46
2020-03-05,EH,Netherlands,3297,1670,78,29,1627,783,766,1549,49
2020-03-06,EH,Netherlands,3440,1820,67,31,1620,778,775,1553,36
2020-03-07,EH,Netherlands,2876,1566,35,13,1310,636,639,1275,22
2020-03-08,EH,Netherlands,3286,1813,19,7,1473,723,731,1454,12
2020-03-09,EH,Netherlands,3276,1717,58,20,1559,752,749,1501,38
2020-03-10,EH,Netherlands,2908,1466,61,15,1442,691,690,1381,46
2020-03-11,EH,Netherlands,2934,1495,59,16,1439,692,688,1380,43
2020-03-12,EH,Netherlands,3084,1578,63,14,1506,726,717,1443,49
2020-03-13,EH,Netherlands,3222,1732,61,16,1490,715,714,1429,45
2020-03-14,EH,Netherlands,2620,1444,23,8,1176,567,586,1153,15
2020-03-15,EH,Netherlands,2849,1512,19,7,1337,653,665,1318,12
2020-03-16,EH,Netherlands,2674,1374,52,8,1300,631,617,1248,44
2020-03-17,EH,Netherlands,2142,1081,61,9,1061,495,505,1000,52
2020-03-18,EH,Netherlands,1913,1065,53,11,848,385,410,795,42
2020-03-19,EH,Netherlands,1885,1044,54,6,841,391,396,787,48
2020-03-20,EH,Netherlands,1826,1003,49,14,823,379,395,774,35
2020-03-21,EH,Netherlands,1449,848,30,9,601,285,286,571,21
2020-03-22,EH,Netherlands,1305,704,13,2,601,282,306,588,11
2020-03-23,EH,Netherlands,1005,577,37,4,428,199,192,391,33
2020-03-24,EH,Netherlands,953,556,36,3,397,176,185,361,33
2020-03-25,EH,Netherlands,832,444,31,3,388,178,179,357,28
2020-03-26,EH,Netherlands,785,392,48,3,393,172,173,345,45
2020-03-27,EH,Netherlands,805,441,18,0,364,166,180,346,18
2020-03-28,EH,Netherlands,582,339,13,3,243,116,114,230,10
2020-03-29,EH,Netherlands,579,345,14,10,234,107,113,220,4
2020-03-30,EH,Netherlands,488,280,24,3,208,91,93,184,21
2020-03-31,EH,Netherlands,571,306,49,5,265,108,108,216,44
2020-04-01,EH,Netherlands,494,267,36,3,227,95,96,191,33
2020-04-02,EH,Netherlands,519,295,30,2,224,98,96,194,28
2020-04-03,EH,Netherlands,494,262,17,1,232,108,107,215,16
2020-04-04,EH,Netherlands,435,242,9,3,193,94,90,184,6
2020-04-05,EH,Netherlands,442,251,12,4,191,84,95,179,8
2020-04-06,EH,Netherlands,416,221,21,0,195,87,87,174,21
2020-04-07,EH,Netherlands,441,237,36,4,204,88,80,168,32
2020-04-08,EH,Netherlands,438,244,28,4,194,82,84,166,24
2020-04-09,EH,Netherlands,487,272,38,5,215,88,89,177,33
2020-04-10,EH,Netherlands,389,197,25,4,192,82,85,167,21
2020-04-11,EH,Netherlands,365,202,10,1,163,77,76,153,9
2020-04-12,EH,Netherlands,342,195,2,2,147,72,73,145,0
2020-04-13,EH,Netherlands,320,166,26,0,154,61,67,128,26
2020-04-14,EH,Netherlands,383,205,42,2,178,68,68,136,40
2020-04-15,EH,Netherlands,460,258,30,4,202,88,84,172,26
2020-04-16,EH,Netherlands,461,249,42,10,212,82,88,170,32
2020-04-17,EH,Netherlands,426,229,24,7,197,87,86,173,17
2020-04-18,EH,Netherlands,363,181,6,2,182,88,88,176,4
2020-04-19,EH,Netherlands,382,211,13,9,171,77,81,158,4
2020-04-20,EH,Netherlands,429,228,29,6,201,84,88,172,23
2020-04-21,EH,Netherlands,454,238,32,3,216,93,91,184,29
2020-04-22,EH,Netherlands,477,259,29,5,218,98,91,189,24
2020-04-23,EH,Netherlands,509,252,43,3,257,105,109,214,40
2020-04-24,EH,Netherlands,470,252,24,3,218,98,96,194,21
2020-04-25,EH,Netherlands,436,218,10,0,218,104,104,208,10
2020-04-26,EH,Netherlands,447,249,3,2,198,94,101,195,1
2020-04-27,EH,Netherlands,455,259,29,3,196,84,83,167,26
2020-04-28,EH,Netherlands,477,253,42,2,224,91,91,182,40
2020-04-29,EH,Netherlands,493,262,26,2,231,106,99,205,24
2020-04-30,EH,Netherlands,547,290,33,0,257,110,114,224,33
2020-05-01,EH,Netherlands,481,261,26,3,220,97,97,194,23
2020-05-02,EH,Netherlands,445,238,5,1,207,98,104,202,4
2020-05-03,EH,Netherlands,455,249,8,0,206,97,101,198,8
2020-05-04,EH,Netherlands,500,267,19,1,233,108,106,214,18
2020-05-05,EH,Netherlands,529,277,35,5,252,112,105,217,30
2020-05-06,EH,Netherlands,612,340,39,4,272,121,112,233,35
2020-05-07,EH,Netherlands,615,315,47,7,300,122,131,253,40
2020-05-08,EH,Netherlands,569,283,26,3,286,133,127,260,23
2020-05-09,EH,Netherlands,473,251,5,2,222,108,109,217,3
2020-05-10,EH,Netherlands,541,307,8,2,234,109,117,226,6
2020-05-11,EH,Netherlands,547,287,35,10,260,112,113,225,25
2020-05-12,EH,Netherlands,590,287,62,14,303,122,119,241,48
2020-05-13,EH,Netherlands,608,319,45,9,289,124,120,244,36
2020-05-14,EH,Netherlands,650,307,80,20,343,129,134,263,60
2020-05-15,EH,Netherlands,637,325,52,10,312,125,135,260,42
2020-05-16,EH,Netherlands,518,282,17,5,236,111,108,219,12
2020-05-17,EH,Netherlands,547,290,11,2,257,115,131,246,9
2020-05-18,EH,Netherlands,570,298,44,11,272,119,109,228,33
2020-05-19,EH,Netherlands,630,321,53,16,309,130,126,256,37
2020-05-20,EH,Netherlands,691,343,47,13,348,155,146,301,34
2020-05-21,EH,Netherlands,643,309,58,8,334,141,135,276,50
2020-05-22,EH,Netherlands,606,309,43,9,297,122,132,254,34
2020-05-23,EH,Netherlands,594,321,16,4,273,127,130,257,12
2020-05-24,EH,Netherlands,574,313,11,5,261,123,127,250,6
2020-05-25,EH,Netherlands,630,321,57,16,309,127,125,252,41
2020-05-26,EH,Netherlands,688,341,72,12,347,139,136,275,60
2020-05-27,EH,Netherlands,725,372,60,11,353,149,144,293,49
2020-05-28,EH,Netherlands,725,362,56,12,363,154,153,307,44
2020-05-29,EH,Netherlands,714,357,60,15,357,149,148,297,45
2020-05-30,EH,Netherlands,597,297,35,9,300,133,132,265,26
2020-05-31,EH,Netherlands,566,295,7,1,271,128,136,264,6
2020-06-01,EH,Netherlands,635,321,34,2,314,141,139,280,32
2020-06-02,EH,Netherlands,704,333,72,14,371,150,149,299,58
2020-06-03,EH,Netherlands,752,388,65,13,364,156,143,299,52
2020-06-04,EH,Netherlands,752,359,85,14,393,153,155,308,71
2020-06-05,EH,Netherlands,711,344,46,11,367,160,161,321,35
2020-06-06,EH,Netherlands,660,349,19,5,311,148,144,292,14
2020-06-07,EH,Netherlands,635,334,13,1,301,142,146,288,12
2020-06-08,EH,Netherlands,722,356,56,19,366,152,158,310,37
2020-06-09,EH,Netherlands,700,311,73,20,389,156,160,316,53
2020-06-10,EH,Netherlands,750,369,71,22,381,158,152,310,49
2020-06-11,EH,Netherlands,759,339,53,11,420,187,180,367,42
2020-06-12,EH,Netherlands,770,337,61,14,433,182,190,372,47
2020-06-13,EH,Netherlands,636,293,28,4,343,160,155,315,24
2020-06-14,EH,Netherlands,646,323,11,2,323,151,161,312,9
2020-06-15,EH,Netherlands,782,359,54,13,423,188,181,369,41
2020-06-16,EH,Netherlands,782,357,65,16,425,181,179,360,49
2020-06-17,EH,Netherlands,827,386,81,18,441,177,183,360,63
2020-06-18,EH,Netherlands,873,360,75,18,513,219,219,438,57
2020-06-19,EH,Netherlands,881,401,52,10,480,215,213,428,42
2020-06-20,EH,Netherlands,750,316,32,11,434,208,194,402,21
2020-06-21,EH,Netherlands,779,351,23,4,428,193,212,405,19
2020-06-22,EH,Netherlands,849,381,48,8,468,208,212,420,40
2020-06-23,EH,Netherlands,887,385,77,22,502,216,209,425,55
2020-06-24,EH,Netherlands,913,429,56,13,484,216,212,428,43
2020-06-25,EH,Netherlands,928,402,80,21,526,224,222,446,59
2020-06-26,EH,Netherlands,943,436,62,22,507,224,221,445,40
2020-06-27,EH,Netherlands,765,338,25,6,427,196,206,402,19
2020-06-28,EH,Netherlands,803,355,19,6,448,210,219,429,13
2020-06-29,EH,Netherlands,888,375,63,20,513,225,225,450,43
2020-06-30,EH,Netherlands,917,396,65,21,521,223,233,456,44
2020-07-01,EH,Netherlands,1273,658,62,19,615,281,272,553,43
2020-07-02,EH,Netherlands,1340,634,74,22,706,315,317,632,52
2020-07-03,EH,Netherlands,1411,661,62,21,750,346,342,688,41
2020-07-04,EH,Netherlands,1266,591,25,16,675,334,316,650,9
2020-07-05,EH,Netherlands,1302,605,12,4,697,344,341,685,8
2020-07-06,EH,Netherlands,1296,573,55,18,723,332,336,668,37
2020-07-07,EH,Netherlands,1324,632,65,17,692,315,312,627,48
2020-07-08,EH,Netherlands,1348,623,45,17,725,341,339,680,28
2020-07-09,EH,Netherlands,1407,653,52,12,754,350,352,702,40
2020-07-10,EH,Netherlands,1523,700,78,20,823,372,373,745,58
2020-07-11,EH,Netherlands,1382,644,17,2,738,369,352,721,15
2020-07-12,EH,Netherlands,1410,696,19,3,714,342,353,695,16
2020-07-13,EH,Netherlands,1411,642,59,15,769,351,359,710,44
2020-07-14,EH,Netherlands,1355,644,67,16,711,326,318,644,51
2020-07-15,EH,Netherlands,1521,721,77,26,800,360,363,723,51
2020-07-16,EH,Netherlands,1636,796,78,18,840,378,384,762,60
2020-07-17,EH,Netherlands,1661,826,42,10,835,401,392,793,32
2020-07-18,EH,Netherlands,1508,746,17,0,762,374,371,745,17
2020-07-19,EH,Netherlands,1599,801,14,3,798,390,394,784,11
2020-07-20,EH,Netherlands,1586,792,55,14,794,368,371,739,41
2020-07-21,EH,Netherlands,1488,727,69,17,761,345,347,692,52
2020-07-22,EH,Netherlands,1565,773,61,9,792,365,366,731,52
2020-07-23,EH,Netherlands,1599,786,80,14,813,367,366,733,66
2020-07-24,EH,Netherlands,1673,808,61,17,865,403,401,804,44
2020-07-25,EH,Netherlands,1549,753,19,6,796,393,384,777,13
2020-07-26,EH,Netherlands,1604,825,13,3,779,379,387,766,10
2020-07-27,EH,Netherlands,1500,705,61,16,795,363,371,734,45
2020-07-28,EH,Netherlands,1399,690,59,5,709,324,326,650,54
2020-07-29,EH,Netherlands,1519,750,51,4,769,355,363,718,47
2020-07-30,EH,Netherlands,1596,765,80,15,831,380,371,751,65
2020-07-31,EH,Netherlands,1717,838,29,9,879,426,424,850,20
2020-08-01,EH,Netherlands,1711,910,14,4,801,397,390,787,10
2020-08-02,EH,Netherlands,1767,957,11,1,810,390,409,799,10
2020-08-03,EH,Netherlands,1884,909,38,7,975,489,448,937,31
2020-08-04,EH,Netherlands,1841,866,68,17,975,452,455,907,51
2020-08-05,EH,Netherlands,1940,917,62,10,1023,479,482,961,52
2020-08-06,EH,Netherlands,1955,943,62,9,1012,470,480,950,53
2020-08-07,EH,Netherlands,2074,995,40,6,1079,521,518,1039,34
2020-08-08,EH,Netherlands,1916,958,10,5,958,478,470,948,5
2020-08-09,EH,Netherlands,2032,1012,11,2,1020,500,509,1009,9
2020-08-10,EH,Netherlands,1961,926,39,5,1035,501,495,996,34
2020-08-11,EH,Netherlands,1787,849,61,11,938,433,444,877,50
2020-08-12,EH,Netherlands,1983,982,41,6,1001,484,476,960,35
2020-08-13,EH,Netherlands,1935,924,69,11,1011,476,466,942,58
2020-08-14,EH,Netherlands,2113,1005,46,10,1108,529,533,1062,36
2020-08-15,EH,Netherlands,1950,952,17,7,998,495,486,981,10
2020-08-16,EH,Netherlands,2081,1042,11,0,1039,506,522,1028,11
2020-08-17,EH,Netherlands,1936,927,40,8,1009,485,484,969,32
2020-08-18,EH,Netherlands,1807,856,73,16,951,441,437,878,57
2020-08-19,EH,Netherlands,1932,918,46,12,1014,487,481,968,34
2020-08-20,EH,Netherlands,1930,914,71,13,1016,468,477,945,58
2020-08-21,EH,Netherlands,2082,995,42,13,1087,530,515,1045,29
2020-08-22,EH,Netherlands,1901,936,20,4,965,477,468,945,16
2020-08-23,EH,Netherlands,2043,988,19,0,1055,509,527,1036,19
2020-08-24,EH,Netherlands,1950,933,50,17,1017,478,489,967,33
2020-08-25,EH,Netherlands,1753,814,57,19,939,439,443,882,38
2020-08-26,EH,Netherlands,1937,911,61,19,1026,484,481,965,42
2020-08-27,EH,Netherlands,1930,904,85,16,1026,475,466,941,69
2020-08-28,EH,Netherlands,2113,1037,38,13,1076,519,519,1038,25
2020-08-29,EH,Netherlands,1940,973,18,3,967,477,472,949,15
2020-08-30,EH,Netherlands,2119,1068,35,10,1051,498,518,1016,25
2020-08-31,EH,Netherlands,2093,994,56,16,1099,527,516,1043,40
2020-09-01,EH,Netherlands,1946,917,85,19,1029,468,476,944,66
2020-09-02,EH,Netherlands,1965,927,61,17,1038,490,487,977,44
2020-09-03,EH,Netherlands,2024,958,91,18,1066,492,483,975,73
2020-09-04,EH,Netherlands,2152,1071,49,12,1081,517,515,1032,37
2020-09-05,EH,Netherlands,1966,950,33,3,1016,497,486,983,30
2020-09-06,EH,Netherlands,2133,1061,29,2,1072,519,524,1043,27
2020-09-07,EH,Netherlands,1994,966,59,13,1028,483,486,969,46
2020-09-08,EH,Netherlands,1775,861,61,16,914,425,428,853,45
2020-09-09,EH,Netherlands,1894,906,48,13,988,466,474,940,35
2020-09-10,EH,Netherlands,1935,907,75,14,1028,477,476,953,61
2020-09-11,EH,Netherlands,2177,1074,58,15,1103,522,523,1045,43
2020-09-12,EH,Netherlands,1872,924,23,4,948,468,457,925,19
2020-09-13,EH,Netherlands,2064,1060,14,2,1004,484,506,990,12
2020-09-14,EH,Netherlands,1992,962,58,19,1030,485,487,972,39
2020-09-15,EH,Netherlands,1811,891,73,19,920,429,418,847,54
2020-09-16,EH,Netherlands,1860,904,69,22,956,438,449,887,47
2020-09-17,EH,Netherlands,1896,938,81,15,958,439,438,877,66
2020-09-18,EH,Netherlands,2100,1077,43,12,1023,498,482,980,31
2020-09-19,EH,Netherlands,1779,918,27,6,861,419,415,834,21
2020-09-20,EH,Netherlands,1984,1050,16,1,934,450,468,918,15
2020-09-21,EH,Netherlands,1936,985,48,7,951,449,454,903,41
2020-09-22,EH,Netherlands,1715,861,71,13,854,390,393,783,58
2020-09-23,EH,Netherlands,1819,905,57,10,914,425,432,857,47
2020-09-24,EH,Netherlands,1839,881,70,13,958,446,442,888,57
2020-09-25,EH,Netherlands,2055,1030,56,18,1025,488,481,969,38
2020-09-26,EH,Netherlands,1749,887,35,15,862,421,406,827,20
2020-09-27,EH,Netherlands,1966,1031,19,5,935,450,466,916,14
2020-09-28,EH,Netherlands,1925,1003,38,2,922,440,444,884,36
2020-09-29,EH,Netherlands,1666,870,69,13,796,364,363,727,56
2020-09-30,EH,Netherlands,1815,919,56,19,896,422,418,840,37
2020-10-01,EH,Netherlands,1761,893,70,12,868,398,400,798,58
2020-10-02,EH,Netherlands,2032,1060,57,12,972,460,455,915,45
2020-10-03,EH,Netherlands,1808,987,19,5,821,409,393,802,14
2020-10-04,EH,Netherlands,1882,991,17,4,891,422,452,874,13
2020-10-05,EH,Netherlands,1723,864,44,9,859,409,406,815,35
2020-10-06,EH,Netherlands,1510,764,60,18,746,337,349,686,42
2020-10-07,EH,Netherlands,1621,829,63,18,792,371,358,729,45
2020-10-08,EH,Netherlands,1701,866,69,16,835,384,382,766,53
2020-10-09,EH,Netherlands,1947,988,66,21,959,453,440,893,45
2020-10-10,EH,Netherlands,1775,943,21,8,832,408,403,811,13
2020-10-11,EH,Netherlands,1869,992,14,1,877,431,432,863,13
2020-10-12,EH,Netherlands,1642,817,49,17,825,383,393,776,32
2020-10-13,EH,Netherlands,1490,736,79,22,754,336,339,675,57
2020-10-14,EH,Netherlands,1592,780,57,20,812,377,378,755,37
2020-10-15,EH,Netherlands,1640,799,75,19,841,383,383,766,56
2020-10-16,EH,Netherlands,1900,976,52,12,924,441,431,872,40
2020-10-17,EH,Netherlands,1731,908,27,7,823,399,397,796,20
2020-10-18,EH,Netherlands,1842,1004,12,1,838,411,415,826,11
2020-10-19,EH,Netherlands,1549,742,58,10,807,374,375,749,48
2020-10-20,EH,Netherlands,1380,671,65,12,709,319,325,644,53
2020-10-21,EH,Netherlands,1502,726,51,12,776,359,366,725,39
2020-10-22,EH,Netherlands,1521,735,71,19,786,359,356,715,52
2020-10-23,EH,Netherlands,1738,869,48,17,869,413,408,821,31
2020-10-24,EH,Netherlands,1661,889,20,6,772,380,372,752,14
2020-10-25,EH,Netherlands,1640,866,26,7,774,367,381,748,19
2020-10-26,EH,Netherlands,1532,748,34,4,784,381,369,750,30
2020-10-27,EH,Netherlands,1336,666,69,12,670,298,303,601,57
2020-10-28,EH,Netherlands,1431,726,45,9,705,330,330,660,36
2020-10-29,EH,Netherlands,1489,749,69,10,740,338,333,671,59
2020-10-30,EH,Netherlands,1802,951,63,15,851,394,394,788,48
2020-10-31,EH,Netherlands,1576,884,34,12,692,330,328,658,22
2020-11-01,EH,Netherlands,1642,913,25,1,729,347,357,704,24
2020-11-02,EH,Netherlands,1435,709,31,7,726,346,349,695,24
2020-11-03,EH,Netherlands,1219,570,70,14,649,284,295,579,56
2020-11-04,EH,Netherlands,1352,662,54,14,690,324,312,636,40
2020-11-05,EH,Netherlands,1407,659,86,16,748,330,332,662,70
2020-11-06,EH,Netherlands,1626,827,50,6,799,376,373,749,44
2020-11-07,EH,Netherlands,1314,685,26,7,629,302,301,603,19
2020-11-08,EH,Netherlands,1435,739,17,2,696,338,341,679,15
2020-11-09,EH,Netherlands,1268,570,48,6,698,329,321,650,42
2020-11-10,EH,Netherlands,1095,496,56,4,599,268,275,543,52
2020-11-11,EH,Netherlands,1140,491,54,8,649,300,295,595,46
2020-11-12,EH,Netherlands,1209,536,83,22,673,296,294,590,61
2020-11-13,EH,Netherlands,1346,598,76,27,748,342,330,672,49
2020-11-14,EH,Netherlands,1070,500,10,5,570,276,284,560,5
2020-11-15,EH,Netherlands,1217,557,15,3,660,320,325,645,12
2020-11-16,EH,Netherlands,1121,488,46,20,633,287,300,587,26
2020-11-17,EH,Netherlands,1042,477,68,27,565,243,254,497,41
2020-11-18,EH,Netherlands,1055,450,72,21,605,268,265,533,51
2020-11-19,EH,Netherlands,1164,548,56,16,616,281,279,560,40
2020-11-20,EH,Netherlands,1199,514,70,24,685,301,314,615,46
2020-11-21,EH,Netherlands,966,450,20,13,516,242,254,496,7
2020-11-22,EH,Netherlands,1078,504,17,2,574,283,274,557,15
2020-11-23,EH,Netherlands,1050,440,64,24,610,276,270,546,40
2020-11-24,EH,Netherlands,961,434,74,24,527,222,231,453,50
2020-11-25,EH,Netherlands,1003,436,57,16,567,251,259,510,41
2020-11-26,EH,Netherlands,1050,486,69,18,564,252,243,495,51
2020-11-27,EH,Netherlands,1151,495,37,16,656,310,309,619,21
2020-11-28,EH,Netherlands,977,472,19,4,505,236,250,486,15
2020-11-29,EH,Netherlands,1084,521,17,5,563,282,264,546,12
2020-11-30,EH,Netherlands,1009,420,22,2,589,285,282,567,20
2020-12-01,EH,Netherlands,984,450,58,15,534,229,247,476,43
2020-12-02,EH,Netherlands,998,464,36,3,534,247,251,498,33
2020-12-03,EH,Netherlands,1142,554,51,7,588,273,264,537,44
2020-12-04,EH,Netherlands,1239,567,57,9,672,312,303,615,48
2020-12-05,EH,Netherlands,1097,544,22,5,553,254,277,531,17
2020-12-06,EH,Netherlands,1126,563,15,3,563,283,265,548,12
2020-12-07,EH,Netherlands,1112,505,45,8,607,284,278,562,37
2020-12-08,EH,Netherlands,1058,501,67,12,557,241,249,490,55
2020-12-09,EH,Netherlands,1056,543,12,5,513,255,246,501,7
2020-12-10,EH,Netherlands,1245,587,69,10,658,299,290,589,59
2020-12-11,EH,Netherlands,1410,706,50,17,704,331,323,654,33
2020-12-12,EH,Netherlands,1194,637,5,5,557,272,280,552,0
2020-12-13,EH,Netherlands,1243,627,26,2,616,297,293,590,24
2020-12-14,EH,Netherlands,1229,551,55,12,678,314,309,623,43
2020-12-15,EH,Netherlands,1174,558,45,4,616,274,297,571,41
2020-12-16,EH,Netherlands,1256,604,41,3,652,316,295,611,38
2020-12-17,EH,Netherlands,1546,781,51,3,765,364,350,714,48
2020-12-18,EH,Netherlands,1779,926,37,8,853,406,410,816,29
2020-12-19,EH,Netherlands,1651,834,13,1,817,404,400,804,12
2020-12-20,EH,Netherlands,1685,867,21,2,818,393,404,797,19
2020-12-21,EH,Netherlands,1469,707,37,2,762,364,361,725,35
2020-12-22,EH,Netherlands,1184,528,33,1,656,305,318,623,32
2020-12-23,EH,Netherlands,1313,553,28,4,760,365,367,732,24
2020-12-24,EH,Netherlands,1055,431,31,5,624,287,306,593,26
2020-12-25,EH,Netherlands,682,228,7,1,454,223,224,447,6
2020-12-26,EH,Netherlands,996,424,4,1,572,290,278,568,3
2020-12-27,EH,Netherlands,1205,497,9,7,708,356,343,699,2
2020-12-28,EH,Netherlands,1162,472,46,2,690,324,320,644,44
2020-12-29,EH,Netherlands,1061,460,38,1,601,276,287,563,37
2020-12-30,EH,Netherlands,1164,482,24,2,682,332,326,658,22
2020-12-31,EH,Netherlands,871,374,11,0,497,235,251,486,11
2020-01-01,LW,North Macedonia,339,295,0,0,44,22,22,44,0
2020-01-02,LW,North Macedonia,438,379,0,0,59,28,31,59,0
2020-01-03,LW,North Macedonia,404,344,0,0,60,31,29,60,0
2020-01-04,LW,North Macedonia,428,376,0,0,52,25,27,52,0
2020-01-05,LW,North Macedonia,464,407,0,0,57,28,29,57,0
2020-01-06,LW,North Macedonia,437,378,0,0,59,31,28,59,0
2020-01-07,LW,North Macedonia,369,328,0,0,41,20,21,41,0
2020-01-08,LW,North Macedonia,402,346,0,0,56,28,28,56,0
2020-01-09,LW,North Macedonia,374,339,0,0,35,18,17,35,0
2020-01-10,LW,North Macedonia,376,323,0,0,53,26,27,53,0
2020-01-11,LW,North Macedonia,430,384,0,0,46,23,23,46,0
2020-01-12,LW,North Macedonia,438,388,0,0,50,25,25,50,0
2020-01-13,LW,North Macedonia,400,345,0,0,55,28,27,55,0
2020-01-14,LW,North Macedonia,414,372,1,0,42,20,21,41,1
2020-01-15,LW,North Macedonia,367,325,0,0,42,20,22,42,0
2020-01-16,LW,North Macedonia,377,342,1,0,35,18,16,34,1
2020-01-17,LW,North Macedonia,381,323,0,0,58,29,29,58,0
2020-01-18,LW,North Macedonia,402,355,0,0,47,23,24,47,0
2020-01-19,LW,North Macedonia,407,360,0,0,47,23,24,47,0
2020-01-20,LW,North Macedonia,380,322,0,0,58,30,28,58,0
2020-01-21,LW,North Macedonia,351,302,0,0,49,25,24,49,0
2020-01-22,LW,North Macedonia,362,317,0,0,45,22,23,45,0
2020-01-23,LW,North Macedonia,353,315,0,0,38,18,20,38,0
2020-01-24,LW,North Macedonia,368,309,0,0,59,30,29,59,0
2020-01-25,LW,North Macedonia,375,328,0,0,47,24,23,47,0
2020-01-26,LW,North Macedonia,382,334,0,0,48,23,25,48,0
2020-01-27,LW,North Macedonia,364,306,0,0,58,30,28,58,0
2020-01-28,LW,North Macedonia,336,294,0,0,42,21,21,42,0
2020-01-29,LW,North Macedonia,327,276,0,0,51,22,29,51,0
2020-01-30,LW,North Macedonia,369,335,0,0,34,17,17,34,0
2020-01-31,LW,North Macedonia,389,335,0,0,54,28,26,54,0
2020-02-01,LW,North Macedonia,392,346,0,0,46,23,23,46,0
2020-02-02,LW,North Macedonia,405,359,0,0,46,22,24,46,0
2020-02-03,LW,North Macedonia,349,294,0,0,55,29,26,55,0
2020-02-04,LW,North Macedonia,338,299,0,0,39,19,20,39,0
2020-02-05,LW,North Macedonia,348,299,0,0,49,24,25,49,0
2020-02-06,LW,North Macedonia,373,337,0,0,36,18,18,36,0
2020-02-07,LW,North Macedonia,408,352,0,0,56,28,28,56,0
2020-02-08,LW,North Macedonia,422,377,0,0,45,22,23,45,0
2020-02-09,LW,North Macedonia,405,357,0,0,48,23,25,48,0
2020-02-10,LW,North Macedonia,355,299,0,0,56,29,27,56,0
2020-02-11,LW,North Macedonia,312,267,0,0,45,23,22,45,0
2020-02-12,LW,North Macedonia,357,304,0,0,53,26,27,53,0
2020-02-13,LW,North Macedonia,335,298,0,0,37,19,18,37,0
2020-02-14,LW,North Macedonia,362,306,0,0,56,28,28,56,0
2020-02-15,LW,North Macedonia,417,367,0,0,50,26,24,50,0
2020-02-16,LW,North Macedonia,415,366,0,0,49,23,26,49,0
2020-02-17,LW,North Macedonia,361,302,0,0,59,31,28,59,0
2020-02-18,LW,North Macedonia,338,298,0,0,40,19,21,40,0
2020-02-19,LW,North Macedonia,377,329,0,0,48,24,24,48,0
2020-02-20,LW,North Macedonia,372,333,0,0,39,19,20,39,0
2020-02-21,LW,North Macedonia,396,340,0,0,56,29,27,56,0
2020-02-22,LW,North Macedonia,446,397,0,0,49,25,24,49,0
2020-02-23,LW,North Macedonia,398,350,0,0,48,23,25,48,0
2020-02-24,LW,North Macedonia,350,296,0,0,54,28,26,54,0
2020-02-25,LW,North Macedonia,347,308,0,0,39,18,21,39,0
2020-02-26,LW,North Macedonia,367,318,0,0,49,24,25,49,0
2020-02-27,LW,North Macedonia,347,312,0,0,35,17,18,35,0
2020-02-28,LW,North Macedonia,395,336,0,0,59,30,29,59,0
2020-02-29,LW,North Macedonia,433,385,0,0,48,23,25,48,0
2020-03-01,LW,North Macedonia,423,374,0,0,49,24,25,49,0
2020-03-02,LW,North Macedonia,378,317,0,0,61,32,29,61,0
2020-03-03,LW,North Macedonia,344,302,0,0,42,20,22,42,0
2020-03-04,LW,North Macedonia,340,288,0,0,52,27,25,52,0
2020-03-05,LW,North Macedonia,360,321,0,0,39,19,20,39,0
2020-03-06,LW,North Macedonia,361,303,0,0,58,29,29,58,0
2020-03-07,LW,North Macedonia,396,349,0,0,47,23,24,47,0
2020-03-08,LW,North Macedonia,394,347,0,0,47,23,24,47,0
2020-03-09,LW,North Macedonia,332,280,0,0,52,28,24,52,0
2020-03-10,LW,North Macedonia,315,273,0,0,42,20,22,42,0
2020-03-11,LW,North Macedonia,353,305,0,0,48,24,24,48,0
2020-03-12,LW,North Macedonia,315,279,0,0,36,18,18,36,0
2020-03-13,LW,North Macedonia,338,290,0,0,48,24,24,48,0
2020-03-14,LW,North Macedonia,372,328,0,0,44,22,22,44,0
2020-03-15,LW,North Macedonia,335,294,0,0,41,21,20,41,0
2020-03-16,LW,North Macedonia,332,294,0,0,38,20,18,38,0
2020-03-17,LW,North Macedonia,280,249,0,0,31,16,15,31,0
2020-03-18,LW,North Macedonia,307,282,0,0,25,13,12,25,0
2020-03-19,LW,North Macedonia,247,242,0,0,5,2,3,5,0
2020-03-20,LW,North Macedonia,222,216,0,0,6,3,3,6,0
2020-03-21,LW,North Macedonia,176,174,0,0,2,1,1,2,0
2020-03-22,LW,North Macedonia,127,125,0,0,2,1,1,2,0
2020-03-23,LW,North Macedonia,92,88,0,0,4,2,2,4,0
2020-03-24,LW,North Macedonia,97,91,0,0,6,3,3,6,0
2020-03-25,LW,North Macedonia,67,63,0,0,4,2,2,4,0
2020-03-26,LW,North Macedonia,75,68,0,0,7,4,3,7,0
2020-03-27,LW,North Macedonia,50,42,0,0,8,4,4,8,0
2020-03-28,LW,North Macedonia,66,60,0,0,6,3,3,6,0
2020-03-29,LW,North Macedonia,41,37,0,0,4,2,2,4,0
2020-03-30,LW,North Macedonia,48,40,0,0,8,4,4,8,0
2020-03-31,LW,North Macedonia,47,43,0,0,4,2,2,4,0
2020-04-01,LW,North Macedonia,60,56,0,0,4,2,2,4,0
2020-04-02,LW,North Macedonia,56,50,0,0,6,3,3,6,0
2020-04-03,LW,North Macedonia,60,49,0,0,11,5,6,11,0
2020-04-04,LW,North Macedonia,45,43,0,0,2,1,1,2,0
2020-04-05,LW,North Macedonia,44,42,0,0,2,1,1,2,0
2020-04-06,LW,North Macedonia,45,37,0,0,8,4,4,8,0
2020-04-07,LW,North Macedonia,52,46,0,0,6,3,3,6,0
2020-04-08,LW,North Macedonia,59,53,0,0,6,3,3,6,0
2020-04-09,LW,North Macedonia,56,48,0,0,8,4,4,8,0
2020-04-10,LW,North Macedonia,41,33,0,0,8,4,4,8,0
2020-04-11,LW,North Macedonia,42,36,0,0,6,3,3,6,0
2020-04-12,LW,North Macedonia,26,26,0,0,0,0,0,0,0
2020-04-13,LW,North Macedonia,41,35,0,0,6,3,3,6,0
2020-04-14,LW,North Macedonia,38,30,0,0,8,4,4,8,0
2020-04-15,LW,North Macedonia,53,47,0,0,6,3,3,6,0
2020-04-16,LW,North Macedonia,62,58,0,0,4,2,2,4,0
2020-04-17,LW,North Macedonia,42,38,0,0,4,2,2,4,0
2020-04-18,LW,North Macedonia,53,46,0,0,7,4,3,7,0
2020-04-19,LW,North Macedonia,43,37,0,0,6,3,3,6,0
2020-04-20,LW,North Macedonia,35,31,0,0,4,2,2,4,0
2020-04-21,LW,North Macedonia,45,39,0,0,6,3,3,6,0
2020-04-22,LW,North Macedonia,62,56,0,0,6,3,3,6,0
2020-04-23,LW,North Macedonia,75,71,0,0,4,2,2,4,0
2020-04-24,LW,North Macedonia,64,59,0,0,5,3,2,5,0
2020-04-25,LW,North Macedonia,40,40,0,0,0,0,0,0,0
2020-04-26,LW,North Macedonia,47,47,0,0,0,0,0,0,0
2020-04-27,LW,North Macedonia,70,65,0,0,5,2,3,5,0
2020-04-28,LW,North Macedonia,60,52,0,0,8,4,4,8,0
2020-04-29,LW,North Macedonia,75,67,0,0,8,4,4,8,0
2020-04-30,LW,North Macedonia,66,62,0,0,4,2,2,4,0
2020-05-01,LW,North Macedonia,54,54,0,0,0,0,0,0,0
2020-05-02,LW,North Macedonia,57,57,0,0,0,0,0,0,0
2020-05-03,LW,North Macedonia,53,53,0,0,0,0,0,0,0
2020-05-04,LW,North Macedonia,43,35,0,0,8,4,4,8,0
2020-05-05,LW,North Macedonia,55,51,0,0,4,2,2,4,0
2020-05-06,LW,North Macedonia,62,56,0,0,6,3,3,6,0
2020-05-07,LW,North Macedonia,66,60,0,0,6,3,3,6,0
2020-05-08,LW,North Macedonia,63,59,0,0,4,2,2,4,0
2020-05-09,LW,North Macedonia,53,51,0,0,2,1,1,2,0
2020-05-10,LW,North Macedonia,38,38,0,0,0,0,0,0,0
2020-05-11,LW,North Macedonia,58,52,0,0,6,3,3,6,0
2020-05-12,LW,North Macedonia,56,50,0,0,6,3,3,6,0
2020-05-13,LW,North Macedonia,57,53,0,0,4,2,2,4,0
2020-05-14,LW,North Macedonia,67,62,1,1,5,2,2,4,0
2020-05-15,LW,North Macedonia,61,51,0,0,10,5,5,10,0
2020-05-16,LW,North Macedonia,56,52,0,0,4,2,2,4,0
2020-05-17,LW,North Macedonia,53,44,3,3,9,3,3,6,0
2020-05-18,LW,North Macedonia,60,52,2,2,8,3,3,6,0
2020-05-19,LW,North Macedonia,52,46,0,0,6,3,3,6,0
2020-05-20,LW,North Macedonia,64,58,0,0,6,3,3,6,0
2020-05-21,LW,North Macedonia,72,68,0,0,4,2,2,4,0
2020-05-22,LW,North Macedonia,56,50,0,0,6,3,3,6,0
2020-05-23,LW,North Macedonia,55,53,0,0,2,1,1,2,0
2020-05-24,LW,North Macedonia,29,29,0,0,0,0,0,0,0
2020-05-25,LW,North Macedonia,43,37,0,0,6,3,3,6,0
2020-05-26,LW,North Macedonia,57,49,0,0,8,4,4,8,0
2020-05-27,LW,North Macedonia,72,67,0,0,5,3,2,5,0
2020-05-28,LW,North Macedonia,74,65,0,0,9,4,5,9,0
2020-05-29,LW,North Macedonia,62,56,0,0,6,3,3,6,0
2020-05-30,LW,North Macedonia,58,58,0,0,0,0,0,0,0
2020-05-31,LW,North Macedonia,55,55,0,0,0,0,0,0,0
2020-06-01,LW,North Macedonia,59,55,0,0,4,2,2,4,0
2020-06-02,LW,North Macedonia,67,61,0,0,6,3,3,6,0
2020-06-03,LW,North Macedonia,68,64,0,0,4,2,2,4,0
2020-06-04,LW,North Macedonia,64,60,0,0,4,2,2,4,0
2020-06-05,LW,North Macedonia,57,49,0,0,8,4,4,8,0
2020-06-06,LW,North Macedonia,72,68,0,0,4,2,2,4,0
2020-06-07,LW,North Macedonia,59,59,0,0,0,0,0,0,0
2020-06-08,LW,North Macedonia,54,50,0,0,4,2,2,4,0
2020-06-09,LW,North Macedonia,72,67,1,1,5,2,2,4,0
2020-06-10,LW,North Macedonia,77,71,0,0,6,3,3,6,0
2020-06-11,LW,North Macedonia,75,69,0,0,6,3,3,6,0
2020-06-12,LW,North Macedonia,81,73,0,0,8,4,4,8,0
2020-06-13,LW,North Macedonia,87,85,0,0,2,1,1,2,0
2020-06-14,LW,North Macedonia,63,63,0,0,0,0,0,0,0
2020-06-15,LW,North Macedonia,92,84,0,0,8,4,4,8,0
2020-06-16,LW,North Macedonia,97,91,2,2,6,2,2,4,0
2020-06-17,LW,North Macedonia,97,91,2,2,6,2,2,4,0
2020-06-18,LW,North Macedonia,94,90,0,0,4,2,2,4,0
2020-06-19,LW,North Macedonia,98,90,0,0,8,4,4,8,0
2020-06-20,LW,North Macedonia,81,79,0,0,2,1,1,2,0
2020-06-21,LW,North Macedonia,77,77,0,0,0,0,0,0,0
2020-06-22,LW,North Macedonia,97,93,0,0,4,2,2,4,0
2020-06-23,LW,North Macedonia,72,68,0,0,4,2,2,4,0
2020-06-24,LW,North Macedonia,91,87,0,0,4,2,2,4,0
2020-06-25,LW,North Macedonia,96,92,0,0,4,2,2,4,0
2020-06-26,LW,North Macedonia,119,113,0,0,6,3,3,6,0
2020-06-27,LW,North Macedonia,142,140,0,0,2,1,1,2,0
2020-06-28,LW,North Macedonia,122,122,0,0,0,0,0,0,0
2020-06-29,LW,North Macedonia,135,131,0,0,4,2,2,4,0
2020-06-30,LW,North Macedonia,131,123,0,0,8,4,4,8,0
2020-07-01,LW,North Macedonia,284,246,0,0,38,18,20,38,0
2020-07-02,LW,North Macedonia,301,265,0,0,36,19,17,36,0
2020-07-03,LW,North Macedonia,350,309,0,0,41,20,21,41,0
2020-07-04,LW,North Macedonia,387,347,0,0,40,20,20,40,0
2020-07-05,LW,North Macedonia,348,316,0,0,32,16,16,32,0
2020-07-06,LW,North Macedonia,320,284,0,0,36,18,18,36,0
2020-07-07,LW,North Macedonia,298,264,0,0,34,17,17,34,0
2020-07-08,LW,North Macedonia,298,266,2,1,32,14,16,30,1
2020-07-09,LW,North Macedonia,309,276,0,0,33,17,16,33,0
2020-07-10,LW,North Macedonia,337,300,0,0,37,18,19,37,0
2020-07-11,LW,North Macedonia,387,352,0,0,35,18,17,35,0
2020-07-12,LW,North Macedonia,321,303,0,0,18,9,9,18,0
2020-07-13,LW,North Macedonia,335,293,0,0,42,21,21,42,0
2020-07-14,LW,North Macedonia,282,247,0,0,35,17,18,35,0
2020-07-15,LW,North Macedonia,318,287,0,0,31,16,15,31,0
2020-07-16,LW,North Macedonia,311,278,0,0,33,16,17,33,0
2020-07-17,LW,North Macedonia,351,317,0,0,34,17,17,34,0
2020-07-18,LW,North Macedonia,445,415,0,0,30,15,15,30,0
2020-07-19,LW,North Macedonia,337,319,0,0,18,8,10,18,0
2020-07-20,LW,North Macedonia,343,310,0,0,33,18,15,33,0
2020-07-21,LW,North Macedonia,349,321,0,0,28,14,14,28,0
2020-07-22,LW,North Macedonia,353,329,0,0,24,12,12,24,0
2020-07-23,LW,North Macedonia,335,311,2,0,24,11,11,22,2
2020-07-24,LW,North Macedonia,397,367,0,0,30,15,15,30,0
2020-07-25,LW,North Macedonia,484,457,0,0,27,13,14,27,0
2020-07-26,LW,North Macedonia,386,369,0,0,17,8,9,17,0
2020-07-27,LW,North Macedonia,343,311,0,0,32,17,15,32,0
2020-07-28,LW,North Macedonia,374,350,0,0,24,12,12,24,0
2020-07-29,LW,North Macedonia,386,361,0,0,25,12,13,25,0
2020-07-30,LW,North Macedonia,351,325,0,0,26,14,12,26,0
2020-07-31,LW,North Macedonia,426,392,0,0,34,17,17,34,0
2020-08-01,LW,North Macedonia,622,586,0,0,36,18,18,36,0
2020-08-02,LW,North Macedonia,480,460,0,0,20,8,12,20,0
2020-08-03,LW,North Macedonia,445,408,0,0,37,20,17,37,0
2020-08-04,LW,North Macedonia,428,404,0,0,24,12,12,24,0
2020-08-05,LW,North Macedonia,478,451,0,0,27,13,14,27,0
2020-08-06,LW,North Macedonia,416,390,0,0,26,13,13,26,0
2020-08-07,LW,North Macedonia,491,454,1,1,37,18,18,36,0
2020-08-08,LW,North Macedonia,629,603,0,0,26,13,13,26,0
2020-08-09,LW,North Macedonia,499,479,0,0,20,9,11,20,0
2020-08-10,LW,North Macedonia,467,427,0,0,40,21,19,40,0
2020-08-11,LW,North Macedonia,455,429,0,0,26,11,15,26,0
2020-08-12,LW,North Macedonia,461,431,0,0,30,16,14,30,0
2020-08-13,LW,North Macedonia,446,418,0,0,28,14,14,28,0
2020-08-14,LW,North Macedonia,459,414,0,0,45,22,23,45,0
2020-08-15,LW,North Macedonia,657,623,0,0,34,18,16,34,0
2020-08-16,LW,North Macedonia,480,459,0,0,21,10,11,21,0
2020-08-17,LW,North Macedonia,452,407,0,0,45,24,21,45,0
2020-08-18,LW,North Macedonia,432,404,0,0,28,12,16,28,0
2020-08-19,LW,North Macedonia,444,415,0,0,29,16,13,29,0
2020-08-20,LW,North Macedonia,441,417,0,0,24,12,12,24,0
2020-08-21,LW,North Macedonia,485,445,0,0,40,19,21,40,0
2020-08-22,LW,North Macedonia,615,581,0,0,34,18,16,34,0
2020-08-23,LW,North Macedonia,466,445,0,0,21,9,12,21,0
2020-08-24,LW,North Macedonia,474,437,0,0,37,20,17,37,0
2020-08-25,LW,North Macedonia,431,406,0,0,25,11,14,25,0
2020-08-26,LW,North Macedonia,472,440,0,0,32,17,15,32,0
2020-08-27,LW,North Macedonia,442,417,0,0,25,12,13,25,0
2020-08-28,LW,North Macedonia,499,457,0,0,42,20,22,42,0
2020-08-29,LW,North Macedonia,598,568,0,0,30,16,14,30,0
2020-08-30,LW,North Macedonia,477,457,0,0,20,9,11,20,0
2020-08-31,LW,North Macedonia,435,399,0,0,36,19,17,36,0
2020-09-01,LW,North Macedonia,407,383,0,0,24,11,13,24,0
2020-09-02,LW,North Macedonia,424,394,0,0,30,16,14,30,0
2020-09-03,LW,North Macedonia,398,369,0,0,29,14,15,29,0
2020-09-04,LW,North Macedonia,469,433,0,0,36,17,19,36,0
2020-09-05,LW,North Macedonia,584,555,0,0,29,15,14,29,0
2020-09-06,LW,North Macedonia,455,430,0,0,25,12,13,25,0
2020-09-07,LW,North Macedonia,433,393,0,0,40,22,18,40,0
2020-09-08,LW,North Macedonia,401,381,0,0,20,9,11,20,0
2020-09-09,LW,North Macedonia,421,392,0,0,29,15,14,29,0
2020-09-10,LW,North Macedonia,403,374,1,0,29,14,14,28,1
2020-09-11,LW,North Macedonia,478,444,0,0,34,17,17,34,0
2020-09-12,LW,North Macedonia,550,517,0,0,33,17,16,33,0
2020-09-13,LW,North Macedonia,457,432,0,0,25,11,14,25,0
2020-09-14,LW,North Macedonia,423,392,0,0,31,17,14,31,0
2020-09-15,LW,North Macedonia,417,395,0,0,22,10,12,22,0
2020-09-16,LW,North Macedonia,443,416,0,0,27,13,14,27,0
2020-09-17,LW,North Macedonia,348,324,0,0,24,13,11,24,0
2020-09-18,LW,North Macedonia,419,385,0,0,34,16,18,34,0
2020-09-19,LW,North Macedonia,558,529,0,0,29,16,13,29,0
2020-09-20,LW,North Macedonia,432,407,0,0,25,11,14,25,0
2020-09-21,LW,North Macedonia,373,343,0,0,30,18,12,30,0
2020-09-22,LW,North Macedonia,313,298,0,0,15,6,9,15,0
2020-09-23,LW,North Macedonia,423,404,0,0,19,10,9,19,0
2020-09-24,LW,North Macedonia,323,300,0,0,23,12,11,23,0
2020-09-25,LW,North Macedonia,379,357,0,0,22,11,11,22,0
2020-09-26,LW,North Macedonia,507,482,0,0,25,12,13,25,0
2020-09-27,LW,North Macedonia,390,366,0,0,24,12,12,24,0
2020-09-28,LW,North Macedonia,324,297,0,0,27,14,13,27,0
2020-09-29,LW,North Macedonia,306,286,0,0,20,9,11,20,0
2020-09-30,LW,North Macedonia,352,335,0,0,17,10,7,17,0
2020-10-01,LW,North Macedonia,313,294,0,0,19,9,10,19,0
2020-10-02,LW,North Macedonia,394,369,0,0,25,12,13,25,0
2020-10-03,LW,North Macedonia,462,441,0,0,21,11,10,21,0
2020-10-04,LW,North Macedonia,381,360,0,0,21,9,12,21,0
2020-10-05,LW,North Macedonia,303,280,0,0,23,13,10,23,0
2020-10-06,LW,North Macedonia,269,245,0,0,24,11,13,24,0
2020-10-07,LW,North Macedonia,292,272,0,0,20,11,9,20,0
2020-10-08,LW,North Macedonia,291,269,0,0,22,11,11,22,0
2020-10-09,LW,North Macedonia,340,312,0,0,28,13,15,28,0
2020-10-10,LW,North Macedonia,473,454,0,0,19,11,8,19,0
2020-10-11,LW,North Macedonia,395,372,0,0,23,11,12,23,0
2020-10-12,LW,North Macedonia,352,326,0,0,26,13,13,26,0
2020-10-13,LW,North Macedonia,280,254,0,0,26,12,14,26,0
2020-10-14,LW,North Macedonia,295,281,0,0,14,8,6,14,0
2020-10-15,LW,North Macedonia,156,131,0,0,25,12,13,25,0
2020-10-16,LW,North Macedonia,443,419,0,0,24,11,13,24,0
2020-10-17,LW,North Macedonia,527,505,0,0,22,12,10,22,0
2020-10-18,LW,North Macedonia,386,368,0,0,18,8,10,18,0
2020-10-19,LW,North Macedonia,326,297,0,0,29,15,14,29,0
2020-10-20,LW,North Macedonia,291,269,0,0,22,11,11,22,0
2020-10-21,LW,North Macedonia,323,302,0,0,21,11,10,21,0
2020-10-22,LW,North Macedonia,288,264,0,0,24,12,12,24,0
2020-10-23,LW,North Macedonia,355,328,0,0,27,14,13,27,0
2020-10-24,LW,North Macedonia,472,454,0,0,18,9,9,18,0
2020-10-25,LW,North Macedonia,372,348,0,0,24,11,13,24,0
2020-10-26,LW,North Macedonia,268,243,0,0,25,14,11,25,0
2020-10-27,LW,North Macedonia,252,233,0,0,19,9,10,19,0
2020-10-28,LW,North Macedonia,240,220,0,0,20,10,10,20,0
2020-10-29,LW,North Macedonia,268,250,0,0,18,9,9,18,0
2020-10-30,LW,North Macedonia,337,304,0,0,33,17,16,33,0
2020-10-31,LW,North Macedonia,418,397,0,0,21,10,11,21,0
2020-11-01,LW,North Macedonia,307,286,0,0,21,10,11,21,0
2020-11-02,LW,North Macedonia,230,206,0,0,24,13,11,24,0
2020-11-03,LW,North Macedonia,154,137,0,0,17,7,10,17,0
2020-11-04,LW,North Macedonia,154,133,0,0,21,11,10,21,0
2020-11-05,LW,North Macedonia,201,185,0,0,16,8,8,16,0
2020-11-06,LW,North Macedonia,211,176,0,0,35,17,18,35,0
2020-11-07,LW,North Macedonia,202,181,0,0,21,11,10,21,0
2020-11-08,LW,North Macedonia,225,198,0,0,27,13,14,27,0
2020-11-09,LW,North Macedonia,186,160,0,0,26,14,12,26,0
2020-11-10,LW,North Macedonia,140,124,0,0,16,7,9,16,0
2020-11-11,LW,North Macedonia,141,125,0,0,16,9,7,16,0
2020-11-12,LW,North Macedonia,145,129,0,0,16,8,8,16,0
2020-11-13,LW,North Macedonia,190,154,0,0,36,16,20,36,0
2020-11-14,LW,North Macedonia,159,140,0,0,19,10,9,19,0
2020-11-15,LW,North Macedonia,161,137,0,0,24,11,13,24,0
2020-11-16,LW,North Macedonia,167,136,2,1,31,16,13,29,1
2020-11-17,LW,North Macedonia,118,106,1,1,12,5,6,11,0
2020-11-18,LW,North Macedonia,158,133,0,0,25,12,13,25,0
2020-11-19,LW,North Macedonia,163,151,0,0,12,7,5,12,0
2020-11-20,LW,North Macedonia,186,155,1,0,31,14,16,30,1
2020-11-21,LW,North Macedonia,152,137,0,0,15,8,7,15,0
2020-11-22,LW,North Macedonia,157,137,0,0,20,9,11,20,0
2020-11-23,LW,North Macedonia,128,108,0,0,20,12,8,20,0
2020-11-24,LW,North Macedonia,117,104,0,0,13,6,7,13,0
2020-11-25,LW,North Macedonia,143,121,1,1,22,10,11,21,0
2020-11-26,LW,North Macedonia,124,104,1,1,20,10,9,19,0
2020-11-27,LW,North Macedonia,173,140,1,1,33,16,16,32,0
2020-11-28,LW,North Macedonia,128,111,0,0,17,9,8,17,0
2020-11-29,LW,North Macedonia,133,114,0,0,19,9,10,19,0
2020-11-30,LW,North Macedonia,138,118,0,0,20,11,9,20,0
2020-12-01,LW,North Macedonia,89,74,0,0,15,8,7,15,0
2020-12-02,LW,North Macedonia,130,116,0,0,14,7,7,14,0
2020-12-03,LW,North Macedonia,144,136,0,0,8,4,4,8,0
2020-12-04,LW,North Macedonia,163,133,0,0,30,14,16,30,0
2020-12-05,LW,North Macedonia,135,120,0,0,15,8,7,15,0
2020-12-06,LW,North Macedonia,123,102,0,0,21,10,11,21,0
2020-12-07,LW,North Macedonia,152,132,0,0,20,11,9,20,0
2020-12-08,LW,North Macedonia,112,98,0,0,14,7,7,14,0
2020-12-09,LW,North Macedonia,107,94,0,0,13,6,7,13,0
2020-12-10,LW,North Macedonia,133,115,0,0,18,9,9,18,0
2020-12-11,LW,North Macedonia,181,150,0,0,31,15,16,31,0
2020-12-12,LW,North Macedonia,146,124,0,0,22,12,10,22,0
2020-12-13,LW,North Macedonia,155,134,0,0,21,9,12,21,0
2020-12-14,LW,North Macedonia,179,152,0,0,27,14,13,27,0
2020-12-15,LW,North Macedonia,126,119,0,0,7,5,2,7,0
2020-12-16,LW,North Macedonia,146,132,0,0,14,7,7,14,0
2020-12-17,LW,North Macedonia,216,188,1,0,28,12,15,27,1
2020-12-18,LW,North Macedonia,229,185,0,0,44,22,22,44,0
2020-12-19,LW,North Macedonia,250,216,0,0,34,18,16,34,0
2020-12-20,LW,North Macedonia,217,196,0,0,21,9,12,21,0
2020-12-21,LW,North Macedonia,216,175,1,0,41,21,19,40,1
2020-12-22,LW,North Macedonia,168,142,0,0,26,13,13,26,0
2020-12-23,LW,North Macedonia,204,179,0,0,25,13,12,25,0
2020-12-24,LW,North Macedonia,189,174,0,0,15,8,7,15,0
2020-12-25,LW,North Macedonia,117,100,0,0,17,5,12,17,0
2020-12-26,LW,North Macedonia,170,144,0,0,26,15,11,26,0
2020-12-27,LW,North Macedonia,191,172,0,0,19,8,11,19,0
2020-12-28,LW,North Macedonia,153,125,0,0,28,15,13,28,0
2020-12-29,LW,North Macedonia,108,97,0,0,11,5,6,11,0
2020-12-30,LW,North Macedonia,160,140,0,0,20,10,10,20,0
2020-12-31,LW,North Macedonia,95,78,0,0,17,9,8,17,0
2020-01-01,EN,Norway,1147,185,511,3,962,219,232,451,508
2020-01-02,EN,Norway,1704,238,850,6,1466,309,307,616,844
2020-01-03,EN,Norway,1542,243,733,10,1299,286,280,566,723
2020-01-04,EN,Norway,921,189,265,4,732,236,231,467,261
2020-01-05,EN,Norway,1463,259,614,3,1204,291,299,590,611
2020-01-06,EN,Norway,1746,227,894,2,1519,317,308,625,892
2020-01-07,EN,Norway,1510,194,805,10,1316,254,257,511,795
2020-01-08,EN,Norway,1532,180,803,9,1352,275,274,549,794
2020-01-09,EN,Norway,1616,201,835,16,1415,286,294,580,819
2020-01-10,EN,Norway,1759,242,908,21,1517,304,305,609,887
2020-01-11,EN,Norway,792,187,222,0,605,197,186,383,222
2020-01-12,EN,Norway,1297,245,557,6,1052,241,254,495,551
2020-01-13,EN,Norway,1647,166,895,17,1481,297,289,586,878
2020-01-14,EN,Norway,1633,202,899,18,1431,264,268,532,881
2020-01-15,EN,Norway,1659,160,928,16,1499,286,285,571,912
2020-01-16,EN,Norway,1712,179,946,12,1533,291,296,587,934
2020-01-17,EN,Norway,1727,222,899,3,1505,304,302,606,896
2020-01-18,EN,Norway,828,214,237,7,614,195,182,377,230
2020-01-19,EN,Norway,1358,234,600,11,1124,255,269,524,589
2020-01-20,EN,Norway,1708,216,904,10,1492,293,295,588,894
2020-01-21,EN,Norway,1585,187,861,9,1398,271,266,537,852
2020-01-22,EN,Norway,1710,207,926,14,1503,287,290,577,912
2020-01-23,EN,Norway,1727,160,972,17,1567,294,301,595,955
2020-01-24,EN,Norway,1710,222,876,10,1488,309,303,612,866
2020-01-25,EN,Norway,801,151,251,14,650,206,193,399,237
2020-01-26,EN,Norway,1401,256,633,10,1145,247,265,512,623
2020-01-27,EN,Norway,1763,213,916,2,1550,319,315,634,914
2020-01-28,EN,Norway,1691,215,930,2,1476,272,274,546,928
2020-01-29,EN,Norway,1683,211,896,10,1472,287,289,576,886
2020-01-30,EN,Norway,1754,212,948,4,1542,299,295,594,944
2020-01-31,EN,Norway,1703,204,882,2,1499,308,309,617,880
2020-02-01,EN,Norway,842,185,252,11,657,206,199,405,241
2020-02-02,EN,Norway,1414,255,626,17,1159,258,275,533,609
2020-02-03,EN,Norway,1785,220,929,9,1565,321,315,636,920
2020-02-04,EN,Norway,1668,185,926,4,1483,280,277,557,922
2020-02-05,EN,Norway,1679,167,929,9,1512,291,292,583,920
2020-02-06,EN,Norway,1722,165,960,19,1557,296,301,597,941
2020-02-07,EN,Norway,1683,178,885,8,1505,312,308,620,877
2020-02-08,EN,Norway,924,221,266,1,703,222,215,437,265
2020-02-09,EN,Norway,1347,256,598,8,1091,238,255,493,590
2020-02-10,EN,Norway,1538,228,744,13,1310,286,280,566,731
2020-02-11,EN,Norway,1634,222,876,12,1412,266,270,536,864
2020-02-12,EN,Norway,1732,190,954,17,1542,293,295,588,937
2020-02-13,EN,Norway,1791,192,972,18,1599,313,314,627,954
2020-02-14,EN,Norway,1794,182,933,10,1612,339,340,679,923
2020-02-15,EN,Norway,943,180,271,6,763,249,243,492,265
2020-02-16,EN,Norway,1439,263,619,2,1176,275,282,557,617
2020-02-17,EN,Norway,1673,209,858,4,1464,303,303,606,854
2020-02-18,EN,Norway,1689,207,910,27,1482,290,282,572,883
2020-02-19,EN,Norway,1797,223,939,23,1574,315,320,635,916
2020-02-20,EN,Norway,1745,218,914,6,1527,311,302,613,908
2020-02-21,EN,Norway,1727,217,875,16,1510,316,319,635,859
2020-02-22,EN,Norway,934,224,244,0,710,239,227,466,244
2020-02-23,EN,Norway,1402,249,602,17,1153,267,284,551,585
2020-02-24,EN,Norway,1704,182,882,9,1522,322,318,640,873
2020-02-25,EN,Norway,1674,190,884,8,1484,298,302,600,876
2020-02-26,EN,Norway,1763,215,924,11,1548,314,310,624,913
2020-02-27,EN,Norway,1687,210,867,15,1477,301,309,610,852
2020-02-28,EN,Norway,1815,224,934,14,1591,327,330,657,920
2020-02-29,EN,Norway,903,155,270,6,748,243,235,478,264
2020-03-01,EN,Norway,1465,235,646,6,1230,290,294,584,640
2020-03-02,EN,Norway,1791,228,930,11,1563,317,316,633,919
2020-03-03,EN,Norway,1765,229,922,8,1536,309,305,614,914
2020-03-04,EN,Norway,1779,196,967,9,1583,306,310,616,958
2020-03-05,EN,Norway,1869,221,1011,19,1648,314,323,637,992
2020-03-06,EN,Norway,1843,243,926,7,1600,338,336,674,919
2020-03-07,EN,Norway,923,220,258,3,703,225,220,445,255
2020-03-08,EN,Norway,1470,256,655,4,1214,271,288,559,651
2020-03-09,EN,Norway,1842,244,975,16,1598,311,312,623,959
2020-03-10,EN,Norway,1743,232,948,8,1511,280,283,563,940
2020-03-11,EN,Norway,1774,192,980,16,1582,301,301,602,964
2020-03-12,EN,Norway,1771,195,957,19,1576,311,308,619,938
2020-03-13,EN,Norway,1665,215,843,8,1450,307,300,607,835
2020-03-14,EN,Norway,875,179,277,3,696,215,204,419,274
2020-03-15,EN,Norway,1249,198,582,2,1051,228,241,469,580
2020-03-16,EN,Norway,1254,177,658,3,1077,217,202,419,655
2020-03-17,EN,Norway,1033,138,576,2,895,163,156,319,574
2020-03-18,EN,Norway,918,133,502,6,785,142,141,283,496
2020-03-19,EN,Norway,941,151,535,4,790,126,129,255,531
2020-03-20,EN,Norway,890,157,474,6,733,126,133,259,468
2020-03-21,EN,Norway,455,104,136,4,351,99,116,215,132
2020-03-22,EN,Norway,498,116,254,2,382,58,70,128,252
2020-03-23,EN,Norway,643,77,418,4,566,75,73,148,414
2020-03-24,EN,Norway,611,83,403,2,528,62,63,125,401
2020-03-25,EN,Norway,719,74,488,2,645,80,77,157,486
2020-03-26,EN,Norway,684,52,475,6,632,80,77,157,469
2020-03-27,EN,Norway,628,42,450,4,586,65,71,136,446
2020-03-28,EN,Norway,190,36,92,3,154,30,32,62,89
2020-03-29,EN,Norway,357,36,264,0,321,28,29,57,264
2020-03-30,EN,Norway,624,28,469,4,596,67,60,127,465
2020-03-31,EN,Norway,640,34,489,8,606,58,59,117,481
2020-04-01,EN,Norway,680,34,510,2,646,66,70,136,508
2020-04-02,EN,Norway,505,33,398,6,472,37,37,74,392
2020-04-03,EN,Norway,562,22,429,6,540,55,56,111,423
2020-04-04,EN,Norway,235,14,154,5,221,33,34,67,149
2020-04-05,EN,Norway,378,24,289,3,354,30,35,65,286
2020-04-06,EN,Norway,656,27,495,8,629,68,66,134,487
2020-04-07,EN,Norway,655,36,490,6,619,65,64,129,484
2020-04-08,EN,Norway,593,32,437,5,561,62,62,124,432
2020-04-09,EN,Norway,460,19,336,1,441,53,52,105,335
2020-04-10,EN,Norway,259,15,178,3,244,33,33,66,175
2020-04-11,EN,Norway,144,22,82,2,122,19,21,40,80
2020-04-12,EN,Norway,280,13,235,3,267,16,16,32,232
2020-04-13,EN,Norway,518,29,396,1,489,49,44,93,395
2020-04-14,EN,Norway,659,27,525,4,632,55,52,107,521
2020-04-15,EN,Norway,653,13,518,6,640,59,63,122,512
2020-04-16,EN,Norway,639,18,508,5,621,57,56,113,503
2020-04-17,EN,Norway,595,18,451,9,577,62,64,126,442
2020-04-18,EN,Norway,177,14,109,3,163,26,28,54,106
2020-04-19,EN,Norway,306,19,247,5,287,18,22,40,242
2020-04-20,EN,Norway,608,21,465,4,587,62,60,122,461
2020-04-21,EN,Norway,631,22,495,6,609,56,58,114,489
2020-04-22,EN,Norway,673,36,519,9,637,59,59,118,510
2020-04-23,EN,Norway,633,25,485,4,608,62,61,123,481
2020-04-24,EN,Norway,601,33,444,5,568,61,63,124,439
2020-04-25,EN,Norway,190,30,107,4,160,27,26,53,103
2020-04-26,EN,Norway,346,33,261,1,313,24,28,52,260
2020-04-27,EN,Norway,653,34,493,7,619,64,62,126,486
2020-04-28,EN,Norway,666,22,535,8,644,54,55,109,527
2020-04-29,EN,Norway,700,31,532,12,669,69,68,137,520
2020-04-30,EN,Norway,627,26,497,5,601,51,53,104,492
2020-05-01,EN,Norway,497,41,357,2,456,49,50,99,355
2020-05-02,EN,Norway,200,40,94,2,160,35,31,66,92
2020-05-03,EN,Norway,356,44,271,4,312,19,22,41,267
2020-05-04,EN,Norway,668,40,498,4,628,65,65,130,494
2020-05-05,EN,Norway,660,44,487,5,616,67,62,129,482
2020-05-06,EN,Norway,684,34,516,11,650,65,69,134,505
2020-05-07,EN,Norway,646,35,496,11,611,57,58,115,485
2020-05-08,EN,Norway,627,30,470,9,597,63,64,127,461
2020-05-09,EN,Norway,244,28,143,5,216,36,37,73,138
2020-05-10,EN,Norway,345,30,271,2,315,22,22,44,269
2020-05-11,EN,Norway,608,33,457,8,575,59,59,118,449
2020-05-12,EN,Norway,638,28,494,7,610,59,57,116,487
2020-05-13,EN,Norway,681,36,523,15,645,59,63,122,508
2020-05-14,EN,Norway,652,45,503,10,607,54,50,104,493
2020-05-15,EN,Norway,672,49,491,21,623,67,65,132,470
2020-05-16,EN,Norway,231,56,115,1,175,31,29,60,114
2020-05-17,EN,Norway,287,46,205,0,241,16,20,36,205
2020-05-18,EN,Norway,638,39,473,18,599,64,62,126,455
2020-05-19,EN,Norway,710,39,527,24,671,73,71,144,503
2020-05-20,EN,Norway,720,47,530,19,673,71,72,143,511
2020-05-21,EN,Norway,425,48,319,16,377,29,29,58,303
2020-05-22,EN,Norway,579,47,410,13,532,61,61,122,397
2020-05-23,EN,Norway,259,43,153,3,216,31,32,63,150
2020-05-24,EN,Norway,419,39,326,8,380,26,28,54,318
2020-05-25,EN,Norway,686,39,517,16,647,64,66,130,501
2020-05-26,EN,Norway,732,45,537,10,687,75,75,150,527
2020-05-27,EN,Norway,749,49,569,14,700,64,67,131,555
2020-05-28,EN,Norway,682,32,529,11,650,63,58,121,518
2020-05-29,EN,Norway,701,47,512,15,654,70,72,142,497
2020-05-30,EN,Norway,245,46,136,10,199,30,33,63,126
2020-05-31,EN,Norway,374,54,268,9,320,27,25,52,259
2020-06-01,EN,Norway,604,34,442,23,570,64,64,128,419
2020-06-02,EN,Norway,797,40,626,16,757,64,67,131,610
2020-06-03,EN,Norway,840,50,606,16,790,91,93,184,590
2020-06-04,EN,Norway,777,44,580,15,733,77,76,153,565
2020-06-05,EN,Norway,756,66,537,16,690,75,78,153,521
2020-06-06,EN,Norway,271,58,144,15,213,34,35,69,129
2020-06-07,EN,Norway,456,55,333,13,401,32,36,68,320
2020-06-08,EN,Norway,781,41,572,5,740,88,80,168,567
2020-06-09,EN,Norway,821,47,616,13,774,79,79,158,603
2020-06-10,EN,Norway,854,60,625,14,794,84,85,169,611
2020-06-11,EN,Norway,802,40,613,10,762,73,76,149,603
2020-06-12,EN,Norway,776,53,554,7,723,86,83,169,547
2020-06-13,EN,Norway,293,59,159,3,234,37,38,75,156
2020-06-14,EN,Norway,471,64,335,7,407,33,39,72,328
2020-06-15,EN,Norway,827,62,591,8,765,86,88,174,583
2020-06-16,EN,Norway,781,56,570,8,725,79,76,155,562
2020-06-17,EN,Norway,766,66,542,11,700,76,82,158,531
2020-06-18,EN,Norway,726,51,542,16,675,67,66,133,526
2020-06-19,EN,Norway,807,62,563,11,745,93,89,182,552
2020-06-20,EN,Norway,374,64,205,3,310,52,53,105,202
2020-06-21,EN,Norway,591,63,391,4,528,67,70,137,387
2020-06-22,EN,Norway,862,64,609,4,798,95,94,189,605
2020-06-23,EN,Norway,847,63,614,8,784,84,86,170,606
2020-06-24,EN,Norway,900,61,632,11,839,103,104,207,621
2020-06-25,EN,Norway,799,58,594,9,741,73,74,147,585
2020-06-26,EN,Norway,852,71,586,3,781,101,94,195,583
2020-06-27,EN,Norway,317,64,169,8,253,42,42,84,161
2020-06-28,EN,Norway,566,94,364,3,472,53,55,108,361
2020-06-29,EN,Norway,879,69,592,7,810,107,111,218,585
2020-06-30,EN,Norway,887,56,637,8,831,99,95,194,629
2020-07-01,EN,Norway,1024,80,681,13,944,132,131,263,668
2020-07-02,EN,Norway,976,67,696,15,909,106,107,213,681
2020-07-03,EN,Norway,984,79,658,17,905,124,123,247,641
2020-07-04,EN,Norway,472,86,228,0,386,78,80,158,228
2020-07-05,EN,Norway,693,91,436,4,602,80,86,166,432
2020-07-06,EN,Norway,986,65,680,18,921,122,119,241,662
2020-07-07,EN,Norway,992,78,691,17,914,111,112,223,674
2020-07-08,EN,Norway,1001,68,679,21,933,129,125,254,658
2020-07-09,EN,Norway,948,72,668,16,876,105,103,208,652
2020-07-10,EN,Norway,984,82,652,8,902,125,125,250,644
2020-07-11,EN,Norway,481,80,229,5,401,87,85,172,224
2020-07-12,EN,Norway,696,93,425,4,603,88,90,178,421
2020-07-13,EN,Norway,1032,78,711,14,954,122,121,243,697
2020-07-14,EN,Norway,1017,94,693,9,923,116,114,230,684
2020-07-15,EN,Norway,1072,92,706,16,980,136,138,274,690
2020-07-16,EN,Norway,1005,92,677,20,913,115,121,236,657
2020-07-17,EN,Norway,1025,84,659,16,941,140,142,282,643
2020-07-18,EN,Norway,524,90,238,4,434,96,100,196,234
2020-07-19,EN,Norway,726,98,444,7,628,93,91,184,437
2020-07-20,EN,Norway,1006,71,675,8,935,130,130,260,667
2020-07-21,EN,Norway,974,63,677,11,911,119,115,234,666
2020-07-22,EN,Norway,1025,86,689,10,939,125,125,250,679
2020-07-23,EN,Norway,968,77,651,14,891,119,121,240,637
2020-07-24,EN,Norway,1009,80,665,10,929,130,134,264,655
2020-07-25,EN,Norway,523,87,235,3,436,98,103,201,232
2020-07-26,EN,Norway,735,101,429,3,634,103,102,205,426
2020-07-27,EN,Norway,1023,75,695,10,948,129,124,253,685
2020-07-28,EN,Norway,997,77,681,13,920,119,120,239,668
2020-07-29,EN,Norway,1046,82,690,12,964,137,137,274,678
2020-07-30,EN,Norway,1059,93,700,13,966,133,133,266,687
2020-07-31,EN,Norway,1004,82,652,20,922,134,136,270,632
2020-08-01,EN,Norway,513,89,221,2,424,101,102,203,219
2020-08-02,EN,Norway,777,126,428,7,651,112,111,223,421
2020-08-03,EN,Norway,1068,96,686,19,972,144,142,286,667
2020-08-04,EN,Norway,1018,86,690,13,932,123,119,242,677
2020-08-05,EN,Norway,997,90,656,11,907,123,128,251,645
2020-08-06,EN,Norway,1046,92,700,27,954,124,130,254,673
2020-08-07,EN,Norway,1080,102,684,21,978,141,153,294,663
2020-08-08,EN,Norway,571,80,259,6,491,117,115,232,253
2020-08-09,EN,Norway,790,111,455,3,679,110,114,224,452
2020-08-10,EN,Norway,1103,90,711,12,1013,153,149,302,699
2020-08-11,EN,Norway,1064,92,717,21,972,125,130,255,696
2020-08-12,EN,Norway,1055,77,706,25,978,141,131,272,681
2020-08-13,EN,Norway,1036,104,685,22,932,120,127,247,663
2020-08-14,EN,Norway,1152,102,726,9,1050,163,161,324,717
2020-08-15,EN,Norway,555,84,245,8,471,114,112,226,237
2020-08-16,EN,Norway,815,114,450,6,701,122,129,251,444
2020-08-17,EN,Norway,1158,90,759,17,1068,151,158,309,742
2020-08-18,EN,Norway,1085,84,732,22,1001,134,135,269,710
2020-08-19,EN,Norway,1139,89,762,14,1050,142,146,288,748
2020-08-20,EN,Norway,1101,95,735,15,1006,138,133,271,720
2020-08-21,EN,Norway,1065,97,680,4,968,145,143,288,676
2020-08-22,EN,Norway,522,67,229,6,455,116,110,226,223
2020-08-23,EN,Norway,769,110,430,8,659,112,117,229,422
2020-08-24,EN,Norway,1147,91,753,15,1056,153,150,303,738
2020-08-25,EN,Norway,1109,97,768,18,1012,122,122,244,750
2020-08-26,EN,Norway,1129,100,757,19,1029,131,141,272,738
2020-08-27,EN,Norway,1120,98,743,18,1022,144,135,279,725
2020-08-28,EN,Norway,1140,90,733,13,1050,162,155,317,720
2020-08-29,EN,Norway,495,75,220,7,420,99,101,200,213
2020-08-30,EN,Norway,828,109,477,6,719,121,121,242,471
2020-08-31,EN,Norway,1147,76,774,21,1071,150,147,297,753
2020-09-01,EN,Norway,1165,85,799,16,1080,143,138,281,783
2020-09-02,EN,Norway,1159,83,811,12,1076,131,134,265,799
2020-09-03,EN,Norway,1153,84,801,26,1069,133,135,268,775
2020-09-04,EN,Norway,1179,85,768,14,1094,166,160,326,754
2020-09-05,EN,Norway,464,83,201,3,381,88,92,180,198
2020-09-06,EN,Norway,814,95,487,2,719,115,117,232,485
2020-09-07,EN,Norway,1172,96,821,18,1076,130,125,255,803
2020-09-08,EN,Norway,1164,89,805,12,1075,134,136,270,793
2020-09-09,EN,Norway,1125,73,787,12,1052,135,130,265,775
2020-09-10,EN,Norway,1128,87,784,9,1041,128,129,257,775
2020-09-11,EN,Norway,1166,91,777,5,1075,149,149,298,772
2020-09-12,EN,Norway,514,98,224,4,416,96,96,192,220
2020-09-13,EN,Norway,790,84,508,15,706,97,101,198,493
2020-09-14,EN,Norway,1141,86,807,21,1055,124,124,248,786
2020-09-15,EN,Norway,1063,84,762,24,979,110,107,217,738
2020-09-16,EN,Norway,1208,95,857,13,1113,127,129,256,844
2020-09-17,EN,Norway,1165,99,835,18,1066,118,113,231,817
2020-09-18,EN,Norway,1123,86,765,15,1037,136,136,272,750
2020-09-19,EN,Norway,509,99,228,12,410,93,89,182,216
2020-09-20,EN,Norway,774,100,497,8,674,86,91,177,489
2020-09-21,EN,Norway,1047,95,743,12,952,104,105,209,731
2020-09-22,EN,Norway,1108,74,805,16,1034,111,118,229,789
2020-09-23,EN,Norway,1115,89,770,10,1026,129,127,256,760
2020-09-24,EN,Norway,1065,88,765,7,977,109,103,212,758
2020-09-25,EN,Norway,1145,125,746,11,1020,137,137,274,735
2020-09-26,EN,Norway,485,92,211,8,393,91,91,182,203
2020-09-27,EN,Norway,794,108,504,11,686,87,95,182,493
2020-09-28,EN,Norway,1054,66,791,17,988,101,96,197,774
2020-09-29,EN,Norway,1109,65,815,15,1044,113,116,229,800
2020-09-30,EN,Norway,1099,79,799,18,1020,110,111,221,781
2020-10-01,EN,Norway,1076,73,809,21,1003,97,97,194,788
2020-10-02,EN,Norway,1105,94,773,13,1011,121,117,238,760
2020-10-03,EN,Norway,453,70,214,8,383,82,87,169,206
2020-10-04,EN,Norway,787,118,498,7,669,85,86,171,491
2020-10-05,EN,Norway,1106,80,796,14,1026,117,113,230,782
2020-10-06,EN,Norway,1055,76,777,12,979,101,101,202,765
2020-10-07,EN,Norway,1124,110,798,10,1014,108,108,216,788
2020-10-08,EN,Norway,1091,90,802,11,1001,98,101,199,791
2020-10-09,EN,Norway,1125,95,781,15,1030,126,123,249,766
2020-10-10,EN,Norway,465,80,209,4,385,87,89,176,205
2020-10-11,EN,Norway,772,102,517,7,670,75,78,153,510
2020-10-12,EN,Norway,1088,70,802,18,1018,110,106,216,784
2020-10-13,EN,Norway,1102,71,817,14,1031,107,107,214,803
2020-10-14,EN,Norway,1083,80,791,20,1003,106,106,212,771
2020-10-15,EN,Norway,1078,76,808,10,1002,95,99,194,798
2020-10-16,EN,Norway,1110,82,789,8,1028,124,115,239,781
2020-10-17,EN,Norway,465,87,224,9,378,76,78,154,215
2020-10-18,EN,Norway,752,82,518,4,670,76,76,152,514
2020-10-19,EN,Norway,1099,87,792,9,1012,111,109,220,783
2020-10-20,EN,Norway,1061,89,777,7,972,95,100,195,770
2020-10-21,EN,Norway,1056,79,784,21,977,97,96,193,763
2020-10-22,EN,Norway,1066,72,804,13,994,95,95,190,791
2020-10-23,EN,Norway,1083,96,768,16,987,112,107,219,752
2020-10-24,EN,Norway,454,72,223,12,382,79,80,159,211
2020-10-25,EN,Norway,791,119,536,12,672,65,71,136,524
2020-10-26,EN,Norway,1083,86,802,15,997,97,98,195,787
2020-10-27,EN,Norway,1086,74,801,18,1012,105,106,211,783
2020-10-28,EN,Norway,1033,96,746,11,937,96,95,191,735
2020-10-29,EN,Norway,1082,104,797,14,978,93,88,181,783
2020-10-30,EN,Norway,1084,102,747,6,982,119,116,235,741
2020-10-31,EN,Norway,423,87,205,7,336,65,66,131,198
2020-11-01,EN,Norway,768,113,517,4,655,66,72,138,513
2020-11-02,EN,Norway,1020,101,747,11,919,88,84,172,736
2020-11-03,EN,Norway,1064,73,805,12,991,94,92,186,793
2020-11-04,EN,Norway,1075,80,791,17,995,102,102,204,774
2020-11-05,EN,Norway,1021,89,777,15,932,77,78,155,762
2020-11-06,EN,Norway,1110,97,776,17,1013,119,118,237,759
2020-11-07,EN,Norway,436,99,214,8,337,60,63,123,206
2020-11-08,EN,Norway,754,84,538,7,670,68,64,132,531
2020-11-09,EN,Norway,1068,75,819,13,993,89,85,174,806
2020-11-10,EN,Norway,972,85,738,23,887,73,76,149,715
2020-11-11,EN,Norway,1028,74,781,15,954,84,89,173,766
2020-11-12,EN,Norway,1012,83,755,5,929,88,86,174,750
2020-11-13,EN,Norway,1004,92,731,6,912,90,91,181,725
2020-11-14,EN,Norway,347,78,182,11,269,43,44,87,171
2020-11-15,EN,Norway,695,108,470,2,587,56,61,117,468
2020-11-16,EN,Norway,965,91,712,16,874,83,79,162,696
2020-11-17,EN,Norway,963,77,737,16,886,74,75,149,721
2020-11-18,EN,Norway,918,80,714,21,838,63,61,124,693
2020-11-19,EN,Norway,816,93,623,18,723,49,51,100,605
2020-11-20,EN,Norway,1009,80,734,19,929,96,99,195,715
2020-11-21,EN,Norway,363,89,188,12,274,45,41,86,176
2020-11-22,EN,Norway,676,96,475,13,580,50,55,105,462
2020-11-23,EN,Norway,978,85,734,22,893,80,79,159,712
2020-11-24,EN,Norway,974,80,752,21,894,73,69,142,731
2020-11-25,EN,Norway,945,73,727,18,872,73,72,145,709
2020-11-26,EN,Norway,985,87,747,19,898,74,77,151,728
2020-11-27,EN,Norway,994,71,740,16,923,91,92,183,724
2020-11-28,EN,Norway,331,92,180,5,239,29,30,59,175
2020-11-29,EN,Norway,654,93,464,1,561,46,51,97,463
2020-11-30,EN,Norway,816,78,615,1,738,62,61,123,614
2020-12-01,EN,Norway,847,63,647,21,784,70,67,137,626
2020-12-02,EN,Norway,786,64,604,15,722,60,58,118,589
2020-12-03,EN,Norway,806,86,611,5,720,52,57,109,606
2020-12-04,EN,Norway,950,100,670,6,850,90,90,180,664
2020-12-05,EN,Norway,402,95,209,4,307,52,46,98,205
2020-12-06,EN,Norway,679,112,458,5,567,51,58,109,453
2020-12-07,EN,Norway,939,82,694,1,857,83,80,163,693
2020-12-08,EN,Norway,902,93,662,0,809,75,72,147,662
2020-12-09,EN,Norway,961,107,689,11,854,82,83,165,678
2020-12-10,EN,Norway,945,90,686,6,855,86,83,169,680
2020-12-11,EN,Norway,961,105,659,8,856,96,101,197,651
2020-12-12,EN,Norway,374,95,171,5,279,54,54,108,166
2020-12-13,EN,Norway,683,114,445,2,569,61,63,124,443
2020-12-14,EN,Norway,913,86,658,8,827,89,80,169,650
2020-12-15,EN,Norway,944,93,690,12,851,80,81,161,678
2020-12-16,EN,Norway,996,97,702,17,899,95,102,197,685
2020-12-17,EN,Norway,1001,103,722,2,898,90,86,176,720
2020-12-18,EN,Norway,1057,106,741,6,951,105,105,210,735
2020-12-19,EN,Norway,540,105,261,5,435,87,87,174,256
2020-12-20,EN,Norway,757,130,474,6,627,74,79,153,468
2020-12-21,EN,Norway,1046,111,755,8,935,91,89,180,747
2020-12-22,EN,Norway,1098,97,778,6,1001,114,109,223,772
2020-12-23,EN,Norway,1045,85,760,7,960,100,100,200,753
2020-12-24,EN,Norway,335,74,185,1,261,38,38,76,184
2020-12-25,EN,Norway,220,71,85,0,149,32,32,64,85
2020-12-26,EN,Norway,368,57,224,0,311,42,45,87,224
2020-12-27,EN,Norway,710,109,479,1,601,60,62,122,478
2020-12-28,EN,Norway,916,93,662,5,823,81,80,161,657
2020-12-29,EN,Norway,937,83,682,0,854,88,84,172,682
2020-12-30,EN,Norway,961,95,709,3,866,78,79,157,706
2020-12-31,EN,Norway,473,72,298,4,401,53,50,103,294
2020-01-01,EP,Poland,1937,1086,72,0,851,397,382,779,72
2020-01-02,EP,Poland,2433,1291,121,4,1142,510,511,1021,117
2020-01-03,EP,Poland,2428,1329,108,5,1099,497,494,991,103
2020-01-04,EP,Poland,2162,1260,74,2,902,410,418,828,72
2020-01-05,EP,Poland,2291,1256,90,3,1035,471,474,945,87
2020-01-06,EP,Poland,2233,1188,93,0,1045,471,481,952,93
2020-01-07,EP,Poland,2094,1077,115,8,1017,447,455,902,107
2020-01-08,EP,Poland,2214,1197,132,12,1017,443,442,885,120
2020-01-09,EP,Poland,2112,1114,125,18,998,435,438,873,107
2020-01-10,EP,Poland,2370,1272,122,10,1098,496,480,976,112
2020-01-11,EP,Poland,2198,1308,93,13,890,393,404,797,80
2020-01-12,EP,Poland,2402,1406,105,11,996,448,443,891,94
2020-01-13,EP,Poland,2241,1134,127,11,1107,491,489,980,116
2020-01-14,EP,Poland,1952,1017,141,16,935,396,398,794,125
2020-01-15,EP,Poland,2110,1074,163,19,1036,431,442,873,144
2020-01-16,EP,Poland,2074,1061,152,20,1013,429,432,861,132
2020-01-17,EP,Poland,2233,1161,107,9,1072,485,480,965,98
2020-01-18,EP,Poland,2086,1158,110,9,928,403,415,818,101
2020-01-19,EP,Poland,2207,1209,97,7,998,457,444,901,90
2020-01-20,EP,Poland,2167,1086,120,17,1081,480,481,961,103
2020-01-21,EP,Poland,2038,1054,148,20,984,417,419,836,128
2020-01-22,EP,Poland,2043,1065,124,9,978,424,430,854,115
2020-01-23,EP,Poland,2078,1065,147,7,1013,436,430,866,140
2020-01-24,EP,Poland,2354,1224,142,16,1130,494,494,988,126
2020-01-25,EP,Poland,1987,1102,85,2,885,397,403,800,83
2020-01-26,EP,Poland,2168,1160,99,5,1008,455,454,909,94
2020-01-27,EP,Poland,2199,1039,118,10,1160,523,519,1042,108
2020-01-28,EP,Poland,1970,996,140,12,974,416,418,834,128
2020-01-29,EP,Poland,2014,1031,124,6,983,427,432,859,118
2020-01-30,EP,Poland,2026,1017,146,8,1009,436,427,863,138
2020-01-31,EP,Poland,2303,1165,127,10,1138,511,500,1011,117
2020-02-01,EP,Poland,2023,1118,87,6,905,402,416,818,81
2020-02-02,EP,Poland,2137,1132,101,8,1005,451,453,904,93
2020-02-03,EP,Poland,2164,1053,133,17,1111,487,491,978,116
2020-02-04,EP,Poland,1944,979,135,19,965,416,414,830,116
2020-02-05,EP,Poland,2051,1030,154,22,1021,435,432,867,132
2020-02-06,EP,Poland,2013,989,136,12,1024,441,447,888,124
2020-02-07,EP,Poland,2263,1120,142,26,1143,510,491,1001,116
2020-02-08,EP,Poland,2049,1142,102,8,907,399,406,805,94
2020-02-09,EP,Poland,2086,1125,100,10,961,431,430,861,90
2020-02-10,EP,Poland,1980,978,101,3,1002,454,447,901,98
2020-02-11,EP,Poland,1912,958,111,2,954,419,424,843,109
2020-02-12,EP,Poland,1986,1009,114,10,977,428,435,863,104
2020-02-13,EP,Poland,2052,1027,147,26,1025,440,438,878,121
2020-02-14,EP,Poland,2262,1166,106,7,1096,503,487,990,99
2020-02-15,EP,Poland,2100,1200,85,7,900,400,415,815,78
2020-02-16,EP,Poland,2175,1170,99,10,1005,453,453,906,89
2020-02-17,EP,Poland,2138,1038,130,16,1100,491,479,970,114
2020-02-18,EP,Poland,1922,943,147,13,979,414,418,832,134
2020-02-19,EP,Poland,2070,1056,145,23,1014,433,436,869,122
2020-02-20,EP,Poland,2079,1040,140,13,1039,451,448,899,127
2020-02-21,EP,Poland,2285,1164,124,10,1121,498,499,997,114
2020-02-22,EP,Poland,2103,1196,94,17,907,402,411,813,77
2020-02-23,EP,Poland,2143,1112,101,8,1031,462,468,930,93
2020-02-24,EP,Poland,2184,1057,137,21,1127,499,491,990,116
2020-02-25,EP,Poland,1978,983,139,19,995,433,423,856,120
2020-02-26,EP,Poland,2060,1017,146,17,1043,442,455,897,129
2020-02-27,EP,Poland,2055,1003,153,28,1052,450,449,899,125
2020-02-28,EP,Poland,2302,1165,125,11,1137,508,504,1012,114
2020-02-29,EP,Poland,2060,1175,82,2,885,400,403,803,80
2020-03-01,EP,Poland,2175,1167,99,14,1008,456,453,909,85
2020-03-02,EP,Poland,2122,1030,118,12,1092,490,484,974,106
2020-03-03,EP,Poland,1981,987,146,25,994,424,424,848,121
2020-03-04,EP,Poland,2024,1017,136,18,1007,435,436,871,118
2020-03-05,EP,Poland,2108,1034,165,30,1074,456,453,909,135
2020-03-06,EP,Poland,2294,1154,137,14,1140,504,499,1003,123
2020-03-07,EP,Poland,2024,1131,99,13,893,392,402,794,86
2020-03-08,EP,Poland,2082,1090,99,6,992,446,447,893,93
2020-03-09,EP,Poland,2149,1058,153,23,1091,467,471,938,130
2020-03-10,EP,Poland,1963,1011,157,22,952,399,396,795,135
2020-03-11,EP,Poland,1929,948,153,18,981,412,416,828,135
2020-03-12,EP,Poland,1862,920,124,11,942,413,405,818,113
2020-03-13,EP,Poland,1974,931,133,17,1043,457,453,910,116
2020-03-14,EP,Poland,1741,926,93,12,815,362,360,722,81
2020-03-15,EP,Poland,1143,980,28,15,163,58,77,135,13
2020-03-16,EP,Poland,933,749,55,22,184,65,64,129,33
2020-03-17,EP,Poland,779,586,43,11,193,75,75,150,32
2020-03-18,EP,Poland,796,572,66,34,224,81,77,158,32
2020-03-19,EP,Poland,679,477,39,12,202,85,78,163,27
2020-03-20,EP,Poland,647,480,27,14,167,67,73,140,13
2020-03-21,EP,Poland,513,405,12,12,108,48,48,96,0
2020-03-22,EP,Poland,476,364,32,27,112,38,42,80,5
2020-03-23,EP,Poland,438,304,35,18,134,55,44,99,17
2020-03-24,EP,Poland,401,277,41,19,124,40,43,83,22
2020-03-25,EP,Poland,425,302,35,10,123,42,46,88,25
2020-03-26,EP,Poland,452,308,66,34,144,39,39,78,32
2020-03-27,EP,Poland,399,291,20,7,108,47,41,88,13
2020-03-28,EP,Poland,265,211,12,6,54,19,23,42,6
2020-03-29,EP,Poland,256,206,6,2,50,20,24,44,4
2020-03-30,EP,Poland,284,189,30,12,95,35,30,65,18
2020-03-31,EP,Poland,267,173,25,7,94,35,34,69,18
2020-04-01,EP,Poland,323,209,41,27,114,37,36,73,14
2020-04-02,EP,Poland,316,207,36,14,109,37,36,73,22
2020-04-03,EP,Poland,334,235,21,13,99,37,41,78,8
2020-04-04,EP,Poland,221,168,17,15,53,17,19,36,2
2020-04-05,EP,Poland,234,179,16,10,55,17,22,39,6
2020-04-06,EP,Poland,279,199,35,10,80,25,20,45,25
2020-04-07,EP,Poland,274,194,28,9,80,26,26,52,19
2020-04-08,EP,Poland,286,211,39,17,75,16,20,36,22
2020-04-09,EP,Poland,284,214,28,10,70,23,19,42,18
2020-04-10,EP,Poland,284,210,24,8,74,24,26,50,16
2020-04-11,EP,Poland,211,183,5,4,28,11,12,23,1
2020-04-12,EP,Poland,229,212,6,1,17,5,6,11,5
2020-04-13,EP,Poland,195,181,1,1,14,8,5,13,0
2020-04-14,EP,Poland,295,220,29,18,75,22,24,46,11
2020-04-15,EP,Poland,303,212,33,15,91,31,27,58,18
2020-04-16,EP,Poland,312,212,37,20,100,32,31,63,17
2020-04-17,EP,Poland,313,235,30,13,78,24,24,48,17
2020-04-18,EP,Poland,229,191,14,9,38,11,13,24,5
2020-04-19,EP,Poland,241,205,12,7,36,12,12,24,5
2020-04-20,EP,Poland,278,200,36,11,78,23,19,42,25
2020-04-21,EP,Poland,305,224,32,7,81,24,25,49,25
2020-04-22,EP,Poland,357,235,56,17,122,34,32,66,39
2020-04-23,EP,Poland,356,265,32,16,91,30,29,59,16
2020-04-24,EP,Poland,339,249,27,9,90,31,32,63,18
2020-04-25,EP,Poland,258,220,15,7,38,10,13,23,8
2020-04-26,EP,Poland,268,243,8,4,25,8,9,17,4
2020-04-27,EP,Poland,331,231,39,18,100,32,29,61,21
2020-04-28,EP,Poland,358,270,35,15,88,25,28,53,20
2020-04-29,EP,Poland,393,290,42,17,103,30,31,61,25
2020-04-30,EP,Poland,365,266,37,17,99,33,29,62,20
2020-05-01,EP,Poland,313,271,14,8,42,11,17,28,6
2020-05-02,EP,Poland,232,207,12,6,25,6,7,13,6
2020-05-03,EP,Poland,283,254,16,7,29,7,6,13,9
2020-05-04,EP,Poland,324,243,37,18,81,21,23,44,19
2020-05-05,EP,Poland,372,276,47,14,96,25,24,49,33
2020-05-06,EP,Poland,366,264,42,16,102,33,27,60,26
2020-05-07,EP,Poland,357,251,51,19,106,28,27,55,32
2020-05-08,EP,Poland,373,269,47,14,104,25,32,57,33
2020-05-09,EP,Poland,281,248,16,7,33,7,10,17,9
2020-05-10,EP,Poland,302,258,15,10,44,15,14,29,5
2020-05-11,EP,Poland,365,270,39,18,95,26,30,56,21
2020-05-12,EP,Poland,385,276,58,22,109,27,24,51,36
2020-05-13,EP,Poland,419,315,52,21,104,24,28,52,31
2020-05-14,EP,Poland,418,309,46,25,109,35,28,63,21
2020-05-15,EP,Poland,448,332,47,26,116,36,33,69,21
2020-05-16,EP,Poland,337,296,20,6,41,12,9,21,14
2020-05-17,EP,Poland,310,277,11,2,33,10,12,22,9
2020-05-18,EP,Poland,396,300,34,12,96,30,32,62,22
2020-05-19,EP,Poland,408,293,55,23,115,31,29,60,32
2020-05-20,EP,Poland,448,316,61,26,132,34,37,71,35
2020-05-21,EP,Poland,453,319,69,20,134,32,33,65,49
2020-05-22,EP,Poland,421,316,51,25,105,26,28,54,26
2020-05-23,EP,Poland,326,275,21,12,51,17,13,30,9
2020-05-24,EP,Poland,341,291,17,7,50,16,17,33,10
2020-05-25,EP,Poland,366,260,52,21,106,27,27,54,31
2020-05-26,EP,Poland,402,274,53,21,128,37,38,75,32
2020-05-27,EP,Poland,467,323,68,22,144,38,38,76,46
2020-05-28,EP,Poland,411,288,60,22,123,33,30,63,38
2020-05-29,EP,Poland,419,309,52,18,110,27,31,58,34
2020-05-30,EP,Poland,346,304,22,12,42,11,9,20,10
2020-05-31,EP,Poland,298,267,11,5,31,8,12,20,6
2020-06-01,EP,Poland,388,238,82,16,150,33,35,68,66
2020-06-02,EP,Poland,433,280,86,20,153,32,35,67,66
2020-06-03,EP,Poland,476,312,87,18,164,40,37,77,69
2020-06-04,EP,Poland,445,283,92,26,162,35,35,70,66
2020-06-05,EP,Poland,464,312,84,19,152,38,30,68,65
2020-06-06,EP,Poland,367,289,35,10,78,20,23,43,25
2020-06-07,EP,Poland,361,284,38,6,77,21,18,39,32
2020-06-08,EP,Poland,420,249,94,13,171,34,43,77,81
2020-06-09,EP,Poland,433,259,97,19,174,41,36,77,78
2020-06-10,EP,Poland,466,299,94,16,167,40,33,73,78
2020-06-11,EP,Poland,365,279,46,6,86,16,24,40,40
2020-06-12,EP,Poland,439,322,59,14,117,29,29,58,45
2020-06-13,EP,Poland,331,273,34,8,58,15,9,24,26
2020-06-14,EP,Poland,393,313,42,6,80,17,21,38,36
2020-06-15,EP,Poland,489,315,89,22,174,39,46,85,67
2020-06-16,EP,Poland,489,308,92,21,181,45,44,89,71
2020-06-17,EP,Poland,585,339,90,27,246,81,75,156,63
2020-06-18,EP,Poland,484,281,88,27,203,57,58,115,61
2020-06-19,EP,Poland,576,353,70,10,223,77,76,153,60
2020-06-20,EP,Poland,455,304,54,15,151,49,48,97,39
2020-06-21,EP,Poland,467,315,44,5,152,51,57,108,39
2020-06-22,EP,Poland,607,365,80,13,242,81,81,162,67
2020-06-23,EP,Poland,566,320,88,27,246,80,78,158,61
2020-06-24,EP,Poland,577,367,75,14,210,66,69,135,61
2020-06-25,EP,Poland,543,305,98,30,238,75,65,140,68
2020-06-26,EP,Poland,604,365,85,26,239,73,81,154,59
2020-06-27,EP,Poland,465,300,54,20,165,61,50,111,34
2020-06-28,EP,Poland,506,336,42,12,170,63,65,128,30
2020-06-29,EP,Poland,577,346,72,24,231,75,84,159,48
2020-06-30,EP,Poland,614,324,103,25,290,91,96,187,78
2020-07-01,EP,Poland,912,471,101,26,441,170,170,340,75
2020-07-02,EP,Poland,819,421,98,18,398,153,147,300,80
2020-07-03,EP,Poland,1010,476,84,21,534,225,225,450,63
2020-07-04,EP,Poland,915,461,59,17,454,201,194,395,42
2020-07-05,EP,Poland,932,429,56,12,503,221,226,447,44
2020-07-06,EP,Poland,851,386,85,27,465,193,187,380,58
2020-07-07,EP,Poland,901,408,93,25,493,200,200,400,68
2020-07-08,EP,Poland,890,413,85,25,477,198,194,392,60
2020-07-09,EP,Poland,860,414,82,13,446,179,185,364,69
2020-07-10,EP,Poland,1015,451,75,17,564,246,243,489,58
2020-07-11,EP,Poland,920,469,47,9,451,197,207,404,38
2020-07-12,EP,Poland,957,439,41,9,518,238,239,477,32
2020-07-13,EP,Poland,885,396,60,10,489,212,217,429,50
2020-07-14,EP,Poland,897,407,73,17,490,209,208,417,56
2020-07-15,EP,Poland,1034,474,107,27,560,229,224,453,80
2020-07-16,EP,Poland,1040,493,99,23,547,225,223,448,76
2020-07-17,EP,Poland,1165,485,93,16,680,290,297,587,77
2020-07-18,EP,Poland,1056,498,65,13,558,252,241,493,52
2020-07-19,EP,Poland,1062,468,62,10,594,261,271,532,52
2020-07-20,EP,Poland,1038,482,91,15,556,231,234,465,76
2020-07-21,EP,Poland,1024,434,99,19,590,244,247,491,80
2020-07-22,EP,Poland,1019,459,115,30,560,225,220,445,85
2020-07-23,EP,Poland,1079,470,118,32,609,242,249,491,86
2020-07-24,EP,Poland,1171,506,103,25,665,284,278,562,78
2020-07-25,EP,Poland,1065,524,72,20,541,236,233,469,52
2020-07-26,EP,Poland,1113,492,71,17,621,272,278,550,54
2020-07-27,EP,Poland,1022,446,107,17,576,233,236,469,90
2020-07-28,EP,Poland,997,434,97,20,563,231,235,466,77
2020-07-29,EP,Poland,1000,452,115,35,548,218,215,433,80
2020-07-30,EP,Poland,1029,449,111,32,580,240,229,469,79
2020-07-31,EP,Poland,1197,532,127,40,665,269,269,538,87
2020-08-01,EP,Poland,1168,565,67,16,603,274,262,536,51
2020-08-02,EP,Poland,1185,531,56,10,654,294,304,598,46
2020-08-03,EP,Poland,1133,489,92,15,644,274,278,552,77
2020-08-04,EP,Poland,1158,485,131,23,673,272,270,542,108
2020-08-05,EP,Poland,1162,511,112,21,651,264,275,539,91
2020-08-06,EP,Poland,1159,503,126,31,656,266,264,530,95
2020-08-07,EP,Poland,1245,518,113,25,727,309,305,614,88
2020-08-08,EP,Poland,1197,568,71,15,629,280,278,558,56
2020-08-09,EP,Poland,1204,534,62,12,670,302,306,608,50
2020-08-10,EP,Poland,1166,512,107,17,654,280,267,547,90
2020-08-11,EP,Poland,1096,452,109,20,644,267,268,535,89
2020-08-12,EP,Poland,1164,494,101,24,670,283,286,569,77
2020-08-13,EP,Poland,1174,523,107,21,651,273,271,544,86
2020-08-14,EP,Poland,1305,556,102,21,749,322,325,647,81
2020-08-15,EP,Poland,1245,571,70,14,674,302,302,604,56
2020-08-16,EP,Poland,1285,552,58,11,733,334,341,675,47
2020-08-17,EP,Poland,1191,523,99,20,668,283,286,569,79
2020-08-18,EP,Poland,1135,462,106,18,673,287,280,567,88
2020-08-19,EP,Poland,1153,485,109,17,668,280,279,559,92
2020-08-20,EP,Poland,1207,523,112,23,684,285,287,572,89
2020-08-21,EP,Poland,1281,538,120,32,743,312,311,623,88
2020-08-22,EP,Poland,1258,589,76,23,669,297,296,593,53
2020-08-23,EP,Poland,1259,537,61,13,722,324,337,661,48
2020-08-24,EP,Poland,1164,483,116,31,681,282,283,565,85
2020-08-25,EP,Poland,1078,422,107,27,656,279,270,549,80
2020-08-26,EP,Poland,1166,501,113,12,665,276,276,552,101
2020-08-27,EP,Poland,1150,486,110,15,664,280,274,554,95
2020-08-28,EP,Poland,1301,563,107,20,738,313,318,631,87
2020-08-29,EP,Poland,1222,563,68,8,659,297,294,591,60
2020-08-30,EP,Poland,1293,564,70,9,729,325,334,659,61
2020-08-31,EP,Poland,1191,509,107,13,682,286,289,575,94
2020-09-01,EP,Poland,1034,430,90,5,604,257,257,514,85
2020-09-02,EP,Poland,1109,464,119,25,645,263,263,526,94
2020-09-03,EP,Poland,1117,485,107,24,632,264,261,525,83
2020-09-04,EP,Poland,1218,508,112,22,710,299,299,598,90
2020-09-05,EP,Poland,1148,553,74,16,595,257,264,521,58
2020-09-06,EP,Poland,1170,487,64,5,683,311,308,619,59
2020-09-07,EP,Poland,1086,468,105,11,618,258,255,513,94
2020-09-08,EP,Poland,1004,429,109,18,575,229,237,466,91
2020-09-09,EP,Poland,1092,474,115,28,618,251,252,503,87
2020-09-10,EP,Poland,1081,465,107,28,616,255,254,509,79
2020-09-11,EP,Poland,1228,515,114,19,713,300,299,599,95
2020-09-12,EP,Poland,1101,533,74,11,568,248,246,494,63
2020-09-13,EP,Poland,1227,534,77,14,693,304,312,616,63
2020-09-14,EP,Poland,1076,458,110,17,618,257,251,508,93
2020-09-15,EP,Poland,944,406,92,15,538,221,225,446,77
2020-09-16,EP,Poland,1068,469,103,23,599,246,250,496,80
2020-09-17,EP,Poland,1048,468,104,16,580,243,233,476,88
2020-09-18,EP,Poland,1192,504,119,17,688,286,283,569,102
2020-09-19,EP,Poland,1098,516,74,19,582,252,256,508,55
2020-09-20,EP,Poland,1134,502,76,19,632,274,282,556,57
2020-09-21,EP,Poland,1021,432,120,31,589,235,234,469,89
2020-09-22,EP,Poland,943,382,133,37,561,214,214,428,96
2020-09-23,EP,Poland,1019,445,123,26,574,226,225,451,97
2020-09-24,EP,Poland,1044,465,119,35,579,229,231,460,84
2020-09-25,EP,Poland,1162,513,107,19,649,276,266,542,88
2020-09-26,EP,Poland,1002,472,58,9,530,236,236,472,49
2020-09-27,EP,Poland,1133,533,59,6,600,268,273,541,53
2020-09-28,EP,Poland,1029,462,107,20,567,232,228,460,87
2020-09-29,EP,Poland,918,404,92,16,514,208,214,422,76
2020-09-30,EP,Poland,1046,452,107,19,594,243,244,487,88
2020-10-01,EP,Poland,1019,465,101,17,554,231,222,453,84
2020-10-02,EP,Poland,1149,519,100,12,630,266,264,530,88
2020-10-03,EP,Poland,1029,526,54,7,503,226,223,449,47
2020-10-04,EP,Poland,1099,514,56,8,585,258,271,529,48
2020-10-05,EP,Poland,969,432,91,15,537,222,224,446,76
2020-10-06,EP,Poland,838,341,109,19,497,192,196,388,90
2020-10-07,EP,Poland,949,421,111,23,528,215,202,417,88
2020-10-08,EP,Poland,922,416,102,28,506,201,203,404,74
2020-10-09,EP,Poland,1089,510,113,12,579,235,231,466,101
2020-10-10,EP,Poland,997,520,63,7,477,207,207,414,56
2020-10-11,EP,Poland,1071,517,59,10,554,246,249,495,49
2020-10-12,EP,Poland,939,472,73,8,467,192,202,394,65
2020-10-13,EP,Poland,777,345,76,10,432,178,178,356,66
2020-10-14,EP,Poland,944,469,99,23,475,194,182,376,76
2020-10-15,EP,Poland,969,451,102,22,518,205,211,416,80
2020-10-16,EP,Poland,1112,572,94,17,540,226,220,446,77
2020-10-17,EP,Poland,979,530,52,7,449,199,198,397,45
2020-10-18,EP,Poland,1038,532,50,6,506,226,230,456,44
2020-10-19,EP,Poland,901,435,85,19,466,190,191,381,66
2020-10-20,EP,Poland,817,405,97,24,412,156,159,315,73
2020-10-21,EP,Poland,917,475,93,20,442,172,177,349,73
2020-10-22,EP,Poland,939,464,100,22,475,184,191,375,78
2020-10-23,EP,Poland,1060,545,99,21,515,214,202,416,78
2020-10-24,EP,Poland,957,526,49,11,431,194,188,382,38
2020-10-25,EP,Poland,993,531,54,3,462,201,207,408,51
2020-10-26,EP,Poland,970,457,92,19,513,209,212,421,73
2020-10-27,EP,Poland,842,420,106,21,422,161,155,316,85
2020-10-28,EP,Poland,918,474,94,20,444,175,175,350,74
2020-10-29,EP,Poland,910,461,99,27,449,174,176,350,72
2020-10-30,EP,Poland,1004,497,82,18,507,218,207,425,64
2020-10-31,EP,Poland,877,475,42,3,402,175,185,360,39
2020-11-01,EP,Poland,959,525,51,2,434,192,191,383,49
2020-11-02,EP,Poland,941,470,80,6,471,195,196,391,74
2020-11-03,EP,Poland,789,427,70,10,362,146,146,292,60
2020-11-04,EP,Poland,866,475,78,14,391,158,155,313,64
2020-11-05,EP,Poland,782,431,88,25,351,131,132,263,63
2020-11-06,EP,Poland,951,483,65,13,468,204,199,403,52
2020-11-07,EP,Poland,838,502,42,6,336,146,148,294,36
2020-11-08,EP,Poland,910,507,58,5,403,174,171,345,53
2020-11-09,EP,Poland,860,456,85,16,404,159,160,319,69
2020-11-10,EP,Poland,686,364,68,15,322,130,124,254,53
2020-11-11,EP,Poland,714,454,55,12,260,99,106,205,43
2020-11-12,EP,Poland,762,446,74,22,316,122,120,242,52
2020-11-13,EP,Poland,871,452,71,23,419,176,172,348,48
2020-11-14,EP,Poland,637,434,38,11,203,82,83,165,27
2020-11-15,EP,Poland,836,516,56,10,320,134,130,264,46
2020-11-16,EP,Poland,800,444,94,23,356,129,133,262,71
2020-11-17,EP,Poland,578,338,66,20,240,89,85,174,46
2020-11-18,EP,Poland,727,420,89,23,307,106,112,218,66
2020-11-19,EP,Poland,749,443,92,28,306,107,107,214,64
2020-11-20,EP,Poland,812,463,102,38,349,125,122,247,64
2020-11-21,EP,Poland,575,416,32,9,159,67,60,127,23
2020-11-22,EP,Poland,694,441,58,15,253,95,100,195,43
2020-11-23,EP,Poland,749,433,80,9,316,116,120,236,71
2020-11-24,EP,Poland,586,396,55,11,190,70,65,135,44
2020-11-25,EP,Poland,691,420,80,23,271,94,97,191,57
2020-11-26,EP,Poland,724,423,86,24,301,101,114,215,62
2020-11-27,EP,Poland,805,477,73,12,328,131,124,255,61
2020-11-28,EP,Poland,596,420,34,6,176,71,71,142,28
2020-11-29,EP,Poland,677,440,52,6,237,91,94,185,46
2020-11-30,EP,Poland,723,430,73,12,293,113,107,220,61
2020-12-01,EP,Poland,576,368,58,21,208,78,72,150,37
2020-12-02,EP,Poland,696,398,84,11,298,106,108,214,73
2020-12-03,EP,Poland,704,422,77,19,282,103,102,205,58
2020-12-04,EP,Poland,789,471,77,13,318,120,121,241,64
2020-12-05,EP,Poland,614,429,41,11,185,74,70,144,30
2020-12-06,EP,Poland,720,471,51,4,249,96,102,198,47
2020-12-07,EP,Poland,739,430,74,10,309,116,119,235,64
2020-12-08,EP,Poland,589,379,52,11,210,77,81,158,41
2020-12-09,EP,Poland,721,449,57,6,272,112,103,215,51
2020-12-10,EP,Poland,714,451,50,6,263,106,107,213,44
2020-12-11,EP,Poland,868,523,50,4,345,150,145,295,46
2020-12-12,EP,Poland,698,467,30,2,231,99,102,201,28
2020-12-13,EP,Poland,801,505,40,4,296,130,126,256,36
2020-12-14,EP,Poland,781,442,72,13,339,132,135,267,59
2020-12-15,EP,Poland,709,442,62,12,267,99,106,205,50
2020-12-16,EP,Poland,803,483,66,10,320,123,131,254,56
2020-12-17,EP,Poland,1004,557,75,10,447,189,183,372,65
2020-12-18,EP,Poland,1216,643,74,14,573,250,249,499,60
2020-12-19,EP,Poland,1031,606,36,3,425,201,188,389,33
2020-12-20,EP,Poland,1054,577,58,9,477,203,216,419,49
2020-12-21,EP,Poland,1037,492,69,6,545,236,240,476,63
2020-12-22,EP,Poland,793,439,52,6,354,151,151,302,46
2020-12-23,EP,Poland,929,527,52,11,402,176,174,350,41
2020-12-24,EP,Poland,647,393,40,0,254,106,108,214,40
2020-12-25,EP,Poland,491,341,35,1,150,59,56,115,34
2020-12-26,EP,Poland,614,401,33,1,213,90,90,180,32
2020-12-27,EP,Poland,827,462,55,9,365,158,152,310,46
2020-12-28,EP,Poland,780,411,62,6,369,156,151,307,56
2020-12-29,EP,Poland,621,361,53,6,260,99,108,207,47
2020-12-30,EP,Poland,766,441,44,2,325,138,143,281,42
2020-12-31,EP,Poland,469,309,24,3,160,65,71,136,21
2020-01-01,LP,Portugal,1699,843,144,0,856,358,354,712,144
2020-01-02,LP,Portugal,1933,899,150,1,1034,451,433,884,149
2020-01-03,LP,Portugal,2109,1028,165,2,1081,461,455,916,163
2020-01-04,LP,Portugal,2448,1367,150,1,1081,468,463,931,149
2020-01-05,LP,Portugal,2143,1092,142,0,1051,460,449,909,142
2020-01-06,LP,Portugal,1916,886,153,3,1030,435,442,877,150
2020-01-07,LP,Portugal,1893,948,140,6,945,400,405,805,134
2020-01-08,LP,Portugal,1649,838,133,2,811,338,340,678,131
2020-01-09,LP,Portugal,1625,763,129,2,862,368,365,733,127
2020-01-10,LP,Portugal,1897,920,152,2,977,416,409,825,150
2020-01-11,LP,Portugal,2013,1121,130,1,892,381,381,762,129
2020-01-12,LP,Portugal,1859,960,120,0,899,386,393,779,120
2020-01-13,LP,Portugal,1656,734,143,4,922,389,390,779,139
2020-01-14,LP,Portugal,1413,697,122,2,716,297,297,594,120
2020-01-15,LP,Portugal,1405,728,110,0,677,281,286,567,110
2020-01-16,LP,Portugal,1600,764,125,2,836,360,351,711,123
2020-01-17,LP,Portugal,1809,873,158,3,936,390,388,778,155
2020-01-18,LP,Portugal,1983,1157,114,1,826,354,358,712,113
2020-01-19,LP,Portugal,1837,951,122,1,886,380,384,764,121
2020-01-20,LP,Portugal,1634,749,144,1,885,368,373,741,143
2020-01-21,LP,Portugal,1443,711,129,4,732,303,300,603,125
2020-01-22,LP,Portugal,1429,726,121,2,703,292,290,582,119
2020-01-23,LP,Portugal,1578,752,123,0,826,358,345,703,123
2020-01-24,LP,Portugal,1773,843,144,2,930,392,394,786,142
2020-01-25,LP,Portugal,1958,1111,123,3,847,364,360,724,120
2020-01-26,LP,Portugal,1796,907,123,1,889,381,385,766,122
2020-01-27,LP,Portugal,1600,722,130,0,878,375,373,748,130
2020-01-28,LP,Portugal,1424,672,134,3,752,306,312,618,131
2020-01-29,LP,Portugal,1407,669,129,5,738,303,306,609,124
2020-01-30,LP,Portugal,1594,743,136,5,851,360,355,715,131
2020-01-31,LP,Portugal,1705,763,145,2,942,400,397,797,143
2020-02-01,LP,Portugal,1978,1111,120,2,867,374,373,747,118
2020-02-02,LP,Portugal,1792,884,124,0,908,393,391,784,124
2020-02-03,LP,Portugal,1626,712,140,6,914,385,389,774,134
2020-02-04,LP,Portugal,1514,748,129,3,766,323,314,637,126
2020-02-05,LP,Portugal,1478,738,119,1,740,308,313,621,118
2020-02-06,LP,Portugal,1618,766,123,3,852,371,358,729,120
2020-02-07,LP,Portugal,1764,801,153,4,963,403,407,810,149
2020-02-08,LP,Portugal,2026,1111,116,1,915,400,399,799,115
2020-02-09,LP,Portugal,1759,844,124,2,915,392,399,791,122
2020-02-10,LP,Portugal,1655,735,140,6,920,394,386,780,134
2020-02-11,LP,Portugal,1583,776,135,8,807,340,332,672,127
2020-02-12,LP,Portugal,1503,726,118,1,777,324,335,659,117
2020-02-13,LP,Portugal,1738,805,135,3,933,405,393,798,132
2020-02-14,LP,Portugal,1835,846,149,3,989,420,420,840,146
2020-02-15,LP,Portugal,2136,1194,123,1,942,404,415,819,122
2020-02-16,LP,Portugal,1928,974,123,1,954,416,415,831,122
2020-02-17,LP,Portugal,1761,779,140,2,982,419,423,842,138
2020-02-18,LP,Portugal,1670,824,133,3,846,359,354,713,130
2020-02-19,LP,Portugal,1619,797,118,3,822,354,350,704,115
2020-02-20,LP,Portugal,1721,785,142,2,936,394,400,794,140
2020-02-21,LP,Portugal,1927,884,156,1,1043,447,440,887,155
2020-02-22,LP,Portugal,2172,1170,125,0,1002,439,438,877,125
2020-02-23,LP,Portugal,1788,801,121,0,987,433,433,866,121
2020-02-24,LP,Portugal,1948,922,146,1,1026,438,442,880,145
2020-02-25,LP,Portugal,1931,1031,136,4,900,381,383,764,132
2020-02-26,LP,Portugal,1717,831,131,7,886,382,373,755,124
2020-02-27,LP,Portugal,1739,790,137,3,949,411,401,812,134
2020-02-28,LP,Portugal,1889,877,144,0,1012,433,435,868,144
2020-02-29,LP,Portugal,2210,1218,131,3,992,433,428,861,128
2020-03-01,LP,Portugal,2029,1042,125,1,987,433,429,862,124
2020-03-02,LP,Portugal,1816,833,144,3,983,414,425,839,141
2020-03-03,LP,Portugal,1692,822,132,4,870,372,366,738,128
2020-03-04,LP,Portugal,1524,691,125,5,833,353,355,708,120
2020-03-05,LP,Portugal,1731,789,131,4,942,409,402,811,127
2020-03-06,LP,Portugal,1904,892,141,2,1012,432,439,871,139
2020-03-07,LP,Portugal,2036,1081,125,3,955,412,418,830,122
2020-03-08,LP,Portugal,1968,979,126,1,989,435,428,863,125
2020-03-09,LP,Portugal,1784,816,138,1,968,412,418,830,137
2020-03-10,LP,Portugal,1670,817,127,3,853,367,359,726,124
2020-03-11,LP,Portugal,1494,728,121,6,766,321,324,645,115
2020-03-12,LP,Portugal,1690,806,134,3,884,377,373,750,131
2020-03-13,LP,Portugal,1845,878,146,2,967,410,411,821,144
2020-03-14,LP,Portugal,2057,1105,117,0,952,417,418,835,117
2020-03-15,LP,Portugal,2008,1120,113,1,888,383,392,775,112
2020-03-16,LP,Portugal,1613,794,115,1,819,350,354,704,114
2020-03-17,LP,Portugal,1336,796,87,1,540,230,223,453,86
2020-03-18,LP,Portugal,1192,666,83,0,526,217,226,443,83
2020-03-19,LP,Portugal,1127,688,65,0,439,188,186,374,65
2020-03-20,LP,Portugal,1116,655,65,0,461,198,198,396,65
2020-03-21,LP,Portugal,1157,740,50,0,417,185,182,367,50
2020-03-22,LP,Portugal,724,364,47,0,360,156,157,313,47
2020-03-23,LP,Portugal,454,226,37,0,228,93,98,191,37
2020-03-24,LP,Portugal,399,208,29,0,191,86,76,162,29
2020-03-25,LP,Portugal,287,168,29,1,119,43,47,90,28
2020-03-26,LP,Portugal,292,168,27,0,124,47,50,97,27
2020-03-27,LP,Portugal,276,155,38,12,121,41,42,83,26
2020-03-28,LP,Portugal,255,147,23,0,108,44,41,85,23
2020-03-29,LP,Portugal,204,119,20,0,85,32,33,65,20
2020-03-30,LP,Portugal,175,74,30,0,101,40,31,71,30
2020-03-31,LP,Portugal,168,82,27,1,86,27,32,59,26
2020-04-01,LP,Portugal,131,62,21,0,69,25,23,48,21
2020-04-02,LP,Portugal,130,59,31,8,71,19,21,40,23
2020-04-03,LP,Portugal,145,70,32,0,75,21,22,43,32
2020-04-04,LP,Portugal,108,54,16,0,54,19,19,38,16
2020-04-05,LP,Portugal,96,54,12,0,42,13,17,30,12
2020-04-06,LP,Portugal,119,41,31,1,78,25,22,47,30
2020-04-07,LP,Portugal,126,67,28,0,59,14,17,31,28
2020-04-08,LP,Portugal,123,47,28,3,76,24,24,48,25
2020-04-09,LP,Portugal,111,51,22,2,60,20,18,38,20
2020-04-10,LP,Portugal,81,49,19,1,32,7,6,13,18
2020-04-11,LP,Portugal,77,49,17,0,28,5,6,11,17
2020-04-12,LP,Portugal,58,36,10,0,22,5,7,12,10
2020-04-13,LP,Portugal,74,33,20,0,41,10,11,21,20
2020-04-14,LP,Portugal,135,54,36,6,81,23,22,45,30
2020-04-15,LP,Portugal,128,50,32,3,78,23,23,46,29
2020-04-16,LP,Portugal,130,47,27,1,83,29,27,56,26
2020-04-17,LP,Portugal,133,61,28,0,72,25,19,44,28
2020-04-18,LP,Portugal,98,46,20,0,52,16,16,32,20
2020-04-19,LP,Portugal,102,56,15,0,46,16,15,31,15
2020-04-20,LP,Portugal,110,42,23,0,68,22,23,45,23
2020-04-21,LP,Portugal,129,45,33,4,84,26,25,51,29
2020-04-22,LP,Portugal,108,44,24,0,64,24,16,40,24
2020-04-23,LP,Portugal,125,59,22,0,66,22,22,44,22
2020-04-24,LP,Portugal,136,60,32,0,76,22,22,44,32
2020-04-25,LP,Portugal,84,39,18,0,45,13,14,27,18
2020-04-26,LP,Portugal,86,44,14,0,42,15,13,28,14
2020-04-27,LP,Portugal,115,47,33,5,68,18,17,35,28
2020-04-28,LP,Portugal,128,52,30,4,76,23,23,46,26
2020-04-29,LP,Portugal,127,68,23,0,59,17,19,36,23
2020-04-30,LP,Portugal,146,76,31,2,70,19,20,39,29
2020-05-01,LP,Portugal,112,63,16,0,49,16,17,33,16
2020-05-02,LP,Portugal,111,50,19,0,61,19,23,42,19
2020-05-03,LP,Portugal,97,50,14,0,47,16,17,33,14
2020-05-04,LP,Portugal,121,39,26,0,82,30,26,56,26
2020-05-05,LP,Portugal,141,54,32,1,87,25,30,55,31
2020-05-06,LP,Portugal,138,56,28,0,82,27,27,54,28
2020-05-07,LP,Portugal,156,78,28,3,78,27,23,50,25
2020-05-08,LP,Portugal,144,60,36,2,84,22,26,48,34
2020-05-09,LP,Portugal,107,53,21,0,54,15,18,33,21
2020-05-10,LP,Portugal,119,57,15,0,62,25,22,47,15
2020-05-11,LP,Portugal,172,73,38,4,99,32,29,61,34
2020-05-12,LP,Portugal,162,82,34,2,80,22,24,46,32
2020-05-13,LP,Portugal,152,71,32,0,81,24,25,49,32
2020-05-14,LP,Portugal,155,58,31,0,97,30,36,66,31
2020-05-15,LP,Portugal,155,63,32,0,92,30,30,60,32
2020-05-16,LP,Portugal,128,44,33,2,84,23,28,51,31
2020-05-17,LP,Portugal,111,48,19,1,63,23,21,44,18
2020-05-18,LP,Portugal,153,63,38,2,90,30,22,52,36
2020-05-19,LP,Portugal,175,79,34,5,96,30,32,62,29
2020-05-20,LP,Portugal,227,117,33,0,110,38,39,77,33
2020-05-21,LP,Portugal,223,98,42,7,125,41,42,83,35
2020-05-22,LP,Portugal,193,72,49,9,121,34,38,72,40
2020-05-23,LP,Portugal,146,52,33,2,94,30,31,61,31
2020-05-24,LP,Portugal,128,50,21,1,78,32,25,57,20
2020-05-25,LP,Portugal,152,52,37,3,100,34,29,63,34
2020-05-26,LP,Portugal,150,54,30,3,96,33,33,66,27
2020-05-27,LP,Portugal,146,54,33,2,92,31,28,59,31
2020-05-28,LP,Portugal,157,60,34,2,97,31,32,63,32
2020-05-29,LP,Portugal,180,69,38,2,111,34,39,73,36
2020-05-30,LP,Portugal,160,59,42,4,101,29,30,59,38
2020-05-31,LP,Portugal,156,77,19,1,79,29,31,60,18
2020-06-01,LP,Portugal,179,65,44,4,114,34,36,70,40
2020-06-02,LP,Portugal,172,56,38,1,116,40,38,78,37
2020-06-03,LP,Portugal,203,81,45,2,122,38,39,77,43
2020-06-04,LP,Portugal,220,70,45,3,150,52,53,105,42
2020-06-05,LP,Portugal,215,80,52,5,135,37,46,83,47
2020-06-06,LP,Portugal,192,66,40,2,126,44,42,86,38
2020-06-07,LP,Portugal,205,68,31,1,137,55,51,106,30
2020-06-08,LP,Portugal,231,94,54,4,137,42,41,83,50
2020-06-09,LP,Portugal,213,64,50,1,149,52,47,99,49
2020-06-10,LP,Portugal,237,97,51,3,140,45,44,89,48
2020-06-11,LP,Portugal,200,68,48,1,132,42,42,84,47
2020-06-12,LP,Portugal,247,97,55,6,150,47,48,95,49
2020-06-13,LP,Portugal,224,102,44,2,122,39,39,78,42
2020-06-14,LP,Portugal,216,80,40,0,136,46,50,96,40
2020-06-15,LP,Portugal,258,78,58,4,180,66,56,122,54
2020-06-16,LP,Portugal,233,70,56,0,163,55,52,107,56
2020-06-17,LP,Portugal,263,97,56,2,166,53,57,110,54
2020-06-18,LP,Portugal,261,76,58,2,185,64,63,127,56
2020-06-19,LP,Portugal,283,89,62,2,194,65,67,132,60
2020-06-20,LP,Portugal,241,79,42,1,162,60,60,120,41
2020-06-21,LP,Portugal,288,84,52,4,204,75,77,152,48
2020-06-22,LP,Portugal,284,92,76,3,192,62,54,116,73
2020-06-23,LP,Portugal,280,84,62,8,196,63,71,134,54
2020-06-24,LP,Portugal,312,115,67,5,197,63,67,130,62
2020-06-25,LP,Portugal,273,81,53,4,192,73,66,139,49
2020-06-26,LP,Portugal,338,128,65,2,210,70,75,145,63
2020-06-27,LP,Portugal,319,122,45,0,197,74,78,152,45
2020-06-28,LP,Portugal,329,121,46,0,208,78,84,162,46
2020-06-29,LP,Portugal,324,105,59,6,219,80,80,160,53
2020-06-30,LP,Portugal,321,99,62,4,222,81,79,160,58
2020-07-01,LP,Portugal,617,204,110,3,413,152,151,303,107
2020-07-02,LP,Portugal,614,198,107,5,416,153,156,309,102
2020-07-03,LP,Portugal,699,229,122,5,470,171,177,348,117
2020-07-04,LP,Portugal,775,273,100,1,502,199,203,402,99
2020-07-05,LP,Portugal,692,255,90,6,437,177,170,347,84
2020-07-06,LP,Portugal,648,203,110,8,445,170,165,335,102
2020-07-07,LP,Portugal,649,213,109,3,436,164,163,327,106
2020-07-08,LP,Portugal,673,233,113,6,440,163,164,327,107
2020-07-09,LP,Portugal,674,221,101,5,453,176,176,352,96
2020-07-10,LP,Portugal,728,226,119,6,502,188,195,383,113
2020-07-11,LP,Portugal,795,276,107,2,519,202,210,412,105
2020-07-12,LP,Portugal,719,253,94,2,466,194,178,372,92
2020-07-13,LP,Portugal,685,209,113,4,476,180,183,363,109
2020-07-14,LP,Portugal,687,228,103,1,459,182,174,356,102
2020-07-15,LP,Portugal,735,260,108,6,475,185,182,367,102
2020-07-16,LP,Portugal,761,262,108,3,499,189,202,391,105
2020-07-17,LP,Portugal,813,282,112,2,531,210,209,419,110
2020-07-18,LP,Portugal,886,346,99,0,540,216,225,441,99
2020-07-19,LP,Portugal,833,306,93,1,527,221,213,434,92
2020-07-20,LP,Portugal,786,259,109,2,527,212,206,418,107
2020-07-21,LP,Portugal,788,289,107,2,499,190,202,392,105
2020-07-22,LP,Portugal,781,295,110,4,486,187,189,376,106
2020-07-23,LP,Portugal,828,282,110,3,546,219,217,436,107
2020-07-24,LP,Portugal,862,297,117,5,565,224,224,448,112
2020-07-25,LP,Portugal,977,409,111,1,568,227,230,457,110
2020-07-26,LP,Portugal,893,349,95,0,544,224,225,449,95
2020-07-27,LP,Portugal,778,250,113,4,528,210,205,415,109
2020-07-28,LP,Portugal,766,280,108,5,486,191,187,378,103
2020-07-29,LP,Portugal,814,286,113,4,528,208,207,415,109
2020-07-30,LP,Portugal,829,291,112,4,538,216,210,426,108
2020-07-31,LP,Portugal,875,309,117,5,566,219,230,449,112
2020-08-01,LP,Portugal,1187,472,124,2,715,295,296,591,122
2020-08-02,LP,Portugal,1093,401,116,2,692,292,284,576,114
2020-08-03,LP,Portugal,1053,327,138,3,726,294,294,588,135
2020-08-04,LP,Portugal,913,288,128,2,625,249,248,497,126
2020-08-05,LP,Portugal,945,316,129,4,629,254,246,500,125
2020-08-06,LP,Portugal,965,316,126,5,649,264,259,523,121
2020-08-07,LP,Portugal,1039,328,144,1,711,288,279,567,143
2020-08-08,LP,Portugal,1153,417,127,2,736,298,311,609,125
2020-08-09,LP,Portugal,1064,377,107,0,687,292,288,580,107
2020-08-10,LP,Portugal,1001,314,134,3,687,277,276,553,131
2020-08-11,LP,Portugal,920,298,134,5,622,242,246,488,129
2020-08-12,LP,Portugal,946,310,128,5,636,250,258,508,123
2020-08-13,LP,Portugal,982,308,139,10,674,274,261,535,129
2020-08-14,LP,Portugal,1067,352,142,3,715,288,285,573,139
2020-08-15,LP,Portugal,1172,436,131,1,736,298,307,605,130
2020-08-16,LP,Portugal,1110,393,118,2,717,305,294,599,116
2020-08-17,LP,Portugal,1048,328,147,7,720,286,287,573,140
2020-08-18,LP,Portugal,910,277,135,4,633,249,249,498,131
2020-08-19,LP,Portugal,948,290,139,8,658,260,259,519,131
2020-08-20,LP,Portugal,926,288,111,0,638,263,264,527,111
2020-08-21,LP,Portugal,1030,308,143,1,722,290,289,579,142
2020-08-22,LP,Portugal,1161,416,132,0,745,297,316,613,132
2020-08-23,LP,Portugal,1126,350,130,4,776,326,320,646,126
2020-08-24,LP,Portugal,1066,313,135,3,753,316,302,618,132
2020-08-25,LP,Portugal,970,279,153,5,691,268,270,538,148
2020-08-26,LP,Portugal,971,296,145,3,675,266,264,530,142
2020-08-27,LP,Portugal,988,275,134,3,713,292,287,579,131
2020-08-28,LP,Portugal,1110,333,143,2,777,315,319,634,141
2020-08-29,LP,Portugal,1218,459,124,0,759,310,325,635,124
2020-08-30,LP,Portugal,1124,372,121,2,752,321,310,631,119
2020-08-31,LP,Portugal,1047,321,135,2,726,297,294,591,133
2020-09-01,LP,Portugal,895,303,123,2,592,233,236,469,121
2020-09-02,LP,Portugal,894,296,128,3,598,237,233,470,125
2020-09-03,LP,Portugal,886,250,128,3,636,255,253,508,125
2020-09-04,LP,Portugal,974,290,126,3,684,282,276,558,123
2020-09-05,LP,Portugal,1113,388,129,4,725,296,300,596,125
2020-09-06,LP,Portugal,1079,383,120,6,696,284,292,576,114
2020-09-07,LP,Portugal,965,283,140,5,682,266,276,542,135
2020-09-08,LP,Portugal,786,242,126,8,544,211,207,418,118
2020-09-09,LP,Portugal,883,307,126,5,576,226,224,450,121
2020-09-10,LP,Portugal,944,297,131,4,647,260,256,516,127
2020-09-11,LP,Portugal,1034,324,132,4,710,294,284,578,128
2020-09-12,LP,Portugal,1081,387,121,2,694,285,288,573,119
2020-09-13,LP,Portugal,982,287,109,0,695,295,291,586,109
2020-09-14,LP,Portugal,887,248,136,7,639,250,253,503,129
2020-09-15,LP,Portugal,767,236,117,1,531,207,207,414,116
2020-09-16,LP,Portugal,791,239,125,2,552,214,213,427,123
2020-09-17,LP,Portugal,833,228,124,3,605,238,243,481,121
2020-09-18,LP,Portugal,941,255,130,1,686,279,277,556,129
2020-09-19,LP,Portugal,1026,355,123,2,671,274,274,548,121
2020-09-20,LP,Portugal,1020,355,108,1,665,279,278,557,107
2020-09-21,LP,Portugal,869,243,135,6,626,240,251,491,129
2020-09-22,LP,Portugal,725,224,122,4,501,194,185,379,118
2020-09-23,LP,Portugal,770,231,114,3,539,214,211,425,111
2020-09-24,LP,Portugal,789,213,119,6,576,230,227,457,113
2020-09-25,LP,Portugal,897,228,141,0,669,261,267,528,141
2020-09-26,LP,Portugal,961,308,121,0,653,263,269,532,121
2020-09-27,LP,Portugal,974,277,116,2,697,295,286,581,114
2020-09-28,LP,Portugal,867,233,137,7,634,242,255,497,130
2020-09-29,LP,Portugal,725,210,128,5,515,199,188,387,123
2020-09-30,LP,Portugal,813,260,130,2,553,212,211,423,128
2020-10-01,LP,Portugal,772,218,123,3,554,210,221,431,120
2020-10-02,LP,Portugal,927,267,135,2,660,267,258,525,133
2020-10-03,LP,Portugal,1011,364,120,4,647,266,261,527,116
2020-10-04,LP,Portugal,945,299,114,6,646,265,267,532,108
2020-10-05,LP,Portugal,827,219,132,5,608,236,240,476,127
2020-10-06,LP,Portugal,678,198,115,6,480,180,185,365,109
2020-10-07,LP,Portugal,741,221,125,4,520,202,193,395,121
2020-10-08,LP,Portugal,758,212,123,2,546,202,221,423,121
2020-10-09,LP,Portugal,892,244,135,6,648,257,256,513,129
2020-10-10,LP,Portugal,977,348,114,3,629,259,256,515,111
2020-10-11,LP,Portugal,936,304,113,2,632,265,254,519,111
2020-10-12,LP,Portugal,789,234,123,5,555,219,213,432,118
2020-10-13,LP,Portugal,672,232,104,4,440,168,168,336,100
2020-10-14,LP,Portugal,700,234,114,4,466,176,176,352,110
2020-10-15,LP,Portugal,733,215,119,6,518,199,200,399,113
2020-10-16,LP,Portugal,879,273,126,1,606,247,233,480,125
2020-10-17,LP,Portugal,971,354,112,2,617,249,256,505,110
2020-10-18,LP,Portugal,885,294,107,3,591,241,243,484,104
2020-10-19,LP,Portugal,783,251,110,0,532,213,209,422,110
2020-10-20,LP,Portugal,596,178,92,1,418,159,167,326,91
2020-10-21,LP,Portugal,695,232,118,2,463,172,173,345,116
2020-10-22,LP,Portugal,743,244,117,4,499,186,196,382,113
2020-10-23,LP,Portugal,876,269,131,2,607,242,234,476,129
2020-10-24,LP,Portugal,989,391,114,0,598,237,247,484,114
2020-10-25,LP,Portugal,938,346,94,0,592,260,238,498,94
2020-10-26,LP,Portugal,816,284,115,2,532,204,213,417,113
2020-10-27,LP,Portugal,575,211,91,4,364,134,139,273,87
2020-10-28,LP,Portugal,644,226,97,1,418,164,157,321,96
2020-10-29,LP,Portugal,715,272,91,3,443,176,176,352,88
2020-10-30,LP,Portugal,858,329,112,4,529,210,207,417,108
2020-10-31,LP,Portugal,969,455,92,2,514,213,209,422,90
2020-11-01,LP,Portugal,977,414,95,3,563,236,232,468,92
2020-11-02,LP,Portugal,768,285,116,6,483,181,186,367,110
2020-11-03,LP,Portugal,652,308,95,11,344,126,123,249,84
2020-11-04,LP,Portugal,616,261,88,5,355,130,137,267,83
2020-11-05,LP,Portugal,614,265,79,3,349,131,139,270,76
2020-11-06,LP,Portugal,769,286,104,3,483,187,192,379,101
2020-11-07,LP,Portugal,903,498,85,5,405,161,159,320,80
2020-11-08,LP,Portugal,880,388,90,7,492,204,198,402,83
2020-11-09,LP,Portugal,687,287,101,8,400,153,146,299,93
2020-11-10,LP,Portugal,528,213,85,9,315,116,114,230,76
2020-11-11,LP,Portugal,544,233,88,7,311,110,113,223,81
2020-11-12,LP,Portugal,592,241,94,10,351,131,126,257,84
2020-11-13,LP,Portugal,679,264,109,6,415,150,156,306,103
2020-11-14,LP,Portugal,751,402,77,4,349,137,135,272,73
2020-11-15,LP,Portugal,726,307,91,8,419,170,158,328,83
2020-11-16,LP,Portugal,601,238,96,5,363,129,138,267,91
2020-11-17,LP,Portugal,426,166,81,12,260,87,92,179,69
2020-11-18,LP,Portugal,492,192,83,10,300,110,107,217,73
2020-11-19,LP,Portugal,493,197,91,13,296,101,104,205,78
2020-11-20,LP,Portugal,638,260,117,11,378,136,125,261,106
2020-11-21,LP,Portugal,673,351,80,4,322,122,120,242,76
2020-11-22,LP,Portugal,628,291,79,3,337,129,129,258,76
2020-11-23,LP,Portugal,525,194,96,5,331,116,119,235,91
2020-11-24,LP,Portugal,397,170,78,5,227,74,75,149,73
2020-11-25,LP,Portugal,481,241,86,8,240,77,77,154,78
2020-11-26,LP,Portugal,443,187,79,5,256,88,89,177,74
2020-11-27,LP,Portugal,603,238,109,7,365,129,127,256,102
2020-11-28,LP,Portugal,670,381,90,6,289,103,96,199,84
2020-11-29,LP,Portugal,678,339,75,5,339,130,134,264,70
2020-11-30,LP,Portugal,597,287,97,4,310,110,103,213,93
2020-12-01,LP,Portugal,464,229,66,2,235,85,84,169,64
2020-12-02,LP,Portugal,587,325,67,4,262,99,96,195,63
2020-12-03,LP,Portugal,556,297,80,4,259,88,91,179,76
2020-12-04,LP,Portugal,675,334,97,0,341,124,120,244,97
2020-12-05,LP,Portugal,807,507,73,3,300,116,111,227,70
2020-12-06,LP,Portugal,641,331,78,2,310,112,120,232,76
2020-12-07,LP,Portugal,547,256,89,0,291,104,98,202,89
2020-12-08,LP,Portugal,479,240,73,3,239,83,83,166,70
2020-12-09,LP,Portugal,488,230,74,4,258,91,93,184,70
2020-12-10,LP,Portugal,564,283,71,3,281,104,106,210,68
2020-12-11,LP,Portugal,693,323,101,1,370,133,136,269,100
2020-12-12,LP,Portugal,850,504,82,0,346,133,131,264,82
2020-12-13,LP,Portugal,738,383,81,3,355,137,137,274,78
2020-12-14,LP,Portugal,663,305,95,2,358,129,134,263,93
2020-12-15,LP,Portugal,642,356,84,3,286,105,97,202,81
2020-12-16,LP,Portugal,658,327,85,1,331,126,120,246,84
2020-12-17,LP,Portugal,869,434,92,8,435,174,169,343,84
2020-12-18,LP,Portugal,996,426,116,1,570,228,226,454,115
2020-12-19,LP,Portugal,1272,694,100,2,578,240,238,478,98
2020-12-20,LP,Portugal,1115,553,92,2,562,231,239,470,90
2020-12-21,LP,Portugal,892,386,102,5,506,206,198,404,97
2020-12-22,LP,Portugal,839,416,99,2,423,153,171,324,97
2020-12-23,LP,Portugal,921,413,107,3,508,204,197,401,104
2020-12-24,LP,Portugal,764,342,85,3,422,167,170,337,82
2020-12-25,LP,Portugal,533,301,39,0,232,99,94,193,39
2020-12-26,LP,Portugal,1122,631,85,4,491,202,204,406,81
2020-12-27,LP,Portugal,1072,525,89,3,547,233,225,458,86
2020-12-28,LP,Portugal,865,391,116,3,474,179,179,358,113
2020-12-29,LP,Portugal,725,359,95,3,366,132,139,271,92
2020-12-30,LP,Portugal,811,390,100,4,421,162,159,321,96
2020-12-31,LP,Portugal,661,316,78,2,345,132,135,267,76
2020-01-01,LR,Romania,1436,1140,8,0,296,141,147,288,8
2020-01-02,LR,Romania,1699,1267,27,0,432,203,202,405,27
2020-01-03,LR,Romania,1817,1317,63,0,500,217,220,437,63
2020-01-04,LR,Romania,1776,1364,31,0,412,192,189,381,31
2020-01-05,LR,Romania,1862,1373,41,2,489,222,226,448,39
2020-01-06,LR,Romania,1687,1210,71,2,477,199,207,406,69
2020-01-07,LR,Romania,1599,1133,68,4,466,200,198,398,64
2020-01-08,LR,Romania,1551,1067,69,6,484,205,210,415,63
2020-01-09,LR,Romania,1549,1113,76,7,436,184,176,360,69
2020-01-10,LR,Romania,1613,1097,77,0,516,215,224,439,77
2020-01-11,LR,Romania,1512,1129,31,0,383,181,171,352,31
2020-01-12,LR,Romania,1653,1189,42,0,464,213,209,422,42
2020-01-13,LR,Romania,1527,1032,86,8,495,203,206,409,78
2020-01-14,LR,Romania,1526,1083,64,4,443,192,187,379,60
2020-01-15,LR,Romania,1510,1041,62,0,469,190,217,407,62
2020-01-16,LR,Romania,1475,1052,69,0,423,184,170,354,69
2020-01-17,LR,Romania,1594,1093,64,1,501,218,219,437,63
2020-01-18,LR,Romania,1533,1174,33,2,359,166,160,326,31
2020-01-19,LR,Romania,1592,1151,47,0,441,193,201,394,47
2020-01-20,LR,Romania,1517,1033,77,13,484,203,204,407,64
2020-01-21,LR,Romania,1511,1070,82,13,441,183,176,359,69
2020-01-22,LR,Romania,1539,1063,94,10,476,188,194,382,84
2020-01-23,LR,Romania,1486,1043,82,8,443,184,177,361,74
2020-01-24,LR,Romania,1608,1133,64,1,475,205,206,411,63
2020-01-25,LR,Romania,1537,1163,31,1,374,174,169,343,30
2020-01-26,LR,Romania,1572,1136,42,0,436,193,201,394,42
2020-01-27,LR,Romania,1492,1020,69,7,472,198,205,403,62
2020-01-28,LR,Romania,1512,1048,78,5,464,194,192,386,73
2020-01-29,LR,Romania,1489,1014,78,10,475,201,196,397,68
2020-01-30,LR,Romania,1462,1036,76,6,426,178,172,350,70
2020-01-31,LR,Romania,1565,1068,74,7,497,208,215,423,67
2020-02-01,LR,Romania,1513,1137,31,2,376,176,169,345,29
2020-02-02,LR,Romania,1602,1171,43,2,431,190,198,388,41
2020-02-03,LR,Romania,1530,1049,77,10,481,203,201,404,67
2020-02-04,LR,Romania,1478,1023,72,6,455,190,193,383,66
2020-02-05,LR,Romania,1499,1030,71,4,469,198,200,398,67
2020-02-06,LR,Romania,1491,1089,58,3,402,176,168,344,55
2020-02-07,LR,Romania,1626,1105,83,11,521,218,220,438,72
2020-02-08,LR,Romania,1583,1216,31,1,367,170,166,336,30
2020-02-09,LR,Romania,1508,1077,51,2,431,187,193,380,49
2020-02-10,LR,Romania,1474,1007,76,7,467,193,198,391,69
2020-02-11,LR,Romania,1461,1021,69,10,440,190,181,371,59
2020-02-12,LR,Romania,1506,1021,82,12,485,197,206,403,70
2020-02-13,LR,Romania,1516,1082,79,11,434,183,172,355,68
2020-02-14,LR,Romania,1577,1074,75,5,503,212,216,428,70
2020-02-15,LR,Romania,1565,1192,32,1,373,174,167,341,31
2020-02-16,LR,Romania,1620,1196,40,0,424,190,194,384,40
2020-02-17,LR,Romania,1529,1043,81,8,486,199,206,405,73
2020-02-18,LR,Romania,1569,1085,87,13,484,199,198,397,74
2020-02-19,LR,Romania,1552,1079,85,8,473,190,198,388,77
2020-02-20,LR,Romania,1542,1105,77,4,437,185,175,360,73
2020-02-21,LR,Romania,1640,1122,78,7,518,221,219,440,71
2020-02-22,LR,Romania,1597,1224,34,3,373,171,168,339,31
2020-02-23,LR,Romania,1560,1121,42,0,439,193,204,397,42
2020-02-24,LR,Romania,1496,1020,75,2,476,200,201,401,73
2020-02-25,LR,Romania,1570,1096,88,13,474,196,190,386,75
2020-02-26,LR,Romania,1578,1098,80,13,480,196,204,400,67
2020-02-27,LR,Romania,1569,1131,86,11,438,180,172,352,75
2020-02-28,LR,Romania,1595,1085,80,8,510,213,217,430,72
2020-02-29,LR,Romania,1586,1211,30,1,375,176,169,345,29
2020-03-01,LR,Romania,1614,1180,43,0,434,194,197,391,43
2020-03-02,LR,Romania,1596,1087,85,9,509,210,214,424,76
2020-03-03,LR,Romania,1582,1123,73,9,459,193,193,386,64
2020-03-04,LR,Romania,1630,1164,76,10,466,194,196,390,66
2020-03-05,LR,Romania,1632,1189,80,5,443,184,179,363,75
2020-03-06,LR,Romania,1731,1209,86,11,522,219,217,436,75
2020-03-07,LR,Romania,1658,1285,38,3,373,170,165,335,35
2020-03-08,LR,Romania,1591,1197,45,2,394,172,177,349,43
2020-03-09,LR,Romania,1511,1086,71,1,425,175,179,354,70
2020-03-10,LR,Romania,1471,1079,73,7,392,159,160,319,66
2020-03-11,LR,Romania,1449,1061,81,8,388,156,151,307,73
2020-03-12,LR,Romania,1379,1020,80,8,359,140,139,279,72
2020-03-13,LR,Romania,1486,1060,78,9,426,173,175,348,69
2020-03-14,LR,Romania,1403,1099,32,2,304,140,132,272,30
2020-03-15,LR,Romania,1346,1033,41,0,313,136,136,272,41
2020-03-16,LR,Romania,1219,906,53,6,313,131,129,260,47
2020-03-17,LR,Romania,1071,772,60,11,299,119,120,239,49
2020-03-18,LR,Romania,1055,772,55,8,283,114,114,228,47
2020-03-19,LR,Romania,946,707,52,12,239,93,94,187,40
2020-03-20,LR,Romania,936,651,59,10,285,113,113,226,49
2020-03-21,LR,Romania,723,569,11,0,154,71,72,143,11
2020-03-22,LR,Romania,646,474,15,0,172,79,78,157,15
2020-03-23,LR,Romania,529,352,24,0,177,78,75,153,24
2020-03-24,LR,Romania,503,346,19,0,157,68,70,138,19
2020-03-25,LR,Romania,401,285,12,3,116,52,52,104,9
2020-03-26,LR,Romania,383,281,12,3,102,45,45,90,9
2020-03-27,LR,Romania,369,289,14,3,80,32,34,66,11
2020-03-28,LR,Romania,312,250,7,4,62,28,27,55,3
2020-03-29,LR,Romania,298,243,4,1,55,25,26,51,3
2020-03-30,LR,Romania,271,205,7,1,66,30,29,59,6
2020-03-31,LR,Romania,321,233,11,3,88,38,39,77,8
2020-04-01,LR,Romania,258,180,18,7,78,30,30,60,11
2020-04-02,LR,Romania,302,214,14,3,88,35,39,74,11
2020-04-03,LR,Romania,291,206,9,3,85,39,37,76,6
2020-04-04,LR,Romania,250,203,3,1,47,21,23,44,2
2020-04-05,LR,Romania,217,186,1,1,31,15,15,30,0
2020-04-06,LR,Romania,224,179,4,0,45,21,20,41,4
2020-04-07,LR,Romania,240,182,16,4,58,20,22,42,12
2020-04-08,LR,Romania,258,190,15,7,68,27,26,53,8
2020-04-09,LR,Romania,306,191,23,5,115,47,45,92,18
2020-04-10,LR,Romania,294,190,16,3,104,44,44,88,13
2020-04-11,LR,Romania,249,189,10,3,60,27,23,50,7
2020-04-12,LR,Romania,182,159,0,0,23,9,14,23,0
2020-04-13,LR,Romania,197,150,7,2,47,20,20,40,5
2020-04-14,LR,Romania,233,163,19,3,70,24,27,51,16
2020-04-15,LR,Romania,252,181,14,4,71,27,30,57,10
2020-04-16,LR,Romania,285,202,7,1,83,40,36,76,6
2020-04-17,LR,Romania,250,194,3,2,56,27,26,53,1
2020-04-18,LR,Romania,233,192,11,2,41,15,15,30,9
2020-04-19,LR,Romania,192,172,0,0,20,10,10,20,0
2020-04-20,LR,Romania,250,207,4,0,43,19,20,39,4
2020-04-21,LR,Romania,275,201,10,4,74,32,32,64,6
2020-04-22,LR,Romania,306,223,21,10,83,31,31,62,11
2020-04-23,LR,Romania,329,237,19,6,92,37,36,73,13
2020-04-24,LR,Romania,302,223,15,5,79,31,33,64,10
2020-04-25,LR,Romania,290,233,10,2,57,23,24,47,8
2020-04-26,LR,Romania,248,210,4,2,38,17,17,34,2
2020-04-27,LR,Romania,273,214,11,4,59,24,24,48,7
2020-04-28,LR,Romania,305,227,18,2,78,31,29,60,16
2020-04-29,LR,Romania,341,253,19,8,88,35,34,69,11
2020-04-30,LR,Romania,290,229,11,2,61,25,25,50,9
2020-05-01,LR,Romania,303,264,0,0,39,19,20,39,0
2020-05-02,LR,Romania,259,230,3,2,29,14,12,26,1
2020-05-03,LR,Romania,254,223,6,1,31,11,14,25,5
2020-05-04,LR,Romania,317,250,11,3,67,28,28,56,8
2020-05-05,LR,Romania,297,224,25,6,73,24,24,48,19
2020-05-06,LR,Romania,333,256,21,7,77,30,26,56,14
2020-05-07,LR,Romania,324,247,21,8,77,29,27,56,13
2020-05-08,LR,Romania,332,246,17,2,86,33,36,69,15
2020-05-09,LR,Romania,285,241,12,4,44,16,16,32,8
2020-05-10,LR,Romania,267,251,1,1,16,8,7,15,0
2020-05-11,LR,Romania,299,217,16,2,82,34,32,66,14
2020-05-12,LR,Romania,308,219,29,7,89,30,30,60,22
2020-05-13,LR,Romania,302,233,20,5,69,25,24,49,15
2020-05-14,LR,Romania,351,273,29,8,78,25,24,49,21
2020-05-15,LR,Romania,318,269,11,2,49,18,20,38,9
2020-05-16,LR,Romania,294,263,5,1,31,12,14,26,4
2020-05-17,LR,Romania,264,219,5,3,45,18,22,40,2
2020-05-18,LR,Romania,309,237,16,4,72,29,27,56,12
2020-05-19,LR,Romania,290,219,21,6,71,25,25,50,15
2020-05-20,LR,Romania,342,250,25,5,92,35,32,67,20
2020-05-21,LR,Romania,345,269,24,5,76,25,27,52,19
2020-05-22,LR,Romania,364,263,39,8,101,31,31,62,31
2020-05-23,LR,Romania,313,268,7,1,45,20,18,38,6
2020-05-24,LR,Romania,265,234,6,1,31,12,13,25,5
2020-05-25,LR,Romania,281,211,17,5,70,27,26,53,12
2020-05-26,LR,Romania,335,240,20,4,95,38,37,75,16
2020-05-27,LR,Romania,366,262,44,12,104,29,31,60,32
2020-05-28,LR,Romania,392,267,43,9,125,43,39,82,34
2020-05-29,LR,Romania,371,294,26,2,77,24,27,51,24
2020-05-30,LR,Romania,331,297,5,0,34,16,13,29,5
2020-05-31,LR,Romania,307,270,5,0,37,15,17,32,5
2020-06-01,LR,Romania,284,236,14,6,48,16,18,34,8
2020-06-02,LR,Romania,332,264,14,4,68,25,29,54,10
2020-06-03,LR,Romania,393,280,43,10,113,32,38,70,33
2020-06-04,LR,Romania,409,307,41,9,102,30,31,61,32
2020-06-05,LR,Romania,404,315,31,3,89,30,28,58,28
2020-06-06,LR,Romania,330,287,13,0,43,15,15,30,13
2020-06-07,LR,Romania,332,296,9,0,36,14,13,27,9
2020-06-08,LR,Romania,312,265,13,0,47,17,17,34,13
2020-06-09,LR,Romania,358,265,34,7,93,29,30,59,27
2020-06-10,LR,Romania,402,294,51,11,108,27,30,57,40
2020-06-11,LR,Romania,399,300,45,7,99,25,29,54,38
2020-06-12,LR,Romania,424,322,39,8,102,34,29,63,31
2020-06-13,LR,Romania,367,324,8,2,43,16,19,35,6
2020-06-14,LR,Romania,363,330,11,2,33,11,11,22,9
2020-06-15,LR,Romania,404,318,32,7,86,27,27,54,25
2020-06-16,LR,Romania,451,345,36,4,106,33,37,70,32
2020-06-17,LR,Romania,479,361,30,1,118,45,43,88,29
2020-06-18,LR,Romania,452,330,45,12,122,41,36,77,33
2020-06-19,LR,Romania,544,396,46,11,148,50,52,102,35
2020-06-20,LR,Romania,439,354,12,3,85,36,37,73,9
2020-06-21,LR,Romania,471,386,12,1,85,37,36,73,11
2020-06-22,LR,Romania,483,331,47,7,152,55,50,105,40
2020-06-23,LR,Romania,517,335,53,11,182,67,62,129,42
2020-06-24,LR,Romania,543,361,49,12,182,67,66,133,37
2020-06-25,LR,Romania,570,372,59,15,198,68,71,139,44
2020-06-26,LR,Romania,640,444,48,11,196,79,69,148,37
2020-06-27,LR,Romania,507,405,11,1,102,45,46,91,10
2020-06-28,LR,Romania,539,406,15,3,133,58,60,118,12
2020-06-29,LR,Romania,514,366,40,10,148,54,54,108,30
2020-06-30,LR,Romania,551,378,45,14,173,61,67,128,31
2020-07-01,LR,Romania,798,550,65,15,248,89,94,183,50
2020-07-02,LR,Romania,743,526,52,8,217,88,77,165,44
2020-07-03,LR,Romania,867,626,50,11,241,90,101,191,39
2020-07-04,LR,Romania,750,615,5,0,135,69,61,130,5
2020-07-05,LR,Romania,764,595,15,1,169,79,75,154,14
2020-07-06,LR,Romania,750,523,41,12,227,93,93,186,29
2020-07-07,LR,Romania,765,518,34,11,247,105,108,213,23
2020-07-08,LR,Romania,803,514,46,12,289,122,121,243,34
2020-07-09,LR,Romania,785,507,53,11,278,114,111,225,42
2020-07-10,LR,Romania,908,622,34,12,286,127,125,252,22
2020-07-11,LR,Romania,851,651,7,3,200,97,96,193,4
2020-07-12,LR,Romania,851,619,18,3,232,107,107,214,15
2020-07-13,LR,Romania,785,525,32,6,260,116,112,228,26
2020-07-14,LR,Romania,812,556,45,16,256,103,108,211,29
2020-07-15,LR,Romania,946,640,53,18,306,126,127,253,35
2020-07-16,LR,Romania,930,654,50,12,276,119,107,226,38
2020-07-17,LR,Romania,1024,726,54,8,298,121,123,244,46
2020-07-18,LR,Romania,949,745,5,0,204,101,98,199,5
2020-07-19,LR,Romania,924,696,15,0,228,103,110,213,15
2020-07-20,LR,Romania,906,625,30,3,281,124,127,251,27
2020-07-21,LR,Romania,890,611,42,6,279,115,122,237,36
2020-07-22,LR,Romania,898,628,44,11,270,114,112,226,33
2020-07-23,LR,Romania,976,679,54,3,297,123,120,243,51
2020-07-24,LR,Romania,1035,742,40,2,293,125,128,253,38
2020-07-25,LR,Romania,1009,812,8,0,197,97,92,189,8
2020-07-26,LR,Romania,973,742,18,1,231,103,110,213,17
2020-07-27,LR,Romania,904,637,40,5,267,118,109,227,35
2020-07-28,LR,Romania,917,645,43,6,272,111,118,229,37
2020-07-29,LR,Romania,927,661,41,6,266,113,112,225,35
2020-07-30,LR,Romania,955,672,48,9,283,119,116,235,39
2020-07-31,LR,Romania,1051,769,43,5,282,118,121,239,38
2020-08-01,LR,Romania,1128,886,13,0,242,114,115,229,13
2020-08-02,LR,Romania,1174,888,26,0,286,129,131,260,26
2020-08-03,LR,Romania,1025,723,39,1,302,131,132,263,38
2020-08-04,LR,Romania,1037,741,40,8,296,129,127,256,32
2020-08-05,LR,Romania,1106,785,46,11,321,137,138,275,35
2020-08-06,LR,Romania,1009,739,35,4,270,120,115,235,31
2020-08-07,LR,Romania,1240,908,54,7,332,138,140,278,47
2020-08-08,LR,Romania,1236,972,10,0,264,130,124,254,10
2020-08-09,LR,Romania,1178,901,23,1,277,123,131,254,22
2020-08-10,LR,Romania,1046,752,45,7,294,127,122,249,38
2020-08-11,LR,Romania,1009,750,36,10,259,108,115,223,26
2020-08-12,LR,Romania,1066,778,36,9,288,127,125,252,27
2020-08-13,LR,Romania,1074,798,42,5,276,116,118,234,37
2020-08-14,LR,Romania,1215,909,47,8,306,131,128,259,39
2020-08-15,LR,Romania,1270,1032,12,1,238,115,111,226,11
2020-08-16,LR,Romania,1178,912,24,2,266,119,123,242,22
2020-08-17,LR,Romania,1026,712,47,1,314,134,133,267,46
2020-08-18,LR,Romania,1018,744,41,8,274,115,118,233,33
2020-08-19,LR,Romania,1034,767,50,11,267,106,111,217,39
2020-08-20,LR,Romania,1062,788,45,8,274,114,115,229,37
2020-08-21,LR,Romania,1193,875,46,6,318,139,133,272,40
2020-08-22,LR,Romania,1233,980,19,1,253,116,118,234,18
2020-08-23,LR,Romania,1149,894,25,0,255,114,116,230,25
2020-08-24,LR,Romania,1053,730,44,4,323,142,137,279,40
2020-08-25,LR,Romania,1038,766,42,8,272,114,116,230,34
2020-08-26,LR,Romania,1063,789,55,5,274,108,111,219,50
2020-08-27,LR,Romania,1028,767,44,6,261,105,112,217,38
2020-08-28,LR,Romania,1171,858,37,4,313,142,134,276,33
2020-08-29,LR,Romania,1192,936,14,1,256,121,121,242,13
2020-08-30,LR,Romania,1196,920,21,0,276,124,131,255,21
2020-08-31,LR,Romania,1090,770,50,4,320,136,134,270,46
2020-09-01,LR,Romania,1013,730,34,2,283,122,127,249,32
2020-09-02,LR,Romania,1086,797,44,4,289,123,122,245,40
2020-09-03,LR,Romania,1004,726,51,3,278,113,114,227,48
2020-09-04,LR,Romania,1210,885,53,0,325,138,134,272,53
2020-09-05,LR,Romania,1191,948,10,1,243,117,116,233,9
2020-09-06,LR,Romania,1128,860,23,1,268,120,125,245,22
2020-09-07,LR,Romania,1053,722,57,3,331,139,135,274,54
2020-09-08,LR,Romania,954,685,40,2,269,112,117,229,38
2020-09-09,LR,Romania,1002,744,37,6,258,110,111,221,31
2020-09-10,LR,Romania,970,718,48,4,252,101,103,204,44
2020-09-11,LR,Romania,1171,843,56,4,328,140,132,272,52
2020-09-12,LR,Romania,1133,913,8,2,220,106,106,212,6
2020-09-13,LR,Romania,1096,834,24,1,262,118,120,238,23
2020-09-14,LR,Romania,976,681,56,5,295,120,119,239,51
2020-09-15,LR,Romania,926,665,37,11,261,106,118,224,26
2020-09-16,LR,Romania,1012,757,47,6,255,107,101,208,41
2020-09-17,LR,Romania,996,755,44,5,241,98,99,197,39
2020-09-18,LR,Romania,1195,853,73,7,342,138,131,269,66
2020-09-19,LR,Romania,1127,921,10,4,206,98,98,196,6
2020-09-20,LR,Romania,1111,849,26,1,262,115,121,236,25
2020-09-21,LR,Romania,1023,730,61,8,293,116,116,232,53
2020-09-22,LR,Romania,927,669,59,10,258,96,103,199,49
2020-09-23,LR,Romania,1006,764,53,6,242,95,94,189,47
2020-09-24,LR,Romania,936,727,46,8,209,81,82,163,38
2020-09-25,LR,Romania,1158,821,72,12,337,131,134,265,60
2020-09-26,LR,Romania,1102,894,13,0,208,100,95,195,13
2020-09-27,LR,Romania,1089,860,22,0,229,100,107,207,22
2020-09-28,LR,Romania,960,678,60,6,282,113,109,222,54
2020-09-29,LR,Romania,843,623,40,3,220,89,91,180,37
2020-09-30,LR,Romania,969,728,51,7,241,97,93,190,44
2020-10-01,LR,Romania,904,678,60,8,226,84,82,166,52
2020-10-02,LR,Romania,1021,724,58,6,297,121,118,239,52
2020-10-03,LR,Romania,1002,818,12,1,184,86,86,172,11
2020-10-04,LR,Romania,1039,813,27,1,226,99,100,199,26
2020-10-05,LR,Romania,904,640,53,4,264,106,105,211,49
2020-10-06,LR,Romania,762,536,42,2,226,89,95,184,40
2020-10-07,LR,Romania,907,672,57,6,235,90,88,178,51
2020-10-08,LR,Romania,877,663,44,6,214,84,86,170,38
2020-10-09,LR,Romania,1021,741,59,1,280,112,109,221,58
2020-10-10,LR,Romania,1047,858,16,2,189,88,85,173,14
2020-10-11,LR,Romania,959,749,26,1,210,89,95,184,25
2020-10-12,LR,Romania,872,595,62,9,277,107,108,215,53
2020-10-13,LR,Romania,703,516,30,4,187,78,79,157,26
2020-10-14,LR,Romania,871,642,64,12,229,83,82,165,52
2020-10-15,LR,Romania,830,610,59,8,220,81,80,161,51
2020-10-16,LR,Romania,973,675,69,10,298,116,113,229,59
2020-10-17,LR,Romania,987,806,11,1,181,86,84,170,10
2020-10-18,LR,Romania,940,727,26,1,213,92,95,187,25
2020-10-19,LR,Romania,826,570,56,6,256,101,99,200,50
2020-10-20,LR,Romania,725,525,40,7,200,79,81,160,33
2020-10-21,LR,Romania,849,654,49,9,195,75,71,146,40
2020-10-22,LR,Romania,833,622,45,6,211,84,82,166,39
2020-10-23,LR,Romania,959,669,55,7,290,117,118,235,48
2020-10-24,LR,Romania,941,767,14,1,174,80,80,160,13
2020-10-25,LR,Romania,940,712,34,5,228,94,100,194,29
2020-10-26,LR,Romania,847,596,59,5,251,95,97,192,54
2020-10-27,LR,Romania,678,480,46,2,198,75,77,152,44
2020-10-28,LR,Romania,814,590,50,6,224,84,90,174,44
2020-10-29,LR,Romania,798,590,50,5,208,80,78,158,45
2020-10-30,LR,Romania,890,612,47,3,278,118,113,231,44
2020-10-31,LR,Romania,866,713,8,1,153,73,72,145,7
2020-11-01,LR,Romania,909,683,24,0,226,100,102,202,24
2020-11-02,LR,Romania,688,507,45,3,181,69,67,136,42
2020-11-03,LR,Romania,586,416,52,10,170,58,60,118,42
2020-11-04,LR,Romania,775,588,52,6,187,67,68,135,46
2020-11-05,LR,Romania,716,547,59,6,169,51,59,110,53
2020-11-06,LR,Romania,811,585,53,6,226,89,84,173,47
2020-11-07,LR,Romania,761,629,10,1,132,65,57,122,9
2020-11-08,LR,Romania,788,601,21,1,187,80,86,166,20
2020-11-09,LR,Romania,654,499,45,4,155,55,55,110,41
2020-11-10,LR,Romania,589,473,33,3,116,41,42,83,30
2020-11-11,LR,Romania,665,514,39,4,151,55,57,112,35
2020-11-12,LR,Romania,687,533,63,6,154,46,45,91,57
2020-11-13,LR,Romania,719,538,43,7,181,71,67,138,36
2020-11-14,LR,Romania,681,585,13,1,96,45,38,83,12
2020-11-15,LR,Romania,739,588,21,2,151,64,66,130,19
2020-11-16,LR,Romania,626,501,48,4,125,39,38,77,44
2020-11-17,LR,Romania,527,417,45,1,110,30,35,65,44
2020-11-18,LR,Romania,646,514,35,2,132,50,47,97,33
2020-11-19,LR,Romania,674,520,46,11,154,54,54,108,35
2020-11-20,LR,Romania,669,499,47,3,170,64,59,123,44
2020-11-21,LR,Romania,592,530,11,1,62,25,26,51,10
2020-11-22,LR,Romania,658,527,23,2,131,51,57,108,21
2020-11-23,LR,Romania,589,458,47,6,131,41,43,84,41
2020-11-24,LR,Romania,536,419,42,5,117,36,39,75,37
2020-11-25,LR,Romania,610,473,37,4,137,53,47,100,33
2020-11-26,LR,Romania,597,465,47,8,132,42,43,85,39
2020-11-27,LR,Romania,684,492,53,9,192,69,70,139,44
2020-11-28,LR,Romania,625,541,16,0,84,39,29,68,16
2020-11-29,LR,Romania,660,524,16,0,136,57,63,120,16
2020-11-30,LR,Romania,553,471,25,0,82,28,29,57,25
2020-12-01,LR,Romania,507,417,19,1,90,34,37,71,18
2020-12-02,LR,Romania,630,487,31,8,143,56,56,112,23
2020-12-03,LR,Romania,610,472,40,6,138,50,48,98,34
2020-12-04,LR,Romania,743,548,47,3,195,74,74,148,44
2020-12-05,LR,Romania,675,575,20,6,100,40,40,80,14
2020-12-06,LR,Romania,712,557,22,1,155,64,69,133,21
2020-12-07,LR,Romania,595,440,43,2,155,56,56,112,41
2020-12-08,LR,Romania,544,429,22,0,115,43,50,93,22
2020-12-09,LR,Romania,669,485,35,0,184,76,73,149,35
2020-12-10,LR,Romania,649,480,35,2,169,68,66,134,33
2020-12-11,LR,Romania,780,557,37,4,223,94,92,186,33
2020-12-12,LR,Romania,732,593,14,2,139,64,61,125,12
2020-12-13,LR,Romania,739,577,22,1,162,68,72,140,21
2020-12-14,LR,Romania,673,493,42,3,180,66,72,138,39
2020-12-15,LR,Romania,658,493,44,9,165,61,60,121,35
2020-12-16,LR,Romania,751,546,45,11,205,79,81,160,34
2020-12-17,LR,Romania,871,600,57,9,271,110,104,214,48
2020-12-18,LR,Romania,1011,664,53,8,347,147,147,294,45
2020-12-19,LR,Romania,917,704,20,0,213,100,93,193,20
2020-12-20,LR,Romania,908,639,23,1,269,121,125,246,22
2020-12-21,LR,Romania,803,534,42,3,269,113,114,227,39
2020-12-22,LR,Romania,695,514,26,0,181,78,77,155,26
2020-12-23,LR,Romania,789,575,33,3,214,91,90,181,30
2020-12-24,LR,Romania,618,493,9,0,125,59,57,116,9
2020-12-25,LR,Romania,514,481,1,0,33,17,15,32,1
2020-12-26,LR,Romania,636,549,12,0,87,36,39,75,12
2020-12-27,LR,Romania,718,557,21,0,161,69,71,140,21
2020-12-28,LR,Romania,655,461,35,5,194,81,78,159,30
2020-12-29,LR,Romania,571,448,21,5,123,52,50,102,16
2020-12-30,LR,Romania,670,515,25,5,155,65,65,130,20
2020-12-31,LR,Romania,445,408,4,0,37,17,16,33,4
2020-01-01,LY,Serbia & Montenegro,1266,1111,8,0,155,76,71,147,8
2020-01-02,LY,Serbia & Montenegro,1573,1345,15,0,228,107,106,213,15
2020-01-03,LY,Serbia & Montenegro,1630,1409,17,0,221,103,101,204,17
2020-01-04,LY,Serbia & Montenegro,1779,1597,18,1,182,81,83,164,17
2020-01-05,LY,Serbia & Montenegro,1791,1578,19,3,213,99,95,194,16
2020-01-06,LY,Serbia & Montenegro,1596,1364,16,1,232,105,111,216,15
2020-01-07,LY,Serbia & Montenegro,1344,1158,19,1,186,82,85,167,18
2020-01-08,LY,Serbia & Montenegro,1473,1264,14,0,209,99,96,195,14
2020-01-09,LY,Serbia & Montenegro,1460,1257,15,0,203,93,95,188,15
2020-01-10,LY,Serbia & Montenegro,1604,1351,21,1,253,117,115,232,20
2020-01-11,LY,Serbia & Montenegro,1655,1475,15,1,180,81,84,165,14
2020-01-12,LY,Serbia & Montenegro,1667,1470,10,0,197,97,90,187,10
2020-01-13,LY,Serbia & Montenegro,1469,1267,21,0,202,84,97,181,21
2020-01-14,LY,Serbia & Montenegro,1302,1141,13,0,161,75,73,148,13
2020-01-15,LY,Serbia & Montenegro,1343,1202,11,0,141,71,59,130,11
2020-01-16,LY,Serbia & Montenegro,1378,1194,19,2,184,81,84,165,17
2020-01-17,LY,Serbia & Montenegro,1518,1296,16,1,222,100,106,206,15
2020-01-18,LY,Serbia & Montenegro,1548,1387,18,1,161,72,71,143,17
2020-01-19,LY,Serbia & Montenegro,1573,1374,14,1,199,93,92,185,13
2020-01-20,LY,Serbia & Montenegro,1426,1218,18,0,208,93,97,190,18
2020-01-21,LY,Serbia & Montenegro,1284,1086,17,1,198,89,92,181,16
2020-01-22,LY,Serbia & Montenegro,1375,1171,17,3,204,97,90,187,14
2020-01-23,LY,Serbia & Montenegro,1348,1144,24,5,204,88,92,180,19
2020-01-24,LY,Serbia & Montenegro,1491,1260,21,3,231,106,104,210,18
2020-01-25,LY,Serbia & Montenegro,1527,1378,20,3,149,64,65,129,17
2020-01-26,LY,Serbia & Montenegro,1554,1361,14,1,193,92,87,179,13
2020-01-27,LY,Serbia & Montenegro,1404,1187,16,0,217,96,105,201,16
2020-01-28,LY,Serbia & Montenegro,1300,1114,17,2,186,83,86,169,15
2020-01-29,LY,Serbia & Montenegro,1380,1177,19,3,203,94,90,184,16
2020-01-30,LY,Serbia & Montenegro,1326,1123,22,4,203,91,90,181,18
2020-01-31,LY,Serbia & Montenegro,1541,1292,25,4,249,113,111,224,21
2020-02-01,LY,Serbia & Montenegro,1544,1383,17,2,161,73,71,144,15
2020-02-02,LY,Serbia & Montenegro,1535,1335,15,1,200,95,90,185,14
2020-02-03,LY,Serbia & Montenegro,1350,1138,20,4,212,93,99,192,16
2020-02-04,LY,Serbia & Montenegro,1287,1102,18,1,185,82,85,167,17
2020-02-05,LY,Serbia & Montenegro,1287,1105,17,1,182,84,81,165,16
2020-02-06,LY,Serbia & Montenegro,1313,1116,19,4,197,90,88,178,15
2020-02-07,LY,Serbia & Montenegro,1517,1285,21,2,232,107,104,211,19
2020-02-08,LY,Serbia & Montenegro,1524,1371,17,1,153,66,70,136,16
2020-02-09,LY,Serbia & Montenegro,1545,1356,12,0,189,89,88,177,12
2020-02-10,LY,Serbia & Montenegro,1361,1159,17,2,202,91,94,185,15
2020-02-11,LY,Serbia & Montenegro,1264,1074,20,1,190,87,83,170,19
2020-02-12,LY,Serbia & Montenegro,1397,1184,22,8,213,95,96,191,14
2020-02-13,LY,Serbia & Montenegro,1403,1190,29,11,213,93,91,184,18
2020-02-14,LY,Serbia & Montenegro,1592,1358,21,1,234,107,106,213,20
2020-02-15,LY,Serbia & Montenegro,1561,1410,14,0,151,69,68,137,14
2020-02-16,LY,Serbia & Montenegro,1649,1451,13,1,198,92,93,185,12
2020-02-17,LY,Serbia & Montenegro,1466,1246,21,2,220,95,104,199,19
2020-02-18,LY,Serbia & Montenegro,1369,1159,27,7,210,90,93,183,20
2020-02-19,LY,Serbia & Montenegro,1464,1229,28,9,235,104,103,207,19
2020-02-20,LY,Serbia & Montenegro,1438,1236,22,7,202,90,90,180,15
2020-02-21,LY,Serbia & Montenegro,1612,1360,25,6,252,115,112,227,19
2020-02-22,LY,Serbia & Montenegro,1632,1469,14,0,163,71,78,149,14
2020-02-23,LY,Serbia & Montenegro,1676,1473,14,1,203,101,88,189,13
2020-02-24,LY,Serbia & Montenegro,1463,1230,20,3,233,100,113,213,17
2020-02-25,LY,Serbia & Montenegro,1318,1109,23,7,209,94,92,186,16
2020-02-26,LY,Serbia & Montenegro,1395,1191,23,8,204,91,90,181,15
2020-02-27,LY,Serbia & Montenegro,1381,1174,19,4,207,96,92,188,15
2020-02-28,LY,Serbia & Montenegro,1608,1375,19,0,233,106,108,214,19
2020-02-29,LY,Serbia & Montenegro,1627,1455,19,3,172,76,77,153,16
2020-03-01,LY,Serbia & Montenegro,1603,1401,16,1,202,95,91,186,15
2020-03-02,LY,Serbia & Montenegro,1490,1270,22,6,220,97,101,198,16
2020-03-03,LY,Serbia & Montenegro,1349,1160,16,0,189,86,87,173,16
2020-03-04,LY,Serbia & Montenegro,1383,1185,15,0,198,93,90,183,15
2020-03-05,LY,Serbia & Montenegro,1292,1087,24,6,205,91,90,181,18
2020-03-06,LY,Serbia & Montenegro,1463,1239,18,2,224,103,103,206,16
2020-03-07,LY,Serbia & Montenegro,1469,1326,13,0,143,66,64,130,13
2020-03-08,LY,Serbia & Montenegro,1476,1280,12,0,196,94,90,184,12
2020-03-09,LY,Serbia & Montenegro,1259,1057,18,2,202,87,97,184,16
2020-03-10,LY,Serbia & Montenegro,1193,1002,20,2,191,86,85,171,18
2020-03-11,LY,Serbia & Montenegro,1208,1016,25,8,192,84,83,167,17
2020-03-12,LY,Serbia & Montenegro,1202,1009,31,10,193,80,82,162,21
2020-03-13,LY,Serbia & Montenegro,1240,1023,24,7,217,96,97,193,17
2020-03-14,LY,Serbia & Montenegro,1264,1125,13,1,139,63,63,126,12
2020-03-15,LY,Serbia & Montenegro,1264,1089,15,1,175,81,79,160,14
2020-03-16,LY,Serbia & Montenegro,1069,911,9,1,158,70,79,149,8
2020-03-17,LY,Serbia & Montenegro,881,796,0,0,85,44,41,85,0
2020-03-18,LY,Serbia & Montenegro,902,818,5,1,84,40,39,79,4
2020-03-19,LY,Serbia & Montenegro,760,683,7,1,77,35,35,70,6
2020-03-20,LY,Serbia & Montenegro,763,722,3,3,41,18,20,38,0
2020-03-21,LY,Serbia & Montenegro,557,534,4,0,23,9,10,19,4
2020-03-22,LY,Serbia & Montenegro,422,397,1,0,25,12,12,24,1
2020-03-23,LY,Serbia & Montenegro,328,300,0,0,28,14,14,28,0
2020-03-24,LY,Serbia & Montenegro,280,250,0,0,30,15,15,30,0
2020-03-25,LY,Serbia & Montenegro,215,199,0,0,16,7,9,16,0
2020-03-26,LY,Serbia & Montenegro,227,195,3,0,32,16,13,29,3
2020-03-27,LY,Serbia & Montenegro,201,170,1,1,31,14,16,30,0
2020-03-28,LY,Serbia & Montenegro,185,172,1,1,13,6,6,12,0
2020-03-29,LY,Serbia & Montenegro,154,143,0,0,11,6,5,11,0
2020-03-30,LY,Serbia & Montenegro,151,128,0,0,23,12,11,23,0
2020-03-31,LY,Serbia & Montenegro,179,156,0,0,23,11,12,23,0
2020-04-01,LY,Serbia & Montenegro,196,170,2,0,26,13,11,24,2
2020-04-02,LY,Serbia & Montenegro,180,150,0,0,30,14,16,30,0
2020-04-03,LY,Serbia & Montenegro,200,155,1,0,45,23,21,44,1
2020-04-04,LY,Serbia & Montenegro,162,136,0,0,26,12,14,26,0
2020-04-05,LY,Serbia & Montenegro,148,140,0,0,8,4,4,8,0
2020-04-06,LY,Serbia & Montenegro,142,126,0,0,16,8,8,16,0
2020-04-07,LY,Serbia & Montenegro,129,116,0,0,13,6,7,13,0
2020-04-08,LY,Serbia & Montenegro,182,158,0,0,24,12,12,24,0
2020-04-09,LY,Serbia & Montenegro,195,153,4,0,42,19,19,38,4
2020-04-10,LY,Serbia & Montenegro,169,148,0,0,21,11,10,21,0
2020-04-11,LY,Serbia & Montenegro,136,129,0,0,7,4,3,7,0
2020-04-12,LY,Serbia & Montenegro,116,102,0,0,14,6,8,14,0
2020-04-13,LY,Serbia & Montenegro,161,134,1,1,27,13,13,26,0
2020-04-14,LY,Serbia & Montenegro,126,101,2,2,25,13,10,23,0
2020-04-15,LY,Serbia & Montenegro,178,151,4,2,27,11,12,23,2
2020-04-16,LY,Serbia & Montenegro,156,130,0,0,26,14,12,26,0
2020-04-17,LY,Serbia & Montenegro,161,139,1,0,22,12,9,21,1
2020-04-18,LY,Serbia & Montenegro,144,127,0,0,17,8,9,17,0
2020-04-19,LY,Serbia & Montenegro,115,111,0,0,4,2,2,4,0
2020-04-20,LY,Serbia & Montenegro,149,128,0,0,21,11,10,21,0
2020-04-21,LY,Serbia & Montenegro,155,136,1,1,19,8,10,18,0
2020-04-22,LY,Serbia & Montenegro,199,169,1,1,30,14,15,29,0
2020-04-23,LY,Serbia & Montenegro,199,164,2,1,35,17,16,33,1
2020-04-24,LY,Serbia & Montenegro,176,140,3,1,36,15,18,33,2
2020-04-25,LY,Serbia & Montenegro,157,141,0,0,16,9,7,16,0
2020-04-26,LY,Serbia & Montenegro,146,126,2,0,20,9,9,18,2
2020-04-27,LY,Serbia & Montenegro,166,142,4,2,24,10,10,20,2
2020-04-28,LY,Serbia & Montenegro,187,162,5,3,25,11,9,20,2
2020-04-29,LY,Serbia & Montenegro,205,184,0,0,21,9,12,21,0
2020-04-30,LY,Serbia & Montenegro,211,178,2,2,33,16,15,31,0
2020-05-01,LY,Serbia & Montenegro,201,181,0,0,20,10,10,20,0
2020-05-02,LY,Serbia & Montenegro,195,181,0,0,14,8,6,14,0
2020-05-03,LY,Serbia & Montenegro,171,160,1,1,11,3,7,10,0
2020-05-04,LY,Serbia & Montenegro,178,149,2,2,29,15,12,27,0
2020-05-05,LY,Serbia & Montenegro,191,167,4,0,24,9,11,20,4
2020-05-06,LY,Serbia & Montenegro,215,195,3,1,20,9,8,17,2
2020-05-07,LY,Serbia & Montenegro,219,194,7,2,25,9,9,18,5
2020-05-08,LY,Serbia & Montenegro,212,176,4,3,36,16,16,32,1
2020-05-09,LY,Serbia & Montenegro,195,174,0,0,21,11,10,21,0
2020-05-10,LY,Serbia & Montenegro,168,155,0,0,13,6,7,13,0
2020-05-11,LY,Serbia & Montenegro,191,166,5,5,25,10,10,20,0
2020-05-12,LY,Serbia & Montenegro,203,172,4,3,31,14,13,27,1
2020-05-13,LY,Serbia & Montenegro,217,180,7,6,37,15,15,30,1
2020-05-14,LY,Serbia & Montenegro,230,196,2,2,34,16,16,32,0
2020-05-15,LY,Serbia & Montenegro,226,182,6,2,44,19,19,38,4
2020-05-16,LY,Serbia & Montenegro,221,186,2,0,35,17,16,33,2
2020-05-17,LY,Serbia & Montenegro,199,184,0,0,15,7,8,15,0
2020-05-18,LY,Serbia & Montenegro,214,183,1,1,31,14,16,30,0
2020-05-19,LY,Serbia & Montenegro,214,181,4,2,33,15,14,29,2
2020-05-20,LY,Serbia & Montenegro,272,246,3,1,26,11,12,23,2
2020-05-21,LY,Serbia & Montenegro,266,214,11,5,52,20,21,41,6
2020-05-22,LY,Serbia & Montenegro,236,197,1,1,39,18,20,38,0
2020-05-23,LY,Serbia & Montenegro,249,210,1,0,39,19,19,38,1
2020-05-24,LY,Serbia & Montenegro,199,181,1,0,18,10,7,17,1
2020-05-25,LY,Serbia & Montenegro,202,173,6,2,29,11,12,23,4
2020-05-26,LY,Serbia & Montenegro,225,191,6,1,34,14,14,28,5
2020-05-27,LY,Serbia & Montenegro,264,212,6,1,52,22,24,46,5
2020-05-28,LY,Serbia & Montenegro,261,208,5,2,53,22,26,48,3
2020-05-29,LY,Serbia & Montenegro,229,182,5,3,47,22,20,42,2
2020-05-30,LY,Serbia & Montenegro,234,208,1,0,26,11,14,25,1
2020-05-31,LY,Serbia & Montenegro,212,188,0,0,24,12,12,24,0
2020-06-01,LY,Serbia & Montenegro,232,182,3,0,50,24,23,47,3
2020-06-02,LY,Serbia & Montenegro,224,188,1,0,36,18,17,35,1
2020-06-03,LY,Serbia & Montenegro,268,204,5,2,64,29,30,59,3
2020-06-04,LY,Serbia & Montenegro,283,218,9,5,65,28,28,56,4
2020-06-05,LY,Serbia & Montenegro,319,233,2,1,86,44,40,84,1
2020-06-06,LY,Serbia & Montenegro,267,228,2,0,39,19,18,37,2
2020-06-07,LY,Serbia & Montenegro,315,246,3,1,69,33,33,66,2
2020-06-08,LY,Serbia & Montenegro,269,213,2,2,56,28,26,54,0
2020-06-09,LY,Serbia & Montenegro,263,218,7,3,45,19,19,38,4
2020-06-10,LY,Serbia & Montenegro,321,260,3,2,61,29,29,58,1
2020-06-11,LY,Serbia & Montenegro,361,289,7,5,72,32,33,65,2
2020-06-12,LY,Serbia & Montenegro,351,257,10,5,94,38,46,84,5
2020-06-13,LY,Serbia & Montenegro,338,286,2,1,52,24,26,50,1
2020-06-14,LY,Serbia & Montenegro,367,304,3,1,63,31,29,60,2
2020-06-15,LY,Serbia & Montenegro,474,344,16,8,130,55,59,114,8
2020-06-16,LY,Serbia & Montenegro,377,291,7,1,86,42,37,79,6
2020-06-17,LY,Serbia & Montenegro,473,377,10,2,96,44,42,86,8
2020-06-18,LY,Serbia & Montenegro,444,357,9,3,87,38,40,78,6
2020-06-19,LY,Serbia & Montenegro,538,375,24,11,163,70,69,139,13
2020-06-20,LY,Serbia & Montenegro,459,393,10,0,66,28,28,56,10
2020-06-21,LY,Serbia & Montenegro,456,362,6,1,94,43,45,88,5
2020-06-22,LY,Serbia & Montenegro,477,359,6,3,118,60,52,112,3
2020-06-23,LY,Serbia & Montenegro,417,348,9,1,69,31,29,60,8
2020-06-24,LY,Serbia & Montenegro,503,401,13,8,102,42,47,89,5
2020-06-25,LY,Serbia & Montenegro,529,423,19,10,106,45,42,87,9
2020-06-26,LY,Serbia & Montenegro,627,492,11,5,135,62,62,124,6
2020-06-27,LY,Serbia & Montenegro,594,521,8,0,73,30,35,65,8
2020-06-28,LY,Serbia & Montenegro,611,528,4,1,83,38,41,79,3
2020-06-29,LY,Serbia & Montenegro,589,456,23,8,133,58,52,110,15
2020-06-30,LY,Serbia & Montenegro,535,453,16,6,82,35,31,66,10
2020-07-01,LY,Serbia & Montenegro,920,786,12,9,134,59,63,122,3
2020-07-02,LY,Serbia & Montenegro,1024,867,22,0,157,67,68,135,22
2020-07-03,LY,Serbia & Montenegro,1140,963,14,4,177,82,81,163,10
2020-07-04,LY,Serbia & Montenegro,1176,1040,18,2,136,57,61,118,16
2020-07-05,LY,Serbia & Montenegro,1111,950,18,3,161,74,69,143,15
2020-07-06,LY,Serbia & Montenegro,987,824,18,8,163,72,73,145,10
2020-07-07,LY,Serbia & Montenegro,888,768,15,5,120,51,54,105,10
2020-07-08,LY,Serbia & Montenegro,972,822,20,6,150,66,64,130,14
2020-07-09,LY,Serbia & Montenegro,1014,842,23,6,172,77,72,149,17
2020-07-10,LY,Serbia & Montenegro,1168,967,22,4,201,90,89,179,18
2020-07-11,LY,Serbia & Montenegro,1224,1083,21,1,141,57,63,120,20
2020-07-12,LY,Serbia & Montenegro,1111,957,13,0,154,74,67,141,13
2020-07-13,LY,Serbia & Montenegro,1038,863,15,5,175,78,82,160,10
2020-07-14,LY,Serbia & Montenegro,905,789,9,6,116,55,52,107,3
2020-07-15,LY,Serbia & Montenegro,1045,898,17,12,147,62,68,130,5
2020-07-16,LY,Serbia & Montenegro,1094,927,20,3,167,77,70,147,17
2020-07-17,LY,Serbia & Montenegro,1244,1076,24,6,168,72,72,144,18
2020-07-18,LY,Serbia & Montenegro,1419,1291,19,0,128,55,54,109,19
2020-07-19,LY,Serbia & Montenegro,1273,1127,14,1,146,68,64,132,13
2020-07-20,LY,Serbia & Montenegro,1104,951,28,10,153,60,65,125,18
2020-07-21,LY,Serbia & Montenegro,1040,942,14,8,98,42,42,84,6
2020-07-22,LY,Serbia & Montenegro,1113,1016,12,7,97,42,43,85,5
2020-07-23,LY,Serbia & Montenegro,1151,991,17,5,160,74,69,143,12
2020-07-24,LY,Serbia & Montenegro,1313,1154,21,9,159,68,70,138,12
2020-07-25,LY,Serbia & Montenegro,1558,1423,15,0,135,58,62,120,15
2020-07-26,LY,Serbia & Montenegro,1393,1233,23,2,160,70,67,137,21
2020-07-27,LY,Serbia & Montenegro,1133,992,14,4,141,61,66,127,10
2020-07-28,LY,Serbia & Montenegro,1091,990,6,4,101,47,48,95,2
2020-07-29,LY,Serbia & Montenegro,1172,1031,28,8,141,57,56,113,20
2020-07-30,LY,Serbia & Montenegro,1188,1017,29,8,171,70,72,142,21
2020-07-31,LY,Serbia & Montenegro,1398,1238,18,9,160,75,67,142,9
2020-08-01,LY,Serbia & Montenegro,1814,1668,16,0,146,62,68,130,16
2020-08-02,LY,Serbia & Montenegro,1653,1471,24,0,182,81,77,158,24
2020-08-03,LY,Serbia & Montenegro,1371,1208,19,2,163,69,75,144,17
2020-08-04,LY,Serbia & Montenegro,1291,1188,8,5,103,47,48,95,3
2020-08-05,LY,Serbia & Montenegro,1398,1273,12,3,125,56,57,113,9
2020-08-06,LY,Serbia & Montenegro,1361,1206,26,7,155,69,60,129,19
2020-08-07,LY,Serbia & Montenegro,1540,1353,30,8,187,81,76,157,22
2020-08-08,LY,Serbia & Montenegro,1793,1656,16,0,137,60,61,121,16
2020-08-09,LY,Serbia & Montenegro,1632,1484,13,0,148,67,68,135,13
2020-08-10,LY,Serbia & Montenegro,1447,1267,34,8,180,72,74,146,26
2020-08-11,LY,Serbia & Montenegro,1345,1232,25,10,113,45,43,88,15
2020-08-12,LY,Serbia & Montenegro,1383,1248,24,10,135,55,56,111,14
2020-08-13,LY,Serbia & Montenegro,1345,1193,27,9,152,60,65,125,18
2020-08-14,LY,Serbia & Montenegro,1530,1344,29,5,186,81,76,157,24
2020-08-15,LY,Serbia & Montenegro,1875,1721,12,0,154,73,69,142,12
2020-08-16,LY,Serbia & Montenegro,1672,1520,6,0,152,74,72,146,6
2020-08-17,LY,Serbia & Montenegro,1461,1299,15,1,162,71,76,147,14
2020-08-18,LY,Serbia & Montenegro,1312,1197,21,12,115,47,47,94,9
2020-08-19,LY,Serbia & Montenegro,1425,1284,26,4,141,56,59,115,22
2020-08-20,LY,Serbia & Montenegro,1391,1231,31,11,160,68,61,129,20
2020-08-21,LY,Serbia & Montenegro,1614,1412,35,11,202,83,84,167,24
2020-08-22,LY,Serbia & Montenegro,1876,1712,22,1,164,69,73,142,21
2020-08-23,LY,Serbia & Montenegro,1673,1497,31,0,176,76,69,145,31
2020-08-24,LY,Serbia & Montenegro,1443,1281,24,8,162,67,71,138,16
2020-08-25,LY,Serbia & Montenegro,1362,1233,18,1,129,56,55,111,17
2020-08-26,LY,Serbia & Montenegro,1433,1275,35,12,158,59,64,123,23
2020-08-27,LY,Serbia & Montenegro,1415,1253,34,12,162,65,63,128,22
2020-08-28,LY,Serbia & Montenegro,1645,1445,37,12,200,82,81,163,25
2020-08-29,LY,Serbia & Montenegro,1874,1710,29,3,164,65,70,135,26
2020-08-30,LY,Serbia & Montenegro,1658,1465,32,2,193,83,78,161,30
2020-08-31,LY,Serbia & Montenegro,1418,1237,29,4,181,74,78,152,25
2020-09-01,LY,Serbia & Montenegro,1351,1222,22,2,129,54,53,107,20
2020-09-02,LY,Serbia & Montenegro,1358,1234,21,4,124,51,52,103,17
2020-09-03,LY,Serbia & Montenegro,1331,1188,22,2,143,63,58,121,20
2020-09-04,LY,Serbia & Montenegro,1538,1354,32,4,184,74,78,152,28
2020-09-05,LY,Serbia & Montenegro,1822,1661,23,2,161,70,68,138,21
2020-09-06,LY,Serbia & Montenegro,1622,1443,28,0,179,76,75,151,28
2020-09-07,LY,Serbia & Montenegro,1379,1193,28,7,186,78,80,158,21
2020-09-08,LY,Serbia & Montenegro,1246,1114,32,5,132,51,49,100,27
2020-09-09,LY,Serbia & Montenegro,1334,1200,28,6,134,53,53,106,22
2020-09-10,LY,Serbia & Montenegro,1284,1150,27,5,134,55,52,107,22
2020-09-11,LY,Serbia & Montenegro,1530,1341,34,6,189,78,77,155,28
2020-09-12,LY,Serbia & Montenegro,1768,1625,23,0,143,58,62,120,23
2020-09-13,LY,Serbia & Montenegro,1592,1430,29,0,162,67,66,133,29
2020-09-14,LY,Serbia & Montenegro,1315,1136,37,6,179,70,72,142,31
2020-09-15,LY,Serbia & Montenegro,1183,1073,26,2,110,44,40,84,24
2020-09-16,LY,Serbia & Montenegro,1261,1108,28,5,153,59,66,125,23
2020-09-17,LY,Serbia & Montenegro,1175,1038,32,5,137,52,53,105,27
2020-09-18,LY,Serbia & Montenegro,1407,1220,33,4,187,78,76,154,29
2020-09-19,LY,Serbia & Montenegro,1698,1560,21,0,138,58,59,117,21
2020-09-20,LY,Serbia & Montenegro,1552,1380,24,0,172,74,74,148,24
2020-09-21,LY,Serbia & Montenegro,1224,1062,34,4,162,64,64,128,30
2020-09-22,LY,Serbia & Montenegro,1048,945,21,2,103,40,42,82,19
2020-09-23,LY,Serbia & Montenegro,1203,1067,19,1,136,62,55,117,18
2020-09-24,LY,Serbia & Montenegro,1092,974,24,5,118,48,46,94,19
2020-09-25,LY,Serbia & Montenegro,1368,1192,17,4,176,80,79,159,13
2020-09-26,LY,Serbia & Montenegro,1676,1541,16,0,135,59,60,119,16
2020-09-27,LY,Serbia & Montenegro,1465,1290,21,1,175,78,76,154,20
2020-09-28,LY,Serbia & Montenegro,1119,973,21,2,146,58,67,125,19
2020-09-29,LY,Serbia & Montenegro,1050,948,16,1,102,42,44,86,15
2020-09-30,LY,Serbia & Montenegro,1184,1048,28,11,136,58,50,108,17
2020-10-01,LY,Serbia & Montenegro,1038,928,16,2,110,47,47,94,14
2020-10-02,LY,Serbia & Montenegro,1359,1170,23,6,189,81,85,166,17
2020-10-03,LY,Serbia & Montenegro,1599,1465,15,1,134,61,58,119,14
2020-10-04,LY,Serbia & Montenegro,1397,1248,14,0,149,70,65,135,14
2020-10-05,LY,Serbia & Montenegro,1130,970,15,1,160,69,76,145,14
2020-10-06,LY,Serbia & Montenegro,956,861,22,9,95,39,34,73,13
2020-10-07,LY,Serbia & Montenegro,1025,895,21,8,130,52,57,109,13
2020-10-08,LY,Serbia & Montenegro,998,861,14,1,137,64,59,123,13
2020-10-09,LY,Serbia & Montenegro,1223,1042,19,5,181,79,83,162,14
2020-10-10,LY,Serbia & Montenegro,1612,1477,17,2,135,58,60,118,15
2020-10-11,LY,Serbia & Montenegro,1410,1249,19,2,161,70,72,142,17
2020-10-12,LY,Serbia & Montenegro,1082,930,15,2,152,69,68,137,13
2020-10-13,LY,Serbia & Montenegro,928,837,14,2,91,37,40,77,12
2020-10-14,LY,Serbia & Montenegro,1035,898,26,13,137,59,52,111,13
2020-10-15,LY,Serbia & Montenegro,730,614,14,6,116,50,52,102,8
2020-10-16,LY,Serbia & Montenegro,1385,1214,19,3,171,76,76,152,16
2020-10-17,LY,Serbia & Montenegro,1587,1476,12,0,111,50,49,99,12
2020-10-18,LY,Serbia & Montenegro,1329,1176,13,1,153,71,69,140,12
2020-10-19,LY,Serbia & Montenegro,1018,866,26,12,152,63,63,126,14
2020-10-20,LY,Serbia & Montenegro,846,748,21,11,98,38,39,77,10
2020-10-21,LY,Serbia & Montenegro,923,802,14,1,121,53,54,107,13
2020-10-22,LY,Serbia & Montenegro,911,781,27,11,130,53,50,103,16
2020-10-23,LY,Serbia & Montenegro,1174,996,24,13,178,75,79,154,11
2020-10-24,LY,Serbia & Montenegro,1548,1441,11,0,107,49,47,96,11
2020-10-25,LY,Serbia & Montenegro,1237,1102,16,0,135,61,58,119,16
2020-10-26,LY,Serbia & Montenegro,851,710,20,9,141,59,62,121,11
2020-10-27,LY,Serbia & Montenegro,718,636,13,1,82,33,36,69,12
2020-10-28,LY,Serbia & Montenegro,875,737,24,9,138,54,60,114,15
2020-10-29,LY,Serbia & Montenegro,820,705,14,3,115,52,49,101,11
2020-10-30,LY,Serbia & Montenegro,1081,924,24,10,157,69,64,133,14
2020-10-31,LY,Serbia & Montenegro,1270,1164,19,0,106,40,47,87,19
2020-11-01,LY,Serbia & Montenegro,1161,1021,23,2,140,59,58,117,21
2020-11-02,LY,Serbia & Montenegro,755,607,28,13,148,59,61,120,15
2020-11-03,LY,Serbia & Montenegro,643,538,25,14,105,43,37,80,11
2020-11-04,LY,Serbia & Montenegro,629,529,14,4,100,40,46,86,10
2020-11-05,LY,Serbia & Montenegro,674,563,12,0,111,49,50,99,12
2020-11-06,LY,Serbia & Montenegro,800,656,13,2,144,62,69,131,11
2020-11-07,LY,Serbia & Montenegro,822,718,10,0,104,50,44,94,10
2020-11-08,LY,Serbia & Montenegro,881,764,12,0,117,54,51,105,12
2020-11-09,LY,Serbia & Montenegro,616,498,11,0,118,51,56,107,11
2020-11-10,LY,Serbia & Montenegro,504,420,12,1,84,37,35,72,11
2020-11-11,LY,Serbia & Montenegro,581,485,10,0,96,42,44,86,10
2020-11-12,LY,Serbia & Montenegro,574,470,26,11,104,38,40,78,15
2020-11-13,LY,Serbia & Montenegro,673,548,15,2,125,58,52,110,13
2020-11-14,LY,Serbia & Montenegro,644,565,13,2,79,33,33,66,11
2020-11-15,LY,Serbia & Montenegro,701,589,18,1,112,48,46,94,17
2020-11-16,LY,Serbia & Montenegro,552,423,21,8,129,52,56,108,13
2020-11-17,LY,Serbia & Montenegro,434,379,7,0,55,21,27,48,7
2020-11-18,LY,Serbia & Montenegro,518,431,11,0,87,43,33,76,11
2020-11-19,LY,Serbia & Montenegro,502,421,11,3,81,35,35,70,8
2020-11-20,LY,Serbia & Montenegro,619,503,18,6,116,47,51,98,12
2020-11-21,LY,Serbia & Montenegro,543,487,10,0,56,21,25,46,10
2020-11-22,LY,Serbia & Montenegro,627,527,10,0,100,46,44,90,10
2020-11-23,LY,Serbia & Montenegro,491,366,17,5,125,57,51,108,12
2020-11-24,LY,Serbia & Montenegro,384,338,7,1,46,20,19,39,6
2020-11-25,LY,Serbia & Montenegro,511,434,15,3,77,29,33,62,12
2020-11-26,LY,Serbia & Montenegro,453,379,8,0,74,32,34,66,8
2020-11-27,LY,Serbia & Montenegro,643,525,13,3,118,52,53,105,10
2020-11-28,LY,Serbia & Montenegro,524,461,13,0,63,24,26,50,13
2020-11-29,LY,Serbia & Montenegro,584,505,10,0,79,35,34,69,10
2020-11-30,LY,Serbia & Montenegro,478,368,18,5,110,45,47,92,13
2020-12-01,LY,Serbia & Montenegro,399,332,18,9,67,27,22,49,9
2020-12-02,LY,Serbia & Montenegro,503,429,14,8,74,32,28,60,6
2020-12-03,LY,Serbia & Montenegro,538,458,12,4,80,32,36,68,8
2020-12-04,LY,Serbia & Montenegro,635,519,11,2,116,52,53,105,9
2020-12-05,LY,Serbia & Montenegro,587,536,8,0,51,22,21,43,8
2020-12-06,LY,Serbia & Montenegro,626,538,6,0,88,41,41,82,6
2020-12-07,LY,Serbia & Montenegro,536,426,10,1,110,51,49,100,9
2020-12-08,LY,Serbia & Montenegro,411,355,11,0,56,22,23,45,11
2020-12-09,LY,Serbia & Montenegro,522,459,8,2,63,29,26,55,6
2020-12-10,LY,Serbia & Montenegro,568,490,16,6,78,30,32,62,10
2020-12-11,LY,Serbia & Montenegro,696,555,10,0,141,67,64,131,10
2020-12-12,LY,Serbia & Montenegro,675,611,8,0,64,27,29,56,8
2020-12-13,LY,Serbia & Montenegro,678,587,7,0,91,45,39,84,7
2020-12-14,LY,Serbia & Montenegro,617,504,12,1,113,46,55,101,11
2020-12-15,LY,Serbia & Montenegro,519,448,10,1,71,35,26,61,9
2020-12-16,LY,Serbia & Montenegro,612,543,13,4,69,27,29,56,9
2020-12-17,LY,Serbia & Montenegro,748,653,10,1,95,43,42,85,9
2020-12-18,LY,Serbia & Montenegro,955,801,18,4,154,66,70,136,14
2020-12-19,LY,Serbia & Montenegro,1040,930,12,1,110,46,52,98,11
2020-12-20,LY,Serbia & Montenegro,958,841,10,0,117,57,50,107,10
2020-12-21,LY,Serbia & Montenegro,707,584,12,2,123,56,55,111,10
2020-12-22,LY,Serbia & Montenegro,656,561,10,4,95,42,43,85,6
2020-12-23,LY,Serbia & Montenegro,771,651,13,4,120,55,52,107,9
2020-12-24,LY,Serbia & Montenegro,695,599,8,2,96,41,47,88,6
2020-12-25,LY,Serbia & Montenegro,532,432,14,1,100,43,43,86,13
2020-12-26,LY,Serbia & Montenegro,695,637,7,0,58,25,26,51,7
2020-12-27,LY,Serbia & Montenegro,780,681,5,0,99,50,44,94,5
2020-12-28,LY,Serbia & Montenegro,646,532,9,3,114,53,52,105,6
2020-12-29,LY,Serbia & Montenegro,488,421,7,1,67,29,31,60,6
2020-12-30,LY,Serbia & Montenegro,658,562,8,3,96,44,44,88,5
2020-12-31,LY,Serbia & Montenegro,443,389,8,0,54,22,24,46,8
2020-01-01,LZ,Slovakia,962,924,1,1,38,18,19,37,0
2020-01-02,LZ,Slovakia,1210,1153,4,0,57,26,27,53,4
2020-01-03,LZ,Slovakia,1231,1162,3,0,69,33,33,66,3
2020-01-04,LZ,Slovakia,1207,1163,5,0,44,21,18,39,5
2020-01-05,LZ,Slovakia,1175,1119,0,0,56,28,28,56,0
2020-01-06,LZ,Slovakia,1117,1053,1,1,64,32,31,63,0
2020-01-07,LZ,Slovakia,999,941,3,2,58,23,32,55,1
2020-01-08,LZ,Slovakia,985,921,2,0,64,32,30,62,2
2020-01-09,LZ,Slovakia,1033,973,0,0,60,29,31,60,0
2020-01-10,LZ,Slovakia,1079,1002,2,2,77,38,37,75,0
2020-01-11,LZ,Slovakia,1031,989,1,1,42,19,22,41,0
2020-01-12,LZ,Slovakia,1065,1010,2,1,55,26,27,53,1
2020-01-13,LZ,Slovakia,1004,928,2,0,76,42,32,74,2
2020-01-14,LZ,Slovakia,927,886,2,1,41,18,21,39,1
2020-01-15,LZ,Slovakia,985,917,4,1,68,32,32,64,3
2020-01-16,LZ,Slovakia,991,903,7,2,88,40,41,81,5
2020-01-17,LZ,Slovakia,1054,969,7,0,85,37,41,78,7
2020-01-18,LZ,Slovakia,990,950,2,0,40,22,16,38,2
2020-01-19,LZ,Slovakia,1031,962,2,0,69,30,37,67,2
2020-01-20,LZ,Slovakia,991,922,6,1,69,35,28,63,5
2020-01-21,LZ,Slovakia,933,875,5,3,58,27,26,53,2
2020-01-22,LZ,Slovakia,979,903,7,4,76,29,40,69,3
2020-01-23,LZ,Slovakia,1010,921,17,10,89,39,33,72,7
2020-01-24,LZ,Slovakia,1066,971,9,1,95,43,43,86,8
2020-01-25,LZ,Slovakia,944,907,0,0,37,18,19,37,0
2020-01-26,LZ,Slovakia,1036,982,1,0,54,25,28,53,1
2020-01-27,LZ,Slovakia,960,883,3,0,77,39,35,74,3
2020-01-28,LZ,Slovakia,945,891,8,7,54,19,27,46,1
2020-01-29,LZ,Slovakia,989,917,12,6,72,32,28,60,6
2020-01-30,LZ,Slovakia,939,868,9,3,71,33,29,62,6
2020-01-31,LZ,Slovakia,1063,981,5,1,82,39,38,77,4
2020-02-01,LZ,Slovakia,992,944,4,2,48,22,22,44,2
2020-02-02,LZ,Slovakia,1068,1006,3,0,62,26,33,59,3
2020-02-03,LZ,Slovakia,1018,946,2,1,72,38,32,70,1
2020-02-04,LZ,Slovakia,956,902,2,0,54,26,26,52,2
2020-02-05,LZ,Slovakia,906,844,6,2,62,28,28,56,4
2020-02-06,LZ,Slovakia,975,900,10,4,75,33,32,65,6
2020-02-07,LZ,Slovakia,1065,985,4,0,80,38,38,76,4
2020-02-08,LZ,Slovakia,1026,980,4,2,46,23,19,42,2
2020-02-09,LZ,Slovakia,954,896,2,2,58,26,30,56,0
2020-02-10,LZ,Slovakia,976,920,1,0,56,28,27,55,1
2020-02-11,LZ,Slovakia,929,881,2,1,48,23,23,46,1
2020-02-12,LZ,Slovakia,957,884,8,2,73,29,36,65,6
2020-02-13,LZ,Slovakia,979,899,8,2,80,37,35,72,6
2020-02-14,LZ,Slovakia,1083,989,9,4,94,42,43,85,5
2020-02-15,LZ,Slovakia,1021,958,5,3,63,31,27,58,2
2020-02-16,LZ,Slovakia,1038,983,1,0,55,28,26,54,1
2020-02-17,LZ,Slovakia,1010,942,7,3,68,33,28,61,4
2020-02-18,LZ,Slovakia,951,880,14,6,71,24,33,57,8
2020-02-19,LZ,Slovakia,975,899,16,6,76,29,31,60,10
2020-02-20,LZ,Slovakia,1007,927,12,5,80,34,34,68,7
2020-02-21,LZ,Slovakia,1079,990,4,1,89,44,41,85,3
2020-02-22,LZ,Slovakia,1061,1013,0,0,48,24,24,48,0
2020-02-23,LZ,Slovakia,1062,998,2,0,64,30,32,62,2
2020-02-24,LZ,Slovakia,1033,958,7,0,75,36,32,68,7
2020-02-25,LZ,Slovakia,980,907,12,2,73,29,32,61,10
2020-02-26,LZ,Slovakia,1012,927,9,8,85,36,40,76,1
2020-02-27,LZ,Slovakia,963,896,11,5,67,27,29,56,6
2020-02-28,LZ,Slovakia,1060,979,1,0,81,41,39,80,1
2020-02-29,LZ,Slovakia,1005,964,1,1,41,21,19,40,0
2020-03-01,LZ,Slovakia,1006,948,3,0,58,27,28,55,3
2020-03-02,LZ,Slovakia,998,932,5,1,66,32,29,61,4
2020-03-03,LZ,Slovakia,945,881,11,6,64,25,28,53,5
2020-03-04,LZ,Slovakia,1015,944,8,4,71,31,32,63,4
2020-03-05,LZ,Slovakia,982,911,9,3,71,32,30,62,6
2020-03-06,LZ,Slovakia,1059,978,0,0,81,39,42,81,0
2020-03-07,LZ,Slovakia,1002,961,0,0,41,22,19,41,0
2020-03-08,LZ,Slovakia,982,925,2,2,57,27,28,55,0
2020-03-09,LZ,Slovakia,969,888,11,4,81,36,34,70,7
2020-03-10,LZ,Slovakia,938,860,20,9,78,27,31,58,11
2020-03-11,LZ,Slovakia,906,833,13,5,73,26,34,60,8
2020-03-12,LZ,Slovakia,908,830,4,0,78,40,34,74,4
2020-03-13,LZ,Slovakia,881,868,0,0,13,10,3,13,0
2020-03-14,LZ,Slovakia,815,812,0,0,3,1,2,3,0
2020-03-15,LZ,Slovakia,765,763,0,0,2,1,1,2,0
2020-03-16,LZ,Slovakia,697,684,0,0,13,6,7,13,0
2020-03-17,LZ,Slovakia,598,576,1,0,22,9,12,21,1
2020-03-18,LZ,Slovakia,593,573,2,0,20,10,8,18,2
2020-03-19,LZ,Slovakia,547,529,1,0,18,7,10,17,1
2020-03-20,LZ,Slovakia,532,514,0,0,18,10,8,18,0
2020-03-21,LZ,Slovakia,447,432,0,0,15,7,8,15,0
2020-03-22,LZ,Slovakia,360,356,0,0,4,2,2,4,0
2020-03-23,LZ,Slovakia,314,295,0,0,19,10,9,19,0
2020-03-24,LZ,Slovakia,290,275,0,0,15,7,8,15,0
2020-03-25,LZ,Slovakia,243,221,0,0,22,10,12,22,0
2020-03-26,LZ,Slovakia,239,222,2,0,17,8,7,15,2
2020-03-27,LZ,Slovakia,223,206,0,0,17,9,8,17,0
2020-03-28,LZ,Slovakia,184,178,0,0,6,3,3,6,0
2020-03-29,LZ,Slovakia,175,164,0,0,11,5,6,11,0
2020-03-30,LZ,Slovakia,188,175,0,0,13,7,6,13,0
2020-03-31,LZ,Slovakia,192,175,2,2,17,7,8,15,0
2020-04-01,LZ,Slovakia,160,148,1,1,12,6,5,11,0
2020-04-02,LZ,Slovakia,205,187,4,3,18,7,7,14,1
2020-04-03,LZ,Slovakia,237,227,2,0,10,5,3,8,2
2020-04-04,LZ,Slovakia,175,175,0,0,0,0,0,0,0
2020-04-05,LZ,Slovakia,151,148,0,0,3,1,2,3,0
2020-04-06,LZ,Slovakia,178,166,2,0,12,7,3,10,2
2020-04-07,LZ,Slovakia,170,157,1,1,13,5,7,12,0
2020-04-08,LZ,Slovakia,184,165,3,2,19,5,11,16,1
2020-04-09,LZ,Slovakia,208,196,1,0,12,6,5,11,1
2020-04-10,LZ,Slovakia,196,190,0,0,6,3,3,6,0
2020-04-11,LZ,Slovakia,176,168,0,0,8,1,7,8,0
2020-04-12,LZ,Slovakia,118,118,0,0,0,0,0,0,0
2020-04-13,LZ,Slovakia,130,124,0,0,6,3,3,6,0
2020-04-14,LZ,Slovakia,154,130,4,1,24,8,12,20,3
2020-04-15,LZ,Slovakia,190,166,3,1,24,11,10,21,2
2020-04-16,LZ,Slovakia,190,167,8,0,23,8,7,15,8
2020-04-17,LZ,Slovakia,173,159,2,2,14,5,7,12,0
2020-04-18,LZ,Slovakia,141,138,0,0,3,1,2,3,0
2020-04-19,LZ,Slovakia,117,113,0,0,4,2,2,4,0
2020-04-20,LZ,Slovakia,180,158,6,2,22,7,9,16,4
2020-04-21,LZ,Slovakia,198,168,8,4,30,10,12,22,4
2020-04-22,LZ,Slovakia,193,177,4,4,16,6,6,12,0
2020-04-23,LZ,Slovakia,192,173,2,2,19,8,9,17,0
2020-04-24,LZ,Slovakia,191,178,1,1,13,6,6,12,0
2020-04-25,LZ,Slovakia,156,154,1,1,2,1,0,1,0
2020-04-26,LZ,Slovakia,164,156,0,0,8,3,5,8,0
2020-04-27,LZ,Slovakia,184,166,6,0,18,7,5,12,6
2020-04-28,LZ,Slovakia,198,176,9,4,22,6,7,13,5
2020-04-29,LZ,Slovakia,202,187,5,2,15,5,5,10,3
2020-04-30,LZ,Slovakia,158,143,4,2,15,6,5,11,2
2020-05-01,LZ,Slovakia,204,199,0,0,5,2,3,5,0
2020-05-02,LZ,Slovakia,150,146,0,0,4,2,2,4,0
2020-05-03,LZ,Slovakia,151,150,0,0,1,0,1,1,0
2020-05-04,LZ,Slovakia,207,193,3,0,14,6,5,11,3
2020-05-05,LZ,Slovakia,209,200,0,0,9,4,5,9,0
2020-05-06,LZ,Slovakia,229,211,1,0,18,8,9,17,1
2020-05-07,LZ,Slovakia,216,190,7,0,26,10,9,19,7
2020-05-08,LZ,Slovakia,207,198,0,0,9,4,5,9,0
2020-05-09,LZ,Slovakia,174,172,1,1,2,1,0,1,0
2020-05-10,LZ,Slovakia,164,160,0,0,4,2,2,4,0
2020-05-11,LZ,Slovakia,182,174,1,0,8,3,4,7,1
2020-05-12,LZ,Slovakia,183,166,4,4,17,6,7,13,0
2020-05-13,LZ,Slovakia,211,191,5,2,20,7,8,15,3
2020-05-14,LZ,Slovakia,220,195,9,3,25,9,7,16,6
2020-05-15,LZ,Slovakia,216,198,3,1,18,8,7,15,2
2020-05-16,LZ,Slovakia,220,214,3,3,6,1,2,3,0
2020-05-17,LZ,Slovakia,169,165,1,1,4,1,2,3,0
2020-05-18,LZ,Slovakia,215,200,7,5,15,4,4,8,2
2020-05-19,LZ,Slovakia,202,173,11,7,29,9,9,18,4
2020-05-20,LZ,Slovakia,212,192,9,7,20,6,5,11,2
2020-05-21,LZ,Slovakia,209,185,9,6,24,8,7,15,3
2020-05-22,LZ,Slovakia,231,201,10,3,30,11,9,20,7
2020-05-23,LZ,Slovakia,203,200,1,0,3,1,1,2,1
2020-05-24,LZ,Slovakia,162,157,0,0,5,2,3,5,0
2020-05-25,LZ,Slovakia,186,170,6,2,16,5,5,10,4
2020-05-26,LZ,Slovakia,203,181,0,0,22,11,11,22,0
2020-05-27,LZ,Slovakia,229,207,7,5,22,8,7,15,2
2020-05-28,LZ,Slovakia,233,213,7,3,20,6,7,13,4
2020-05-29,LZ,Slovakia,219,202,5,2,17,7,5,12,3
2020-05-30,LZ,Slovakia,187,182,0,0,5,3,2,5,0
2020-05-31,LZ,Slovakia,172,168,0,0,4,1,3,4,0
2020-06-01,LZ,Slovakia,181,165,5,2,16,7,4,11,3
2020-06-02,LZ,Slovakia,219,194,9,9,25,7,9,16,0
2020-06-03,LZ,Slovakia,253,222,7,7,31,11,13,24,0
2020-06-04,LZ,Slovakia,251,222,13,6,29,7,9,16,7
2020-06-05,LZ,Slovakia,256,233,3,1,23,12,8,20,2
2020-06-06,LZ,Slovakia,218,213,0,0,5,2,3,5,0
2020-06-07,LZ,Slovakia,200,189,2,0,11,3,6,9,2
2020-06-08,LZ,Slovakia,214,199,3,0,15,7,5,12,3
2020-06-09,LZ,Slovakia,225,207,5,5,18,5,8,13,0
2020-06-10,LZ,Slovakia,252,229,7,3,23,10,6,16,4
2020-06-11,LZ,Slovakia,268,232,13,9,36,11,12,23,4
2020-06-12,LZ,Slovakia,268,238,8,4,30,13,9,22,4
2020-06-13,LZ,Slovakia,241,241,0,0,0,0,0,0,0
2020-06-14,LZ,Slovakia,256,247,1,0,9,2,6,8,1
2020-06-15,LZ,Slovakia,305,271,2,2,34,14,18,32,0
2020-06-16,LZ,Slovakia,299,263,9,3,36,12,15,27,6
2020-06-17,LZ,Slovakia,345,310,10,8,35,13,12,25,2
2020-06-18,LZ,Slovakia,288,249,8,2,39,16,15,31,6
2020-06-19,LZ,Slovakia,338,303,5,2,35,15,15,30,3
2020-06-20,LZ,Slovakia,308,296,1,0,12,6,5,11,1
2020-06-21,LZ,Slovakia,299,279,1,0,20,10,9,19,1
2020-06-22,LZ,Slovakia,326,293,4,1,33,14,15,29,3
2020-06-23,LZ,Slovakia,319,287,6,4,32,11,15,26,2
2020-06-24,LZ,Slovakia,365,315,10,3,50,21,19,40,7
2020-06-25,LZ,Slovakia,352,313,10,2,39,15,14,29,8
2020-06-26,LZ,Slovakia,437,393,4,1,44,21,19,40,3
2020-06-27,LZ,Slovakia,354,342,2,2,12,6,4,10,0
2020-06-28,LZ,Slovakia,366,347,0,0,19,9,10,19,0
2020-06-29,LZ,Slovakia,360,331,6,0,29,11,12,23,6
2020-06-30,LZ,Slovakia,385,340,12,6,45,13,20,33,6
2020-07-01,LZ,Slovakia,535,498,3,3,37,18,16,34,0
2020-07-02,LZ,Slovakia,493,451,4,1,42,20,18,38,3
2020-07-03,LZ,Slovakia,588,545,3,1,43,20,20,40,2
2020-07-04,LZ,Slovakia,557,536,1,1,21,11,9,20,0
2020-07-05,LZ,Slovakia,499,483,0,0,16,5,11,16,0
2020-07-06,LZ,Slovakia,511,466,3,1,45,24,18,42,2
2020-07-07,LZ,Slovakia,529,473,10,5,56,23,23,46,5
2020-07-08,LZ,Slovakia,537,492,5,3,45,17,23,40,2
2020-07-09,LZ,Slovakia,514,470,6,4,44,18,20,38,2
2020-07-10,LZ,Slovakia,629,582,8,3,47,23,16,39,5
2020-07-11,LZ,Slovakia,615,590,0,0,25,12,13,25,0
2020-07-12,LZ,Slovakia,595,565,2,1,30,10,18,28,1
2020-07-13,LZ,Slovakia,545,511,7,5,34,14,13,27,2
2020-07-14,LZ,Slovakia,543,502,9,2,41,16,16,32,7
2020-07-15,LZ,Slovakia,593,540,6,1,53,22,25,47,5
2020-07-16,LZ,Slovakia,632,583,3,1,49,24,22,46,2
2020-07-17,LZ,Slovakia,742,690,6,3,52,23,23,46,3
2020-07-18,LZ,Slovakia,685,653,1,0,32,15,16,31,1
2020-07-19,LZ,Slovakia,651,625,1,0,26,12,13,25,1
2020-07-20,LZ,Slovakia,643,599,8,2,44,19,17,36,6
2020-07-21,LZ,Slovakia,608,565,5,1,43,19,19,38,4
2020-07-22,LZ,Slovakia,589,530,5,3,59,26,28,54,2
2020-07-23,LZ,Slovakia,631,580,5,1,51,24,22,46,4
2020-07-24,LZ,Slovakia,705,665,4,4,40,18,18,36,0
2020-07-25,LZ,Slovakia,689,638,1,1,51,24,26,50,0
2020-07-26,LZ,Slovakia,689,651,4,1,38,17,17,34,3
2020-07-27,LZ,Slovakia,630,575,10,8,55,25,20,45,2
2020-07-28,LZ,Slovakia,588,543,17,5,45,15,13,28,12
2020-07-29,LZ,Slovakia,590,533,7,4,57,24,26,50,3
2020-07-30,LZ,Slovakia,638,584,7,0,54,24,23,47,7
2020-07-31,LZ,Slovakia,721,683,5,3,38,17,16,33,2
2020-08-01,LZ,Slovakia,758,717,0,0,41,21,20,41,0
2020-08-02,LZ,Slovakia,779,728,1,1,51,22,28,50,0
2020-08-03,LZ,Slovakia,717,667,4,2,50,25,21,46,2
2020-08-04,LZ,Slovakia,693,649,7,2,44,16,21,37,5
2020-08-05,LZ,Slovakia,663,612,5,2,51,25,21,46,3
2020-08-06,LZ,Slovakia,643,593,6,1,50,22,22,44,5
2020-08-07,LZ,Slovakia,776,723,7,1,53,21,25,46,6
2020-08-08,LZ,Slovakia,840,793,1,1,47,23,23,46,0
2020-08-09,LZ,Slovakia,777,738,3,1,39,18,18,36,2
2020-08-10,LZ,Slovakia,730,684,2,1,46,23,21,44,1
2020-08-11,LZ,Slovakia,679,620,3,2,59,29,27,56,1
2020-08-12,LZ,Slovakia,668,610,8,2,58,23,27,50,6
2020-08-13,LZ,Slovakia,751,690,9,1,61,29,23,52,8
2020-08-14,LZ,Slovakia,789,727,4,2,62,26,32,58,2
2020-08-15,LZ,Slovakia,835,778,4,1,57,25,28,53,3
2020-08-16,LZ,Slovakia,795,741,4,1,54,26,24,50,3
2020-08-17,LZ,Slovakia,722,668,4,2,54,27,23,50,2
2020-08-18,LZ,Slovakia,631,588,3,3,43,19,21,40,0
2020-08-19,LZ,Slovakia,667,608,8,5,59,25,26,51,3
2020-08-20,LZ,Slovakia,646,590,7,3,56,25,24,49,4
2020-08-21,LZ,Slovakia,797,733,5,0,64,30,29,59,5
2020-08-22,LZ,Slovakia,846,796,1,0,50,24,25,49,1
2020-08-23,LZ,Slovakia,770,711,1,0,59,27,31,58,1
2020-08-24,LZ,Slovakia,634,578,4,2,56,24,28,52,2
2020-08-25,LZ,Slovakia,645,588,4,0,57,28,25,53,4
2020-08-26,LZ,Slovakia,662,587,9,1,75,35,31,66,8
2020-08-27,LZ,Slovakia,644,579,8,2,65,30,27,57,6
2020-08-28,LZ,Slovakia,793,729,4,0,64,27,33,60,4
2020-08-29,LZ,Slovakia,829,773,4,2,56,26,26,52,2
2020-08-30,LZ,Slovakia,812,763,1,0,49,24,24,48,1
2020-08-31,LZ,Slovakia,741,666,0,0,75,36,39,75,0
2020-09-01,LZ,Slovakia,638,602,2,0,36,17,17,34,2
2020-09-02,LZ,Slovakia,644,592,9,1,52,22,21,43,8
2020-09-03,LZ,Slovakia,625,566,8,2,59,25,26,51,6
2020-09-04,LZ,Slovakia,734,671,5,1,63,29,29,58,4
2020-09-05,LZ,Slovakia,765,711,3,1,54,28,23,51,2
2020-09-06,LZ,Slovakia,736,694,1,0,42,17,24,41,1
2020-09-07,LZ,Slovakia,590,550,1,0,40,22,17,39,1
2020-09-08,LZ,Slovakia,581,529,6,3,52,21,25,46,3
2020-09-09,LZ,Slovakia,592,526,7,0,66,31,28,59,7
2020-09-10,LZ,Slovakia,586,529,5,1,57,25,27,52,4
2020-09-11,LZ,Slovakia,715,649,10,2,66,27,29,56,8
2020-09-12,LZ,Slovakia,712,683,0,0,29,16,13,29,0
2020-09-13,LZ,Slovakia,715,661,5,1,54,25,24,49,4
2020-09-14,LZ,Slovakia,579,536,1,0,43,22,20,42,1
2020-09-15,LZ,Slovakia,529,482,5,1,47,18,24,42,4
2020-09-16,LZ,Slovakia,611,548,7,4,63,28,28,56,3
2020-09-17,LZ,Slovakia,626,557,10,3,69,28,31,59,7
2020-09-18,LZ,Slovakia,681,620,11,0,61,26,24,50,11
2020-09-19,LZ,Slovakia,698,670,3,1,28,14,11,25,2
2020-09-20,LZ,Slovakia,661,625,2,1,36,16,18,34,1
2020-09-21,LZ,Slovakia,550,516,3,3,34,18,13,31,0
2020-09-22,LZ,Slovakia,517,472,8,4,45,19,18,37,4
2020-09-23,LZ,Slovakia,539,493,8,1,46,20,18,38,7
2020-09-24,LZ,Slovakia,538,490,6,2,48,21,21,42,4
2020-09-25,LZ,Slovakia,619,583,0,0,36,17,19,36,0
2020-09-26,LZ,Slovakia,698,675,5,1,23,10,8,18,4
2020-09-27,LZ,Slovakia,669,647,0,0,22,10,12,22,0
2020-09-28,LZ,Slovakia,527,496,2,0,31,13,16,29,2
2020-09-29,LZ,Slovakia,478,442,9,2,36,15,12,27,7
2020-09-30,LZ,Slovakia,542,498,8,1,44,18,18,36,7
2020-10-01,LZ,Slovakia,518,475,4,1,43,18,21,39,3
2020-10-02,LZ,Slovakia,635,585,11,2,50,20,19,39,9
2020-10-03,LZ,Slovakia,735,717,1,1,18,7,10,17,0
2020-10-04,LZ,Slovakia,653,625,1,0,28,13,14,27,1
2020-10-05,LZ,Slovakia,524,488,6,4,36,16,14,30,2
2020-10-06,LZ,Slovakia,437,396,11,4,41,14,16,30,7
2020-10-07,LZ,Slovakia,524,464,7,1,60,25,28,53,6
2020-10-08,LZ,Slovakia,513,451,7,0,62,29,26,55,7
2020-10-09,LZ,Slovakia,610,553,8,2,57,25,24,49,6
2020-10-10,LZ,Slovakia,651,622,4,0,29,11,14,25,4
2020-10-11,LZ,Slovakia,612,593,2,0,19,8,9,17,2
2020-10-12,LZ,Slovakia,483,446,4,0,37,18,15,33,4
2020-10-13,LZ,Slovakia,447,423,2,0,24,10,12,22,2
2020-10-14,LZ,Slovakia,469,440,2,0,29,14,13,27,2
2020-10-15,LZ,Slovakia,480,435,9,4,45,19,17,36,5
2020-10-16,LZ,Slovakia,613,567,6,0,46,20,20,40,6
2020-10-17,LZ,Slovakia,645,624,3,0,21,10,8,18,3
2020-10-18,LZ,Slovakia,590,564,2,1,26,12,12,24,1
2020-10-19,LZ,Slovakia,469,435,5,3,34,15,14,29,2
2020-10-20,LZ,Slovakia,436,403,4,2,33,16,13,29,2
2020-10-21,LZ,Slovakia,515,486,8,1,29,10,11,21,7
2020-10-22,LZ,Slovakia,549,500,7,2,49,21,21,42,5
2020-10-23,LZ,Slovakia,571,536,5,3,35,14,16,30,2
2020-10-24,LZ,Slovakia,571,558,0,0,13,7,6,13,0
2020-10-25,LZ,Slovakia,553,523,0,0,30,14,16,30,0
2020-10-26,LZ,Slovakia,540,512,4,4,28,12,12,24,0
2020-10-27,LZ,Slovakia,381,361,3,1,20,8,9,17,2
2020-10-28,LZ,Slovakia,452,415,6,2,37,16,15,31,4
2020-10-29,LZ,Slovakia,452,427,2,1,25,12,11,23,1
2020-10-30,LZ,Slovakia,494,464,3,3,30,15,12,27,0
2020-10-31,LZ,Slovakia,470,461,1,1,9,4,4,8,0
2020-11-01,LZ,Slovakia,487,471,1,0,16,7,8,15,1
2020-11-02,LZ,Slovakia,421,396,1,0,25,12,12,24,1
2020-11-03,LZ,Slovakia,358,337,4,2,21,9,8,17,2
2020-11-04,LZ,Slovakia,438,414,4,2,24,10,10,20,2
2020-11-05,LZ,Slovakia,380,345,8,4,35,16,11,27,4
2020-11-06,LZ,Slovakia,448,422,4,1,26,11,11,22,3
2020-11-07,LZ,Slovakia,419,410,2,1,9,3,4,7,1
2020-11-08,LZ,Slovakia,430,411,2,1,19,7,10,17,1
2020-11-09,LZ,Slovakia,417,393,6,2,24,10,8,18,4
2020-11-10,LZ,Slovakia,330,309,4,0,21,7,10,17,4
2020-11-11,LZ,Slovakia,395,352,11,6,43,16,16,32,5
2020-11-12,LZ,Slovakia,377,343,11,2,34,11,12,23,9
2020-11-13,LZ,Slovakia,432,409,2,0,23,12,9,21,2
2020-11-14,LZ,Slovakia,359,355,1,1,4,1,2,3,0
2020-11-15,LZ,Slovakia,380,366,1,0,14,6,7,13,1
2020-11-16,LZ,Slovakia,363,339,4,1,24,8,12,20,3
2020-11-17,LZ,Slovakia,295,273,5,2,22,11,6,17,3
2020-11-18,LZ,Slovakia,400,357,12,5,43,15,16,31,7
2020-11-19,LZ,Slovakia,385,352,14,4,33,9,10,19,10
2020-11-20,LZ,Slovakia,393,367,9,2,26,9,8,17,7
2020-11-21,LZ,Slovakia,340,328,0,0,12,8,4,12,0
2020-11-22,LZ,Slovakia,339,329,1,0,10,3,6,9,1
2020-11-23,LZ,Slovakia,336,315,4,1,21,8,9,17,3
2020-11-24,LZ,Slovakia,275,263,0,0,12,4,8,12,0
2020-11-25,LZ,Slovakia,344,314,9,1,30,11,10,21,8
2020-11-26,LZ,Slovakia,337,306,4,0,31,13,14,27,4
2020-11-27,LZ,Slovakia,406,379,4,0,27,14,9,23,4
2020-11-28,LZ,Slovakia,315,305,0,0,10,5,5,10,0
2020-11-29,LZ,Slovakia,360,350,2,0,10,4,4,8,2
2020-11-30,LZ,Slovakia,342,324,4,2,18,7,7,14,2
2020-12-01,LZ,Slovakia,279,246,15,6,33,10,8,18,9
2020-12-02,LZ,Slovakia,341,309,9,0,32,9,14,23,9
2020-12-03,LZ,Slovakia,328,307,0,0,21,10,11,21,0
2020-12-04,LZ,Slovakia,389,368,3,1,21,11,7,18,2
2020-12-05,LZ,Slovakia,368,361,0,0,7,4,3,7,0
2020-12-06,LZ,Slovakia,373,360,2,0,13,5,6,11,2
2020-12-07,LZ,Slovakia,311,285,2,0,26,11,13,24,2
2020-12-08,LZ,Slovakia,295,269,4,2,26,10,12,22,2
2020-12-09,LZ,Slovakia,365,310,12,2,55,21,22,43,10
2020-12-10,LZ,Slovakia,342,295,5,2,47,23,19,42,3
2020-12-11,LZ,Slovakia,462,420,5,2,42,18,19,37,3
2020-12-12,LZ,Slovakia,382,371,1,0,11,5,5,10,1
2020-12-13,LZ,Slovakia,386,372,0,0,14,9,5,14,0
2020-12-14,LZ,Slovakia,386,347,6,1,39,15,18,33,5
2020-12-15,LZ,Slovakia,384,348,4,0,36,18,14,32,4
2020-12-16,LZ,Slovakia,415,373,9,0,42,16,17,33,9
2020-12-17,LZ,Slovakia,461,421,3,0,40,18,19,37,3
2020-12-18,LZ,Slovakia,572,514,7,2,58,25,26,51,5
2020-12-19,LZ,Slovakia,494,473,0,0,21,10,11,21,0
2020-12-20,LZ,Slovakia,451,425,0,0,26,13,13,26,0
2020-12-21,LZ,Slovakia,442,417,2,0,25,11,12,23,2
2020-12-22,LZ,Slovakia,372,343,3,0,29,13,13,26,3
2020-12-23,LZ,Slovakia,437,422,1,0,15,7,7,14,1
2020-12-24,LZ,Slovakia,298,290,0,0,8,5,3,8,0
2020-12-25,LZ,Slovakia,270,261,0,0,9,6,3,9,0
2020-12-26,LZ,Slovakia,328,314,2,0,14,5,7,12,2
2020-12-27,LZ,Slovakia,375,335,11,0,40,15,14,29,11
2020-12-28,LZ,Slovakia,326,306,2,0,20,9,9,18,2
2020-12-29,LZ,Slovakia,279,263,3,1,16,6,7,13,2
2020-12-30,LZ,Slovakia,351,328,0,0,23,11,12,23,0
2020-12-31,LZ,Slovakia,251,234,1,0,17,9,7,16,1
2020-01-01,LJ,Slovenia,675,646,0,0,29,15,14,29,0
2020-01-02,LJ,Slovenia,868,818,0,0,50,24,26,50,0
2020-01-03,LJ,Slovenia,911,854,1,1,57,28,28,56,0
2020-01-04,LJ,Slovenia,976,937,0,0,39,19,20,39,0
2020-01-05,LJ,Slovenia,933,887,1,1,46,23,22,45,0
2020-01-06,LJ,Slovenia,880,810,11,3,70,27,32,59,8
2020-01-07,LJ,Slovenia,789,724,11,7,65,27,27,54,4
2020-01-08,LJ,Slovenia,801,738,9,0,63,26,28,54,9
2020-01-09,LJ,Slovenia,842,763,14,6,79,32,33,65,8
2020-01-10,LJ,Slovenia,907,846,5,3,61,28,28,56,2
2020-01-11,LJ,Slovenia,908,870,0,0,38,21,17,38,0
2020-01-12,LJ,Slovenia,856,806,1,1,50,24,25,49,0
2020-01-13,LJ,Slovenia,824,766,4,0,58,27,27,54,4
2020-01-14,LJ,Slovenia,799,743,4,2,56,25,27,52,2
2020-01-15,LJ,Slovenia,780,718,10,6,62,27,25,52,4
2020-01-16,LJ,Slovenia,776,721,4,0,55,25,26,51,4
2020-01-17,LJ,Slovenia,885,819,7,7,66,31,28,59,0
2020-01-18,LJ,Slovenia,847,812,0,0,35,19,16,35,0
2020-01-19,LJ,Slovenia,841,799,0,0,42,21,21,42,0
2020-01-20,LJ,Slovenia,822,771,2,2,51,24,25,49,0
2020-01-21,LJ,Slovenia,761,700,8,3,61,27,26,53,5
2020-01-22,LJ,Slovenia,772,712,8,4,60,25,27,52,4
2020-01-23,LJ,Slovenia,775,709,6,3,66,30,30,60,3
2020-01-24,LJ,Slovenia,884,817,4,4,67,31,32,63,0
2020-01-25,LJ,Slovenia,832,788,1,1,44,22,21,43,0
2020-01-26,LJ,Slovenia,852,811,0,0,41,20,21,41,0
2020-01-27,LJ,Slovenia,823,767,1,1,56,26,29,55,0
2020-01-28,LJ,Slovenia,732,674,3,2,58,29,26,55,1
2020-01-29,LJ,Slovenia,771,714,4,2,57,24,29,53,2
2020-01-30,LJ,Slovenia,743,678,5,3,65,29,31,60,2
2020-01-31,LJ,Slovenia,965,885,5,2,80,41,34,75,3
2020-02-01,LJ,Slovenia,854,809,0,0,45,22,23,45,0
2020-02-02,LJ,Slovenia,808,766,2,0,42,20,20,40,2
2020-02-03,LJ,Slovenia,799,741,4,0,58,26,28,54,4
2020-02-04,LJ,Slovenia,727,685,0,0,42,21,21,42,0
2020-02-05,LJ,Slovenia,768,725,2,0,43,21,20,41,2
2020-02-06,LJ,Slovenia,762,700,4,0,62,30,28,58,4
2020-02-07,LJ,Slovenia,935,870,1,1,65,31,33,64,0
2020-02-08,LJ,Slovenia,904,855,2,0,49,23,24,47,2
2020-02-09,LJ,Slovenia,835,793,1,0,42,21,20,41,1
2020-02-10,LJ,Slovenia,783,727,0,0,56,28,28,56,0
2020-02-11,LJ,Slovenia,752,694,4,1,58,25,29,54,3
2020-02-12,LJ,Slovenia,827,768,3,1,59,30,26,56,2
2020-02-13,LJ,Slovenia,781,706,3,0,75,36,36,72,3
2020-02-14,LJ,Slovenia,930,863,0,0,67,34,33,67,0
2020-02-15,LJ,Slovenia,914,872,3,1,42,18,21,39,2
2020-02-16,LJ,Slovenia,865,822,2,0,43,22,19,41,2
2020-02-17,LJ,Slovenia,872,800,4,0,72,31,37,68,4
2020-02-18,LJ,Slovenia,817,765,0,0,52,25,27,52,0
2020-02-19,LJ,Slovenia,809,756,1,1,53,27,25,52,0
2020-02-20,LJ,Slovenia,830,767,5,3,63,28,30,58,2
2020-02-21,LJ,Slovenia,960,885,7,3,75,33,35,68,4
2020-02-22,LJ,Slovenia,926,880,0,0,46,22,24,46,0
2020-02-23,LJ,Slovenia,924,876,0,0,48,25,23,48,0
2020-02-24,LJ,Slovenia,886,820,2,2,66,32,32,64,0
2020-02-25,LJ,Slovenia,798,741,0,0,57,29,28,57,0
2020-02-26,LJ,Slovenia,835,776,0,0,59,30,29,59,0
2020-02-27,LJ,Slovenia,802,746,2,1,56,28,26,54,1
2020-02-28,LJ,Slovenia,954,900,0,0,54,28,26,54,0
2020-02-29,LJ,Slovenia,939,895,0,0,44,22,22,44,0
2020-03-01,LJ,Slovenia,924,881,0,0,43,22,21,43,0
2020-03-02,LJ,Slovenia,881,821,0,0,60,30,30,60,0
2020-03-03,LJ,Slovenia,791,745,0,0,46,23,23,46,0
2020-03-04,LJ,Slovenia,804,736,6,2,68,31,31,62,4
2020-03-05,LJ,Slovenia,815,752,3,1,63,29,31,60,2
2020-03-06,LJ,Slovenia,909,843,0,0,66,33,33,66,0
2020-03-07,LJ,Slovenia,872,839,0,0,33,16,17,33,0
2020-03-08,LJ,Slovenia,850,801,0,0,49,22,27,49,0
2020-03-09,LJ,Slovenia,747,678,2,1,69,34,33,67,1
2020-03-10,LJ,Slovenia,716,660,3,1,56,29,24,53,2
2020-03-11,LJ,Slovenia,717,665,6,0,52,22,24,46,6
2020-03-12,LJ,Slovenia,737,669,0,0,68,33,35,68,0
2020-03-13,LJ,Slovenia,807,743,0,0,64,32,32,64,0
2020-03-14,LJ,Slovenia,726,689,4,2,37,17,16,33,2
2020-03-15,LJ,Slovenia,715,667,1,1,48,22,25,47,0
2020-03-16,LJ,Slovenia,628,566,2,0,62,29,31,60,2
2020-03-17,LJ,Slovenia,553,532,2,0,21,9,10,19,2
2020-03-18,LJ,Slovenia,546,525,0,0,21,10,11,21,0
2020-03-19,LJ,Slovenia,438,417,2,0,21,9,10,19,2
2020-03-20,LJ,Slovenia,497,467,2,1,30,13,15,28,1
2020-03-21,LJ,Slovenia,368,359,0,0,9,4,5,9,0
2020-03-22,LJ,Slovenia,254,248,0,0,6,3,3,6,0
2020-03-23,LJ,Slovenia,196,178,4,0,18,7,7,14,4
2020-03-24,LJ,Slovenia,208,190,0,0,18,9,9,18,0
2020-03-25,LJ,Slovenia,157,134,0,0,23,11,12,23,0
2020-03-26,LJ,Slovenia,151,133,0,0,18,9,9,18,0
2020-03-27,LJ,Slovenia,145,127,2,2,18,8,8,16,0
2020-03-28,LJ,Slovenia,116,108,0,0,8,5,3,8,0
2020-03-29,LJ,Slovenia,90,87,0,0,3,0,3,3,0
2020-03-30,LJ,Slovenia,115,100,0,0,15,7,8,15,0
2020-03-31,LJ,Slovenia,139,117,4,2,22,10,8,18,2
2020-04-01,LJ,Slovenia,147,121,1,1,26,12,13,25,0
2020-04-02,LJ,Slovenia,138,120,2,0,18,8,8,16,2
2020-04-03,LJ,Slovenia,138,118,0,0,20,10,10,20,0
2020-04-04,LJ,Slovenia,101,96,0,0,5,3,2,5,0
2020-04-05,LJ,Slovenia,88,86,0,0,2,1,1,2,0
2020-04-06,LJ,Slovenia,117,98,0,0,19,10,9,19,0
2020-04-07,LJ,Slovenia,110,90,3,1,20,9,8,17,2
2020-04-08,LJ,Slovenia,120,100,4,0,20,8,8,16,4
2020-04-09,LJ,Slovenia,119,101,2,2,18,8,8,16,0
2020-04-10,LJ,Slovenia,108,83,1,1,25,12,12,24,0
2020-04-11,LJ,Slovenia,85,73,2,2,12,4,6,10,0
2020-04-12,LJ,Slovenia,78,70,0,0,8,5,3,8,0
2020-04-13,LJ,Slovenia,88,83,1,0,5,2,2,4,1
2020-04-14,LJ,Slovenia,101,83,1,1,18,9,8,17,0
2020-04-15,LJ,Slovenia,121,95,2,1,26,12,12,24,1
2020-04-16,LJ,Slovenia,104,83,3,1,21,9,9,18,2
2020-04-17,LJ,Slovenia,120,97,5,0,23,9,9,18,5
2020-04-18,LJ,Slovenia,77,72,0,0,5,2,3,5,0
2020-04-19,LJ,Slovenia,76,73,0,0,3,2,1,3,0
2020-04-20,LJ,Slovenia,99,81,4,1,18,6,8,14,3
2020-04-21,LJ,Slovenia,105,92,0,0,13,6,7,13,0
2020-04-22,LJ,Slovenia,121,98,1,1,23,11,11,22,0
2020-04-23,LJ,Slovenia,145,113,5,1,32,13,14,27,4
2020-04-24,LJ,Slovenia,122,97,7,0,25,10,8,18,7
2020-04-25,LJ,Slovenia,91,85,0,0,6,3,3,6,0
2020-04-26,LJ,Slovenia,80,75,0,0,5,2,3,5,0
2020-04-27,LJ,Slovenia,121,107,0,0,14,7,7,14,0
2020-04-28,LJ,Slovenia,130,104,5,2,26,11,10,21,3
2020-04-29,LJ,Slovenia,130,113,1,1,17,7,9,16,0
2020-04-30,LJ,Slovenia,127,103,4,2,24,11,9,20,2
2020-05-01,LJ,Slovenia,113,107,0,0,6,3,3,6,0
2020-05-02,LJ,Slovenia,105,104,1,1,1,0,0,0,0
2020-05-03,LJ,Slovenia,91,88,0,0,3,1,2,3,0
2020-05-04,LJ,Slovenia,110,87,5,2,23,9,9,18,3
2020-05-05,LJ,Slovenia,110,91,1,1,19,9,9,18,0
2020-05-06,LJ,Slovenia,129,112,2,1,17,8,7,15,1
2020-05-07,LJ,Slovenia,132,108,6,2,24,8,10,18,4
2020-05-08,LJ,Slovenia,133,112,8,2,21,7,6,13,6
2020-05-09,LJ,Slovenia,101,94,0,0,7,3,4,7,0
2020-05-10,LJ,Slovenia,93,82,0,0,11,5,6,11,0
2020-05-11,LJ,Slovenia,121,104,0,0,17,8,9,17,0
2020-05-12,LJ,Slovenia,114,102,1,1,12,6,5,11,0
2020-05-13,LJ,Slovenia,126,101,2,2,25,12,11,23,0
2020-05-14,LJ,Slovenia,131,107,2,2,24,10,12,22,0
2020-05-15,LJ,Slovenia,145,127,2,2,18,8,8,16,0
2020-05-16,LJ,Slovenia,114,105,1,1,9,5,3,8,0
2020-05-17,LJ,Slovenia,113,111,1,1,2,0,1,1,0
2020-05-18,LJ,Slovenia,122,107,1,1,15,7,7,14,0
2020-05-19,LJ,Slovenia,107,89,1,1,18,8,9,17,0
2020-05-20,LJ,Slovenia,155,133,2,1,22,11,9,20,1
2020-05-21,LJ,Slovenia,152,132,3,1,20,9,8,17,2
2020-05-22,LJ,Slovenia,125,114,1,1,11,5,5,10,0
2020-05-23,LJ,Slovenia,120,114,0,0,6,3,3,6,0
2020-05-24,LJ,Slovenia,113,110,0,0,3,1,2,3,0
2020-05-25,LJ,Slovenia,116,96,0,0,20,11,9,20,0
2020-05-26,LJ,Slovenia,141,122,1,0,19,9,9,18,1
2020-05-27,LJ,Slovenia,173,127,2,2,46,21,23,44,0
2020-05-28,LJ,Slovenia,157,133,2,1,24,12,10,22,1
2020-05-29,LJ,Slovenia,142,121,1,0,21,8,12,20,1
2020-05-30,LJ,Slovenia,134,123,1,1,11,6,4,10,0
2020-05-31,LJ,Slovenia,121,114,2,2,7,2,3,5,0
2020-06-01,LJ,Slovenia,152,125,0,0,27,13,14,27,0
2020-06-02,LJ,Slovenia,154,128,1,0,26,12,13,25,1
2020-06-03,LJ,Slovenia,199,158,2,1,41,19,20,39,1
2020-06-04,LJ,Slovenia,184,152,1,1,32,17,14,31,0
2020-06-05,LJ,Slovenia,194,170,0,0,24,12,12,24,0
2020-06-06,LJ,Slovenia,195,170,5,2,25,9,11,20,3
2020-06-07,LJ,Slovenia,195,168,2,2,27,13,12,25,0
2020-06-08,LJ,Slovenia,186,162,2,1,24,11,11,22,1
2020-06-09,LJ,Slovenia,175,149,3,3,26,13,10,23,0
2020-06-10,LJ,Slovenia,197,171,3,2,26,11,12,23,1
2020-06-11,LJ,Slovenia,230,186,9,3,44,11,24,35,6
2020-06-12,LJ,Slovenia,241,186,8,6,55,23,24,47,2
2020-06-13,LJ,Slovenia,212,183,2,0,29,18,9,27,2
2020-06-14,LJ,Slovenia,213,194,1,1,19,13,5,18,0
2020-06-15,LJ,Slovenia,279,254,0,0,25,14,11,25,0
2020-06-16,LJ,Slovenia,258,208,4,2,50,25,21,46,2
2020-06-17,LJ,Slovenia,286,254,2,2,32,13,17,30,0
2020-06-18,LJ,Slovenia,282,238,7,1,44,18,19,37,6
2020-06-19,LJ,Slovenia,356,307,0,0,49,24,25,49,0
2020-06-20,LJ,Slovenia,320,301,1,1,19,10,8,18,0
2020-06-21,LJ,Slovenia,293,269,1,1,24,13,10,23,0
2020-06-22,LJ,Slovenia,332,284,0,0,48,24,24,48,0
2020-06-23,LJ,Slovenia,286,244,3,0,42,19,20,39,3
2020-06-24,LJ,Slovenia,356,298,6,2,58,27,25,52,4
2020-06-25,LJ,Slovenia,321,284,0,0,37,19,18,37,0
2020-06-26,LJ,Slovenia,398,344,1,1,54,24,29,53,0
2020-06-27,LJ,Slovenia,399,379,1,1,20,8,11,19,0
2020-06-28,LJ,Slovenia,411,375,1,1,36,19,16,35,0
2020-06-29,LJ,Slovenia,384,346,7,1,38,18,13,31,6
2020-06-30,LJ,Slovenia,354,314,5,2,40,17,18,35,3
2020-07-01,LJ,Slovenia,587,543,1,0,44,22,21,43,1
2020-07-02,LJ,Slovenia,612,564,2,1,48,22,24,46,1
2020-07-03,LJ,Slovenia,699,665,0,0,34,18,16,34,0
2020-07-04,LJ,Slovenia,755,729,0,0,26,12,14,26,0
2020-07-05,LJ,Slovenia,698,664,0,0,34,17,17,34,0
2020-07-06,LJ,Slovenia,625,578,6,4,47,22,19,41,2
2020-07-07,LJ,Slovenia,549,513,4,2,36,15,17,32,2
2020-07-08,LJ,Slovenia,618,577,1,1,41,20,20,40,0
2020-07-09,LJ,Slovenia,603,557,1,0,46,22,23,45,1
2020-07-10,LJ,Slovenia,769,734,4,2,35,16,15,31,2
2020-07-11,LJ,Slovenia,791,775,0,0,16,8,8,16,0
2020-07-12,LJ,Slovenia,766,733,0,0,33,17,16,33,0
2020-07-13,LJ,Slovenia,642,600,3,1,42,19,20,39,2
2020-07-14,LJ,Slovenia,578,539,0,0,39,19,20,39,0
2020-07-15,LJ,Slovenia,626,587,4,3,39,17,18,35,1
2020-07-16,LJ,Slovenia,661,619,3,0,42,20,19,39,3
2020-07-17,LJ,Slovenia,773,738,1,1,35,17,17,34,0
2020-07-18,LJ,Slovenia,901,871,0,0,30,15,15,30,0
2020-07-19,LJ,Slovenia,776,744,0,0,32,16,16,32,0
2020-07-20,LJ,Slovenia,692,645,5,2,47,19,23,42,3
2020-07-21,LJ,Slovenia,676,619,8,2,57,23,26,49,6
2020-07-22,LJ,Slovenia,678,645,1,1,33,14,18,32,0
2020-07-23,LJ,Slovenia,689,640,1,0,49,27,21,48,1
2020-07-24,LJ,Slovenia,785,757,2,1,28,13,13,26,1
2020-07-25,LJ,Slovenia,980,932,1,1,48,23,24,47,0
2020-07-26,LJ,Slovenia,830,799,2,1,31,15,14,29,1
2020-07-27,LJ,Slovenia,709,651,10,2,58,24,24,48,8
2020-07-28,LJ,Slovenia,715,677,2,1,38,18,18,36,1
2020-07-29,LJ,Slovenia,672,634,5,0,38,17,16,33,5
2020-07-30,LJ,Slovenia,705,650,4,3,55,25,26,51,1
2020-07-31,LJ,Slovenia,822,769,7,3,53,23,23,46,4
2020-08-01,LJ,Slovenia,1180,1144,0,0,36,18,18,36,0
2020-08-02,LJ,Slovenia,975,934,0,0,41,19,22,41,0
2020-08-03,LJ,Slovenia,834,792,2,2,42,20,20,40,0
2020-08-04,LJ,Slovenia,770,727,2,1,43,21,20,41,1
2020-08-05,LJ,Slovenia,827,784,3,3,43,21,19,40,0
2020-08-06,LJ,Slovenia,831,783,1,1,48,22,25,47,0
2020-08-07,LJ,Slovenia,937,875,4,1,62,28,30,58,3
2020-08-08,LJ,Slovenia,1159,1125,1,1,34,16,17,33,0
2020-08-09,LJ,Slovenia,991,949,0,0,42,21,21,42,0
2020-08-10,LJ,Slovenia,859,806,0,0,53,26,27,53,0
2020-08-11,LJ,Slovenia,776,736,3,0,40,19,18,37,3
2020-08-12,LJ,Slovenia,817,784,1,0,33,16,16,32,1
2020-08-13,LJ,Slovenia,806,759,7,3,47,21,19,40,4
2020-08-14,LJ,Slovenia,865,811,5,1,54,24,25,49,4
2020-08-15,LJ,Slovenia,1127,1101,0,0,26,12,14,26,0
2020-08-16,LJ,Slovenia,1034,998,0,0,36,20,16,36,0
2020-08-17,LJ,Slovenia,861,817,3,1,44,22,19,41,2
2020-08-18,LJ,Slovenia,758,722,4,4,36,16,16,32,0
2020-08-19,LJ,Slovenia,842,793,7,5,49,22,20,42,2
2020-08-20,LJ,Slovenia,830,775,8,2,55,24,23,47,6
2020-08-21,LJ,Slovenia,1004,954,1,0,50,25,24,49,1
2020-08-22,LJ,Slovenia,1163,1142,2,2,21,9,10,19,0
2020-08-23,LJ,Slovenia,1036,992,1,0,44,23,20,43,1
2020-08-24,LJ,Slovenia,887,838,0,0,49,25,24,49,0
2020-08-25,LJ,Slovenia,824,756,5,4,68,32,31,63,1
2020-08-26,LJ,Slovenia,852,797,5,3,55,23,27,50,2
2020-08-27,LJ,Slovenia,838,770,6,4,68,30,32,62,2
2020-08-28,LJ,Slovenia,987,934,5,5,53,28,20,48,0
2020-08-29,LJ,Slovenia,1171,1143,0,0,28,13,15,28,0
2020-08-30,LJ,Slovenia,972,939,1,1,33,14,18,32,0
2020-08-31,LJ,Slovenia,811,753,1,1,58,30,27,57,0
2020-09-01,LJ,Slovenia,770,729,4,1,41,19,18,37,3
2020-09-02,LJ,Slovenia,812,771,4,2,41,17,20,37,2
2020-09-03,LJ,Slovenia,818,774,5,4,44,19,20,39,1
2020-09-04,LJ,Slovenia,905,855,8,3,50,24,18,42,5
2020-09-05,LJ,Slovenia,1093,1061,2,1,32,15,15,30,1
2020-09-06,LJ,Slovenia,966,934,3,3,32,15,14,29,0
2020-09-07,LJ,Slovenia,795,745,0,0,50,26,24,50,0
2020-09-08,LJ,Slovenia,752,703,5,4,49,22,22,44,1
2020-09-09,LJ,Slovenia,789,745,9,5,44,17,18,35,4
2020-09-10,LJ,Slovenia,762,714,10,5,48,16,22,38,5
2020-09-11,LJ,Slovenia,865,799,9,3,66,29,28,57,6
2020-09-12,LJ,Slovenia,1021,1000,2,2,21,10,9,19,0
2020-09-13,LJ,Slovenia,909,883,0,0,26,12,14,26,0
2020-09-14,LJ,Slovenia,717,665,8,3,52,21,23,44,5
2020-09-15,LJ,Slovenia,729,669,13,3,60,24,23,47,10
2020-09-16,LJ,Slovenia,709,659,10,3,50,19,21,40,7
2020-09-17,LJ,Slovenia,651,613,6,2,38,16,16,32,4
2020-09-18,LJ,Slovenia,817,763,7,1,54,24,23,47,6
2020-09-19,LJ,Slovenia,987,967,1,1,20,9,10,19,0
2020-09-20,LJ,Slovenia,858,828,2,1,30,14,14,28,1
2020-09-21,LJ,Slovenia,682,634,2,0,48,21,25,46,2
2020-09-22,LJ,Slovenia,611,565,10,2,46,19,17,36,8
2020-09-23,LJ,Slovenia,683,641,5,1,42,18,19,37,4
2020-09-24,LJ,Slovenia,611,552,14,2,59,23,22,45,12
2020-09-25,LJ,Slovenia,769,727,0,0,42,21,21,42,0
2020-09-26,LJ,Slovenia,965,947,2,1,18,8,8,16,1
2020-09-27,LJ,Slovenia,762,728,0,0,34,16,18,34,0
2020-09-28,LJ,Slovenia,622,593,0,0,29,15,14,29,0
2020-09-29,LJ,Slovenia,585,545,9,1,40,16,15,31,8
2020-09-30,LJ,Slovenia,656,601,15,5,55,19,21,40,10
2020-10-01,LJ,Slovenia,615,556,11,3,59,24,24,48,8
2020-10-02,LJ,Slovenia,736,697,2,0,39,19,18,37,2
2020-10-03,LJ,Slovenia,780,773,0,0,7,4,3,7,0
2020-10-04,LJ,Slovenia,687,672,1,1,15,6,8,14,0
2020-10-05,LJ,Slovenia,627,589,1,1,38,19,18,37,0
2020-10-06,LJ,Slovenia,520,490,5,3,30,10,15,25,2
2020-10-07,LJ,Slovenia,532,496,2,0,36,17,17,34,2
2020-10-08,LJ,Slovenia,574,514,15,4,60,20,25,45,11
2020-10-09,LJ,Slovenia,693,645,0,0,48,25,23,48,0
2020-10-10,LJ,Slovenia,890,857,3,2,33,16,14,30,1
2020-10-11,LJ,Slovenia,759,739,0,0,20,8,12,20,0
2020-10-12,LJ,Slovenia,596,557,0,0,39,21,18,39,0
2020-10-13,LJ,Slovenia,507,482,2,1,25,13,10,23,1
2020-10-14,LJ,Slovenia,566,519,6,1,47,19,22,41,5
2020-10-15,LJ,Slovenia,382,349,0,0,33,15,18,33,0
2020-10-16,LJ,Slovenia,784,744,0,0,40,20,20,40,0
2020-10-17,LJ,Slovenia,909,887,2,2,22,11,9,20,0
2020-10-18,LJ,Slovenia,680,663,1,1,17,8,8,16,0
2020-10-19,LJ,Slovenia,561,529,4,2,32,15,13,28,2
2020-10-20,LJ,Slovenia,468,439,1,1,29,15,13,28,0
2020-10-21,LJ,Slovenia,473,436,3,1,37,16,18,34,2
2020-10-22,LJ,Slovenia,495,449,3,3,46,20,23,43,0
2020-10-23,LJ,Slovenia,650,615,4,2,35,16,15,31,2
2020-10-24,LJ,Slovenia,863,850,0,0,13,6,7,13,0
2020-10-25,LJ,Slovenia,634,619,0,0,15,8,7,15,0
2020-10-26,LJ,Slovenia,459,426,6,0,33,11,16,27,6
2020-10-27,LJ,Slovenia,412,389,0,0,23,12,11,23,0
2020-10-28,LJ,Slovenia,483,444,3,0,39,19,17,36,3
2020-10-29,LJ,Slovenia,459,429,2,0,30,13,15,28,2
2020-10-30,LJ,Slovenia,555,518,3,2,37,17,17,34,1
2020-10-31,LJ,Slovenia,656,631,0,0,25,11,14,25,0
2020-11-01,LJ,Slovenia,579,564,1,1,15,7,7,14,0
2020-11-02,LJ,Slovenia,397,369,1,1,28,15,12,27,0
2020-11-03,LJ,Slovenia,322,297,6,0,25,9,10,19,6
2020-11-04,LJ,Slovenia,345,322,0,0,23,11,12,23,0
2020-11-05,LJ,Slovenia,350,328,0,0,22,10,12,22,0
2020-11-06,LJ,Slovenia,411,382,4,4,29,12,13,25,0
2020-11-07,LJ,Slovenia,447,440,2,2,7,3,2,5,0
2020-11-08,LJ,Slovenia,445,431,0,0,14,6,8,14,0
2020-11-09,LJ,Slovenia,335,316,0,0,19,10,9,19,0
2020-11-10,LJ,Slovenia,286,258,1,1,28,13,14,27,0
2020-11-11,LJ,Slovenia,325,299,2,2,26,12,12,24,0
2020-11-12,LJ,Slovenia,287,263,3,1,24,10,11,21,2
2020-11-13,LJ,Slovenia,382,350,2,0,32,15,15,30,2
2020-11-14,LJ,Slovenia,347,338,1,1,9,5,3,8,0
2020-11-15,LJ,Slovenia,345,333,2,1,12,4,6,10,1
2020-11-16,LJ,Slovenia,301,268,3,0,33,16,14,30,3
2020-11-17,LJ,Slovenia,257,237,4,3,20,7,9,16,1
2020-11-18,LJ,Slovenia,284,241,2,1,43,21,20,41,1
2020-11-19,LJ,Slovenia,269,245,0,0,24,12,12,24,0
2020-11-20,LJ,Slovenia,319,291,3,0,28,12,13,25,3
2020-11-21,LJ,Slovenia,279,265,3,2,14,5,6,11,1
2020-11-22,LJ,Slovenia,291,281,0,0,10,4,6,10,0
2020-11-23,LJ,Slovenia,229,200,6,1,29,12,11,23,5
2020-11-24,LJ,Slovenia,211,186,7,5,25,9,9,18,2
2020-11-25,LJ,Slovenia,269,239,2,2,30,14,14,28,0
2020-11-26,LJ,Slovenia,204,188,0,0,16,9,7,16,0
2020-11-27,LJ,Slovenia,319,294,0,0,25,12,13,25,0
2020-11-28,LJ,Slovenia,269,260,0,0,9,4,5,9,0
2020-11-29,LJ,Slovenia,278,266,0,0,12,5,7,12,0
2020-11-30,LJ,Slovenia,247,213,10,4,34,13,11,24,6
2020-12-01,LJ,Slovenia,216,196,2,1,20,10,8,18,1
2020-12-02,LJ,Slovenia,264,245,0,0,19,9,10,19,0
2020-12-03,LJ,Slovenia,274,252,1,1,22,11,10,21,0
2020-12-04,LJ,Slovenia,346,315,2,0,31,15,14,29,2
2020-12-05,LJ,Slovenia,288,279,0,0,9,4,5,9,0
2020-12-06,LJ,Slovenia,274,268,0,0,6,4,2,6,0
2020-12-07,LJ,Slovenia,270,243,0,0,27,13,14,27,0
2020-12-08,LJ,Slovenia,209,193,0,0,16,7,9,16,0
2020-12-09,LJ,Slovenia,256,233,0,0,23,11,12,23,0
2020-12-10,LJ,Slovenia,313,284,1,0,29,15,13,28,1
2020-12-11,LJ,Slovenia,345,312,1,0,33,17,15,32,1
2020-12-12,LJ,Slovenia,323,313,0,0,10,4,6,10,0
2020-12-13,LJ,Slovenia,343,328,1,1,15,7,7,14,0
2020-12-14,LJ,Slovenia,326,286,6,3,40,17,17,34,3
2020-12-15,LJ,Slovenia,282,241,1,0,41,20,20,40,1
2020-12-16,LJ,Slovenia,355,306,9,5,49,23,17,40,4
2020-12-17,LJ,Slovenia,367,344,2,1,23,10,11,21,1
2020-12-18,LJ,Slovenia,510,479,3,1,31,13,15,28,2
2020-12-19,LJ,Slovenia,539,526,1,1,13,6,6,12,0
2020-12-20,LJ,Slovenia,454,438,0,0,16,6,10,16,0
2020-12-21,LJ,Slovenia,390,365,0,0,25,15,10,25,0
2020-12-22,LJ,Slovenia,340,310,3,1,30,12,15,27,2
2020-12-23,LJ,Slovenia,429,388,1,1,41,20,20,40,0
2020-12-24,LJ,Slovenia,361,341,1,1,20,9,10,19,0
2020-12-25,LJ,Slovenia,232,226,0,0,6,4,2,6,0
2020-12-26,LJ,Slovenia,325,325,0,0,0,0,0,0,0
2020-12-27,LJ,Slovenia,370,354,2,2,16,7,7,14,0
2020-12-28,LJ,Slovenia,328,306,0,0,22,12,10,22,0
2020-12-29,LJ,Slovenia,269,255,0,0,14,7,7,14,0
2020-12-30,LJ,Slovenia,345,326,0,0,19,9,10,19,0
2020-12-31,LJ,Slovenia,200,177,2,0,23,10,11,21,2
2020-01-01,LE,Spain,3929,736,874,0,3193,1159,1160,2319,874
2020-01-02,LE,Spain,4834,839,1101,8,3995,1457,1437,2894,1093
2020-01-03,LE,Spain,4893,842,1096,8,4051,1481,1474,2955,1088
2020-01-04,LE,Spain,5171,986,964,9,4185,1612,1609,3221,955
2020-01-05,LE,Spain,5035,972,949,6,4063,1575,1539,3114,943
2020-01-06,LE,Spain,4735,948,1044,10,3787,1378,1365,2743,1034
2020-01-07,LE,Spain,4369,779,1104,32,3590,1236,1250,2486,1072
2020-01-08,LE,Spain,3898,678,1031,39,3220,1092,1097,2189,992
2020-01-09,LE,Spain,4130,683,1104,41,3447,1155,1188,2343,1063
2020-01-10,LE,Spain,4500,748,1151,29,3752,1304,1297,2601,1122
2020-01-11,LE,Spain,4386,784,880,25,3602,1361,1361,2722,855
2020-01-12,LE,Spain,4574,771,1042,15,3803,1399,1362,2761,1027
2020-01-13,LE,Spain,4217,738,1111,29,3479,1179,1189,2368,1082
2020-01-14,LE,Spain,3479,527,1026,37,2952,964,962,1926,989
2020-01-15,LE,Spain,3427,497,1015,41,2930,961,954,1915,974
2020-01-16,LE,Spain,3932,637,1070,41,3295,1104,1121,2225,1029
2020-01-17,LE,Spain,4404,696,1159,37,3708,1273,1276,2549,1122
2020-01-18,LE,Spain,4190,754,867,16,3436,1287,1282,2569,851
2020-01-19,LE,Spain,4331,697,997,9,3634,1325,1312,2637,988
2020-01-20,LE,Spain,4019,659,1073,22,3360,1141,1146,2287,1051
2020-01-21,LE,Spain,3568,554,998,36,3014,1015,1001,2016,962
2020-01-22,LE,Spain,3480,493,1044,49,2987,966,977,1943,995
2020-01-23,LE,Spain,3927,595,1091,52,3332,1110,1131,2241,1039
2020-01-24,LE,Spain,4365,623,1163,37,3742,1290,1289,2579,1126
2020-01-25,LE,Spain,4171,714,868,14,3457,1302,1287,2589,854
2020-01-26,LE,Spain,4451,748,1044,19,3703,1334,1325,2659,1025
2020-01-27,LE,Spain,4145,686,1092,36,3459,1189,1178,2367,1056
2020-01-28,LE,Spain,3541,559,980,43,2982,1008,994,2002,937
2020-01-29,LE,Spain,3521,513,1054,42,3008,974,980,1954,1012
2020-01-30,LE,Spain,4040,654,1101,40,3386,1133,1152,2285,1061
2020-01-31,LE,Spain,4457,717,1170,28,3740,1286,1284,2570,1142
2020-02-01,LE,Spain,4361,813,889,18,3548,1319,1340,2659,871
2020-02-02,LE,Spain,4594,784,1075,16,3810,1376,1359,2735,1059
2020-02-03,LE,Spain,4232,743,1128,25,3489,1189,1172,2361,1103
2020-02-04,LE,Spain,3761,635,994,27,3126,1056,1076,2132,967
2020-02-05,LE,Spain,3764,576,1083,38,3188,1054,1051,2105,1045
2020-02-06,LE,Spain,4187,704,1128,34,3483,1167,1188,2355,1094
2020-02-07,LE,Spain,4521,715,1182,28,3806,1313,1311,2624,1154
2020-02-08,LE,Spain,4539,900,887,17,3639,1381,1371,2752,870
2020-02-09,LE,Spain,4463,790,1056,17,3673,1288,1329,2617,1039
2020-02-10,LE,Spain,4332,792,1105,32,3540,1242,1193,2435,1073
2020-02-11,LE,Spain,3900,665,1022,34,3235,1113,1100,2213,988
2020-02-12,LE,Spain,3890,643,1055,37,3247,1098,1094,2192,1018
2020-02-13,LE,Spain,4408,836,1110,40,3572,1229,1233,2462,1070
2020-02-14,LE,Spain,4834,832,1207,26,4002,1403,1392,2795,1181
2020-02-15,LE,Spain,4784,966,932,27,3818,1426,1460,2886,905
2020-02-16,LE,Spain,4853,867,1076,18,3986,1458,1452,2910,1058
2020-02-17,LE,Spain,4605,805,1162,39,3800,1324,1314,2638,1123
2020-02-18,LE,Spain,4184,720,1065,34,3464,1195,1204,2399,1031
2020-02-19,LE,Spain,4177,710,1130,33,3467,1168,1169,2337,1097
2020-02-20,LE,Spain,4477,771,1152,36,3706,1270,1284,2554,1116
2020-02-21,LE,Spain,4960,840,1237,27,4120,1452,1431,2883,1210
2020-02-22,LE,Spain,4957,1046,929,19,3911,1464,1518,2982,910
2020-02-23,LE,Spain,4793,1116,902,23,3677,1392,1383,2775,879
2020-02-24,LE,Spain,4816,852,1215,37,3964,1375,1374,2749,1178
2020-02-25,LE,Spain,4483,709,1155,33,3774,1314,1305,2619,1122
2020-02-26,LE,Spain,4341,697,1153,39,3644,1237,1254,2491,1114
2020-02-27,LE,Spain,4586,759,1169,34,3827,1336,1322,2658,1135
2020-02-28,LE,Spain,4934,824,1225,31,4110,1455,1430,2885,1194
2020-02-29,LE,Spain,4921,930,944,20,3991,1521,1526,3047,924
2020-03-01,LE,Spain,4942,854,1087,14,4088,1515,1486,3001,1073
2020-03-02,LE,Spain,4669,850,1147,12,3819,1341,1331,2672,1135
2020-03-03,LE,Spain,4168,731,1018,19,3437,1207,1212,2419,999
2020-03-04,LE,Spain,4122,661,1106,32,3461,1169,1186,2355,1074
2020-03-05,LE,Spain,4468,768,1132,37,3700,1280,1288,2568,1095
2020-03-06,LE,Spain,4767,787,1182,20,3980,1407,1391,2798,1162
2020-03-07,LE,Spain,4700,829,950,16,3871,1460,1461,2921,934
2020-03-08,LE,Spain,4881,833,1097,18,4048,1485,1466,2951,1079
2020-03-09,LE,Spain,4461,796,1114,22,3665,1269,1282,2551,1092
2020-03-10,LE,Spain,4049,705,1026,32,3344,1165,1153,2318,994
2020-03-11,LE,Spain,3783,615,1096,38,3168,1036,1036,2072,1058
2020-03-12,LE,Spain,4132,688,1154,38,3444,1142,1148,2290,1116
2020-03-13,LE,Spain,4438,724,1213,18,3714,1248,1253,2501,1195
2020-03-14,LE,Spain,4224,786,813,14,3438,1303,1322,2625,799
2020-03-15,LE,Spain,4238,701,872,4,3537,1367,1298,2665,868
2020-03-16,LE,Spain,3712,781,775,2,2931,1064,1092,2156,773
2020-03-17,LE,Spain,2805,590,560,3,2215,831,824,1655,557
2020-03-18,LE,Spain,2382,611,336,9,1771,728,707,1435,327
2020-03-19,LE,Spain,2239,588,255,5,1651,690,706,1396,250
2020-03-20,LE,Spain,2021,510,221,1,1511,648,642,1290,220
2020-03-21,LE,Spain,1627,391,182,3,1236,533,521,1054,179
2020-03-22,LE,Spain,1113,351,153,7,762,305,304,609,146
2020-03-23,LE,Spain,704,214,182,14,490,153,155,308,168
2020-03-24,LE,Spain,699,152,220,52,547,164,163,327,168
2020-03-25,LE,Spain,556,55,170,9,501,166,165,331,161
2020-03-26,LE,Spain,589,60,205,36,529,162,162,324,169
2020-03-27,LE,Spain,593,66,209,31,527,161,157,318,178
2020-03-28,LE,Spain,422,82,109,1,340,109,122,231,108
2020-03-29,LE,Spain,412,80,104,1,332,119,109,228,103
2020-03-30,LE,Spain,376,55,130,2,321,95,96,191,128
2020-03-31,LE,Spain,425,50,151,31,375,111,113,224,120
2020-04-01,LE,Spain,372,32,132,9,340,101,107,208,123
2020-04-02,LE,Spain,364,28,147,32,336,96,93,189,115
2020-04-03,LE,Spain,379,46,130,7,333,95,108,203,123
2020-04-04,LE,Spain,278,49,84,2,229,73,72,145,82
2020-04-05,LE,Spain,255,43,99,1,212,57,56,113,98
2020-04-06,LE,Spain,280,44,118,6,236,62,56,118,112
2020-04-07,LE,Spain,332,24,113,19,308,95,100,195,94
2020-04-08,LE,Spain,348,52,119,10,296,89,88,177,109
2020-04-09,LE,Spain,306,35,97,9,271,90,84,174,88
2020-04-10,LE,Spain,232,31,82,1,201,60,59,119,81
2020-04-11,LE,Spain,175,7,63,2,168,49,56,105,61
2020-04-12,LE,Spain,201,14,90,1,187,50,47,97,89
2020-04-13,LE,Spain,246,7,122,17,239,58,59,117,105
2020-04-14,LE,Spain,294,28,114,18,266,69,83,152,96
2020-04-15,LE,Spain,281,32,112,10,249,73,64,137,102
2020-04-16,LE,Spain,322,38,123,19,284,85,76,161,104
2020-04-17,LE,Spain,341,29,119,4,312,91,102,193,115
2020-04-18,LE,Spain,212,34,72,1,178,51,55,106,71
2020-04-19,LE,Spain,232,30,82,0,202,60,60,120,82
2020-04-20,LE,Spain,300,34,118,12,266,76,72,148,106
2020-04-21,LE,Spain,313,32,118,13,281,84,79,163,105
2020-04-22,LE,Spain,296,40,109,14,256,69,78,147,95
2020-04-23,LE,Spain,332,29,123,20,303,87,93,180,103
2020-04-24,LE,Spain,357,38,124,11,319,100,95,195,113
2020-04-25,LE,Spain,200,21,57,2,179,59,63,122,55
2020-04-26,LE,Spain,236,24,82,0,212,65,65,130,82
2020-04-27,LE,Spain,285,29,132,17,256,64,60,124,115
2020-04-28,LE,Spain,355,62,129,12,293,85,79,164,117
2020-04-29,LE,Spain,288,24,113,16,264,69,82,151,97
2020-04-30,LE,Spain,362,45,124,19,317,99,94,193,105
2020-05-01,LE,Spain,266,36,104,11,230,62,64,126,93
2020-05-02,LE,Spain,238,39,71,0,199,66,62,128,71
2020-05-03,LE,Spain,258,37,87,1,221,66,68,134,86
2020-05-04,LE,Spain,324,54,114,12,270,75,81,156,102
2020-05-05,LE,Spain,348,49,128,25,299,85,86,171,103
2020-05-06,LE,Spain,329,44,125,13,285,78,82,160,112
2020-05-07,LE,Spain,359,55,125,24,304,93,86,179,101
2020-05-08,LE,Spain,353,56,120,13,297,86,91,177,107
2020-05-09,LE,Spain,251,45,62,0,206,75,69,144,62
2020-05-10,LE,Spain,265,34,78,1,231,75,78,153,77
2020-05-11,LE,Spain,395,58,165,21,337,85,87,172,144
2020-05-12,LE,Spain,361,33,124,9,328,100,104,204,115
2020-05-13,LE,Spain,369,40,129,13,329,98,102,200,116
2020-05-14,LE,Spain,394,41,154,11,353,99,100,199,143
2020-05-15,LE,Spain,392,44,158,20,348,98,92,190,138
2020-05-16,LE,Spain,246,29,74,1,217,72,71,143,73
2020-05-17,LE,Spain,296,25,108,0,271,80,83,163,108
2020-05-18,LE,Spain,375,40,159,21,335,88,88,176,138
2020-05-19,LE,Spain,372,42,141,21,330,93,96,189,120
2020-05-20,LE,Spain,467,53,172,30,414,120,122,242,142
2020-05-21,LE,Spain,428,58,148,14,370,115,107,222,134
2020-05-22,LE,Spain,436,63,158,27,373,101,114,215,131
2020-05-23,LE,Spain,270,37,76,0,233,78,79,157,76
2020-05-24,LE,Spain,293,26,94,0,267,84,89,173,94
2020-05-25,LE,Spain,348,34,153,18,314,84,77,161,135
2020-05-26,LE,Spain,412,54,154,31,358,102,102,204,123
2020-05-27,LE,Spain,413,36,163,21,377,104,110,214,142
2020-05-28,LE,Spain,476,55,204,33,421,106,111,217,171
2020-05-29,LE,Spain,466,60,195,34,406,104,107,211,161
2020-05-30,LE,Spain,292,30,113,13,262,79,70,149,100
2020-05-31,LE,Spain,287,43,104,6,244,70,70,140,98
2020-06-01,LE,Spain,420,46,188,28,374,95,91,186,160
2020-06-02,LE,Spain,466,52,198,40,414,112,104,216,158
2020-06-03,LE,Spain,465,68,187,33,397,105,105,210,154
2020-06-04,LE,Spain,450,67,183,26,383,99,101,200,157
2020-06-05,LE,Spain,491,75,205,42,416,93,118,211,163
2020-06-06,LE,Spain,365,91,106,12,274,88,80,168,94
2020-06-07,LE,Spain,354,72,102,4,282,87,93,180,98
2020-06-08,LE,Spain,487,64,218,38,423,107,98,205,180
2020-06-09,LE,Spain,498,86,204,32,412,99,109,208,172
2020-06-10,LE,Spain,493,59,219,36,434,112,103,215,183
2020-06-11,LE,Spain,436,40,220,33,396,92,84,176,187
2020-06-12,LE,Spain,527,54,251,28,473,111,111,222,223
2020-06-13,LE,Spain,384,70,156,17,314,78,80,158,139
2020-06-14,LE,Spain,418,72,160,7,346,87,99,186,153
2020-06-15,LE,Spain,571,53,260,29,518,132,126,258,231
2020-06-16,LE,Spain,559,54,278,36,505,113,114,227,242
2020-06-17,LE,Spain,547,57,254,42,490,115,121,236,212
2020-06-18,LE,Spain,596,74,287,54,522,123,112,235,233
2020-06-19,LE,Spain,609,39,323,37,570,121,126,247,286
2020-06-20,LE,Spain,459,53,199,19,406,101,106,207,180
2020-06-21,LE,Spain,738,83,282,9,655,182,191,373,273
2020-06-22,LE,Spain,836,25,425,40,811,190,196,386,385
2020-06-23,LE,Spain,822,45,401,41,777,180,196,376,360
2020-06-24,LE,Spain,840,54,382,32,786,200,204,404,350
2020-06-25,LE,Spain,830,46,408,34,784,184,192,376,374
2020-06-26,LE,Spain,991,65,446,22,926,234,246,480,424
2020-06-27,LE,Spain,895,99,304,13,796,237,255,492,291
2020-06-28,LE,Spain,933,79,403,25,854,237,214,451,378
2020-06-29,LE,Spain,956,83,409,26,873,239,225,464,383
2020-06-30,LE,Spain,946,98,393,21,848,231,224,455,372
2020-07-01,LE,Spain,1858,156,594,33,1702,524,584,1108,561
2020-07-02,LE,Spain,1888,170,623,31,1718,541,554,1095,592
2020-07-03,LE,Spain,2163,217,708,31,1946,614,624,1238,677
2020-07-04,LE,Spain,2192,272,516,8,1920,696,708,1404,508
2020-07-05,LE,Spain,2075,217,601,10,1858,634,623,1257,591
2020-07-06,LE,Spain,1987,189,656,38,1798,575,567,1142,618
2020-07-07,LE,Spain,1921,208,631,44,1713,541,541,1082,587
2020-07-08,LE,Spain,1962,178,679,54,1784,555,550,1105,625
2020-07-09,LE,Spain,2024,184,703,58,1840,579,558,1137,645
2020-07-10,LE,Spain,2321,234,775,36,2087,646,666,1312,739
2020-07-11,LE,Spain,2486,295,602,18,2191,783,806,1589,584
2020-07-12,LE,Spain,2254,203,670,14,2051,696,685,1381,656
2020-07-13,LE,Spain,2212,184,771,45,2028,633,624,1257,726
2020-07-14,LE,Spain,2082,174,731,47,1908,592,585,1177,684
2020-07-15,LE,Spain,2251,216,753,42,2035,647,635,1282,711
2020-07-16,LE,Spain,2482,218,801,46,2264,722,741,1463,755
2020-07-17,LE,Spain,2789,219,926,39,2570,815,829,1644,887
2020-07-18,LE,Spain,2876,292,728,12,2584,918,938,1856,716
2020-07-19,LE,Spain,2772,241,820,9,2531,868,843,1711,811
2020-07-20,LE,Spain,2667,229,888,38,2438,783,767,1550,850
2020-07-21,LE,Spain,2445,213,811,47,2232,714,707,1421,764
2020-07-22,LE,Spain,2406,224,825,39,2182,673,684,1357,786
2020-07-23,LE,Spain,2575,241,830,38,2334,745,759,1504,792
2020-07-24,LE,Spain,2895,258,945,35,2637,840,852,1692,910
2020-07-25,LE,Spain,3093,285,754,21,2808,1023,1031,2054,733
2020-07-26,LE,Spain,2956,234,863,15,2722,942,917,1859,848
2020-07-27,LE,Spain,2686,219,897,34,2467,795,775,1570,863
2020-07-28,LE,Spain,2477,234,791,44,2243,731,721,1452,747
2020-07-29,LE,Spain,2516,265,833,42,2251,709,709,1418,791
2020-07-30,LE,Spain,2684,250,855,38,2434,785,794,1579,817
2020-07-31,LE,Spain,2938,217,969,47,2721,876,876,1752,922
2020-08-01,LE,Spain,3692,377,924,27,3315,1182,1209,2391,897
2020-08-02,LE,Spain,3584,353,991,10,3231,1132,1108,2240,981
2020-08-03,LE,Spain,3381,345,1016,34,3036,1017,1003,2020,982
2020-08-04,LE,Spain,2900,301,901,40,2599,852,846,1698,861
2020-08-05,LE,Spain,2884,302,921,37,2582,830,831,1661,884
2020-08-06,LE,Spain,3128,322,981,46,2806,909,916,1825,935
2020-08-07,LE,Spain,3421,344,1062,23,3077,1015,1000,2015,1039
2020-08-08,LE,Spain,3543,405,922,9,3138,1097,1119,2216,913
2020-08-09,LE,Spain,3453,364,990,12,3089,1063,1036,2099,978
2020-08-10,LE,Spain,3187,325,971,26,2862,944,947,1891,945
2020-08-11,LE,Spain,2789,279,880,30,2510,819,811,1630,850
2020-08-12,LE,Spain,2806,291,903,33,2515,805,807,1612,870
2020-08-13,LE,Spain,3024,327,969,30,2697,862,866,1728,939
2020-08-14,LE,Spain,3370,362,1090,40,3008,952,966,1918,1050
2020-08-15,LE,Spain,3490,410,918,27,3080,1077,1085,2162,891
2020-08-16,LE,Spain,3517,384,1005,13,3133,1089,1039,2128,992
2020-08-17,LE,Spain,3195,357,1003,36,2838,921,914,1835,967
2020-08-18,LE,Spain,2828,314,909,55,2514,801,804,1605,854
2020-08-19,LE,Spain,2837,311,928,36,2526,800,798,1598,892
2020-08-20,LE,Spain,3044,325,984,45,2719,868,867,1735,939
2020-08-21,LE,Spain,3269,343,1060,27,2926,932,934,1866,1033
2020-08-22,LE,Spain,3436,427,924,25,3009,1038,1047,2085,899
2020-08-23,LE,Spain,3415,394,1022,27,3021,1008,991,1999,995
2020-08-24,LE,Spain,3184,424,1025,34,2760,871,864,1735,991
2020-08-25,LE,Spain,2742,348,895,44,2394,748,751,1499,851
2020-08-26,LE,Spain,2788,344,947,43,2444,746,751,1497,904
2020-08-27,LE,Spain,3036,373,996,48,2663,827,840,1667,948
2020-08-28,LE,Spain,3300,403,1064,31,2897,921,912,1833,1033
2020-08-29,LE,Spain,3369,464,889,10,2905,1011,1005,2016,879
2020-08-30,LE,Spain,3377,419,1028,13,2958,973,957,1930,1015
2020-08-31,LE,Spain,3055,377,1008,36,2678,837,833,1670,972
2020-09-01,LE,Spain,2404,270,847,36,2134,642,645,1287,811
2020-09-02,LE,Spain,2407,299,913,42,2108,589,606,1195,871
2020-09-03,LE,Spain,2549,302,904,49,2247,663,680,1343,855
2020-09-04,LE,Spain,2789,341,990,39,2448,731,727,1458,951
2020-09-05,LE,Spain,2882,417,793,15,2465,837,835,1672,778
2020-09-06,LE,Spain,2813,370,907,21,2443,773,763,1536,886
2020-09-07,LE,Spain,2565,305,922,49,2260,672,666,1338,873
2020-09-08,LE,Spain,2216,264,817,29,1952,570,565,1135,788
2020-09-09,LE,Spain,2249,275,879,46,1974,546,549,1095,833
2020-09-10,LE,Spain,2441,343,887,38,2098,609,602,1211,849
2020-09-11,LE,Spain,2678,357,981,42,2321,665,675,1340,939
2020-09-12,LE,Spain,2629,416,785,20,2213,719,709,1428,765
2020-09-13,LE,Spain,2673,409,889,18,2264,689,686,1375,871
2020-09-14,LE,Spain,2404,359,856,33,2045,597,592,1189,823
2020-09-15,LE,Spain,2075,321,721,40,1754,524,509,1033,681
2020-09-16,LE,Spain,2048,322,748,52,1726,486,492,978,696
2020-09-17,LE,Spain,2191,344,734,44,1847,550,563,1113,690
2020-09-18,LE,Spain,2487,384,823,18,2103,635,645,1280,805
2020-09-19,LE,Spain,2431,441,680,17,1990,657,653,1310,663
2020-09-20,LE,Spain,2535,423,823,24,2112,644,645,1289,799
2020-09-21,LE,Spain,2303,358,815,41,1945,570,560,1130,774
2020-09-22,LE,Spain,1961,289,702,35,1672,485,485,970,667
2020-09-23,LE,Spain,1990,306,719,35,1684,481,484,965,684
2020-09-24,LE,Spain,2152,351,706,29,1801,547,548,1095,677
2020-09-25,LE,Spain,2419,367,833,24,2052,599,620,1219,809
2020-09-26,LE,Spain,2384,429,650,11,1955,644,661,1305,639
2020-09-27,LE,Spain,2534,434,773,11,2100,675,652,1327,762
2020-09-28,LE,Spain,2243,334,779,37,1909,565,565,1130,742
2020-09-29,LE,Spain,1967,288,690,45,1679,497,492,989,645
2020-09-30,LE,Spain,2026,307,746,42,1719,489,484,973,704
2020-10-01,LE,Spain,1935,296,723,31,1639,453,463,916,692
2020-10-02,LE,Spain,2248,355,802,21,1893,544,547,1091,781
2020-10-03,LE,Spain,2203,433,603,9,1770,576,591,1167,594
2020-10-04,LE,Spain,2243,390,719,10,1853,578,556,1134,709
2020-10-05,LE,Spain,1985,315,747,41,1670,461,462,923,706
2020-10-06,LE,Spain,1637,249,624,32,1388,383,381,764,592
2020-10-07,LE,Spain,1723,254,655,37,1469,406,408,814,618
2020-10-08,LE,Spain,1870,283,695,47,1587,450,442,892,648
2020-10-09,LE,Spain,2289,313,850,31,1976,553,573,1126,819
2020-10-10,LE,Spain,2139,431,593,9,1708,556,559,1115,584
2020-10-11,LE,Spain,2189,424,658,6,1765,571,536,1107,652
2020-10-12,LE,Spain,1959,294,726,10,1665,462,477,939,716
2020-10-13,LE,Spain,1572,220,643,44,1352,349,360,709,599
2020-10-14,LE,Spain,1736,257,682,37,1479,403,394,797,645
2020-10-15,LE,Spain,1852,294,709,36,1558,427,422,849,673
2020-10-16,LE,Spain,2346,342,901,42,2004,535,568,1103,859
2020-10-17,LE,Spain,2306,470,638,23,1836,599,599,1198,615
2020-10-18,LE,Spain,2255,377,742,14,1878,573,563,1136,728
2020-10-19,LE,Spain,1921,317,752,27,1604,430,422,852,725
2020-10-20,LE,Spain,1471,265,549,36,1206,328,329,657,513
2020-10-21,LE,Spain,1562,217,623,40,1345,362,360,722,583
2020-10-22,LE,Spain,1672,259,628,41,1413,390,395,785,587
2020-10-23,LE,Spain,2144,311,820,27,1833,494,519,1013,793
2020-10-24,LE,Spain,2196,442,588,19,1754,580,586,1166,569
2020-10-25,LE,Spain,2105,391,713,8,1714,506,495,1001,705
2020-10-26,LE,Spain,1851,298,716,29,1553,423,414,837,687
2020-10-27,LE,Spain,1367,175,604,32,1192,297,291,588,572
2020-10-28,LE,Spain,1524,230,625,29,1294,334,335,669,596
2020-10-29,LE,Spain,1736,253,687,38,1483,373,423,796,649
2020-10-30,LE,Spain,2178,307,867,49,1871,509,495,1004,818
2020-10-31,LE,Spain,2083,366,592,27,1717,567,558,1125,565
2020-11-01,LE,Spain,2034,372,624,17,1662,520,518,1038,607
2020-11-02,LE,Spain,1705,238,653,20,1467,418,396,814,633
2020-11-03,LE,Spain,1275,130,524,39,1145,322,299,621,485
2020-11-04,LE,Spain,1341,155,519,31,1186,325,342,667,488
2020-11-05,LE,Spain,1312,131,562,34,1181,306,313,619,528
2020-11-06,LE,Spain,1812,230,702,36,1582,432,448,880,666
2020-11-07,LE,Spain,1658,274,462,14,1384,459,463,922,448
2020-11-08,LE,Spain,1718,260,557,17,1458,463,438,901,540
2020-11-09,LE,Spain,1475,172,594,32,1303,359,350,709,562
2020-11-10,LE,Spain,1137,95,496,32,1042,282,264,546,464
2020-11-11,LE,Spain,1203,101,536,36,1102,277,289,566,500
2020-11-12,LE,Spain,1193,142,495,24,1051,283,273,556,471
2020-11-13,LE,Spain,1610,166,688,29,1444,368,388,756,659
2020-11-14,LE,Spain,1413,207,465,16,1206,369,372,741,449
2020-11-15,LE,Spain,1530,220,582,20,1310,381,347,728,562
2020-11-16,LE,Spain,1369,126,605,26,1243,312,326,638,579
2020-11-17,LE,Spain,1067,63,523,26,1004,237,244,481,497
2020-11-18,LE,Spain,1193,66,543,35,1127,284,300,584,508
2020-11-19,LE,Spain,1152,63,508,24,1089,298,283,581,484
2020-11-20,LE,Spain,1421,127,667,40,1294,308,319,627,627
2020-11-21,LE,Spain,1283,158,445,18,1125,331,349,680,427
2020-11-22,LE,Spain,1398,162,576,18,1236,338,322,660,558
2020-11-23,LE,Spain,1214,86,601,34,1128,279,248,527,567
2020-11-24,LE,Spain,942,41,519,52,901,195,187,382,467
2020-11-25,LE,Spain,1046,48,527,29,998,234,237,471,498
2020-11-26,LE,Spain,1049,73,490,24,976,245,241,486,466
2020-11-27,LE,Spain,1392,125,647,23,1267,299,321,620,624
2020-11-28,LE,Spain,1184,135,436,11,1049,305,308,613,425
2020-11-29,LE,Spain,1273,134,528,3,1139,312,299,611,525
2020-11-30,LE,Spain,1281,105,620,40,1176,287,269,556,580
2020-12-01,LE,Spain,1053,68,543,31,985,219,223,442,512
2020-12-02,LE,Spain,1171,58,566,31,1113,269,278,547,535
2020-12-03,LE,Spain,1249,56,614,31,1193,294,285,579,583
2020-12-04,LE,Spain,1525,87,760,16,1438,340,338,678,744
2020-12-05,LE,Spain,1375,133,490,5,1242,378,374,752,485
2020-12-06,LE,Spain,1217,173,443,18,1044,308,293,601,425
2020-12-07,LE,Spain,1099,111,443,13,988,275,270,545,430
2020-12-08,LE,Spain,1116,22,592,9,1094,244,258,502,583
2020-12-09,LE,Spain,1197,73,568,42,1124,283,273,556,526
2020-12-10,LE,Spain,1271,127,509,22,1144,309,326,635,487
2020-12-11,LE,Spain,1566,188,646,19,1378,364,368,732,627
2020-12-12,LE,Spain,1496,227,467,15,1269,396,406,802,452
2020-12-13,LE,Spain,1501,191,604,15,1310,353,353,706,589
2020-12-14,LE,Spain,1449,160,629,26,1289,337,323,660,603
2020-12-15,LE,Spain,1293,149,543,32,1144,304,297,601,511
2020-12-16,LE,Spain,1439,141,613,30,1298,335,350,685,583
2020-12-17,LE,Spain,1892,299,691,35,1593,449,453,902,656
2020-12-18,LE,Spain,2289,400,788,18,1889,548,553,1101,770
2020-12-19,LE,Spain,2477,493,615,6,1984,673,696,1369,609
2020-12-20,LE,Spain,2272,454,665,4,1818,586,567,1153,661
2020-12-21,LE,Spain,2040,340,734,30,1700,474,492,966,704
2020-12-22,LE,Spain,1920,220,749,24,1700,477,474,951,725
2020-12-23,LE,Spain,2084,267,801,27,1817,520,496,1016,774
2020-12-24,LE,Spain,1496,292,549,4,1204,317,338,655,545
2020-12-25,LE,Spain,994,192,375,1,802,204,223,427,374
2020-12-26,LE,Spain,2135,395,606,9,1740,561,573,1134,597
2020-12-27,LE,Spain,2157,372,701,9,1785,538,546,1084,692
2020-12-28,LE,Spain,1857,287,668,16,1570,455,447,902,652
2020-12-29,LE,Spain,1591,223,622,3,1368,371,375,746,619
2020-12-30,LE,Spain,1797,250,693,14,1547,423,431,854,679
2020-12-31,LE,Spain,1234,240,463,2,994,265,266,531,461
2020-01-01,ES,Sweden,1617,959,149,0,658,256,253,509,149
2020-01-02,ES,Sweden,2100,1217,227,2,883,325,331,656,225
2020-01-03,ES,Sweden,2048,1147,231,7,901,333,337,670,224
2020-01-04,ES,Sweden,1535,944,88,3,591,254,249,503,85
2020-01-05,ES,Sweden,2023,1175,201,2,848,321,326,647,199
2020-01-06,ES,Sweden,2047,1151,205,4,896,343,348,691,201
2020-01-07,ES,Sweden,2008,1065,286,3,943,329,328,657,283
2020-01-08,ES,Sweden,2090,1072,329,12,1018,342,347,689,317
2020-01-09,ES,Sweden,2076,1071,335,12,1005,339,331,670,323
2020-01-10,ES,Sweden,2154,1108,323,11,1046,367,356,723,312
2020-01-11,ES,Sweden,1474,943,92,6,531,216,223,439,86
2020-01-12,ES,Sweden,1896,1072,229,4,824,298,297,595,225
2020-01-13,ES,Sweden,2223,1142,364,20,1081,356,361,717,344
2020-01-14,ES,Sweden,2069,1055,376,19,1014,321,317,638,357
2020-01-15,ES,Sweden,2128,1056,411,19,1072,327,334,661,392
2020-01-16,ES,Sweden,2175,1075,427,17,1100,339,334,673,410
2020-01-17,ES,Sweden,2279,1157,404,19,1122,355,363,718,385
2020-01-18,ES,Sweden,1430,931,92,0,499,207,200,407,92
2020-01-19,ES,Sweden,1894,1023,264,8,871,298,309,607,256
2020-01-20,ES,Sweden,2207,1134,369,21,1073,354,350,704,348
2020-01-21,ES,Sweden,2021,986,387,16,1035,324,324,648,371
2020-01-22,ES,Sweden,2089,977,424,18,1112,344,344,688,406
2020-01-23,ES,Sweden,2200,1073,437,14,1127,347,343,690,423
2020-01-24,ES,Sweden,2265,1137,403,12,1128,359,366,725,391
2020-01-25,ES,Sweden,1424,902,85,1,522,218,219,437,84
2020-01-26,ES,Sweden,1970,1091,277,4,879,300,302,602,273
2020-01-27,ES,Sweden,2284,1185,377,14,1099,359,363,722,363
2020-01-28,ES,Sweden,2055,1028,383,20,1027,324,320,644,363
2020-01-29,ES,Sweden,2190,1078,420,16,1112,341,351,692,404
2020-01-30,ES,Sweden,2298,1147,454,15,1151,349,348,697,439
2020-01-31,ES,Sweden,2353,1219,414,12,1134,363,357,720,402
2020-02-01,ES,Sweden,1485,936,100,0,549,226,223,449,100
2020-02-02,ES,Sweden,2028,1133,281,3,895,306,308,614,278
2020-02-03,ES,Sweden,2299,1149,400,21,1150,374,376,750,379
2020-02-04,ES,Sweden,1942,907,372,8,1035,337,326,663,364
2020-02-05,ES,Sweden,2180,1014,438,12,1166,358,370,728,426
2020-02-06,ES,Sweden,2202,1039,472,10,1163,347,344,691,462
2020-02-07,ES,Sweden,2314,1137,417,15,1177,377,383,760,402
2020-02-08,ES,Sweden,1562,959,113,6,603,243,247,490,107
2020-02-09,ES,Sweden,1933,1078,278,9,855,288,289,577,269
2020-02-10,ES,Sweden,2156,1126,356,5,1030,336,338,674,351
2020-02-11,ES,Sweden,2089,1033,392,19,1056,333,331,664,373
2020-02-12,ES,Sweden,2214,1071,421,20,1143,359,363,722,401
2020-02-13,ES,Sweden,2267,1121,447,18,1146,355,344,699,429
2020-02-14,ES,Sweden,2246,1094,409,21,1152,371,372,743,388
2020-02-15,ES,Sweden,1619,992,117,4,627,254,256,510,113
2020-02-16,ES,Sweden,2050,1152,287,3,898,308,303,611,284
2020-02-17,ES,Sweden,2219,1143,359,15,1076,352,365,717,344
2020-02-18,ES,Sweden,2110,1050,388,8,1060,339,333,672,380
2020-02-19,ES,Sweden,2190,1042,426,20,1148,360,362,722,406
2020-02-20,ES,Sweden,2269,1130,418,18,1139,357,364,721,400
2020-02-21,ES,Sweden,2379,1194,398,23,1185,393,394,787,375
2020-02-22,ES,Sweden,1647,975,115,2,672,291,266,557,113
2020-02-23,ES,Sweden,2046,1123,290,14,923,315,318,633,276
2020-02-24,ES,Sweden,2187,1107,368,15,1080,358,354,712,353
2020-02-25,ES,Sweden,2135,1072,389,17,1063,340,334,674,372
2020-02-26,ES,Sweden,2124,994,422,24,1130,350,358,708,398
2020-02-27,ES,Sweden,2305,1153,427,16,1152,362,363,725,411
2020-02-28,ES,Sweden,2397,1238,391,28,1159,384,384,768,363
2020-02-29,ES,Sweden,1658,957,121,5,701,284,296,580,116
2020-03-01,ES,Sweden,2139,1162,290,6,977,341,346,687,284
2020-03-02,ES,Sweden,2350,1188,378,17,1162,397,387,784,361
2020-03-03,ES,Sweden,2020,904,404,19,1116,354,358,712,385
2020-03-04,ES,Sweden,2263,1088,433,21,1175,373,369,742,412
2020-03-05,ES,Sweden,2357,1135,463,31,1222,378,381,759,432
2020-03-06,ES,Sweden,2188,1009,406,14,1179,385,388,773,392
2020-03-07,ES,Sweden,1487,852,104,3,635,264,267,531,101
2020-03-08,ES,Sweden,2094,1162,269,3,932,333,330,663,266
2020-03-09,ES,Sweden,2275,1123,401,14,1152,377,374,751,387
2020-03-10,ES,Sweden,2123,1043,418,16,1080,332,330,662,402
2020-03-11,ES,Sweden,2190,1058,442,23,1132,346,344,690,419
2020-03-12,ES,Sweden,2144,1078,392,17,1066,335,339,674,375
2020-03-13,ES,Sweden,2235,1131,404,23,1104,354,346,700,381
2020-03-14,ES,Sweden,1412,849,103,9,563,230,230,460,94
2020-03-15,ES,Sweden,1736,918,254,6,818,276,288,564,248
2020-03-16,ES,Sweden,1613,786,318,15,827,251,258,509,303
2020-03-17,ES,Sweden,1324,592,301,29,732,217,214,431,272
2020-03-18,ES,Sweden,1241,562,296,27,679,197,186,383,269
2020-03-19,ES,Sweden,1109,499,276,37,610,170,164,334,239
2020-03-20,ES,Sweden,1001,426,230,34,575,173,172,345,196
2020-03-21,ES,Sweden,685,415,56,13,270,107,107,214,43
2020-03-22,ES,Sweden,675,338,157,8,337,91,89,180,149
2020-03-23,ES,Sweden,681,330,192,28,351,82,77,159,164
2020-03-24,ES,Sweden,636,318,170,35,318,69,79,148,135
2020-03-25,ES,Sweden,608,279,167,32,329,81,81,162,135
2020-03-26,ES,Sweden,583,266,177,31,317,71,69,140,146
2020-03-27,ES,Sweden,582,259,174,22,323,75,74,149,152
2020-03-28,ES,Sweden,294,186,30,4,108,40,38,78,26
2020-03-29,ES,Sweden,358,164,116,7,194,40,38,78,109
2020-03-30,ES,Sweden,422,149,155,27,273,60,58,118,128
2020-03-31,ES,Sweden,435,192,119,27,243,61,63,124,92
2020-04-01,ES,Sweden,438,187,137,29,251,56,58,114,108
2020-04-02,ES,Sweden,402,179,126,23,223,49,48,97,103
2020-04-03,ES,Sweden,413,199,111,18,214,48,55,103,93
2020-04-04,ES,Sweden,204,140,23,5,64,20,21,41,18
2020-04-05,ES,Sweden,262,148,58,6,114,28,28,56,52
2020-04-06,ES,Sweden,374,160,117,25,214,48,49,97,92
2020-04-07,ES,Sweden,391,178,123,27,213,47,43,90,96
2020-04-08,ES,Sweden,388,173,122,40,215,48,45,93,82
2020-04-09,ES,Sweden,352,169,98,15,183,41,44,85,83
2020-04-10,ES,Sweden,233,149,41,9,84,22,21,43,32
2020-04-11,ES,Sweden,179,132,20,4,47,13,14,27,16
2020-04-12,ES,Sweden,190,130,29,3,60,17,14,31,26
2020-04-13,ES,Sweden,223,134,43,8,89,20,26,46,35
2020-04-14,ES,Sweden,358,164,107,24,194,40,47,87,83
2020-04-15,ES,Sweden,396,185,105,27,211,56,50,106,78
2020-04-16,ES,Sweden,369,170,119,29,199,39,41,80,90
2020-04-17,ES,Sweden,356,182,89,16,174,44,41,85,73
2020-04-18,ES,Sweden,199,139,19,6,60,21,20,41,13
2020-04-19,ES,Sweden,265,169,52,14,96,21,23,44,38
2020-04-20,ES,Sweden,377,182,113,18,195,41,41,82,95
2020-04-21,ES,Sweden,393,183,125,30,210,43,42,85,95
2020-04-22,ES,Sweden,405,202,105,18,203,49,49,98,87
2020-04-23,ES,Sweden,411,199,124,25,212,44,44,88,99
2020-04-24,ES,Sweden,383,193,108,14,190,39,43,82,94
2020-04-25,ES,Sweden,243,186,15,2,57,22,20,42,13
2020-04-26,ES,Sweden,294,188,50,6,106,29,27,56,44
2020-04-27,ES,Sweden,369,188,99,13,181,41,41,82,86
2020-04-28,ES,Sweden,382,193,95,30,189,46,48,94,65
2020-04-29,ES,Sweden,450,245,103,25,205,50,52,102,78
2020-04-30,ES,Sweden,370,202,96,26,168,37,35,72,70
2020-05-01,ES,Sweden,309,219,37,3,90,26,27,53,34
2020-05-02,ES,Sweden,259,209,11,2,50,19,20,39,9
2020-05-03,ES,Sweden,299,205,46,7,94,24,24,48,39
2020-05-04,ES,Sweden,410,214,102,22,196,50,44,94,80
2020-05-05,ES,Sweden,420,236,96,25,184,42,46,88,71
2020-05-06,ES,Sweden,458,255,96,26,203,54,53,107,70
2020-05-07,ES,Sweden,493,242,148,36,251,55,48,103,112
2020-05-08,ES,Sweden,429,251,93,17,178,41,44,85,76
2020-05-09,ES,Sweden,280,209,24,10,71,23,24,47,14
2020-05-10,ES,Sweden,323,215,52,3,108,27,29,56,49
2020-05-11,ES,Sweden,432,223,107,18,209,52,50,102,89
2020-05-12,ES,Sweden,460,265,104,19,195,45,46,91,85
2020-05-13,ES,Sweden,497,280,120,28,217,49,48,97,92
2020-05-14,ES,Sweden,483,254,129,33,229,48,52,100,96
2020-05-15,ES,Sweden,506,272,119,20,234,57,58,115,99
2020-05-16,ES,Sweden,344,248,34,13,96,28,34,62,21
2020-05-17,ES,Sweden,350,243,52,7,107,29,26,55,45
2020-05-18,ES,Sweden,464,248,122,28,216,48,46,94,94
2020-05-19,ES,Sweden,481,266,114,31,215,48,53,101,83
2020-05-20,ES,Sweden,520,296,105,29,224,56,63,119,76
2020-05-21,ES,Sweden,393,252,72,27,141,35,34,69,45
2020-05-22,ES,Sweden,457,297,80,15,160,39,41,80,65
2020-05-23,ES,Sweden,348,264,19,7,84,35,30,65,12
2020-05-24,ES,Sweden,397,274,58,5,123,30,35,65,53
2020-05-25,ES,Sweden,497,269,130,26,228,53,45,98,104
2020-05-26,ES,Sweden,530,286,121,25,244,60,63,123,96
2020-05-27,ES,Sweden,519,282,115,23,237,60,62,122,92
2020-05-28,ES,Sweden,505,279,124,26,226,54,48,102,98
2020-05-29,ES,Sweden,527,306,117,27,221,53,51,104,90
2020-05-30,ES,Sweden,320,240,26,9,80,25,29,54,17
2020-05-31,ES,Sweden,384,256,69,11,128,28,31,59,58
2020-06-01,ES,Sweden,472,251,130,30,221,49,42,91,100
2020-06-02,ES,Sweden,489,274,122,22,215,44,49,93,100
2020-06-03,ES,Sweden,572,306,129,32,266,68,69,137,97
2020-06-04,ES,Sweden,526,292,121,25,234,58,55,113,96
2020-06-05,ES,Sweden,522,314,101,24,208,51,56,107,77
2020-06-06,ES,Sweden,383,302,19,5,81,32,30,62,14
2020-06-07,ES,Sweden,415,276,59,10,139,38,42,80,49
2020-06-08,ES,Sweden,523,296,121,28,227,54,52,106,93
2020-06-09,ES,Sweden,491,257,109,15,234,62,63,125,94
2020-06-10,ES,Sweden,578,308,124,30,270,74,72,146,94
2020-06-11,ES,Sweden,490,253,111,27,237,61,65,126,84
2020-06-12,ES,Sweden,535,294,121,23,241,60,60,120,98
2020-06-13,ES,Sweden,324,232,34,9,92,29,29,58,25
2020-06-14,ES,Sweden,418,270,61,8,148,46,41,87,53
2020-06-15,ES,Sweden,573,311,139,25,262,63,60,123,114
2020-06-16,ES,Sweden,580,308,153,34,272,59,60,119,119
2020-06-17,ES,Sweden,678,349,170,34,329,80,79,159,136
2020-06-18,ES,Sweden,605,310,157,23,295,69,69,138,134
2020-06-19,ES,Sweden,456,350,16,8,106,44,46,90,8
2020-06-20,ES,Sweden,348,277,21,3,71,25,25,50,18
2020-06-21,ES,Sweden,469,287,80,3,182,50,52,102,77
2020-06-22,ES,Sweden,622,340,145,18,282,68,69,137,127
2020-06-23,ES,Sweden,587,319,140,23,268,63,65,128,117
2020-06-24,ES,Sweden,655,339,158,21,316,79,79,158,137
2020-06-25,ES,Sweden,597,298,160,25,299,70,69,139,135
2020-06-26,ES,Sweden,658,373,141,12,285,73,71,144,129
2020-06-27,ES,Sweden,396,286,30,5,110,42,38,80,25
2020-06-28,ES,Sweden,499,319,72,8,180,50,58,108,64
2020-06-29,ES,Sweden,622,364,129,17,258,65,64,129,112
2020-06-30,ES,Sweden,623,366,136,16,257,60,61,121,120
2020-07-01,ES,Sweden,831,458,159,20,373,108,106,214,139
2020-07-02,ES,Sweden,782,443,158,17,339,94,87,181,141
2020-07-03,ES,Sweden,852,478,163,14,374,109,102,211,149
2020-07-04,ES,Sweden,567,419,32,3,148,57,59,116,29
2020-07-05,ES,Sweden,703,421,89,6,282,92,101,193,83
2020-07-06,ES,Sweden,735,429,130,13,306,90,86,176,117
2020-07-07,ES,Sweden,734,430,142,11,304,83,79,162,131
2020-07-08,ES,Sweden,806,448,145,18,358,103,110,213,127
2020-07-09,ES,Sweden,753,427,163,16,326,83,80,163,147
2020-07-10,ES,Sweden,814,463,139,9,351,106,106,212,130
2020-07-11,ES,Sweden,593,427,39,8,166,64,63,127,31
2020-07-12,ES,Sweden,694,424,86,3,270,88,96,184,83
2020-07-13,ES,Sweden,761,435,128,12,326,101,97,198,116
2020-07-14,ES,Sweden,766,436,150,13,330,90,90,180,137
2020-07-15,ES,Sweden,817,472,132,16,345,110,103,213,116
2020-07-16,ES,Sweden,783,442,150,23,341,95,96,191,127
2020-07-17,ES,Sweden,808,472,137,14,336,98,101,199,123
2020-07-18,ES,Sweden,656,474,41,7,182,70,71,141,34
2020-07-19,ES,Sweden,741,467,95,6,274,90,89,179,89
2020-07-20,ES,Sweden,780,449,141,12,331,97,93,190,129
2020-07-21,ES,Sweden,791,470,156,14,321,82,83,165,142
2020-07-22,ES,Sweden,809,472,137,15,337,97,103,200,122
2020-07-23,ES,Sweden,821,486,143,9,335,96,96,192,134
2020-07-24,ES,Sweden,829,507,129,12,322,96,97,193,117
2020-07-25,ES,Sweden,684,486,42,6,198,79,77,156,36
2020-07-26,ES,Sweden,760,472,94,5,288,92,102,194,89
2020-07-27,ES,Sweden,769,432,136,9,337,103,98,201,127
2020-07-28,ES,Sweden,759,466,134,15,293,81,78,159,119
2020-07-29,ES,Sweden,816,483,143,16,333,94,96,190,127
2020-07-30,ES,Sweden,819,495,125,14,324,101,98,199,111
2020-07-31,ES,Sweden,783,467,121,8,316,95,100,195,113
2020-08-01,ES,Sweden,727,507,51,0,220,85,84,169,51
2020-08-02,ES,Sweden,799,478,95,9,321,112,114,226,86
2020-08-03,ES,Sweden,830,451,156,11,379,107,116,223,145
2020-08-04,ES,Sweden,803,473,139,19,330,98,93,191,120
2020-08-05,ES,Sweden,877,495,144,15,382,119,119,238,129
2020-08-06,ES,Sweden,872,494,168,23,378,107,103,210,145
2020-08-07,ES,Sweden,903,514,156,16,389,117,116,233,140
2020-08-08,ES,Sweden,671,459,30,2,212,95,87,182,28
2020-08-09,ES,Sweden,788,444,114,5,344,115,115,230,109
2020-08-10,ES,Sweden,856,484,131,12,372,119,122,241,119
2020-08-11,ES,Sweden,803,473,133,10,330,99,98,197,123
2020-08-12,ES,Sweden,886,472,168,19,414,122,124,246,149
2020-08-13,ES,Sweden,921,502,169,21,419,126,124,250,148
2020-08-14,ES,Sweden,939,530,154,23,409,129,126,255,131
2020-08-15,ES,Sweden,733,495,41,4,238,98,99,197,37
2020-08-16,ES,Sweden,867,502,103,11,365,130,132,262,92
2020-08-17,ES,Sweden,927,469,187,31,458,137,134,271,156
2020-08-18,ES,Sweden,828,437,178,27,391,107,106,213,151
2020-08-19,ES,Sweden,911,500,171,22,411,123,117,240,149
2020-08-20,ES,Sweden,895,479,177,28,416,120,119,239,149
2020-08-21,ES,Sweden,967,528,182,28,439,125,132,257,154
2020-08-22,ES,Sweden,712,454,43,6,258,108,107,215,37
2020-08-23,ES,Sweden,882,521,116,7,361,121,124,245,109
2020-08-24,ES,Sweden,921,478,197,22,443,124,122,246,175
2020-08-25,ES,Sweden,894,500,193,27,394,101,100,201,166
2020-08-26,ES,Sweden,932,501,194,26,431,119,118,237,168
2020-08-27,ES,Sweden,930,478,205,30,452,125,122,247,175
2020-08-28,ES,Sweden,960,495,203,25,465,133,129,262,178
2020-08-29,ES,Sweden,697,457,39,3,240,102,99,201,36
2020-08-30,ES,Sweden,868,489,119,5,379,126,134,260,114
2020-08-31,ES,Sweden,949,470,208,21,479,136,135,271,187
2020-09-01,ES,Sweden,886,471,185,23,415,110,120,230,162
2020-09-02,ES,Sweden,914,454,190,25,460,138,132,270,165
2020-09-03,ES,Sweden,984,514,206,12,470,134,130,264,194
2020-09-04,ES,Sweden,1018,530,205,23,488,139,144,283,182
2020-09-05,ES,Sweden,694,459,36,4,235,100,99,199,32
2020-09-06,ES,Sweden,871,501,115,4,370,123,132,255,111
2020-09-07,ES,Sweden,955,499,207,28,456,127,122,249,179
2020-09-08,ES,Sweden,889,491,187,19,398,105,106,211,168
2020-09-09,ES,Sweden,925,481,197,16,444,125,122,247,181
2020-09-10,ES,Sweden,973,503,189,17,470,142,139,281,172
2020-09-11,ES,Sweden,996,538,184,18,458,137,137,274,166
2020-09-12,ES,Sweden,703,466,40,6,237,100,97,197,34
2020-09-13,ES,Sweden,862,489,121,8,373,119,133,252,113
2020-09-14,ES,Sweden,933,471,198,29,462,132,132,264,169
2020-09-15,ES,Sweden,874,447,207,25,427,108,112,220,182
2020-09-16,ES,Sweden,894,443,203,27,451,126,122,248,176
2020-09-17,ES,Sweden,949,447,218,21,502,141,143,284,197
2020-09-18,ES,Sweden,980,507,210,19,473,135,128,263,191
2020-09-19,ES,Sweden,642,418,45,4,224,91,88,179,41
2020-09-20,ES,Sweden,876,484,132,1,392,126,134,260,131
2020-09-21,ES,Sweden,940,483,214,23,457,122,121,243,191
2020-09-22,ES,Sweden,927,476,223,33,451,114,114,228,190
2020-09-23,ES,Sweden,960,498,209,23,462,126,127,253,186
2020-09-24,ES,Sweden,985,487,226,23,498,138,134,272,203
2020-09-25,ES,Sweden,987,514,194,12,473,141,138,279,182
2020-09-26,ES,Sweden,643,430,36,2,213,91,86,177,34
2020-09-27,ES,Sweden,816,438,112,3,378,130,136,266,109
2020-09-28,ES,Sweden,882,434,179,11,448,134,135,269,168
2020-09-29,ES,Sweden,859,444,181,12,415,122,112,234,169
2020-09-30,ES,Sweden,896,446,199,21,450,123,128,251,178
2020-10-01,ES,Sweden,855,356,237,19,499,128,134,262,218
2020-10-02,ES,Sweden,968,471,221,15,497,143,133,276,206
2020-10-03,ES,Sweden,602,400,42,3,202,81,79,160,39
2020-10-04,ES,Sweden,826,452,123,6,374,126,125,251,117
2020-10-05,ES,Sweden,886,423,206,20,463,130,127,257,186
2020-10-06,ES,Sweden,796,396,178,12,400,111,111,222,166
2020-10-07,ES,Sweden,876,418,207,18,458,125,126,251,189
2020-10-08,ES,Sweden,904,429,230,23,475,120,125,245,207
2020-10-09,ES,Sweden,973,512,200,14,461,131,130,261,186
2020-10-10,ES,Sweden,663,425,40,5,238,98,100,198,35
2020-10-11,ES,Sweden,839,451,134,9,388,125,129,254,125
2020-10-12,ES,Sweden,879,420,209,21,459,124,126,250,188
2020-10-13,ES,Sweden,800,382,196,30,418,113,109,222,166
2020-10-14,ES,Sweden,806,363,207,18,443,115,121,236,189
2020-10-15,ES,Sweden,851,384,223,25,467,126,118,244,198
2020-10-16,ES,Sweden,956,465,203,16,491,136,152,288,187
2020-10-17,ES,Sweden,668,450,33,8,218,98,87,185,25
2020-10-18,ES,Sweden,799,426,126,7,373,122,125,247,119
2020-10-19,ES,Sweden,861,434,191,19,427,122,114,236,172
2020-10-20,ES,Sweden,813,403,195,20,410,107,108,215,175
2020-10-21,ES,Sweden,848,416,200,24,432,114,118,232,176
2020-10-22,ES,Sweden,918,436,230,19,482,125,127,252,211
2020-10-23,ES,Sweden,997,494,217,28,503,138,148,286,189
2020-10-24,ES,Sweden,706,425,44,4,281,121,116,237,40
2020-10-25,ES,Sweden,825,448,124,3,377,129,124,253,121
2020-10-26,ES,Sweden,893,429,195,28,464,136,133,269,167
2020-10-27,ES,Sweden,832,410,213,25,422,104,105,209,188
2020-10-28,ES,Sweden,881,428,213,36,453,118,122,240,177
2020-10-29,ES,Sweden,892,414,219,23,478,127,132,259,196
2020-10-30,ES,Sweden,950,521,163,14,429,131,135,266,149
2020-10-31,ES,Sweden,611,380,36,3,231,96,99,195,33
2020-11-01,ES,Sweden,853,465,125,3,388,127,136,263,122
2020-11-02,ES,Sweden,892,422,190,13,470,143,137,280,177
2020-11-03,ES,Sweden,769,356,206,31,413,102,105,207,175
2020-11-04,ES,Sweden,827,366,226,37,461,119,116,235,189
2020-11-05,ES,Sweden,875,429,226,27,446,112,108,220,199
2020-11-06,ES,Sweden,961,494,220,27,467,126,121,247,193
2020-11-07,ES,Sweden,565,366,44,14,199,77,78,155,30
2020-11-08,ES,Sweden,755,410,131,3,345,103,111,214,128
2020-11-09,ES,Sweden,821,392,200,24,429,117,112,229,176
2020-11-10,ES,Sweden,722,346,210,33,376,81,85,166,177
2020-11-11,ES,Sweden,734,350,197,31,384,95,92,187,166
2020-11-12,ES,Sweden,765,370,205,22,395,94,96,190,183
2020-11-13,ES,Sweden,882,465,192,22,417,117,108,225,170
2020-11-14,ES,Sweden,480,316,33,4,164,67,64,131,29
2020-11-15,ES,Sweden,698,403,123,11,295,81,91,172,112
2020-11-16,ES,Sweden,791,389,201,38,402,100,101,201,163
2020-11-17,ES,Sweden,681,339,177,25,342,83,82,165,152
2020-11-18,ES,Sweden,715,372,182,19,343,80,81,161,163
2020-11-19,ES,Sweden,735,366,174,10,369,96,99,195,164
2020-11-20,ES,Sweden,836,434,188,28,402,112,102,214,160
2020-11-21,ES,Sweden,461,324,20,3,137,61,56,117,17
2020-11-22,ES,Sweden,652,370,123,8,282,76,83,159,115
2020-11-23,ES,Sweden,782,378,210,27,404,100,94,194,183
2020-11-24,ES,Sweden,630,329,145,17,301,78,78,156,128
2020-11-25,ES,Sweden,695,380,153,25,315,78,84,162,128
2020-11-26,ES,Sweden,745,370,204,32,375,88,83,171,172
2020-11-27,ES,Sweden,774,416,149,19,358,104,105,209,130
2020-11-28,ES,Sweden,454,301,44,9,153,58,51,109,35
2020-11-29,ES,Sweden,636,359,111,2,277,82,84,166,109
2020-11-30,ES,Sweden,698,365,144,6,333,96,93,189,138
2020-12-01,ES,Sweden,566,315,118,10,251,68,65,133,108
2020-12-02,ES,Sweden,671,359,148,25,312,79,85,164,123
2020-12-03,ES,Sweden,722,404,144,16,318,85,89,174,128
2020-12-04,ES,Sweden,834,453,160,12,381,110,111,221,148
2020-12-05,ES,Sweden,484,324,42,6,160,60,58,118,36
2020-12-06,ES,Sweden,640,372,106,6,268,81,81,162,100
2020-12-07,ES,Sweden,697,363,125,14,334,105,104,209,111
2020-12-08,ES,Sweden,633,339,139,21,294,75,80,155,118
2020-12-09,ES,Sweden,680,365,126,18,315,97,92,189,108
2020-12-10,ES,Sweden,742,369,169,16,373,99,105,204,153
2020-12-11,ES,Sweden,832,448,145,7,384,119,120,239,138
2020-12-12,ES,Sweden,537,356,34,3,181,75,72,147,31
2020-12-13,ES,Sweden,682,407,96,1,275,87,92,179,95
2020-12-14,ES,Sweden,749,398,145,19,351,107,99,206,126
2020-12-15,ES,Sweden,684,385,133,11,299,83,83,166,122
2020-12-16,ES,Sweden,783,411,150,20,372,109,113,222,130
2020-12-17,ES,Sweden,907,479,174,18,428,126,128,254,156
2020-12-18,ES,Sweden,1035,573,185,16,462,139,138,277,169
2020-12-19,ES,Sweden,787,490,50,7,297,125,122,247,43
2020-12-20,ES,Sweden,838,497,113,6,341,112,116,228,107
2020-12-21,ES,Sweden,857,456,159,18,401,121,121,242,141
2020-12-22,ES,Sweden,848,440,171,10,408,116,121,237,161
2020-12-23,ES,Sweden,903,470,176,10,433,133,124,257,166
2020-12-24,ES,Sweden,339,235,9,0,104,49,46,95,9
2020-12-25,ES,Sweden,335,236,12,2,99,41,46,87,10
2020-12-26,ES,Sweden,517,319,33,2,198,81,84,165,31
2020-12-27,ES,Sweden,728,405,107,2,323,109,107,216,105
2020-12-28,ES,Sweden,719,365,139,4,354,108,107,215,135
2020-12-29,ES,Sweden,628,328,114,7,300,94,92,186,107
2020-12-30,ES,Sweden,736,392,140,6,344,106,98,204,134
2020-12-31,ES,Sweden,345,237,23,1,108,45,40,85,22
2020-01-01,LS,Switzerland,2099,1118,27,2,981,478,476,954,25
2020-01-02,LS,Switzerland,2742,1449,35,1,1293,622,636,1258,34
2020-01-03,LS,Switzerland,2853,1483,42,2,1370,666,662,1328,40
2020-01-04,LS,Switzerland,2905,1577,34,1,1328,648,646,1294,33
2020-01-05,LS,Switzerland,3139,1659,47,1,1480,713,720,1433,46
2020-01-06,LS,Switzerland,2753,1471,42,4,1282,631,609,1240,38
2020-01-07,LS,Switzerland,2339,1257,42,5,1082,518,522,1040,37
2020-01-08,LS,Switzerland,2503,1361,55,6,1142,546,541,1087,49
2020-01-09,LS,Switzerland,2618,1403,50,3,1215,581,584,1165,47
2020-01-10,LS,Switzerland,2761,1440,51,7,1321,634,636,1270,44
2020-01-11,LS,Switzerland,2629,1437,47,2,1192,573,572,1145,45
2020-01-12,LS,Switzerland,2841,1535,31,3,1306,634,641,1275,28
2020-01-13,LS,Switzerland,2572,1394,32,1,1178,575,571,1146,31
2020-01-14,LS,Switzerland,2295,1250,38,5,1045,502,505,1007,33
2020-01-15,LS,Switzerland,2505,1309,47,1,1196,581,568,1149,46
2020-01-16,LS,Switzerland,2721,1425,58,2,1296,611,627,1238,56
2020-01-17,LS,Switzerland,2731,1405,61,1,1326,621,644,1265,60
2020-01-18,LS,Switzerland,2409,1270,36,2,1139,552,551,1103,34
2020-01-19,LS,Switzerland,2841,1452,40,0,1389,683,666,1349,40
2020-01-20,LS,Switzerland,2668,1270,46,4,1398,651,701,1352,42
2020-01-21,LS,Switzerland,2290,1088,47,0,1202,551,604,1155,47
2020-01-22,LS,Switzerland,2350,1146,51,5,1204,573,580,1153,46
2020-01-23,LS,Switzerland,2690,1279,91,3,1411,681,639,1320,88
2020-01-24,LS,Switzerland,2983,1439,81,3,1544,749,714,1463,78
2020-01-25,LS,Switzerland,2390,1249,42,2,1141,556,543,1099,40
2020-01-26,LS,Switzerland,2691,1404,42,1,1287,626,619,1245,41
2020-01-27,LS,Switzerland,2570,1340,56,5,1230,600,574,1174,51
2020-01-28,LS,Switzerland,2140,1116,40,4,1024,494,490,984,36
2020-01-29,LS,Switzerland,2382,1252,45,3,1130,536,549,1085,42
2020-01-30,LS,Switzerland,2553,1320,50,0,1233,582,601,1183,50
2020-01-31,LS,Switzerland,2881,1519,55,2,1362,639,668,1307,53
2020-02-01,LS,Switzerland,2523,1360,36,2,1163,569,558,1127,34
2020-02-02,LS,Switzerland,2744,1474,27,2,1270,631,612,1243,25
2020-02-03,LS,Switzerland,2687,1427,38,3,1260,617,605,1222,35
2020-02-04,LS,Switzerland,2252,1191,28,2,1061,511,522,1033,26
2020-02-05,LS,Switzerland,2414,1233,41,3,1181,561,579,1140,38
2020-02-06,LS,Switzerland,2732,1409,67,6,1323,630,626,1256,61
2020-02-07,LS,Switzerland,2957,1598,48,3,1359,647,664,1311,45
2020-02-08,LS,Switzerland,2630,1400,33,2,1230,597,600,1197,31
2020-02-09,LS,Switzerland,2424,1312,36,4,1112,533,543,1076,32
2020-02-10,LS,Switzerland,2273,1289,24,2,984,499,461,960,22
2020-02-11,LS,Switzerland,2365,1277,40,2,1088,523,525,1048,38
2020-02-12,LS,Switzerland,2550,1319,52,4,1231,582,597,1179,48
2020-02-13,LS,Switzerland,2721,1441,61,1,1280,601,618,1219,60
2020-02-14,LS,Switzerland,3186,1638,70,4,1548,732,746,1478,66
2020-02-15,LS,Switzerland,2949,1562,45,4,1387,666,676,1342,41
2020-02-16,LS,Switzerland,2920,1575,46,3,1345,657,642,1299,43
2020-02-17,LS,Switzerland,2771,1517,46,3,1254,624,584,1208,43
2020-02-18,LS,Switzerland,2525,1357,56,7,1168,551,561,1112,49
2020-02-19,LS,Switzerland,2558,1364,51,2,1194,559,584,1143,49
2020-02-20,LS,Switzerland,2929,1619,61,5,1310,623,626,1249,56
2020-02-21,LS,Switzerland,3220,1703,53,0,1517,725,739,1464,53
2020-02-22,LS,Switzerland,3108,1630,53,3,1478,723,702,1425,50
2020-02-23,LS,Switzerland,3165,1650,47,0,1515,739,729,1468,47
2020-02-24,LS,Switzerland,2949,1609,53,1,1340,662,625,1287,52
2020-02-25,LS,Switzerland,2498,1329,34,4,1169,568,567,1135,30
2020-02-26,LS,Switzerland,2634,1469,32,0,1165,567,566,1133,32
2020-02-27,LS,Switzerland,2648,1424,32,1,1224,587,605,1192,31
2020-02-28,LS,Switzerland,3092,1628,63,4,1464,701,700,1401,59
2020-02-29,LS,Switzerland,2768,1506,32,1,1262,621,609,1230,31
2020-03-01,LS,Switzerland,2957,1585,39,2,1372,668,665,1333,37
2020-03-02,LS,Switzerland,2789,1519,49,3,1270,608,613,1221,46
2020-03-03,LS,Switzerland,2442,1272,47,2,1170,559,564,1123,45
2020-03-04,LS,Switzerland,2558,1313,61,3,1245,593,591,1184,58
2020-03-05,LS,Switzerland,2584,1356,37,3,1228,590,601,1191,34
2020-03-06,LS,Switzerland,2860,1519,42,5,1341,645,654,1299,37
2020-03-07,LS,Switzerland,2618,1456,41,2,1162,565,556,1121,39
2020-03-08,LS,Switzerland,2756,1421,51,1,1335,653,631,1284,50
2020-03-09,LS,Switzerland,2387,1230,55,8,1157,547,555,1102,47
2020-03-10,LS,Switzerland,1976,1012,58,6,964,445,461,906,52
2020-03-11,LS,Switzerland,2090,1053,79,3,1037,489,469,958,76
2020-03-12,LS,Switzerland,2191,1075,65,6,1116,522,529,1051,59
2020-03-13,LS,Switzerland,2371,1154,57,6,1217,569,591,1160,51
2020-03-14,LS,Switzerland,2036,963,43,3,1073,515,515,1030,40
2020-03-15,LS,Switzerland,2083,963,47,2,1120,540,533,1073,45
2020-03-16,LS,Switzerland,1774,888,50,5,886,420,416,836,45
2020-03-17,LS,Switzerland,1325,703,33,3,622,298,291,589,30
2020-03-18,LS,Switzerland,1228,692,38,4,536,249,249,498,34
2020-03-19,LS,Switzerland,1059,588,36,4,471,218,217,435,32
2020-03-20,LS,Switzerland,1062,578,41,1,484,229,214,443,40
2020-03-21,LS,Switzerland,726,389,15,0,337,158,164,322,15
2020-03-22,LS,Switzerland,661,336,13,1,325,158,154,312,12
2020-03-23,LS,Switzerland,420,247,11,1,173,80,82,162,10
2020-03-24,LS,Switzerland,378,252,14,3,126,56,56,112,11
2020-03-25,LS,Switzerland,342,202,19,1,140,60,61,121,18
2020-03-26,LS,Switzerland,374,210,19,2,164,70,75,145,17
2020-03-27,LS,Switzerland,344,193,14,0,151,70,67,137,14
2020-03-28,LS,Switzerland,263,153,5,1,110,51,54,105,4
2020-03-29,LS,Switzerland,264,146,2,0,118,61,55,116,2
2020-03-30,LS,Switzerland,243,140,5,0,103,48,50,98,5
2020-03-31,LS,Switzerland,273,158,27,4,115,44,44,88,23
2020-04-01,LS,Switzerland,291,152,32,2,139,54,53,107,30
2020-04-02,LS,Switzerland,255,150,18,1,105,47,40,87,17
2020-04-03,LS,Switzerland,263,141,27,1,122,47,48,95,26
2020-04-04,LS,Switzerland,198,109,16,2,89,37,36,73,14
2020-04-05,LS,Switzerland,196,100,14,2,96,39,43,82,12
2020-04-06,LS,Switzerland,190,102,8,2,88,40,40,80,6
2020-04-07,LS,Switzerland,237,127,26,5,110,42,42,84,21
2020-04-08,LS,Switzerland,256,136,38,4,120,45,37,82,34
2020-04-09,LS,Switzerland,249,141,24,6,108,43,41,84,18
2020-04-10,LS,Switzerland,205,112,10,1,93,40,43,83,9
2020-04-11,LS,Switzerland,175,101,15,3,74,31,28,59,12
2020-04-12,LS,Switzerland,162,84,7,1,78,35,36,71,6
2020-04-13,LS,Switzerland,170,98,13,1,72,32,27,59,12
2020-04-14,LS,Switzerland,197,122,18,1,75,24,33,57,17
2020-04-15,LS,Switzerland,229,139,21,5,90,32,37,69,16
2020-04-16,LS,Switzerland,269,146,35,2,123,43,45,88,33
2020-04-17,LS,Switzerland,273,147,32,0,126,46,48,94,32
2020-04-18,LS,Switzerland,189,106,21,1,83,31,31,62,20
2020-04-19,LS,Switzerland,160,88,10,1,72,30,32,62,9
2020-04-20,LS,Switzerland,218,141,5,1,77,37,35,72,4
2020-04-21,LS,Switzerland,246,149,32,3,97,37,28,65,29
2020-04-22,LS,Switzerland,235,138,40,2,97,28,29,57,38
2020-04-23,LS,Switzerland,276,142,36,2,134,48,50,98,34
2020-04-24,LS,Switzerland,282,155,30,3,127,50,47,97,27
2020-04-25,LS,Switzerland,203,114,23,0,89,33,33,66,23
2020-04-26,LS,Switzerland,166,76,15,0,90,38,37,75,15
2020-04-27,LS,Switzerland,248,148,19,2,100,39,42,81,17
2020-04-28,LS,Switzerland,245,142,26,2,103,41,36,77,24
2020-04-29,LS,Switzerland,278,152,45,3,126,41,40,81,42
2020-04-30,LS,Switzerland,248,144,23,5,104,36,45,81,18
2020-05-01,LS,Switzerland,222,111,12,1,111,50,49,99,11
2020-05-02,LS,Switzerland,188,113,8,2,75,32,35,67,6
2020-05-03,LS,Switzerland,200,113,13,0,87,39,35,74,13
2020-05-04,LS,Switzerland,278,132,51,3,146,51,44,95,48
2020-05-05,LS,Switzerland,259,153,29,3,106,38,39,77,26
2020-05-06,LS,Switzerland,307,177,31,7,130,51,48,99,24
2020-05-07,LS,Switzerland,322,171,50,4,151,49,52,101,46
2020-05-08,LS,Switzerland,330,167,45,4,163,61,57,118,41
2020-05-09,LS,Switzerland,244,135,26,1,109,45,38,83,25
2020-05-10,LS,Switzerland,235,120,15,0,115,47,53,100,15
2020-05-11,LS,Switzerland,296,157,29,3,139,58,52,110,26
2020-05-12,LS,Switzerland,358,193,38,4,165,60,67,127,34
2020-05-13,LS,Switzerland,323,173,41,7,150,61,48,109,34
2020-05-14,LS,Switzerland,370,184,53,13,186,67,66,133,40
2020-05-15,LS,Switzerland,382,178,40,9,204,77,87,164,31
2020-05-16,LS,Switzerland,267,138,27,4,129,51,51,102,23
2020-05-17,LS,Switzerland,283,143,33,4,140,53,54,107,29
2020-05-18,LS,Switzerland,339,169,55,9,170,59,56,115,46
2020-05-19,LS,Switzerland,354,194,55,8,160,54,51,105,47
2020-05-20,LS,Switzerland,450,214,83,9,236,78,75,153,74
2020-05-21,LS,Switzerland,369,186,37,3,183,71,75,146,34
2020-05-22,LS,Switzerland,326,175,41,2,151,54,56,110,39
2020-05-23,LS,Switzerland,269,167,11,3,102,48,43,91,8
2020-05-24,LS,Switzerland,314,135,31,1,179,63,85,148,30
2020-05-25,LS,Switzerland,374,162,52,3,212,81,79,160,49
2020-05-26,LS,Switzerland,398,184,67,6,214,76,71,147,61
2020-05-27,LS,Switzerland,447,209,81,7,238,79,78,157,74
2020-05-28,LS,Switzerland,398,195,56,7,203,72,75,147,49
2020-05-29,LS,Switzerland,472,198,78,8,274,96,100,196,70
2020-05-30,LS,Switzerland,285,135,40,4,150,59,51,110,36
2020-05-31,LS,Switzerland,267,134,13,0,133,56,64,120,13
2020-06-01,LS,Switzerland,381,179,46,5,202,79,77,156,41
2020-06-02,LS,Switzerland,373,169,65,2,204,70,69,139,63
2020-06-03,LS,Switzerland,443,222,56,1,221,84,81,165,55
2020-06-04,LS,Switzerland,454,209,37,1,245,112,96,208,36
2020-06-05,LS,Switzerland,529,246,41,2,283,117,125,242,39
2020-06-06,LS,Switzerland,392,196,20,7,196,86,90,176,13
2020-06-07,LS,Switzerland,395,164,25,3,231,103,103,206,22
2020-06-08,LS,Switzerland,493,210,53,4,283,117,113,230,49
2020-06-09,LS,Switzerland,433,227,51,3,206,76,79,155,48
2020-06-10,LS,Switzerland,476,243,33,3,233,95,105,200,30
2020-06-11,LS,Switzerland,440,231,31,4,209,92,86,178,27
2020-06-12,LS,Switzerland,521,238,67,6,283,106,110,216,61
2020-06-13,LS,Switzerland,391,172,34,2,219,93,92,185,32
2020-06-14,LS,Switzerland,421,184,9,0,237,112,116,228,9
2020-06-15,LS,Switzerland,764,335,38,5,429,197,194,391,33
2020-06-16,LS,Switzerland,616,284,39,6,332,143,150,293,33
2020-06-17,LS,Switzerland,662,299,50,6,363,161,152,313,44
2020-06-18,LS,Switzerland,739,327,46,4,412,181,185,366,42
2020-06-19,LS,Switzerland,812,338,48,7,474,226,200,426,41
2020-06-20,LS,Switzerland,591,263,34,5,328,148,146,294,29
2020-06-21,LS,Switzerland,720,319,19,1,401,179,203,382,18
2020-06-22,LS,Switzerland,783,344,37,5,439,195,207,402,32
2020-06-23,LS,Switzerland,692,341,43,2,351,157,151,308,41
2020-06-24,LS,Switzerland,746,355,39,4,391,182,170,352,35
2020-06-25,LS,Switzerland,849,402,48,5,447,203,196,399,43
2020-06-26,LS,Switzerland,928,425,43,3,503,233,227,460,40
2020-06-27,LS,Switzerland,781,418,15,0,363,176,172,348,15
2020-06-28,LS,Switzerland,796,411,12,2,385,183,190,373,10
2020-06-29,LS,Switzerland,862,408,18,4,454,217,219,436,14
2020-06-30,LS,Switzerland,802,396,47,3,406,167,192,359,44
2020-07-01,LS,Switzerland,1285,702,47,3,583,284,252,536,44
2020-07-02,LS,Switzerland,1186,654,35,1,532,251,246,497,34
2020-07-03,LS,Switzerland,1494,820,27,1,674,338,309,647,26
2020-07-04,LS,Switzerland,1420,829,24,1,591,283,284,567,23
2020-07-05,LS,Switzerland,1456,841,28,0,615,282,305,587,28
2020-07-06,LS,Switzerland,1363,785,32,2,578,276,270,546,30
2020-07-07,LS,Switzerland,1103,621,34,0,482,223,225,448,34
2020-07-08,LS,Switzerland,1257,707,31,0,550,262,257,519,31
2020-07-09,LS,Switzerland,1258,690,44,2,568,266,258,524,42
2020-07-10,LS,Switzerland,1534,863,32,4,671,329,310,639,28
2020-07-11,LS,Switzerland,1512,918,25,0,594,291,278,569,25
2020-07-12,LS,Switzerland,1452,811,31,2,641,295,315,610,29
2020-07-13,LS,Switzerland,1410,783,35,5,627,296,296,592,30
2020-07-14,LS,Switzerland,1167,660,30,3,507,235,242,477,27
2020-07-15,LS,Switzerland,1379,776,25,0,603,298,280,578,25
2020-07-16,LS,Switzerland,1369,772,24,1,597,295,278,573,23
2020-07-17,LS,Switzerland,1627,909,37,3,718,338,343,681,34
2020-07-18,LS,Switzerland,1711,994,38,2,717,346,333,679,36
2020-07-19,LS,Switzerland,1590,942,13,0,648,312,323,635,13
2020-07-20,LS,Switzerland,1551,894,32,5,657,313,312,625,27
2020-07-21,LS,Switzerland,1275,752,31,1,523,252,240,492,30
2020-07-22,LS,Switzerland,1511,903,33,1,608,293,282,575,32
2020-07-23,LS,Switzerland,1460,798,37,1,662,307,318,625,36
2020-07-24,LS,Switzerland,1740,1023,25,3,717,346,346,692,22
2020-07-25,LS,Switzerland,1858,1146,23,1,712,339,350,689,22
2020-07-26,LS,Switzerland,1685,1045,14,0,640,315,311,626,14
2020-07-27,LS,Switzerland,1680,967,26,2,713,340,347,687,24
2020-07-28,LS,Switzerland,1325,815,33,2,510,239,238,477,31
2020-07-29,LS,Switzerland,1530,903,33,1,627,305,289,594,32
2020-07-30,LS,Switzerland,1487,871,29,1,616,291,296,587,28
2020-07-31,LS,Switzerland,1847,1042,32,2,805,392,381,773,30
2020-08-01,LS,Switzerland,2069,1305,20,2,764,375,369,744,18
2020-08-02,LS,Switzerland,1963,1260,14,0,703,340,349,689,14
2020-08-03,LS,Switzerland,1777,1105,25,0,672,324,323,647,25
2020-08-04,LS,Switzerland,1470,913,32,3,557,264,261,525,29
2020-08-05,LS,Switzerland,1702,1045,39,1,657,300,318,618,38
2020-08-06,LS,Switzerland,1655,987,36,3,668,319,313,632,33
2020-08-07,LS,Switzerland,1984,1181,42,4,803,387,374,761,38
2020-08-08,LS,Switzerland,2040,1257,33,0,783,377,373,750,33
2020-08-09,LS,Switzerland,1986,1200,22,0,786,362,402,764,22
2020-08-10,LS,Switzerland,1785,1110,29,2,675,334,312,646,27
2020-08-11,LS,Switzerland,1527,949,49,3,578,275,254,529,46
2020-08-12,LS,Switzerland,1655,1019,31,4,636,308,297,605,27
2020-08-13,LS,Switzerland,1561,939,30,3,622,298,294,592,27
2020-08-14,LS,Switzerland,1865,1106,29,4,759,370,360,730,25
2020-08-15,LS,Switzerland,2044,1258,39,4,786,367,380,747,35
2020-08-16,LS,Switzerland,1988,1184,15,1,804,386,403,789,14
2020-08-17,LS,Switzerland,1818,1122,32,2,696,330,334,664,30
2020-08-18,LS,Switzerland,1547,968,42,6,579,275,262,537,36
2020-08-19,LS,Switzerland,1681,977,52,3,704,322,330,652,49
2020-08-20,LS,Switzerland,1664,1007,37,0,657,320,300,620,37
2020-08-21,LS,Switzerland,1955,1190,42,4,765,361,362,723,38
2020-08-22,LS,Switzerland,1987,1281,25,2,706,347,334,681,23
2020-08-23,LS,Switzerland,1998,1235,18,0,763,363,382,745,18
2020-08-24,LS,Switzerland,1820,1122,41,5,698,326,331,657,36
2020-08-25,LS,Switzerland,1500,931,35,3,569,261,273,534,32
2020-08-26,LS,Switzerland,1698,1031,37,4,667,318,312,630,33
2020-08-27,LS,Switzerland,1687,1000,50,5,687,327,310,637,45
2020-08-28,LS,Switzerland,1966,1117,42,3,849,408,399,807,39
2020-08-29,LS,Switzerland,1870,1212,19,1,658,323,316,639,18
2020-08-30,LS,Switzerland,1867,1158,18,1,709,336,355,691,17
2020-08-31,LS,Switzerland,1848,1139,34,4,709,343,332,675,30
2020-09-01,LS,Switzerland,1483,911,42,3,572,260,270,530,39
2020-09-02,LS,Switzerland,1493,896,49,2,597,280,268,548,47
2020-09-03,LS,Switzerland,1587,913,34,5,674,322,318,640,29
2020-09-04,LS,Switzerland,1889,1095,57,2,794,381,356,737,55
2020-09-05,LS,Switzerland,1705,1072,21,1,633,304,308,612,20
2020-09-06,LS,Switzerland,1815,1104,19,0,711,342,350,692,19
2020-09-07,LS,Switzerland,1678,1005,44,3,673,312,317,629,41
2020-09-08,LS,Switzerland,1328,818,39,2,510,238,233,471,37
2020-09-09,LS,Switzerland,1462,870,37,3,592,286,269,555,34
2020-09-10,LS,Switzerland,1513,894,33,4,619,296,290,586,29
2020-09-11,LS,Switzerland,1712,1000,43,6,712,340,329,669,37
2020-09-12,LS,Switzerland,1586,985,29,3,601,292,280,572,26
2020-09-13,LS,Switzerland,1806,1043,21,1,763,353,389,742,20
2020-09-14,LS,Switzerland,1547,949,45,4,598,275,278,553,41
2020-09-15,LS,Switzerland,1249,751,37,3,498,237,224,461,34
2020-09-16,LS,Switzerland,1374,823,36,1,551,261,254,515,35
2020-09-17,LS,Switzerland,1431,834,39,4,597,280,278,558,35
2020-09-18,LS,Switzerland,1698,992,45,3,706,335,326,661,42
2020-09-19,LS,Switzerland,1521,956,31,4,565,272,262,534,27
2020-09-20,LS,Switzerland,1609,989,28,0,620,294,298,592,28
2020-09-21,LS,Switzerland,1507,910,33,2,597,269,295,564,31
2020-09-22,LS,Switzerland,1227,716,48,0,511,247,216,463,48
2020-09-23,LS,Switzerland,1286,753,57,0,533,239,237,476,57
2020-09-24,LS,Switzerland,1300,764,42,1,536,249,245,494,41
2020-09-25,LS,Switzerland,1630,976,33,6,654,315,306,621,27
2020-09-26,LS,Switzerland,1439,925,17,4,514,247,250,497,13
2020-09-27,LS,Switzerland,1613,991,17,1,622,300,305,605,16
2020-09-28,LS,Switzerland,1442,850,47,6,592,272,273,545,41
2020-09-29,LS,Switzerland,1164,723,35,1,441,207,199,406,34
2020-09-30,LS,Switzerland,1346,806,61,10,540,248,231,479,51
2020-10-01,LS,Switzerland,1340,777,49,3,563,248,266,514,46
2020-10-02,LS,Switzerland,1545,904,53,3,641,312,276,588,50
2020-10-03,LS,Switzerland,1399,852,17,0,547,271,259,530,17
2020-10-04,LS,Switzerland,1443,866,19,1,577,272,286,558,18
2020-10-05,LS,Switzerland,1324,765,40,4,559,249,270,519,36
2020-10-06,LS,Switzerland,1055,611,37,4,444,194,213,407,33
2020-10-07,LS,Switzerland,1131,644,35,4,487,243,209,452,31
2020-10-08,LS,Switzerland,1209,705,45,2,504,224,235,459,43
2020-10-09,LS,Switzerland,1578,890,63,6,688,320,305,625,57
2020-10-10,LS,Switzerland,1354,812,19,2,542,270,253,523,17
2020-10-11,LS,Switzerland,1488,877,21,1,611,290,300,590,20
2020-10-12,LS,Switzerland,1282,754,38,5,528,238,252,490,33
2020-10-13,LS,Switzerland,1006,584,44,3,422,190,188,378,41
2020-10-14,LS,Switzerland,1124,649,31,1,475,228,216,444,30
2020-10-15,LS,Switzerland,1064,612,35,1,452,213,204,417,34
2020-10-16,LS,Switzerland,1592,922,53,4,670,319,298,617,49
2020-10-17,LS,Switzerland,1387,809,31,2,578,275,272,547,29
2020-10-18,LS,Switzerland,1388,815,33,1,573,255,285,540,32
2020-10-19,LS,Switzerland,1231,768,37,2,463,213,213,426,35
2020-10-20,LS,Switzerland,946,582,42,1,364,165,157,322,41
2020-10-21,LS,Switzerland,1036,657,36,1,379,174,169,343,35
2020-10-22,LS,Switzerland,1093,666,39,4,427,194,194,388,35
2020-10-23,LS,Switzerland,1309,792,32,2,517,253,232,485,30
2020-10-24,LS,Switzerland,1339,806,39,1,533,245,249,494,38
2020-10-25,LS,Switzerland,1286,779,44,2,507,221,242,463,42
2020-10-26,LS,Switzerland,1032,604,21,0,428,203,204,407,21
2020-10-27,LS,Switzerland,864,515,39,1,349,154,156,310,38
2020-10-28,LS,Switzerland,971,564,61,4,407,174,172,346,57
2020-10-29,LS,Switzerland,1003,597,30,1,406,200,176,376,29
2020-10-30,LS,Switzerland,1282,749,52,1,533,233,248,481,51
2020-10-31,LS,Switzerland,1082,689,39,7,393,191,163,354,32
2020-11-01,LS,Switzerland,1218,750,36,0,468,210,222,432,36
2020-11-02,LS,Switzerland,1013,610,37,2,403,178,188,366,35
2020-11-03,LS,Switzerland,734,446,28,3,288,130,130,260,25
2020-11-04,LS,Switzerland,807,447,49,2,360,150,161,311,47
2020-11-05,LS,Switzerland,786,416,47,3,370,167,156,323,44
2020-11-06,LS,Switzerland,974,527,52,6,447,201,194,395,46
2020-11-07,LS,Switzerland,767,450,25,2,317,152,140,292,23
2020-11-08,LS,Switzerland,920,521,25,2,399,178,196,374,23
2020-11-09,LS,Switzerland,779,425,30,4,354,157,167,324,26
2020-11-10,LS,Switzerland,621,349,29,2,272,121,122,243,27
2020-11-11,LS,Switzerland,733,375,59,3,358,151,148,299,56
2020-11-12,LS,Switzerland,751,386,53,5,365,168,144,312,48
2020-11-13,LS,Switzerland,871,441,69,3,430,182,179,361,66
2020-11-14,LS,Switzerland,667,356,40,1,311,138,133,271,39
2020-11-15,LS,Switzerland,785,421,24,1,364,165,175,340,23
2020-11-16,LS,Switzerland,735,371,31,7,364,163,170,333,24
2020-11-17,LS,Switzerland,555,285,38,3,270,118,114,232,35
2020-11-18,LS,Switzerland,678,325,48,3,353,148,157,305,45
2020-11-19,LS,Switzerland,729,367,33,1,362,173,156,329,32
2020-11-20,LS,Switzerland,805,399,43,7,406,193,170,363,36
2020-11-21,LS,Switzerland,657,344,46,3,313,133,134,267,43
2020-11-22,LS,Switzerland,677,339,33,2,338,149,156,305,31
2020-11-23,LS,Switzerland,686,351,46,3,335,131,158,289,43
2020-11-24,LS,Switzerland,595,292,53,4,303,131,119,250,49
2020-11-25,LS,Switzerland,643,321,34,4,322,146,142,288,30
2020-11-26,LS,Switzerland,676,340,34,1,336,150,152,302,33
2020-11-27,LS,Switzerland,811,402,45,3,409,186,178,364,42
2020-11-28,LS,Switzerland,582,287,26,2,295,138,131,269,24
2020-11-29,LS,Switzerland,713,348,38,2,365,154,173,327,36
2020-11-30,LS,Switzerland,766,369,50,5,397,173,174,347,45
2020-12-01,LS,Switzerland,500,286,17,5,214,99,98,197,12
2020-12-02,LS,Switzerland,694,350,38,5,344,157,149,306,33
2020-12-03,LS,Switzerland,766,377,49,2,389,175,165,340,47
2020-12-04,LS,Switzerland,824,423,25,0,401,185,191,376,25
2020-12-05,LS,Switzerland,642,337,13,4,305,150,142,292,9
2020-12-06,LS,Switzerland,648,318,14,1,330,158,158,316,13
2020-12-07,LS,Switzerland,709,334,48,1,375,158,169,327,47
2020-12-08,LS,Switzerland,612,315,30,4,297,139,128,267,26
2020-12-09,LS,Switzerland,704,379,19,2,325,146,160,306,17
2020-12-10,LS,Switzerland,848,395,57,4,453,202,194,396,53
2020-12-11,LS,Switzerland,998,475,49,8,523,250,224,474,41
2020-12-12,LS,Switzerland,738,371,12,0,367,178,177,355,12
2020-12-13,LS,Switzerland,836,384,21,0,452,209,222,431,21
2020-12-14,LS,Switzerland,847,417,49,2,430,187,194,381,47
2020-12-15,LS,Switzerland,745,388,44,1,357,162,151,313,43
2020-12-16,LS,Switzerland,930,476,35,1,454,208,211,419,34
2020-12-17,LS,Switzerland,1096,545,42,6,551,253,256,509,36
2020-12-18,LS,Switzerland,1448,724,48,8,724,349,327,676,40
2020-12-19,LS,Switzerland,1378,700,24,5,678,330,324,654,19
2020-12-20,LS,Switzerland,1263,626,17,0,637,308,312,620,17
2020-12-21,LS,Switzerland,1026,544,38,6,482,223,221,444,32
2020-12-22,LS,Switzerland,949,487,46,4,462,211,205,416,42
2020-12-23,LS,Switzerland,1175,617,42,4,558,261,255,516,38
2020-12-24,LS,Switzerland,679,359,15,1,320,154,151,305,14
2020-12-25,LS,Switzerland,533,232,12,0,301,145,144,289,12
2020-12-26,LS,Switzerland,953,425,30,2,528,250,248,498,28
2020-12-27,LS,Switzerland,1109,535,31,2,574,269,274,543,29
2020-12-28,LS,Switzerland,885,502,12,0,383,191,180,371,12
2020-12-29,LS,Switzerland,729,414,18,1,315,147,150,297,17
2020-12-30,LS,Switzerland,930,500,18,2,430,206,206,412,16
2020-12-31,LS,Switzerland,506,272,20,0,234,107,107,214,20
2020-01-01,LT,Türkiye,3240,1198,770,8,2042,639,633,1272,762
2020-01-02,LT,Türkiye,3685,1412,816,6,2273,730,727,1457,810
2020-01-03,LT,Türkiye,3725,1362,858,13,2363,763,742,1505,845
2020-01-04,LT,Türkiye,3786,1460,762,9,2326,779,785,1564,753
2020-01-05,LT,Türkiye,3851,1470,793,9,2381,792,796,1588,784
2020-01-06,LT,Türkiye,3460,1290,791,12,2170,665,714,1379,779
2020-01-07,LT,Türkiye,3022,1289,544,14,1733,587,602,1189,530
2020-01-08,LT,Türkiye,3296,1159,804,11,2137,684,649,1333,793
2020-01-09,LT,Türkiye,3432,1228,833,16,2204,695,676,1371,817
2020-01-10,LT,Türkiye,3489,1177,893,8,2312,714,705,1419,885
2020-01-11,LT,Türkiye,3493,1298,816,11,2195,683,696,1379,805
2020-01-12,LT,Türkiye,3662,1373,849,8,2289,723,717,1440,841
2020-01-13,LT,Türkiye,3377,1208,846,9,2169,645,678,1323,837
2020-01-14,LT,Türkiye,3267,1187,803,12,2080,648,629,1277,791
2020-01-15,LT,Türkiye,3331,1188,852,14,2143,641,650,1291,838
2020-01-16,LT,Türkiye,3392,1209,852,9,2183,674,657,1331,843
2020-01-17,LT,Türkiye,3472,1158,918,8,2314,704,692,1396,910
2020-01-18,LT,Türkiye,3542,1283,830,8,2259,704,725,1429,822
2020-01-19,LT,Türkiye,3581,1291,858,5,2290,725,707,1432,853
2020-01-20,LT,Türkiye,3338,1163,852,7,2175,646,677,1323,845
2020-01-21,LT,Türkiye,3242,1152,813,11,2090,642,635,1277,802
2020-01-22,LT,Türkiye,3318,1191,862,3,2127,638,627,1265,859
2020-01-23,LT,Türkiye,3423,1220,871,6,2203,666,666,1332,865
2020-01-24,LT,Türkiye,3438,1169,895,11,2269,690,684,1374,884
2020-01-25,LT,Türkiye,3537,1301,882,8,2236,670,684,1354,874
2020-01-26,LT,Türkiye,3577,1285,909,10,2292,696,687,1383,899
2020-01-27,LT,Türkiye,3297,1156,868,9,2141,629,644,1273,859
2020-01-28,LT,Türkiye,3187,1124,823,8,2063,615,625,1240,815
2020-01-29,LT,Türkiye,3278,1167,859,13,2111,631,621,1252,846
2020-01-30,LT,Türkiye,3376,1196,858,9,2180,668,654,1322,849
2020-01-31,LT,Türkiye,3464,1152,930,9,2312,693,689,1382,921
2020-02-01,LT,Türkiye,3544,1264,867,9,2280,702,711,1413,858
2020-02-02,LT,Türkiye,3620,1313,889,7,2307,711,707,1418,882
2020-02-03,LT,Türkiye,3258,1113,852,8,2145,631,662,1293,844
2020-02-04,LT,Türkiye,3147,1127,790,8,2020,620,610,1230,782
2020-02-05,LT,Türkiye,3060,1118,760,11,1942,574,608,1182,749
2020-02-06,LT,Türkiye,3419,1237,900,7,2182,665,617,1282,893
2020-02-07,LT,Türkiye,3370,1168,872,11,2202,649,681,1330,861
2020-02-08,LT,Türkiye,3327,1294,693,9,2033,677,663,1340,684
2020-02-09,LT,Türkiye,3344,1288,757,10,2056,654,645,1299,747
2020-02-10,LT,Türkiye,3212,1149,842,12,2063,606,615,1221,830
2020-02-11,LT,Türkiye,3082,1123,790,10,1959,592,577,1169,780
2020-02-12,LT,Türkiye,3230,1176,802,10,2054,635,617,1252,792
2020-02-13,LT,Türkiye,3277,1229,734,8,2048,652,662,1314,726
2020-02-14,LT,Türkiye,3449,1152,906,6,2297,699,692,1391,900
2020-02-15,LT,Türkiye,3514,1328,820,7,2186,677,689,1366,813
2020-02-16,LT,Türkiye,3588,1381,833,9,2207,692,682,1374,824
2020-02-17,LT,Türkiye,3331,1207,847,11,2124,623,654,1277,836
2020-02-18,LT,Türkiye,3204,1197,797,12,2007,609,601,1210,785
2020-02-19,LT,Türkiye,3340,1239,838,8,2101,635,628,1263,830
2020-02-20,LT,Türkiye,3423,1232,844,12,2191,682,665,1347,832
2020-02-21,LT,Türkiye,3478,1190,884,8,2288,704,700,1404,876
2020-02-22,LT,Türkiye,3525,1299,832,10,2226,691,703,1394,822
2020-02-23,LT,Türkiye,3582,1310,854,8,2272,713,705,1418,846
2020-02-24,LT,Türkiye,3298,1145,860,11,2153,637,656,1293,849
2020-02-25,LT,Türkiye,3186,1170,790,12,2016,614,612,1226,778
2020-02-26,LT,Türkiye,3244,1160,843,9,2084,621,620,1241,834
2020-02-27,LT,Türkiye,3358,1224,869,14,2134,631,634,1265,855
2020-02-28,LT,Türkiye,3435,1196,893,11,2239,689,657,1346,882
2020-02-29,LT,Türkiye,3454,1310,800,10,2144,657,687,1344,790
2020-03-01,LT,Türkiye,3516,1326,863,6,2190,663,664,1327,857
2020-03-02,LT,Türkiye,3244,1206,840,6,2038,591,607,1198,834
2020-03-03,LT,Türkiye,3178,1194,798,13,1984,600,586,1186,785
2020-03-04,LT,Türkiye,3284,1275,844,14,2009,584,581,1165,830
2020-03-05,LT,Türkiye,3347,1264,856,9,2083,610,617,1227,847
2020-03-06,LT,Türkiye,3397,1226,917,19,2171,628,626,1254,898
2020-03-07,LT,Türkiye,3413,1347,836,13,2066,612,618,1230,823
2020-03-08,LT,Türkiye,3408,1279,861,9,2129,633,635,1268,852
2020-03-09,LT,Türkiye,3077,1100,838,10,1977,561,578,1139,828
2020-03-10,LT,Türkiye,2971,1096,753,13,1875,564,558,1122,740
2020-03-11,LT,Türkiye,2996,1123,800,16,1873,527,546,1073,784
2020-03-12,LT,Türkiye,3016,1077,825,13,1939,558,556,1114,812
2020-03-13,LT,Türkiye,3032,1027,842,13,2005,585,578,1163,829
2020-03-14,LT,Türkiye,3031,1075,804,12,1956,563,589,1152,792
2020-03-15,LT,Türkiye,3079,1023,872,9,2056,591,593,1184,863
2020-03-16,LT,Türkiye,2662,918,840,11,1744,443,461,904,829
2020-03-17,LT,Türkiye,2218,821,701,11,1397,335,361,696,690
2020-03-18,LT,Türkiye,2137,854,705,9,1283,285,293,578,696
2020-03-19,LT,Türkiye,1947,749,644,8,1198,277,277,554,636
2020-03-20,LT,Türkiye,1932,639,665,10,1293,313,315,628,655
2020-03-21,LT,Türkiye,1551,632,558,13,919,161,200,361,545
2020-03-22,LT,Türkiye,1345,558,539,10,787,116,132,248,529
2020-03-23,LT,Türkiye,1045,394,444,7,651,101,106,207,437
2020-03-24,LT,Türkiye,915,389,304,8,526,111,111,222,296
2020-03-25,LT,Türkiye,816,304,325,7,512,93,94,187,318
2020-03-26,LT,Türkiye,812,296,301,6,516,103,112,215,295
2020-03-27,LT,Türkiye,788,298,326,11,490,80,84,164,315
2020-03-28,LT,Türkiye,608,282,188,8,326,69,69,138,180
2020-03-29,LT,Türkiye,434,290,32,6,144,53,59,112,26
2020-03-30,LT,Türkiye,362,209,61,7,153,48,44,92,54
2020-03-31,LT,Türkiye,411,254,52,8,157,52,53,105,44
2020-04-01,LT,Türkiye,400,211,75,4,189,56,58,114,71
2020-04-02,LT,Türkiye,392,223,36,6,169,67,66,133,30
2020-04-03,LT,Türkiye,403,220,61,8,183,62,60,122,53
2020-04-04,LT,Türkiye,372,226,25,6,146,59,62,121,19
2020-04-05,LT,Türkiye,332,199,18,6,133,59,56,115,12
2020-04-06,LT,Türkiye,313,204,14,7,109,46,49,95,7
2020-04-07,LT,Türkiye,358,216,26,9,142,59,57,116,17
2020-04-08,LT,Türkiye,379,220,26,6,159,67,66,133,20
2020-04-09,LT,Türkiye,356,225,16,5,131,55,60,115,11
2020-04-10,LT,Türkiye,356,212,11,7,144,67,66,133,4
2020-04-11,LT,Türkiye,352,227,22,7,125,50,53,103,15
2020-04-12,LT,Türkiye,306,201,8,8,105,51,46,97,0
2020-04-13,LT,Türkiye,297,206,16,6,91,35,40,75,10
2020-04-14,LT,Türkiye,337,179,29,7,158,65,64,129,22
2020-04-15,LT,Türkiye,333,205,11,8,128,56,61,117,3
2020-04-16,LT,Türkiye,393,224,30,7,169,69,70,139,23
2020-04-17,LT,Türkiye,396,225,31,12,171,71,69,140,19
2020-04-18,LT,Türkiye,376,246,17,6,130,53,60,113,11
2020-04-19,LT,Türkiye,333,218,12,7,115,55,48,103,5
2020-04-20,LT,Türkiye,388,232,43,8,156,57,56,113,35
2020-04-21,LT,Türkiye,404,225,38,9,179,70,71,141,29
2020-04-22,LT,Türkiye,494,267,46,6,227,92,89,181,40
2020-04-23,LT,Türkiye,528,297,58,8,231,88,85,173,50
2020-04-24,LT,Türkiye,419,256,23,5,163,74,66,140,18
2020-04-25,LT,Türkiye,424,280,20,5,144,56,68,124,15
2020-04-26,LT,Türkiye,378,261,17,7,117,51,49,100,10
2020-04-27,LT,Türkiye,424,281,30,6,143,61,52,113,24
2020-04-28,LT,Türkiye,464,282,30,7,182,75,77,152,23
2020-04-29,LT,Türkiye,462,307,19,5,155,67,69,136,14
2020-04-30,LT,Türkiye,489,289,45,8,200,80,75,155,37
2020-05-01,LT,Türkiye,486,321,31,5,165,69,65,134,26
2020-05-02,LT,Türkiye,458,295,36,8,163,63,64,127,28
2020-05-03,LT,Türkiye,424,272,34,6,152,58,60,118,28
2020-05-04,LT,Türkiye,483,269,73,6,214,70,71,141,67
2020-05-05,LT,Türkiye,502,291,53,8,211,80,78,158,45
2020-05-06,LT,Türkiye,514,309,46,6,205,77,82,159,40
2020-05-07,LT,Türkiye,536,292,70,9,244,87,87,174,61
2020-05-08,LT,Türkiye,517,312,51,5,205,80,74,154,46
2020-05-09,LT,Türkiye,486,301,45,5,185,69,71,140,40
2020-05-10,LT,Türkiye,469,296,39,6,173,71,63,134,33
2020-05-11,LT,Türkiye,451,287,52,7,164,56,56,112,45
2020-05-12,LT,Türkiye,466,298,37,5,168,64,67,131,32
2020-05-13,LT,Türkiye,519,303,37,8,216,89,90,179,29
2020-05-14,LT,Türkiye,533,315,43,9,218,91,84,175,34
2020-05-15,LT,Türkiye,556,346,39,7,210,84,87,171,32
2020-05-16,LT,Türkiye,501,332,33,7,169,71,65,136,26
2020-05-17,LT,Türkiye,438,305,14,6,133,61,58,119,8
2020-05-18,LT,Türkiye,423,275,21,7,148,65,62,127,14
2020-05-19,LT,Türkiye,439,298,22,7,141,56,63,119,15
2020-05-20,LT,Türkiye,490,315,31,7,175,69,75,144,24
2020-05-21,LT,Türkiye,564,319,42,6,245,105,98,203,36
2020-05-22,LT,Türkiye,557,284,83,8,273,97,93,190,75
2020-05-23,LT,Türkiye,509,331,18,6,178,81,79,160,12
2020-05-24,LT,Türkiye,452,292,15,7,160,68,77,145,8
2020-05-25,LT,Türkiye,403,278,27,6,125,50,48,98,21
2020-05-26,LT,Türkiye,462,309,12,7,153,70,71,141,5
2020-05-27,LT,Türkiye,534,347,40,6,187,72,75,147,34
2020-05-28,LT,Türkiye,527,328,35,4,199,84,80,164,31
2020-05-29,LT,Türkiye,498,308,30,6,190,82,78,160,24
2020-05-30,LT,Türkiye,516,340,19,6,176,77,80,157,13
2020-05-31,LT,Türkiye,546,310,85,6,236,78,73,151,79
2020-06-01,LT,Türkiye,551,287,135,7,264,61,68,129,128
2020-06-02,LT,Türkiye,598,309,147,15,289,70,72,142,132
2020-06-03,LT,Türkiye,609,326,138,8,283,70,75,145,130
2020-06-04,LT,Türkiye,915,328,410,7,587,90,87,177,403
2020-06-05,LT,Türkiye,888,346,370,9,542,88,84,172,361
2020-06-06,LT,Türkiye,788,342,283,7,446,78,85,163,276
2020-06-07,LT,Türkiye,830,318,346,7,512,88,78,166,339
2020-06-08,LT,Türkiye,800,304,363,2,496,67,66,133,361
2020-06-09,LT,Türkiye,810,311,352,2,499,70,77,147,350
2020-06-10,LT,Türkiye,900,332,343,2,568,112,113,225,341
2020-06-11,LT,Türkiye,927,337,345,0,590,121,124,245,345
2020-06-12,LT,Türkiye,1010,328,434,3,682,129,119,248,431
2020-06-13,LT,Türkiye,944,353,347,7,591,118,126,244,340
2020-06-14,LT,Türkiye,951,330,392,11,621,120,109,229,381
2020-06-15,LT,Türkiye,1004,326,423,6,678,126,129,255,417
2020-06-16,LT,Türkiye,943,309,374,8,634,128,132,260,366
2020-06-17,LT,Türkiye,1049,322,410,10,727,160,157,317,400
2020-06-18,LT,Türkiye,1059,342,407,8,717,151,159,310,399
2020-06-19,LT,Türkiye,1177,349,480,9,828,172,176,348,471
2020-06-20,LT,Türkiye,1081,337,393,6,744,179,172,351,387
2020-06-21,LT,Türkiye,1118,331,428,7,787,181,178,359,421
2020-06-22,LT,Türkiye,1060,326,426,6,734,155,153,308,420
2020-06-23,LT,Türkiye,989,293,405,7,696,141,150,291,398
2020-06-24,LT,Türkiye,1142,324,458,8,818,182,178,360,450
2020-06-25,LT,Türkiye,1167,341,460,6,826,185,181,366,454
2020-06-26,LT,Türkiye,1352,367,545,5,985,228,212,440,540
2020-06-27,LT,Türkiye,1236,345,458,6,891,205,228,433,452
2020-06-28,LT,Türkiye,1256,323,500,6,933,218,215,433,494
2020-06-29,LT,Türkiye,1166,320,483,7,846,178,185,363,476
2020-06-30,LT,Türkiye,1092,310,423,7,782,186,173,359,416
2020-07-01,LT,Türkiye,1494,391,557,7,1103,277,269,546,550
2020-07-02,LT,Türkiye,1570,390,596,8,1180,286,298,584,588
2020-07-03,LT,Türkiye,1689,424,649,5,1265,314,302,616,644
2020-07-04,LT,Türkiye,1588,439,576,10,1149,283,290,573,566
2020-07-05,LT,Türkiye,1633,442,649,7,1191,274,268,542,642
2020-07-06,LT,Türkiye,1475,385,623,7,1090,230,237,467,616
2020-07-07,LT,Türkiye,1366,369,549,5,997,219,229,448,544
2020-07-08,LT,Türkiye,1522,412,592,6,1110,265,253,518,586
2020-07-09,LT,Türkiye,1499,381,600,6,1118,259,259,518,594
2020-07-10,LT,Türkiye,1656,417,652,7,1239,295,292,587,645
2020-07-11,LT,Türkiye,1620,460,582,5,1160,290,288,578,577
2020-07-12,LT,Türkiye,1601,421,643,5,1180,266,271,537,638
2020-07-13,LT,Türkiye,1542,394,643,5,1148,250,255,505,638
2020-07-14,LT,Türkiye,1388,379,557,7,1009,218,234,452,550
2020-07-15,LT,Türkiye,1622,461,579,7,1161,302,280,582,572
2020-07-16,LT,Türkiye,1749,447,627,8,1302,337,338,675,619
2020-07-17,LT,Türkiye,1843,471,662,7,1372,354,356,710,655
2020-07-18,LT,Türkiye,1809,508,587,5,1301,361,353,714,582
2020-07-19,LT,Türkiye,1772,472,654,4,1300,315,331,646,650
2020-07-20,LT,Türkiye,1669,438,650,7,1231,301,280,581,643
2020-07-21,LT,Türkiye,1529,382,584,6,1147,267,296,563,578
2020-07-22,LT,Türkiye,1682,454,618,7,1228,308,302,610,611
2020-07-23,LT,Türkiye,1848,452,683,12,1396,356,357,713,671
2020-07-24,LT,Türkiye,1917,416,763,6,1501,368,370,738,757
2020-07-25,LT,Türkiye,1943,509,701,6,1434,361,372,733,695
2020-07-26,LT,Türkiye,1891,470,733,5,1421,345,343,688,728
2020-07-27,LT,Türkiye,1754,417,706,7,1337,321,310,631,699
2020-07-28,LT,Türkiye,1682,377,677,7,1305,310,318,628,670
2020-07-29,LT,Türkiye,1820,465,708,7,1355,334,313,647,701
2020-07-30,LT,Türkiye,1924,428,769,6,1496,366,361,727,763
2020-07-31,LT,Türkiye,1849,468,652,6,1381,365,364,729,646
2020-08-01,LT,Türkiye,2125,545,623,7,1580,484,473,957,616
2020-08-02,LT,Türkiye,2051,513,670,7,1538,432,436,868,663
2020-08-03,LT,Türkiye,2019,431,783,9,1588,401,404,805,774
2020-08-04,LT,Türkiye,1902,416,726,7,1486,380,380,760,719
2020-08-05,LT,Türkiye,2086,515,713,9,1571,431,427,858,704
2020-08-06,LT,Türkiye,2074,491,718,5,1583,434,431,865,713
2020-08-07,LT,Türkiye,2174,483,751,9,1691,451,489,940,742
2020-08-08,LT,Türkiye,2297,557,710,7,1740,526,504,1030,703
2020-08-09,LT,Türkiye,2165,543,739,8,1622,448,435,883,731
2020-08-10,LT,Türkiye,2199,449,735,8,1750,503,512,1015,727
2020-08-11,LT,Türkiye,2054,420,697,9,1634,472,465,937,688
2020-08-12,LT,Türkiye,2191,494,722,10,1697,481,494,975,712
2020-08-13,LT,Türkiye,2217,495,729,9,1722,503,490,993,720
2020-08-14,LT,Türkiye,2347,480,766,10,1867,550,551,1101,756
2020-08-15,LT,Türkiye,2508,602,721,7,1906,589,596,1185,714
2020-08-16,LT,Türkiye,2396,554,779,7,1842,537,526,1063,772
2020-08-17,LT,Türkiye,2233,480,746,6,1753,507,500,1007,740
2020-08-18,LT,Türkiye,2047,458,686,7,1589,451,452,903,679
2020-08-19,LT,Türkiye,2255,541,720,10,1714,495,499,994,710
2020-08-20,LT,Türkiye,2346,536,759,10,1810,529,522,1051,749
2020-08-21,LT,Türkiye,2416,502,773,7,1914,566,575,1141,766
2020-08-22,LT,Türkiye,2517,616,725,6,1901,592,584,1176,719
2020-08-23,LT,Türkiye,2414,535,785,6,1879,548,546,1094,779
2020-08-24,LT,Türkiye,2220,468,742,8,1752,500,510,1010,734
2020-08-25,LT,Türkiye,2165,485,705,7,1680,493,482,975,698
2020-08-26,LT,Türkiye,2302,568,729,14,1734,505,500,1005,715
2020-08-27,LT,Türkiye,2361,558,720,10,1803,545,538,1083,710
2020-08-28,LT,Türkiye,2480,522,796,9,1958,578,584,1162,787
2020-08-29,LT,Türkiye,2545,618,744,4,1927,583,600,1183,740
2020-08-30,LT,Türkiye,2540,597,804,7,1943,578,561,1139,797
2020-08-31,LT,Türkiye,2311,523,745,7,1788,521,522,1043,738
2020-09-01,LT,Türkiye,2151,482,674,6,1669,499,496,995,668
2020-09-02,LT,Türkiye,2330,586,698,6,1744,529,517,1046,692
2020-09-03,LT,Türkiye,2361,529,724,7,1832,547,561,1108,717
2020-09-04,LT,Türkiye,2467,564,747,8,1903,582,574,1156,739
2020-09-05,LT,Türkiye,2555,635,699,7,1920,600,621,1221,692
2020-09-06,LT,Türkiye,2509,659,753,5,1850,563,534,1097,748
2020-09-07,LT,Türkiye,2302,525,732,7,1777,521,524,1045,725
2020-09-08,LT,Türkiye,2078,482,668,11,1596,467,461,928,657
2020-09-09,LT,Türkiye,2283,584,687,10,1699,507,505,1012,677
2020-09-10,LT,Türkiye,2408,556,738,6,1852,555,559,1114,732
2020-09-11,LT,Türkiye,2464,565,764,6,1899,564,571,1135,758
2020-09-12,LT,Türkiye,2596,649,759,6,1947,591,597,1188,753
2020-09-13,LT,Türkiye,2495,617,767,6,1878,563,548,1111,761
2020-09-14,LT,Türkiye,2230,498,715,8,1732,507,510,1017,707
2020-09-15,LT,Türkiye,2081,477,666,8,1604,466,472,938,658
2020-09-16,LT,Türkiye,2296,619,687,6,1677,504,486,990,681
2020-09-17,LT,Türkiye,2401,596,708,8,1805,545,552,1097,700
2020-09-18,LT,Türkiye,2479,580,767,10,1899,570,562,1132,757
2020-09-19,LT,Türkiye,2517,647,687,11,1870,587,596,1183,676
2020-09-20,LT,Türkiye,2525,638,762,10,1887,569,556,1125,752
2020-09-21,LT,Türkiye,2242,572,705,7,1670,482,483,965,698
2020-09-22,LT,Türkiye,2050,484,646,10,1566,453,467,920,636
2020-09-23,LT,Türkiye,2279,603,676,9,1676,505,495,1000,667
2020-09-24,LT,Türkiye,2358,577,700,8,1781,545,536,1081,692
2020-09-25,LT,Türkiye,2561,590,785,9,1971,586,600,1186,776
2020-09-26,LT,Türkiye,2624,703,719,11,1921,602,600,1202,708
2020-09-27,LT,Türkiye,2514,621,754,7,1893,569,570,1139,747
2020-09-28,LT,Türkiye,2147,473,706,6,1674,497,471,968,700
2020-09-29,LT,Türkiye,2044,472,638,7,1572,459,475,934,631
2020-09-30,LT,Türkiye,2259,560,662,11,1699,528,509,1037,651
2020-10-01,LT,Türkiye,2313,549,658,10,1764,548,558,1106,648
2020-10-02,LT,Türkiye,2404,498,729,6,1906,592,585,1177,723
2020-10-03,LT,Türkiye,2542,618,650,6,1924,627,647,1274,644
2020-10-04,LT,Türkiye,2483,588,730,5,1895,579,586,1165,725
2020-10-05,LT,Türkiye,2132,482,671,6,1650,496,483,979,665
2020-10-06,LT,Türkiye,1925,413,620,8,1512,441,451,892,612
2020-10-07,LT,Türkiye,2167,526,650,11,1641,498,493,991,639
2020-10-08,LT,Türkiye,2215,524,647,6,1691,523,521,1044,641
2020-10-09,LT,Türkiye,2397,533,725,9,1864,578,561,1139,716
2020-10-10,LT,Türkiye,2559,690,646,9,1869,606,617,1223,637
2020-10-11,LT,Türkiye,2432,557,728,6,1875,573,574,1147,722
2020-10-12,LT,Türkiye,2100,454,675,11,1646,485,486,971,664
2020-10-13,LT,Türkiye,1932,453,606,10,1479,431,442,873,596
2020-10-14,LT,Türkiye,2140,547,626,7,1593,490,477,967,619
2020-10-15,LT,Türkiye,2201,527,663,9,1674,503,508,1011,654
2020-10-16,LT,Türkiye,2373,562,734,8,1811,544,533,1077,726
2020-10-17,LT,Türkiye,2476,690,631,3,1786,571,584,1155,628
2020-10-18,LT,Türkiye,2466,615,741,7,1851,553,557,1110,734
2020-10-19,LT,Türkiye,2013,484,666,7,1529,437,426,863,659
2020-10-20,LT,Türkiye,1820,454,594,7,1366,384,388,772,587
2020-10-21,LT,Türkiye,2082,556,616,5,1526,462,448,910,611
2020-10-22,LT,Türkiye,2127,555,628,8,1572,466,478,944,620
2020-10-23,LT,Türkiye,2300,573,743,1,1727,499,485,984,742
2020-10-24,LT,Türkiye,2435,707,630,4,1728,545,553,1098,626
2020-10-25,LT,Türkiye,2301,638,687,7,1663,483,493,976,680
2020-10-26,LT,Türkiye,1960,503,630,7,1457,418,409,827,623
2020-10-27,LT,Türkiye,1723,485,554,8,1238,340,344,684,546
2020-10-28,LT,Türkiye,2031,604,608,6,1427,420,399,819,602
2020-10-29,LT,Türkiye,1972,597,584,8,1375,394,397,791,576
2020-10-30,LT,Türkiye,2164,598,688,10,1566,443,435,878,678
2020-10-31,LT,Türkiye,2260,733,599,5,1527,460,468,928,594
2020-11-01,LT,Türkiye,2301,669,732,7,1632,447,453,900,725
2020-11-02,LT,Türkiye,1832,488,606,7,1344,372,366,738,599
2020-11-03,LT,Türkiye,1615,441,539,7,1174,309,326,635,532
2020-11-04,LT,Türkiye,1876,567,559,9,1309,384,366,750,550
2020-11-05,LT,Türkiye,1866,554,565,8,1312,373,374,747,557
2020-11-06,LT,Türkiye,1991,556,658,5,1435,392,385,777,653
2020-11-07,LT,Türkiye,1998,658,569,6,1340,384,387,771,563
2020-11-08,LT,Türkiye,2092,624,639,4,1468,412,417,829,635
2020-11-09,LT,Türkiye,1762,480,586,5,1282,353,343,696,581
2020-11-10,LT,Türkiye,1655,489,541,6,1166,305,320,625,535
2020-11-11,LT,Türkiye,1757,527,549,6,1230,346,335,681,543
2020-11-12,LT,Türkiye,1821,566,564,7,1255,338,353,691,557
2020-11-13,LT,Türkiye,1952,532,673,3,1420,372,375,747,670
2020-11-14,LT,Türkiye,1873,605,581,8,1268,343,344,687,573
2020-11-15,LT,Türkiye,2012,584,672,6,1428,384,372,756,666
2020-11-16,LT,Türkiye,1771,459,611,8,1312,350,351,701,603
2020-11-17,LT,Türkiye,1516,451,513,4,1065,276,276,552,509
2020-11-18,LT,Türkiye,1704,532,563,5,1172,312,297,609,558
2020-11-19,LT,Türkiye,1759,532,573,6,1227,328,326,654,567
2020-11-20,LT,Türkiye,1888,531,668,9,1357,349,340,689,659
2020-11-21,LT,Türkiye,1747,563,556,8,1184,311,317,628,548
2020-11-22,LT,Türkiye,1895,556,660,6,1339,332,347,679,654
2020-11-23,LT,Türkiye,1657,440,602,7,1217,313,302,615,595
2020-11-24,LT,Türkiye,1462,446,511,8,1016,248,257,505,503
2020-11-25,LT,Türkiye,1716,544,541,3,1172,321,310,631,538
2020-11-26,LT,Türkiye,1700,509,555,8,1191,314,322,636,547
2020-11-27,LT,Türkiye,1833,505,671,8,1328,332,325,657,663
2020-11-28,LT,Türkiye,1701,565,540,7,1136,303,293,596,533
2020-11-29,LT,Türkiye,1856,541,628,10,1315,341,346,687,618
2020-11-30,LT,Türkiye,1642,436,594,14,1206,302,310,612,580
2020-12-01,LT,Türkiye,1449,458,481,4,991,248,262,510,477
2020-12-02,LT,Türkiye,1606,509,497,8,1097,317,283,600,489
2020-12-03,LT,Türkiye,1631,521,482,8,1110,316,312,628,474
2020-12-04,LT,Türkiye,1825,537,581,8,1288,354,353,707,573
2020-12-05,LT,Türkiye,1589,596,370,8,993,310,313,623,362
2020-12-06,LT,Türkiye,1657,561,423,8,1096,334,339,673,415
2020-12-07,LT,Türkiye,1536,462,494,6,1074,292,288,580,488
2020-12-08,LT,Türkiye,1356,446,436,10,910,235,239,474,426
2020-12-09,LT,Türkiye,1562,533,443,9,1029,308,278,586,434
2020-12-10,LT,Türkiye,1622,517,451,6,1105,319,335,654,445
2020-12-11,LT,Türkiye,1763,542,550,12,1221,333,338,671,538
2020-12-12,LT,Türkiye,1510,605,286,10,905,306,313,619,276
2020-12-13,LT,Türkiye,1599,590,317,9,1009,345,347,692,308
2020-12-14,LT,Türkiye,1588,493,488,8,1095,305,302,607,480
2020-12-15,LT,Türkiye,1505,507,446,10,998,271,281,552,436
2020-12-16,LT,Türkiye,1693,607,469,15,1086,318,299,617,454
2020-12-17,LT,Türkiye,1723,594,425,9,1129,355,349,704,416
2020-12-18,LT,Türkiye,1957,627,539,6,1330,392,399,791,533
2020-12-19,LT,Türkiye,1718,700,265,4,1018,375,378,753,261
2020-12-20,LT,Türkiye,1680,654,272,3,1026,381,373,754,269
2020-12-21,LT,Türkiye,1701,535,509,4,1166,324,333,657,505
2020-12-22,LT,Türkiye,1510,501,463,4,1009,268,278,546,459
2020-12-23,LT,Türkiye,1690,607,459,4,1083,323,301,624,455
2020-12-24,LT,Türkiye,1581,471,461,3,1110,321,328,649,458
2020-12-25,LT,Türkiye,1666,489,518,4,1177,333,326,659,514
2020-12-26,LT,Türkiye,1534,571,286,4,963,331,346,677,282
2020-12-27,LT,Türkiye,1550,563,279,4,987,360,348,708,275
2020-12-28,LT,Türkiye,1585,484,471,3,1101,307,323,630,468
2020-12-29,LT,Türkiye,1449,449,420,3,1000,287,293,580,417
2020-12-30,LT,Türkiye,1707,571,472,7,1136,337,327,664,465
2020-12-31,LT,Türkiye,1430,395,446,3,1035,292,297,589,443
2020-01-01,UK,Ukraine,531,183,28,0,348,160,160,320,28
2020-01-02,UK,Ukraine,695,245,37,0,450,210,203,413,37
2020-01-03,UK,Ukraine,728,256,42,1,472,215,215,430,41
2020-01-04,UK,Ukraine,693,265,36,0,428,201,191,392,36
2020-01-05,UK,Ukraine,728,265,41,3,463,205,217,422,38
2020-01-06,UK,Ukraine,615,184,42,0,431,199,190,389,42
2020-01-07,UK,Ukraine,606,203,41,0,403,179,183,362,41
2020-01-08,UK,Ukraine,658,222,52,11,436,194,190,384,41
2020-01-09,UK,Ukraine,570,181,35,2,389,176,178,354,33
2020-01-10,UK,Ukraine,677,225,45,3,452,200,207,407,42
2020-01-11,UK,Ukraine,683,284,33,1,399,188,178,366,32
2020-01-12,UK,Ukraine,711,266,36,1,445,193,216,409,35
2020-01-13,UK,Ukraine,644,218,45,0,426,194,187,381,45
2020-01-14,UK,Ukraine,613,225,45,2,388,171,172,343,43
2020-01-15,UK,Ukraine,631,223,44,1,408,182,182,364,43
2020-01-16,UK,Ukraine,594,216,38,2,378,167,173,340,36
2020-01-17,UK,Ukraine,651,215,47,1,436,196,193,389,46
2020-01-18,UK,Ukraine,618,253,25,1,365,176,164,340,24
2020-01-19,UK,Ukraine,702,274,38,0,428,186,204,390,38
2020-01-20,UK,Ukraine,649,203,51,0,446,199,196,395,51
2020-01-21,UK,Ukraine,623,228,43,0,395,176,176,352,43
2020-01-22,UK,Ukraine,610,207,42,0,403,181,180,361,42
2020-01-23,UK,Ukraine,588,205,47,4,383,168,168,336,43
2020-01-24,UK,Ukraine,674,232,52,3,442,195,195,390,49
2020-01-25,UK,Ukraine,603,231,35,1,372,174,163,337,34
2020-01-26,UK,Ukraine,682,252,41,0,430,183,206,389,41
2020-01-27,UK,Ukraine,641,213,48,4,428,194,186,380,44
2020-01-28,UK,Ukraine,607,224,41,1,383,176,166,342,40
2020-01-29,UK,Ukraine,636,237,43,1,399,172,184,356,42
2020-01-30,UK,Ukraine,599,203,44,3,396,176,176,352,41
2020-01-31,UK,Ukraine,653,229,45,0,424,193,186,379,45
2020-02-01,UK,Ukraine,599,226,31,0,373,177,165,342,31
2020-02-02,UK,Ukraine,707,275,37,1,432,188,207,395,36
2020-02-03,UK,Ukraine,640,207,43,0,433,199,191,390,43
2020-02-04,UK,Ukraine,593,208,44,0,385,169,172,341,44
2020-02-05,UK,Ukraine,625,212,40,1,413,187,186,373,39
2020-02-06,UK,Ukraine,562,189,33,0,373,170,170,340,33
2020-02-07,UK,Ukraine,651,217,49,3,434,195,190,385,46
2020-02-08,UK,Ukraine,600,222,36,0,378,174,168,342,36
2020-02-09,UK,Ukraine,654,229,36,0,425,183,206,389,36
2020-02-10,UK,Ukraine,623,198,48,4,425,193,184,377,44
2020-02-11,UK,Ukraine,593,228,38,0,365,165,162,327,38
2020-02-12,UK,Ukraine,616,214,42,1,402,177,183,360,41
2020-02-13,UK,Ukraine,593,210,47,0,383,170,166,336,47
2020-02-14,UK,Ukraine,675,226,56,0,449,198,195,393,56
2020-02-15,UK,Ukraine,636,251,35,1,385,180,170,350,34
2020-02-16,UK,Ukraine,687,246,43,0,441,188,210,398,43
2020-02-17,UK,Ukraine,610,193,44,0,417,186,187,373,44
2020-02-18,UK,Ukraine,591,203,42,1,388,173,173,346,41
2020-02-19,UK,Ukraine,649,220,46,7,429,195,188,383,39
2020-02-20,UK,Ukraine,612,211,52,9,401,175,174,349,43
2020-02-21,UK,Ukraine,707,229,64,3,478,206,208,414,61
2020-02-22,UK,Ukraine,610,235,39,4,375,174,162,336,35
2020-02-23,UK,Ukraine,670,237,36,0,433,190,207,397,36
2020-02-24,UK,Ukraine,649,215,54,7,434,194,186,380,47
2020-02-25,UK,Ukraine,583,202,43,0,381,171,167,338,43
2020-02-26,UK,Ukraine,606,203,42,0,403,176,185,361,42
2020-02-27,UK,Ukraine,600,221,45,0,379,165,169,334,45
2020-02-28,UK,Ukraine,667,218,57,2,449,201,191,392,55
2020-02-29,UK,Ukraine,622,243,38,0,379,173,168,341,38
2020-03-01,UK,Ukraine,674,242,35,0,432,187,210,397,35
2020-03-02,UK,Ukraine,629,191,51,1,438,195,192,387,50
2020-03-03,UK,Ukraine,607,210,50,2,397,175,172,347,48
2020-03-04,UK,Ukraine,624,211,48,2,413,182,183,365,46
2020-03-05,UK,Ukraine,626,216,49,2,410,177,184,361,47
2020-03-06,UK,Ukraine,689,231,54,2,458,208,196,404,52
2020-03-07,UK,Ukraine,601,239,28,0,362,171,163,334,28
2020-03-08,UK,Ukraine,663,237,34,1,426,191,201,392,33
2020-03-09,UK,Ukraine,608,194,38,0,414,187,189,376,38
2020-03-10,UK,Ukraine,596,216,34,1,380,171,175,346,33
2020-03-11,UK,Ukraine,632,215,43,2,417,188,186,374,41
2020-03-12,UK,Ukraine,559,193,40,1,366,160,166,326,39
2020-03-13,UK,Ukraine,620,210,38,1,410,183,189,372,37
2020-03-14,UK,Ukraine,572,230,26,0,342,162,154,316,26
2020-03-15,UK,Ukraine,576,216,26,0,360,164,170,334,26
2020-03-16,UK,Ukraine,489,160,38,0,329,154,137,291,38
2020-03-17,UK,Ukraine,250,131,18,0,119,48,53,101,18
2020-03-18,UK,Ukraine,240,104,7,0,136,62,67,129,7
2020-03-19,UK,Ukraine,198,88,9,2,110,49,52,101,7
2020-03-20,UK,Ukraine,178,82,7,1,96,43,46,89,6
2020-03-21,UK,Ukraine,157,82,4,0,75,35,36,71,4
2020-03-22,UK,Ukraine,125,63,4,0,62,28,30,58,4
2020-03-23,UK,Ukraine,96,42,9,0,54,23,22,45,9
2020-03-24,UK,Ukraine,128,64,7,0,64,27,30,57,7
2020-03-25,UK,Ukraine,131,57,4,1,74,37,33,70,3
2020-03-26,UK,Ukraine,127,62,3,0,65,31,31,62,3
2020-03-27,UK,Ukraine,174,60,5,1,114,54,55,109,4
2020-03-28,UK,Ukraine,60,48,2,0,12,4,6,10,2
2020-03-29,UK,Ukraine,58,35,2,0,23,8,13,21,2
2020-03-30,UK,Ukraine,48,30,4,3,18,8,6,14,1
2020-03-31,UK,Ukraine,46,35,2,0,11,4,5,9,2
2020-04-01,UK,Ukraine,67,42,3,0,25,13,9,22,3
2020-04-02,UK,Ukraine,62,41,4,2,21,8,9,17,2
2020-04-03,UK,Ukraine,72,41,2,0,31,16,13,29,2
2020-04-04,UK,Ukraine,56,43,3,1,13,4,6,10,2
2020-04-05,UK,Ukraine,32,27,1,0,5,2,2,4,1
2020-04-06,UK,Ukraine,66,43,4,3,23,10,9,19,1
2020-04-07,UK,Ukraine,60,29,5,2,31,15,11,26,3
2020-04-08,UK,Ukraine,67,42,2,1,25,11,12,23,1
2020-04-09,UK,Ukraine,57,32,1,1,25,11,13,24,0
2020-04-10,UK,Ukraine,58,34,4,3,24,12,8,20,1
2020-04-11,UK,Ukraine,46,25,3,0,21,10,8,18,3
2020-04-12,UK,Ukraine,35,27,0,0,8,3,5,8,0
2020-04-13,UK,Ukraine,37,18,7,2,19,7,5,12,5
2020-04-14,UK,Ukraine,57,39,0,0,18,9,9,18,0
2020-04-15,UK,Ukraine,60,33,6,1,27,11,10,21,5
2020-04-16,UK,Ukraine,64,43,4,1,21,9,8,17,3
2020-04-17,UK,Ukraine,65,31,1,0,34,18,15,33,1
2020-04-18,UK,Ukraine,60,38,0,0,22,10,12,22,0
2020-04-19,UK,Ukraine,52,38,0,0,14,6,8,14,0
2020-04-20,UK,Ukraine,39,23,0,0,16,8,8,16,0
2020-04-21,UK,Ukraine,51,29,0,0,22,11,11,22,0
2020-04-22,UK,Ukraine,65,40,2,2,25,12,11,23,0
2020-04-23,UK,Ukraine,80,48,8,4,32,13,11,24,4
2020-04-24,UK,Ukraine,72,39,1,0,33,16,16,32,1
2020-04-25,UK,Ukraine,49,32,2,1,17,7,8,15,1
2020-04-26,UK,Ukraine,49,30,0,0,19,10,9,19,0
2020-04-27,UK,Ukraine,78,47,6,4,31,12,13,25,2
2020-04-28,UK,Ukraine,73,36,4,2,37,19,14,33,2
2020-04-29,UK,Ukraine,105,62,5,3,43,20,18,38,2
2020-04-30,UK,Ukraine,83,43,5,0,40,17,18,35,5
2020-05-01,UK,Ukraine,88,47,3,0,41,20,18,38,3
2020-05-02,UK,Ukraine,65,44,0,0,21,10,11,21,0
2020-05-03,UK,Ukraine,72,46,1,0,26,13,12,25,1
2020-05-04,UK,Ukraine,89,39,5,3,50,24,21,45,2
2020-05-05,UK,Ukraine,72,27,3,2,45,20,22,42,1
2020-05-06,UK,Ukraine,81,38,10,4,43,16,17,33,6
2020-05-07,UK,Ukraine,78,38,6,1,40,17,17,34,5
2020-05-08,UK,Ukraine,69,38,1,0,31,14,16,30,1
2020-05-09,UK,Ukraine,72,36,4,0,36,18,14,32,4
2020-05-10,UK,Ukraine,83,42,2,1,41,20,19,39,1
2020-05-11,UK,Ukraine,74,37,4,1,37,20,13,33,3
2020-05-12,UK,Ukraine,80,34,1,0,46,22,23,45,1
2020-05-13,UK,Ukraine,102,46,7,2,56,25,24,49,5
2020-05-14,UK,Ukraine,103,44,7,2,59,26,26,52,5
2020-05-15,UK,Ukraine,99,49,2,2,50,23,25,48,0
2020-05-16,UK,Ukraine,67,40,2,2,27,14,11,25,0
2020-05-17,UK,Ukraine,70,38,1,0,32,14,17,31,1
2020-05-18,UK,Ukraine,77,30,2,0,47,24,21,45,2
2020-05-19,UK,Ukraine,77,23,6,3,54,19,29,48,3
2020-05-20,UK,Ukraine,99,42,7,4,57,28,22,50,3
2020-05-21,UK,Ukraine,90,37,9,1,53,23,21,44,8
2020-05-22,UK,Ukraine,109,48,11,2,61,26,24,50,9
2020-05-23,UK,Ukraine,67,34,1,1,33,15,17,32,0
2020-05-24,UK,Ukraine,70,36,2,0,34,14,18,32,2
2020-05-25,UK,Ukraine,84,31,5,2,53,28,20,48,3
2020-05-26,UK,Ukraine,85,32,6,2,53,24,23,47,4
2020-05-27,UK,Ukraine,100,33,16,6,67,24,27,51,10
2020-05-28,UK,Ukraine,81,33,8,1,48,22,18,40,7
2020-05-29,UK,Ukraine,108,43,17,5,65,23,25,48,12
2020-05-30,UK,Ukraine,87,37,3,0,50,24,23,47,3
2020-05-31,UK,Ukraine,75,37,7,0,38,16,15,31,7
2020-06-01,UK,Ukraine,69,32,1,0,37,19,17,36,1
2020-06-02,UK,Ukraine,71,33,3,0,38,17,18,35,3
2020-06-03,UK,Ukraine,79,44,5,0,35,16,14,30,5
2020-06-04,UK,Ukraine,86,40,7,1,46,19,20,39,6
2020-06-05,UK,Ukraine,97,43,9,4,54,22,23,45,5
2020-06-06,UK,Ukraine,67,30,5,1,37,16,16,32,4
2020-06-07,UK,Ukraine,84,46,7,1,38,15,16,31,6
2020-06-08,UK,Ukraine,66,33,6,1,33,15,12,27,5
2020-06-09,UK,Ukraine,66,34,7,0,32,11,14,25,7
2020-06-10,UK,Ukraine,80,53,3,2,27,13,11,24,1
2020-06-11,UK,Ukraine,85,46,10,0,39,15,14,29,10
2020-06-12,UK,Ukraine,104,49,15,1,55,19,21,40,14
2020-06-13,UK,Ukraine,66,32,7,2,34,11,16,27,5
2020-06-14,UK,Ukraine,72,45,6,1,27,9,12,21,5
2020-06-15,UK,Ukraine,118,47,14,0,71,31,26,57,14
2020-06-16,UK,Ukraine,117,38,23,1,79,27,29,56,22
2020-06-17,UK,Ukraine,170,67,26,1,103,40,37,77,25
2020-06-18,UK,Ukraine,135,54,27,2,81,27,27,54,25
2020-06-19,UK,Ukraine,168,59,26,4,109,42,41,83,22
2020-06-20,UK,Ukraine,130,38,25,0,92,35,32,67,25
2020-06-21,UK,Ukraine,137,57,20,0,80,30,30,60,20
2020-06-22,UK,Ukraine,150,38,20,0,112,49,43,92,20
2020-06-23,UK,Ukraine,161,63,21,0,98,37,40,77,21
2020-06-24,UK,Ukraine,160,48,27,1,112,43,42,85,26
2020-06-25,UK,Ukraine,152,54,31,2,98,34,33,67,29
2020-06-26,UK,Ukraine,215,70,32,0,145,57,56,113,32
2020-06-27,UK,Ukraine,126,39,24,2,87,32,31,63,22
2020-06-28,UK,Ukraine,136,53,16,0,83,31,36,67,16
2020-06-29,UK,Ukraine,168,45,33,5,123,45,45,90,28
2020-06-30,UK,Ukraine,137,40,24,1,97,37,36,73,23
2020-07-01,UK,Ukraine,278,93,36,2,185,75,74,149,34
2020-07-02,UK,Ukraine,231,85,37,1,146,57,52,109,36
2020-07-03,UK,Ukraine,353,110,46,3,243,98,99,197,43
2020-07-04,UK,Ukraine,268,88,35,2,180,72,73,145,33
2020-07-05,UK,Ukraine,304,110,40,1,194,73,81,154,39
2020-07-06,UK,Ukraine,278,81,35,0,197,82,80,162,35
2020-07-07,UK,Ukraine,260,101,44,1,159,60,55,115,43
2020-07-08,UK,Ukraine,282,91,33,1,191,76,82,158,32
2020-07-09,UK,Ukraine,278,90,37,1,188,71,80,151,36
2020-07-10,UK,Ukraine,355,132,42,1,223,93,88,181,41
2020-07-11,UK,Ukraine,286,112,35,0,174,73,66,139,35
2020-07-12,UK,Ukraine,327,125,31,0,202,81,90,171,31
2020-07-13,UK,Ukraine,299,94,36,3,205,83,86,169,33
2020-07-14,UK,Ukraine,301,110,40,1,191,75,76,151,39
2020-07-15,UK,Ukraine,347,119,36,5,228,95,97,192,31
2020-07-16,UK,Ukraine,364,128,47,1,236,97,92,189,46
2020-07-17,UK,Ukraine,405,132,47,3,273,116,110,226,44
2020-07-18,UK,Ukraine,361,130,36,0,231,95,100,195,36
2020-07-19,UK,Ukraine,393,153,34,0,240,104,102,206,34
2020-07-20,UK,Ukraine,354,113,40,0,241,100,101,201,40
2020-07-21,UK,Ukraine,344,118,39,0,226,92,95,187,39
2020-07-22,UK,Ukraine,321,101,37,0,220,89,94,183,37
2020-07-23,UK,Ukraine,383,125,44,1,258,108,106,214,43
2020-07-24,UK,Ukraine,424,141,36,0,283,127,120,247,36
2020-07-25,UK,Ukraine,370,134,36,0,236,99,101,200,36
2020-07-26,UK,Ukraine,367,141,32,0,226,98,96,194,32
2020-07-27,UK,Ukraine,352,99,40,2,253,108,105,213,38
2020-07-28,UK,Ukraine,369,124,37,2,245,104,104,208,35
2020-07-29,UK,Ukraine,342,103,37,3,239,101,101,202,34
2020-07-30,UK,Ukraine,358,114,45,4,244,98,101,199,41
2020-07-31,UK,Ukraine,438,140,40,1,298,133,125,258,39
2020-08-01,UK,Ukraine,446,161,40,0,285,124,121,245,40
2020-08-02,UK,Ukraine,471,164,44,2,307,128,135,263,42
2020-08-03,UK,Ukraine,429,146,53,2,283,113,117,230,51
2020-08-04,UK,Ukraine,434,144,51,3,290,126,113,239,48
2020-08-05,UK,Ukraine,435,154,44,1,281,119,118,237,43
2020-08-06,UK,Ukraine,413,137,48,1,276,110,118,228,47
2020-08-07,UK,Ukraine,497,184,42,0,313,138,133,271,42
2020-08-08,UK,Ukraine,459,159,37,0,300,135,128,263,37
2020-08-09,UK,Ukraine,447,162,32,0,285,124,129,253,32
2020-08-10,UK,Ukraine,431,158,44,0,273,113,116,229,44
2020-08-11,UK,Ukraine,426,154,40,0,272,111,121,232,40
2020-08-12,UK,Ukraine,436,158,39,1,278,123,116,239,38
2020-08-13,UK,Ukraine,434,154,51,1,280,112,117,229,50
2020-08-14,UK,Ukraine,528,184,47,1,344,152,145,297,46
2020-08-15,UK,Ukraine,493,191,40,0,302,130,132,262,40
2020-08-16,UK,Ukraine,537,205,40,0,332,146,146,292,40
2020-08-17,UK,Ukraine,480,166,49,2,314,132,133,265,47
2020-08-18,UK,Ukraine,437,146,44,0,291,126,121,247,44
2020-08-19,UK,Ukraine,470,172,47,1,298,127,124,251,46
2020-08-20,UK,Ukraine,464,160,50,0,304,125,129,254,50
2020-08-21,UK,Ukraine,546,170,53,0,376,165,158,323,53
2020-08-22,UK,Ukraine,495,181,46,1,314,134,134,268,45
2020-08-23,UK,Ukraine,516,196,41,1,320,138,141,279,40
2020-08-24,UK,Ukraine,472,161,49,0,311,131,131,262,49
2020-08-25,UK,Ukraine,464,178,47,1,286,120,119,239,46
2020-08-26,UK,Ukraine,488,173,46,0,315,134,135,269,46
2020-08-27,UK,Ukraine,459,147,46,0,312,129,137,266,46
2020-08-28,UK,Ukraine,561,188,49,1,373,167,157,324,48
2020-08-29,UK,Ukraine,492,188,38,1,304,131,135,266,37
2020-08-30,UK,Ukraine,522,186,44,1,336,142,150,292,43
2020-08-31,UK,Ukraine,487,158,56,0,329,137,136,273,56
2020-09-01,UK,Ukraine,449,153,51,1,296,121,124,245,50
2020-09-02,UK,Ukraine,408,137,50,4,271,113,108,221,46
2020-09-03,UK,Ukraine,431,136,56,3,295,120,119,239,53
2020-09-04,UK,Ukraine,521,160,60,1,361,154,147,301,59
2020-09-05,UK,Ukraine,455,162,41,0,293,126,126,252,41
2020-09-06,UK,Ukraine,454,153,36,0,301,129,136,265,36
2020-09-07,UK,Ukraine,442,121,49,1,321,142,130,272,48
2020-09-08,UK,Ukraine,405,147,50,2,258,102,106,208,48
2020-09-09,UK,Ukraine,395,131,40,0,264,109,115,224,40
2020-09-10,UK,Ukraine,417,126,53,2,291,121,117,238,51
2020-09-11,UK,Ukraine,513,158,63,6,355,147,145,292,57
2020-09-12,UK,Ukraine,473,172,45,2,301,130,126,256,43
2020-09-13,UK,Ukraine,459,167,40,0,292,123,129,252,40
2020-09-14,UK,Ukraine,437,139,51,4,298,127,120,247,47
2020-09-15,UK,Ukraine,372,145,51,4,227,87,89,176,47
2020-09-16,UK,Ukraine,407,149,48,0,258,103,107,210,48
2020-09-17,UK,Ukraine,406,145,48,0,261,104,109,213,48
2020-09-18,UK,Ukraine,495,169,55,2,326,140,131,271,53
2020-09-19,UK,Ukraine,443,169,38,0,274,116,120,236,38
2020-09-20,UK,Ukraine,437,171,40,0,266,111,115,226,40
2020-09-21,UK,Ukraine,419,140,52,2,279,116,111,227,50
2020-09-22,UK,Ukraine,364,127,51,1,237,89,97,186,50
2020-09-23,UK,Ukraine,409,150,53,4,259,107,99,206,49
2020-09-24,UK,Ukraine,399,144,53,2,255,105,97,202,51
2020-09-25,UK,Ukraine,486,157,66,3,329,133,130,263,63
2020-09-26,UK,Ukraine,415,153,35,0,262,112,115,227,35
2020-09-27,UK,Ukraine,447,181,34,0,266,111,121,232,34
2020-09-28,UK,Ukraine,392,129,52,0,263,110,101,211,52
2020-09-29,UK,Ukraine,375,143,44,0,232,90,98,188,44
2020-09-30,UK,Ukraine,428,156,53,0,272,109,110,219,53
2020-10-01,UK,Ukraine,380,123,51,2,257,102,104,206,49
2020-10-02,UK,Ukraine,437,138,53,0,299,128,118,246,53
2020-10-03,UK,Ukraine,412,158,37,0,254,105,112,217,37
2020-10-04,UK,Ukraine,437,170,39,0,267,111,117,228,39
2020-10-05,UK,Ukraine,410,125,43,2,285,124,118,242,41
2020-10-06,UK,Ukraine,322,110,40,2,212,89,83,172,38
2020-10-07,UK,Ukraine,380,130,41,2,250,105,104,209,39
2020-10-08,UK,Ukraine,350,126,35,1,224,95,94,189,34
2020-10-09,UK,Ukraine,411,122,48,0,289,116,125,241,48
2020-10-10,UK,Ukraine,396,143,31,0,253,109,113,222,31
2020-10-11,UK,Ukraine,412,147,35,0,265,113,117,230,35
2020-10-12,UK,Ukraine,376,124,47,0,252,101,104,205,47
2020-10-13,UK,Ukraine,281,91,37,2,190,81,72,153,35
2020-10-14,UK,Ukraine,373,122,40,1,251,108,103,211,39
2020-10-15,UK,Ukraine,331,121,38,1,210,88,84,172,37
2020-10-16,UK,Ukraine,419,136,46,3,283,121,116,237,43
2020-10-17,UK,Ukraine,400,150,31,0,250,105,114,219,31
2020-10-18,UK,Ukraine,420,142,33,1,278,116,129,245,32
2020-10-19,UK,Ukraine,340,110,42,1,230,97,91,188,41
2020-10-20,UK,Ukraine,262,96,39,3,166,65,62,127,36
2020-10-21,UK,Ukraine,325,118,41,1,207,82,84,166,40
2020-10-22,UK,Ukraine,327,111,40,1,216,90,86,176,39
2020-10-23,UK,Ukraine,370,113,36,1,257,110,111,221,35
2020-10-24,UK,Ukraine,376,146,40,2,230,91,99,190,38
2020-10-25,UK,Ukraine,392,126,35,0,266,118,113,231,35
2020-10-26,UK,Ukraine,335,117,41,4,218,91,86,177,37
2020-10-27,UK,Ukraine,294,94,47,1,200,78,75,153,46
2020-10-28,UK,Ukraine,326,112,39,1,214,83,92,175,38
2020-10-29,UK,Ukraine,310,94,39,0,216,88,89,177,39
2020-10-30,UK,Ukraine,378,137,35,1,241,105,101,206,34
2020-10-31,UK,Ukraine,354,127,30,0,227,99,98,197,30
2020-11-01,UK,Ukraine,389,140,25,0,249,110,114,224,25
2020-11-02,UK,Ukraine,296,104,36,3,192,79,77,156,33
2020-11-03,UK,Ukraine,255,71,47,5,184,72,65,137,42
2020-11-04,UK,Ukraine,309,115,38,1,194,75,81,156,37
2020-11-05,UK,Ukraine,309,92,42,1,217,88,87,175,41
2020-11-06,UK,Ukraine,351,126,46,4,225,89,90,179,42
2020-11-07,UK,Ukraine,350,131,41,6,219,88,90,178,35
2020-11-08,UK,Ukraine,348,113,36,2,235,99,100,199,34
2020-11-09,UK,Ukraine,279,90,38,0,189,75,76,151,38
2020-11-10,UK,Ukraine,248,86,35,0,162,66,61,127,35
2020-11-11,UK,Ukraine,267,95,40,0,172,62,70,132,40
2020-11-12,UK,Ukraine,279,95,39,2,184,73,72,145,37
2020-11-13,UK,Ukraine,295,100,38,1,195,81,76,157,37
2020-11-14,UK,Ukraine,290,106,34,3,184,74,76,150,31
2020-11-15,UK,Ukraine,318,99,34,0,219,91,94,185,34
2020-11-16,UK,Ukraine,266,85,38,0,181,75,68,143,38
2020-11-17,UK,Ukraine,232,69,35,3,163,71,57,128,32
2020-11-18,UK,Ukraine,268,88,38,1,180,71,71,142,37
2020-11-19,UK,Ukraine,279,102,39,4,177,68,70,138,35
2020-11-20,UK,Ukraine,279,88,42,0,191,72,77,149,42
2020-11-21,UK,Ukraine,260,101,31,1,159,63,65,128,30
2020-11-22,UK,Ukraine,279,89,33,1,190,77,80,157,32
2020-11-23,UK,Ukraine,241,81,33,0,160,65,62,127,33
2020-11-24,UK,Ukraine,217,65,35,2,152,60,57,117,33
2020-11-25,UK,Ukraine,281,93,41,0,188,73,74,147,41
2020-11-26,UK,Ukraine,256,84,36,1,172,70,66,136,35
2020-11-27,UK,Ukraine,277,91,39,5,186,71,76,147,34
2020-11-28,UK,Ukraine,261,97,30,1,164,67,67,134,29
2020-11-29,UK,Ukraine,299,97,34,0,202,83,85,168,34
2020-11-30,UK,Ukraine,261,77,35,2,184,71,78,149,33
2020-12-01,UK,Ukraine,247,84,34,0,163,65,64,129,34
2020-12-02,UK,Ukraine,276,86,45,3,190,74,71,145,42
2020-12-03,UK,Ukraine,245,90,33,2,155,63,59,122,31
2020-12-04,UK,Ukraine,311,113,48,1,198,74,76,150,47
2020-12-05,UK,Ukraine,255,96,33,0,159,64,62,126,33
2020-12-06,UK,Ukraine,296,108,29,1,188,80,79,159,28
2020-12-07,UK,Ukraine,258,95,29,1,163,64,70,134,28
2020-12-08,UK,Ukraine,239,76,41,7,163,64,58,122,34
2020-12-09,UK,Ukraine,284,107,40,1,177,69,68,137,39
2020-12-10,UK,Ukraine,241,103,31,1,138,46,61,107,30
2020-12-11,UK,Ukraine,324,115,41,1,209,85,83,168,40
2020-12-12,UK,Ukraine,320,128,28,2,192,83,81,164,26
2020-12-13,UK,Ukraine,320,109,35,0,211,88,88,176,35
2020-12-14,UK,Ukraine,261,81,34,0,180,73,73,146,34
2020-12-15,UK,Ukraine,270,100,38,0,170,67,65,132,38
2020-12-16,UK,Ukraine,282,90,37,3,192,77,78,155,34
2020-12-17,UK,Ukraine,299,106,35,1,193,76,82,158,34
2020-12-18,UK,Ukraine,385,127,46,4,258,108,104,212,42
2020-12-19,UK,Ukraine,352,123,33,0,229,95,101,196,33
2020-12-20,UK,Ukraine,359,129,36,0,230,98,96,194,36
2020-12-21,UK,Ukraine,333,102,42,0,231,93,96,189,42
2020-12-22,UK,Ukraine,306,109,40,0,197,81,76,157,40
2020-12-23,UK,Ukraine,358,125,45,1,233,93,95,188,44
2020-12-24,UK,Ukraine,315,105,47,2,210,80,83,163,45
2020-12-25,UK,Ukraine,304,113,31,0,191,80,80,160,31
2020-12-26,UK,Ukraine,298,107,28,2,191,81,82,163,26
2020-12-27,UK,Ukraine,352,119,32,0,233,99,102,201,32
2020-12-28,UK,Ukraine,346,119,34,0,227,98,95,193,34
2020-12-29,UK,Ukraine,289,94,43,1,195,78,74,152,42
2020-12-30,UK,Ukraine,317,122,38,1,195,75,82,157,37
2020-12-31,UK,Ukraine,179,72,22,0,107,42,43,85,22
2020-01-01,EG,United Kingdom,5011,1061,493,1,3950,1729,1728,3457,492
2020-01-02,EG,United Kingdom,6491,1239,847,12,5252,2201,2204,4405,835
2020-01-03,EG,United Kingdom,6811,1275,986,25,5536,2260,2290,4550,961
2020-01-04,EG,United Kingdom,6203,1359,574,8,4844,2119,2151,4270,566
2020-01-05,EG,United Kingdom,6762,1372,759,3,5390,2282,2349,4631,756
2020-01-06,EG,United Kingdom,6491,1246,967,13,5245,2143,2135,4278,954
2020-01-07,EG,United Kingdom,5762,1132,874,9,4630,1876,1880,3756,865
2020-01-08,EG,United Kingdom,5516,1042,882,25,4474,1803,1789,3592,857
2020-01-09,EG,United Kingdom,6005,1204,973,13,4801,1916,1912,3828,960
2020-01-10,EG,United Kingdom,6433,1136,1038,20,5297,2140,2119,4259,1018
2020-01-11,EG,United Kingdom,5439,1240,479,8,4199,1852,1868,3720,471
2020-01-12,EG,United Kingdom,6161,1211,732,7,4950,2105,2113,4218,725
2020-01-13,EG,United Kingdom,5995,1170,952,7,4825,1938,1935,3873,945
2020-01-14,EG,United Kingdom,5195,1075,908,8,4120,1597,1615,3212,900
2020-01-15,EG,United Kingdom,5396,1034,978,25,4362,1700,1684,3384,953
2020-01-16,EG,United Kingdom,5949,1163,992,13,4786,1888,1906,3794,979
2020-01-17,EG,United Kingdom,6486,1176,1059,21,5310,2125,2126,4251,1038
2020-01-18,EG,United Kingdom,5303,1148,504,7,4155,1831,1820,3651,497
2020-01-19,EG,United Kingdom,6267,1277,770,9,4990,2091,2129,4220,761
2020-01-20,EG,United Kingdom,6298,1275,1033,12,5023,2013,1977,3990,1021
2020-01-21,EG,United Kingdom,5391,1027,963,23,4364,1680,1721,3401,940
2020-01-22,EG,United Kingdom,5219,977,900,17,4242,1679,1663,3342,883
2020-01-23,EG,United Kingdom,6004,1118,1039,32,4886,1926,1921,3847,1007
2020-01-24,EG,United Kingdom,6786,1350,1118,30,5436,2174,2144,4318,1088
2020-01-25,EG,United Kingdom,5365,1230,487,6,4135,1822,1826,3648,481
2020-01-26,EG,United Kingdom,6124,1190,742,6,4934,2072,2120,4192,736
2020-01-27,EG,United Kingdom,6204,1173,1051,22,5031,1992,1988,3980,1029
2020-01-28,EG,United Kingdom,5294,969,995,20,4325,1655,1675,3330,975
2020-01-29,EG,United Kingdom,5381,977,1010,29,4404,1701,1693,3394,981
2020-01-30,EG,United Kingdom,5964,1098,990,15,4866,1953,1923,3876,975
2020-01-31,EG,United Kingdom,6573,1159,1074,12,5414,2182,2158,4340,1062
2020-02-01,EG,United Kingdom,5471,1173,515,11,4298,1882,1901,3783,504
2020-02-02,EG,United Kingdom,6150,1181,744,11,4969,2090,2135,4225,733
2020-02-03,EG,United Kingdom,6266,1139,1044,20,5127,2054,2029,4083,1024
2020-02-04,EG,United Kingdom,5533,1009,973,28,4524,1766,1785,3551,945
2020-02-05,EG,United Kingdom,5585,980,1040,32,4605,1777,1788,3565,1008
2020-02-06,EG,United Kingdom,6212,1154,1077,38,5058,2003,1978,3981,1039
2020-02-07,EG,United Kingdom,6784,1259,1119,26,5525,2229,2177,4406,1093
2020-02-08,EG,United Kingdom,5554,1144,538,16,4410,1936,1936,3872,522
2020-02-09,EG,United Kingdom,4249,1078,337,4,3171,1440,1394,2834,333
2020-02-10,EG,United Kingdom,6137,1081,1008,7,5056,1973,2075,4048,1001
2020-02-11,EG,United Kingdom,5532,953,932,8,4579,1825,1822,3647,924
2020-02-12,EG,United Kingdom,5774,973,1043,42,4801,1875,1883,3758,1001
2020-02-13,EG,United Kingdom,6380,1081,1055,20,5299,2117,2127,4244,1035
2020-02-14,EG,United Kingdom,7093,1223,1115,23,5870,2388,2367,4755,1092
2020-02-15,EG,United Kingdom,5686,1180,414,1,4506,2086,2006,4092,413
2020-02-16,EG,United Kingdom,6046,1119,673,2,4927,2105,2149,4254,671
2020-02-17,EG,United Kingdom,6612,1220,1037,7,5392,2171,2184,4355,1030
2020-02-18,EG,United Kingdom,6014,1056,1003,19,4958,1966,1989,3955,984
2020-02-19,EG,United Kingdom,5881,975,1029,20,4906,1940,1937,3877,1009
2020-02-20,EG,United Kingdom,6428,1122,1045,16,5306,2139,2122,4261,1029
2020-02-21,EG,United Kingdom,6986,1264,1079,20,5722,2322,2321,4643,1059
2020-02-22,EG,United Kingdom,5954,1109,518,13,4845,2119,2208,4327,505
2020-02-23,EG,United Kingdom,6615,1155,787,20,5460,2311,2362,4673,767
2020-02-24,EG,United Kingdom,6774,1181,1132,11,5593,2235,2226,4461,1121
2020-02-25,EG,United Kingdom,6270,1108,1084,17,5162,2050,2028,4078,1067
2020-02-26,EG,United Kingdom,6084,1034,1067,29,5050,2001,1982,3983,1038
2020-02-27,EG,United Kingdom,6547,1099,1120,19,5448,2156,2172,4328,1101
2020-02-28,EG,United Kingdom,6957,1272,1107,5,5685,2298,2280,4578,1102
2020-02-29,EG,United Kingdom,5755,1224,516,14,4531,2009,2006,4015,502
2020-03-01,EG,United Kingdom,6547,1281,784,9,5266,2242,2240,4482,775
2020-03-02,EG,United Kingdom,6741,1238,1143,23,5503,2182,2178,4360,1120
2020-03-03,EG,United Kingdom,6150,1061,1098,21,5089,1987,2004,3991,1077
2020-03-04,EG,United Kingdom,5970,1079,1032,21,4891,1941,1918,3859,1011
2020-03-05,EG,United Kingdom,6224,1229,878,19,4995,2068,2049,4117,859
2020-03-06,EG,United Kingdom,6597,1288,901,20,5309,2216,2192,4408,881
2020-03-07,EG,United Kingdom,5630,1290,403,3,4340,1960,1977,3937,400
2020-03-08,EG,United Kingdom,6204,1251,606,5,4953,2149,2198,4347,601
2020-03-09,EG,United Kingdom,6338,1163,892,15,5175,2149,2134,4283,877
2020-03-10,EG,United Kingdom,5498,1028,768,27,4470,1855,1847,3702,741
2020-03-11,EG,United Kingdom,5345,1013,777,12,4332,1780,1775,3555,765
2020-03-12,EG,United Kingdom,6046,1143,906,12,4903,2004,1993,3997,894
2020-03-13,EG,United Kingdom,6400,1242,885,21,5158,2156,2117,4273,864
2020-03-14,EG,United Kingdom,5167,1074,437,18,4093,1830,1826,3656,419
2020-03-15,EG,United Kingdom,5555,1107,578,4,4448,1914,1956,3870,574
2020-03-16,EG,United Kingdom,5561,1072,832,21,4489,1816,1841,3657,811
2020-03-17,EG,United Kingdom,4387,812,725,21,3575,1401,1449,2850,704
2020-03-18,EG,United Kingdom,4055,797,721,23,3258,1265,1272,2537,698
2020-03-19,EG,United Kingdom,4084,806,722,16,3278,1269,1287,2556,706
2020-03-20,EG,United Kingdom,4055,790,741,21,3265,1264,1260,2524,720
2020-03-21,EG,United Kingdom,2603,677,294,5,1926,819,813,1632,289
2020-03-22,EG,United Kingdom,2477,573,398,8,1904,746,760,1506,390
2020-03-23,EG,United Kingdom,2228,565,445,18,1663,602,616,1218,427
2020-03-24,EG,United Kingdom,1817,469,345,14,1348,498,505,1003,331
2020-03-25,EG,United Kingdom,1537,466,268,9,1071,398,405,803,259
2020-03-26,EG,United Kingdom,1561,463,260,10,1098,413,425,838,250
2020-03-27,EG,United Kingdom,1479,426,289,40,1053,386,378,764,249
2020-03-28,EG,United Kingdom,1063,330,148,30,733,294,291,585,118
2020-03-29,EG,United Kingdom,1010,304,107,3,706,288,311,599,104
2020-03-30,EG,United Kingdom,953,295,183,7,658,238,237,475,176
2020-03-31,EG,United Kingdom,971,294,196,7,677,240,241,481,189
2020-04-01,EG,United Kingdom,973,293,220,30,680,225,235,460,190
2020-04-02,EG,United Kingdom,907,265,173,14,642,236,233,469,159
2020-04-03,EG,United Kingdom,952,285,181,10,667,244,242,486,171
2020-04-04,EG,United Kingdom,690,225,75,1,465,197,193,390,74
2020-04-05,EG,United Kingdom,687,225,64,3,462,192,206,398,61
2020-04-06,EG,United Kingdom,755,249,145,3,506,191,170,361,142
2020-04-07,EG,United Kingdom,804,240,169,15,564,196,199,395,154
2020-04-08,EG,United Kingdom,840,249,184,7,591,204,203,407,177
2020-04-09,EG,United Kingdom,838,275,164,7,563,199,200,399,157
2020-04-10,EG,United Kingdom,726,253,127,6,473,176,170,346,121
2020-04-11,EG,United Kingdom,560,219,50,3,341,143,148,291,47
2020-04-12,EG,United Kingdom,539,193,50,1,346,146,150,296,49
2020-04-13,EG,United Kingdom,569,216,86,12,353,131,136,267,74
2020-04-14,EG,United Kingdom,712,211,163,10,501,171,167,338,153
2020-04-15,EG,United Kingdom,795,232,179,13,563,195,189,384,166
2020-04-16,EG,United Kingdom,841,256,189,13,585,196,200,396,176
2020-04-17,EG,United Kingdom,783,230,167,5,553,198,188,386,162
2020-04-18,EG,United Kingdom,588,197,71,4,391,160,160,320,67
2020-04-19,EG,United Kingdom,615,216,64,2,399,165,170,335,62
2020-04-20,EG,United Kingdom,759,217,147,9,542,199,196,395,138
2020-04-21,EG,United Kingdom,748,218,161,12,530,181,188,369,149
2020-04-22,EG,United Kingdom,881,268,193,11,613,214,206,420,182
2020-04-23,EG,United Kingdom,866,264,184,10,602,207,211,418,174
2020-04-24,EG,United Kingdom,861,259,170,7,602,222,210,432,163
2020-04-25,EG,United Kingdom,629,212,89,11,417,166,162,328,78
2020-04-26,EG,United Kingdom,647,241,59,8,406,169,178,347,51
2020-04-27,EG,United Kingdom,828,267,162,13,561,199,200,399,149
2020-04-28,EG,United Kingdom,816,252,162,18,564,203,199,402,144
2020-04-29,EG,United Kingdom,920,278,184,16,642,232,226,458,168
2020-04-30,EG,United Kingdom,924,281,184,10,643,224,235,459,174
2020-05-01,EG,United Kingdom,907,296,190,16,611,212,209,421,174
2020-05-02,EG,United Kingdom,637,221,69,7,416,175,172,347,62
2020-05-03,EG,United Kingdom,714,240,65,2,474,200,209,409,63
2020-05-04,EG,United Kingdom,843,258,172,10,585,213,200,413,162
2020-05-05,EG,United Kingdom,841,238,180,15,603,211,212,423,165
2020-05-06,EG,United Kingdom,990,276,213,23,714,248,253,501,190
2020-05-07,EG,United Kingdom,985,307,178,14,678,249,251,500,164
2020-05-08,EG,United Kingdom,861,288,119,18,573,229,225,454,101
2020-05-09,EG,United Kingdom,666,234,57,5,432,189,186,375,52
2020-05-10,EG,United Kingdom,774,261,68,4,513,218,227,445,64
2020-05-11,EG,United Kingdom,915,277,170,18,638,238,230,468,152
2020-05-12,EG,United Kingdom,944,285,204,17,659,221,234,455,187
2020-05-13,EG,United Kingdom,1002,305,202,19,697,246,249,495,183
2020-05-14,EG,United Kingdom,1021,327,199,28,694,249,246,495,171
2020-05-15,EG,United Kingdom,1020,313,205,17,707,252,250,502,188
2020-05-16,EG,United Kingdom,769,283,92,7,486,199,195,394,85
2020-05-17,EG,United Kingdom,780,283,62,1,497,216,219,435,61
2020-05-18,EG,United Kingdom,969,285,187,11,684,252,245,497,176
2020-05-19,EG,United Kingdom,958,300,182,15,658,231,245,476,167
2020-05-20,EG,United Kingdom,1077,316,221,31,761,278,262,540,190
2020-05-21,EG,United Kingdom,996,304,180,19,692,253,259,512,161
2020-05-22,EG,United Kingdom,1050,354,185,7,696,263,248,511,178
2020-05-23,EG,United Kingdom,829,267,88,5,562,230,244,474,83
2020-05-24,EG,United Kingdom,836,282,87,6,554,241,226,467,81
2020-05-25,EG,United Kingdom,908,280,125,8,628,243,260,503,117
2020-05-26,EG,United Kingdom,1070,320,215,16,750,259,276,535,199
2020-05-27,EG,United Kingdom,1162,342,217,13,820,297,306,603,204
2020-05-28,EG,United Kingdom,1053,324,203,23,729,260,266,526,180
2020-05-29,EG,United Kingdom,1200,359,260,25,841,288,293,581,235
2020-05-30,EG,United Kingdom,842,289,102,11,553,223,228,451,91
2020-05-31,EG,United Kingdom,858,307,75,3,551,227,249,476,72
2020-06-01,EG,United Kingdom,1006,292,209,17,714,266,239,505,192
2020-06-02,EG,United Kingdom,1120,301,235,19,819,294,290,584,216
2020-06-03,EG,United Kingdom,1259,368,219,23,891,350,322,672,196
2020-06-04,EG,United Kingdom,1246,358,234,24,888,327,327,654,210
2020-06-05,EG,United Kingdom,1291,352,253,32,939,344,342,686,221
2020-06-06,EG,United Kingdom,1021,327,113,15,694,284,297,581,98
2020-06-07,EG,United Kingdom,1067,339,88,2,728,303,337,640,86
2020-06-08,EG,United Kingdom,1147,354,227,21,793,298,268,566,206
2020-06-09,EG,United Kingdom,1105,333,244,27,772,272,256,528,217
2020-06-10,EG,United Kingdom,1201,367,227,19,834,303,304,607,208
2020-06-11,EG,United Kingdom,1172,392,210,20,780,290,280,570,190
2020-06-12,EG,United Kingdom,1217,373,235,23,844,305,304,609,212
2020-06-13,EG,United Kingdom,884,329,90,6,555,232,233,465,84
2020-06-14,EG,United Kingdom,952,335,83,2,617,268,266,534,81
2020-06-15,EG,United Kingdom,1251,388,246,24,863,312,305,617,222
2020-06-16,EG,United Kingdom,1206,375,233,24,831,305,293,598,209
2020-06-17,EG,United Kingdom,1242,358,260,24,884,315,309,624,236
2020-06-18,EG,United Kingdom,1300,397,239,20,903,332,332,664,219
2020-06-19,EG,United Kingdom,1332,399,259,30,933,341,333,674,229
2020-06-20,EG,United Kingdom,1006,394,110,6,612,253,249,502,104
2020-06-21,EG,United Kingdom,1105,374,109,1,731,308,314,622,108
2020-06-22,EG,United Kingdom,1362,364,294,21,998,356,348,704,273
2020-06-23,EG,United Kingdom,1333,383,288,39,950,330,332,662,249
2020-06-24,EG,United Kingdom,1403,391,298,28,1012,358,356,714,270
2020-06-25,EG,United Kingdom,1475,420,322,25,1055,365,368,733,297
2020-06-26,EG,United Kingdom,1482,431,301,37,1051,385,365,750,264
2020-06-27,EG,United Kingdom,1091,373,114,9,718,305,299,604,105
2020-06-28,EG,United Kingdom,1146,379,127,5,767,309,331,640,122
2020-06-29,EG,United Kingdom,1335,372,272,28,963,350,341,691,244
2020-06-30,EG,United Kingdom,1412,389,277,24,1023,374,372,746,253
2020-07-01,EG,United Kingdom,2098,515,338,25,1583,630,615,1245,313
2020-07-02,EG,United Kingdom,2083,527,329,17,1556,622,605,1227,312
2020-07-03,EG,United Kingdom,2214,545,349,18,1669,661,659,1320,331
2020-07-04,EG,United Kingdom,1857,520,164,5,1337,576,597,1173,159
2020-07-05,EG,United Kingdom,1938,525,169,2,1413,617,627,1244,167
2020-07-06,EG,United Kingdom,2098,496,381,25,1602,618,603,1221,356
2020-07-07,EG,United Kingdom,2027,494,362,33,1533,585,586,1171,329
2020-07-08,EG,United Kingdom,2115,509,359,33,1606,625,622,1247,326
2020-07-09,EG,United Kingdom,2245,554,390,36,1691,654,647,1301,354
2020-07-10,EG,United Kingdom,2469,562,422,30,1907,752,733,1485,392
2020-07-11,EG,United Kingdom,2127,579,236,12,1548,659,653,1312,224
2020-07-12,EG,United Kingdom,2140,546,215,3,1594,678,701,1379,212
2020-07-13,EG,United Kingdom,2214,516,380,21,1698,660,658,1318,359
2020-07-14,EG,United Kingdom,2181,505,424,36,1676,619,633,1252,388
2020-07-15,EG,United Kingdom,2382,501,389,30,1881,756,736,1492,359
2020-07-16,EG,United Kingdom,2687,572,420,31,2115,864,831,1695,389
2020-07-17,EG,United Kingdom,2827,563,445,36,2264,902,917,1819,409
2020-07-18,EG,United Kingdom,2598,604,241,10,1994,887,866,1753,231
2020-07-19,EG,United Kingdom,2580,550,244,4,2030,881,905,1786,240
2020-07-20,EG,United Kingdom,2701,563,451,34,2138,836,851,1687,417
2020-07-21,EG,United Kingdom,2546,502,423,38,2044,805,816,1621,385
2020-07-22,EG,United Kingdom,2654,553,428,27,2101,847,826,1673,401
2020-07-23,EG,United Kingdom,2764,598,443,27,2166,862,861,1723,416
2020-07-24,EG,United Kingdom,3002,583,468,25,2419,983,968,1951,443
2020-07-25,EG,United Kingdom,2809,586,279,5,2223,968,976,1944,274
2020-07-26,EG,United Kingdom,2822,585,290,5,2237,973,974,1947,285
2020-07-27,EG,United Kingdom,2710,554,447,14,2156,869,840,1709,433
2020-07-28,EG,United Kingdom,2566,500,401,25,2066,815,850,1665,376
2020-07-29,EG,United Kingdom,2718,555,428,30,2163,860,875,1735,398
2020-07-30,EG,United Kingdom,2755,564,433,29,2191,890,868,1758,404
2020-07-31,EG,United Kingdom,3130,601,496,29,2529,1014,1019,2033,467
2020-08-01,EG,United Kingdom,3433,617,281,3,2816,1282,1253,2535,278
2020-08-02,EG,United Kingdom,3416,651,324,6,2765,1210,1231,2441,318
2020-08-03,EG,United Kingdom,3493,628,514,31,2865,1160,1191,2351,483
2020-08-04,EG,United Kingdom,3106,607,436,29,2499,1040,1023,2063,407
2020-08-05,EG,United Kingdom,3206,628,451,26,2578,1071,1056,2127,425
2020-08-06,EG,United Kingdom,3322,635,512,20,2687,1089,1086,2175,492
2020-08-07,EG,United Kingdom,3643,666,536,17,2977,1233,1208,2441,519
2020-08-08,EG,United Kingdom,3374,686,266,5,2688,1209,1213,2422,261
2020-08-09,EG,United Kingdom,3435,660,342,7,2775,1209,1224,2433,335
2020-08-10,EG,United Kingdom,3485,653,505,28,2832,1154,1173,2327,477
2020-08-11,EG,United Kingdom,3088,597,421,24,2491,1035,1035,2070,397
2020-08-12,EG,United Kingdom,3196,652,429,15,2544,1056,1059,2115,414
2020-08-13,EG,United Kingdom,3220,654,474,10,2566,1048,1044,2092,464
2020-08-14,EG,United Kingdom,3688,670,499,8,3018,1250,1269,2519,491
2020-08-15,EG,United Kingdom,3396,694,281,10,2702,1226,1195,2421,271
2020-08-16,EG,United Kingdom,3473,694,367,4,2779,1203,1209,2412,363
2020-08-17,EG,United Kingdom,3433,653,512,17,2780,1128,1140,2268,495
2020-08-18,EG,United Kingdom,3081,579,424,16,2502,1052,1026,2078,408
2020-08-19,EG,United Kingdom,3248,627,417,14,2621,1104,1100,2204,403
2020-08-20,EG,United Kingdom,3347,635,506,18,2712,1091,1115,2206,488
2020-08-21,EG,United Kingdom,3607,644,500,5,2963,1225,1238,2463,495
2020-08-22,EG,United Kingdom,3416,690,277,8,2726,1230,1219,2449,269
2020-08-23,EG,United Kingdom,3477,646,372,1,2831,1221,1238,2459,371
2020-08-24,EG,United Kingdom,3548,626,535,18,2922,1187,1200,2387,517
2020-08-25,EG,United Kingdom,3096,583,369,7,2513,1073,1071,2144,362
2020-08-26,EG,United Kingdom,3322,628,474,25,2694,1111,1109,2220,449
2020-08-27,EG,United Kingdom,3440,640,504,26,2800,1151,1145,2296,478
2020-08-28,EG,United Kingdom,3851,697,518,17,3154,1309,1327,2636,501
2020-08-29,EG,United Kingdom,3510,697,293,9,2813,1274,1246,2520,284
2020-08-30,EG,United Kingdom,3643,689,378,11,2954,1283,1293,2576,367
2020-08-31,EG,United Kingdom,3679,671,499,23,3008,1227,1282,2509,476
2020-09-01,EG,United Kingdom,3298,596,501,26,2702,1107,1094,2201,475
2020-09-02,EG,United Kingdom,3163,587,458,26,2576,1059,1059,2118,432
2020-09-03,EG,United Kingdom,3327,601,536,21,2726,1103,1087,2190,515
2020-09-04,EG,United Kingdom,3708,655,541,20,3053,1249,1263,2512,521
2020-09-05,EG,United Kingdom,3229,621,307,10,2608,1155,1146,2301,297
2020-09-06,EG,United Kingdom,3521,694,396,8,2827,1205,1226,2431,388
2020-09-07,EG,United Kingdom,3370,612,530,19,2758,1111,1117,2228,511
2020-09-08,EG,United Kingdom,2963,519,480,28,2444,984,980,1964,452
2020-09-09,EG,United Kingdom,3124,616,530,35,2508,1000,978,1978,495
2020-09-10,EG,United Kingdom,3277,624,548,29,2653,1047,1058,2105,519
2020-09-11,EG,United Kingdom,3778,666,640,24,3112,1227,1245,2472,616
2020-09-12,EG,United Kingdom,3140,627,318,9,2513,1108,1087,2195,309
2020-09-13,EG,United Kingdom,3465,687,396,6,2778,1193,1189,2382,390
2020-09-14,EG,United Kingdom,3373,619,580,27,2754,1080,1094,2174,553
2020-09-15,EG,United Kingdom,2999,562,495,25,2437,971,971,1942,470
2020-09-16,EG,United Kingdom,3103,622,529,32,2481,985,967,1952,497
2020-09-17,EG,United Kingdom,3332,643,623,32,2689,1037,1029,2066,591
2020-09-18,EG,United Kingdom,3714,646,604,18,3068,1218,1246,2464,586
2020-09-19,EG,United Kingdom,3072,618,311,5,2454,1076,1067,2143,306
2020-09-20,EG,United Kingdom,3436,665,418,4,2771,1162,1191,2353,414
2020-09-21,EG,United Kingdom,3347,631,567,32,2716,1068,1081,2149,535
2020-09-22,EG,United Kingdom,2916,543,541,30,2373,930,902,1832,511
2020-09-23,EG,United Kingdom,2994,585,500,34,2409,962,947,1909,466
2020-09-24,EG,United Kingdom,3204,609,586,22,2595,1010,999,2009,564
2020-09-25,EG,United Kingdom,3601,622,604,22,2979,1177,1198,2375,582
2020-09-26,EG,United Kingdom,3046,613,301,6,2433,1078,1054,2132,295
2020-09-27,EG,United Kingdom,3338,645,428,5,2693,1123,1142,2265,423
2020-09-28,EG,United Kingdom,3287,599,571,11,2688,1062,1055,2117,560
2020-09-29,EG,United Kingdom,2904,574,515,29,2330,917,898,1815,486
2020-09-30,EG,United Kingdom,2923,615,472,9,2308,912,924,1836,463
2020-10-01,EG,United Kingdom,2979,622,606,25,2357,887,864,1751,581
2020-10-02,EG,United Kingdom,3423,636,596,12,2787,1082,1109,2191,584
2020-10-03,EG,United Kingdom,2900,645,313,5,2255,977,965,1942,308
2020-10-04,EG,United Kingdom,3066,636,416,3,2430,998,1016,2014,413
2020-10-05,EG,United Kingdom,3062,603,601,25,2459,933,925,1858,576
2020-10-06,EG,United Kingdom,2605,509,521,29,2096,790,785,1575,492
2020-10-07,EG,United Kingdom,2649,512,516,25,2137,811,810,1621,491
2020-10-08,EG,United Kingdom,2899,591,573,19,2308,875,860,1735,554
2020-10-09,EG,United Kingdom,3293,604,597,30,2689,1039,1053,2092,567
2020-10-10,EG,United Kingdom,2759,632,266,8,2127,937,924,1861,258
2020-10-11,EG,United Kingdom,2935,620,406,13,2315,948,961,1909,393
2020-10-12,EG,United Kingdom,2867,583,523,17,2284,883,878,1761,506
2020-10-13,EG,United Kingdom,2420,518,463,31,1902,711,728,1439,432
2020-10-14,EG,United Kingdom,2524,540,488,26,1984,751,745,1496,462
2020-10-15,EG,United Kingdom,2741,597,577,30,2144,790,777,1567,547
2020-10-16,EG,United Kingdom,3316,653,609,28,2663,1020,1034,2054,581
2020-10-17,EG,United Kingdom,2734,568,304,17,2166,939,923,1862,287
2020-10-18,EG,United Kingdom,2868,637,404,10,2231,922,905,1827,394
2020-10-19,EG,United Kingdom,2653,544,518,34,2109,793,798,1591,484
2020-10-20,EG,United Kingdom,2238,471,465,24,1767,641,661,1302,441
2020-10-21,EG,United Kingdom,2319,485,454,25,1834,705,675,1380,429
2020-10-22,EG,United Kingdom,2614,592,559,36,2022,739,724,1463,523
2020-10-23,EG,United Kingdom,2987,579,588,21,2408,909,911,1820,567
2020-10-24,EG,United Kingdom,2563,535,253,1,2028,889,886,1775,252
2020-10-25,EG,United Kingdom,2817,579,393,13,2238,915,930,1845,380
2020-10-26,EG,United Kingdom,2680,532,534,26,2148,806,808,1614,508
2020-10-27,EG,United Kingdom,2237,484,484,16,1753,632,637,1269,468
2020-10-28,EG,United Kingdom,2323,490,461,19,1833,693,679,1372,442
2020-10-29,EG,United Kingdom,2579,551,538,26,2028,748,742,1490,512
2020-10-30,EG,United Kingdom,3081,584,560,16,2497,963,974,1937,544
2020-10-31,EG,United Kingdom,2577,556,284,6,2021,838,899,1737,278
2020-11-01,EG,United Kingdom,2844,585,380,2,2259,946,933,1879,378
2020-11-02,EG,United Kingdom,2570,536,515,22,2034,764,755,1519,493
2020-11-03,EG,United Kingdom,2184,468,490,28,1716,608,618,1226,462
2020-11-04,EG,United Kingdom,2329,504,492,35,1825,681,652,1333,457
2020-11-05,EG,United Kingdom,2220,571,459,26,1649,601,589,1190,433
2020-11-06,EG,United Kingdom,2541,587,452,35,1954,746,756,1502,417
2020-11-07,EG,United Kingdom,1940,537,185,7,1403,614,604,1218,178
2020-11-08,EG,United Kingdom,2125,589,204,2,1536,674,658,1332,202
2020-11-09,EG,United Kingdom,1953,513,331,19,1440,547,562,1109,312
2020-11-10,EG,United Kingdom,1661,422,323,29,1239,452,464,916,294
2020-11-11,EG,United Kingdom,1772,527,346,22,1245,454,445,899,324
2020-11-12,EG,United Kingdom,1880,543,411,37,1337,464,462,926,374
2020-11-13,EG,United Kingdom,2069,538,389,29,1531,572,570,1142,360
2020-11-14,EG,United Kingdom,1481,498,168,2,983,405,410,815,166
2020-11-15,EG,United Kingdom,1659,495,193,8,1164,484,487,971,185
2020-11-16,EG,United Kingdom,1784,507,356,23,1277,465,456,921,333
2020-11-17,EG,United Kingdom,1556,452,336,24,1104,387,381,768,312
2020-11-18,EG,United Kingdom,1572,480,320,21,1092,390,382,772,299
2020-11-19,EG,United Kingdom,1730,484,387,32,1246,429,430,859,355
2020-11-20,EG,United Kingdom,1812,526,405,22,1286,440,441,881,383
2020-11-21,EG,United Kingdom,1390,501,184,16,889,353,352,705,168
2020-11-22,EG,United Kingdom,1523,518,209,29,1005,395,401,796,180
2020-11-23,EG,United Kingdom,1617,471,364,30,1146,393,389,782,334
2020-11-24,EG,United Kingdom,1530,459,370,39,1071,352,349,701,331
2020-11-25,EG,United Kingdom,1596,471,348,17,1125,390,387,777,331
2020-11-26,EG,United Kingdom,1655,495,367,18,1160,405,388,793,349
2020-11-27,EG,United Kingdom,1724,486,371,15,1238,425,442,867,356
2020-11-28,EG,United Kingdom,1343,458,193,24,885,340,352,692,169
2020-11-29,EG,United Kingdom,1515,502,199,29,1013,415,399,814,170
2020-11-30,EG,United Kingdom,1612,454,355,42,1158,396,407,803,313
2020-12-01,EG,United Kingdom,1614,454,380,31,1160,388,392,780,349
2020-12-02,EG,United Kingdom,1760,484,394,29,1276,427,455,882,365
2020-12-03,EG,United Kingdom,1896,522,386,23,1374,490,498,988,363
2020-12-04,EG,United Kingdom,2116,514,502,21,1602,551,549,1100,481
2020-12-05,EG,United Kingdom,1712,544,228,9,1168,473,467,940,219
2020-12-06,EG,United Kingdom,1835,536,255,20,1299,518,526,1044,235
2020-12-07,EG,United Kingdom,1864,515,406,21,1349,484,459,943,385
2020-12-08,EG,United Kingdom,1761,428,392,27,1333,471,470,941,365
2020-12-09,EG,United Kingdom,1925,470,414,34,1455,522,519,1041,380
2020-12-10,EG,United Kingdom,2174,526,470,33,1648,577,601,1178,437
2020-12-11,EG,United Kingdom,2411,519,492,13,1892,702,698,1400,479
2020-12-12,EG,United Kingdom,1967,517,259,9,1450,613,578,1191,250
2020-12-13,EG,United Kingdom,2088,529,311,3,1559,636,612,1248,308
2020-12-14,EG,United Kingdom,2099,517,457,17,1582,557,568,1125,440
2020-12-15,EG,United Kingdom,2058,505,418,19,1553,561,574,1135,399
2020-12-16,EG,United Kingdom,2132,541,408,16,1591,588,595,1183,392
2020-12-17,EG,United Kingdom,2777,581,522,19,2196,856,818,1674,503
2020-12-18,EG,United Kingdom,3109,628,535,10,2481,969,977,1946,525
2020-12-19,EG,United Kingdom,2846,637,305,5,2209,964,940,1904,300
2020-12-20,EG,United Kingdom,2869,613,357,16,2256,954,945,1899,341
2020-12-21,EG,United Kingdom,2436,608,449,17,1828,704,675,1379,432
2020-12-22,EG,United Kingdom,2069,561,421,23,1508,540,547,1087,398
2020-12-23,EG,United Kingdom,2262,578,450,11,1684,606,628,1234,439
2020-12-24,EG,United Kingdom,1763,532,303,10,1231,470,458,928,293
2020-12-25,EG,United Kingdom,657,293,23,2,364,157,184,341,21
2020-12-26,EG,United Kingdom,1389,463,117,1,926,411,398,809,116
2020-12-27,EG,United Kingdom,1861,524,277,3,1337,534,526,1060,274
2020-12-28,EG,United Kingdom,1808,550,268,3,1258,494,496,990,265
2020-12-29,EG,United Kingdom,1720,487,326,11,1233,447,460,907,315
2020-12-30,EG,United Kingdom,1878,519,354,15,1359,505,500,1005,339
2020-12-31,EG,United Kingdom,1421,469,250,9,952,352,350,702,241
