entry_date,country_name,flt_daio,flt_o,flt_i,flt_c,flt_dai,flt_d,flt_a,flt_da,flt_i_excl_c
2022-01-01,Albania,450,398,0,0,52,26,26,52,0
2022-01-02,Albania,581,482,0,0,99,47,52,99,0
2022-01-03,Albania,433,341,0,0,92,47,45,92,0
2022-01-04,Albania,406,316,0,0,90,46,44,90,0
2022-01-05,Albania,430,348,0,0,82,41,41,82,0
2022-01-06,Albania,458,362,0,0,96,47,49,96,0
2022-01-07,Albania,451,361,0,0,90,45,45,90,0
2022-01-08,Albania,531,456,0,0,75,38,37,75,0
2022-01-09,Albania,526,440,0,0,86,44,42,86,0
2022-01-10,Albania,340,252,0,0,88,42,46,88,0
2022-01-11,Albania,288,221,0,0,67,34,33,67,0
2022-01-12,Albania,272,213,0,0,59,30,29,59,0
2022-01-13,Albania,299,221,0,0,78,38,40,78,0
2022-01-14,Albania,411,328,0,0,83,42,41,83,0
2022-01-15,Albania,386,321,0,0,65,33,32,65,0
2022-01-16,Albania,404,333,0,0,71,35,36,71,0
2022-01-17,Albania,322,233,1,1,89,43,45,88,0
2022-01-18,Albania,273,212,1,1,61,31,29,60,0
2022-01-19,Albania,251,197,0,0,54,27,27,54,0
2022-01-20,Albania,296,221,0,0,75,38,37,75,0
2022-01-21,Albania,354,285,0,0,69,35,34,69,0
2022-01-22,Albania,365,309,0,0,56,28,28,56,0
2022-01-23,Albania,349,278,0,0,71,35,36,71,0
2022-01-24,Albania,238,176,0,0,62,32,30,62,0
2022-01-25,Albania,210,155,0,0,55,27,28,55,0
2022-01-26,Albania,247,203,0,0,44,21,23,44,0
2022-01-27,Albania,250,177,0,0,73,37,36,73,0
2022-01-28,Albania,351,273,0,0,78,39,39,78,0
2022-01-29,Albania,320,271,0,0,49,25,24,49,0
2022-01-30,Albania,389,314,0,0,75,37,38,75,0
2022-01-31,Albania,277,216,0,0,61,31,30,61,0
2022-02-01,Albania,256,205,0,0,51,25,26,51,0
2022-02-02,Albania,259,214,0,0,45,23,22,45,0
2022-02-03,Albania,249,183,0,0,66,33,33,66,0
2022-02-04,Albania,385,307,2,0,78,37,39,76,2
2022-02-05,Albania,389,340,0,0,49,25,24,49,0
2022-02-06,Albania,358,283,0,0,75,37,38,75,0
2022-02-07,Albania,277,207,0,0,70,36,34,70,0
2022-02-08,Albania,231,182,0,0,49,24,25,49,0
2022-02-09,Albania,273,230,0,0,43,21,22,43,0
2022-02-10,Albania,309,234,0,0,75,38,37,75,0
2022-02-11,Albania,383,310,0,0,73,36,37,73,0
2022-02-12,Albania,413,358,0,0,55,27,28,55,0
2022-02-13,Albania,423,343,0,0,80,41,39,80,0
2022-02-14,Albania,277,212,0,0,65,34,31,65,0
2022-02-15,Albania,259,207,0,0,52,25,27,52,0
2022-02-16,Albania,302,248,0,0,54,26,28,54,0
2022-02-17,Albania,318,231,0,0,87,44,43,87,0
2022-02-18,Albania,396,321,0,0,75,37,38,75,0
2022-02-19,Albania,414,357,0,0,57,30,27,57,0
2022-02-20,Albania,434,355,0,0,79,39,40,79,0
2022-02-21,Albania,316,247,0,0,69,34,35,69,0
2022-02-22,Albania,285,220,0,0,65,33,32,65,0
2022-02-23,Albania,297,255,0,0,42,21,21,42,0
2022-02-24,Albania,308,232,0,0,76,38,38,76,0
2022-02-25,Albania,438,364,0,0,74,36,38,74,0
2022-02-26,Albania,391,335,0,0,56,29,27,56,0
2022-02-27,Albania,421,338,0,0,83,40,43,83,0
2022-02-28,Albania,336,262,0,0,74,38,36,74,0
2022-03-01,Albania,299,233,0,0,66,33,33,66,0
2022-03-02,Albania,268,208,0,0,60,29,31,60,0
2022-03-03,Albania,351,271,0,0,80,40,40,80,0
2022-03-04,Albania,399,317,0,0,82,41,41,82,0
2022-03-05,Albania,377,318,0,0,59,30,29,59,0
2022-03-06,Albania,401,323,0,0,78,38,40,78,0
2022-03-07,Albania,346,265,0,0,81,42,39,81,0
2022-03-08,Albania,309,244,0,0,65,33,32,65,0
2022-03-09,Albania,315,253,0,0,62,30,32,62,0
2022-03-10,Albania,326,246,0,0,80,40,40,80,0
2022-03-11,Albania,415,333,0,0,82,41,41,82,0
2022-03-12,Albania,422,364,0,0,58,28,30,58,0
2022-03-13,Albania,415,336,0,0,79,39,40,79,0
2022-03-14,Albania,397,317,0,0,80,41,39,80,0
2022-03-15,Albania,349,288,0,0,61,30,31,61,0
2022-03-16,Albania,378,316,0,0,62,32,30,62,0
2022-03-17,Albania,343,264,0,0,79,39,40,79,0
2022-03-18,Albania,405,324,0,0,81,41,40,81,0
2022-03-19,Albania,468,404,0,0,64,32,32,64,0
2022-03-20,Albania,433,357,0,0,76,37,39,76,0
2022-03-21,Albania,357,277,0,0,80,40,40,80,0
2022-03-22,Albania,333,263,0,0,70,35,35,70,0
2022-03-23,Albania,357,284,0,0,73,36,37,73,0
2022-03-24,Albania,381,285,0,0,96,49,47,96,0
2022-03-25,Albania,449,365,0,0,84,41,43,84,0
2022-03-26,Albania,444,378,0,0,66,34,32,66,0
2022-03-27,Albania,545,453,0,0,92,46,46,92,0
2022-03-28,Albania,407,326,0,0,81,41,40,81,0
2022-03-29,Albania,395,318,0,0,77,39,38,77,0
2022-03-30,Albania,447,358,0,0,89,44,45,89,0
2022-03-31,Albania,441,355,0,0,86,42,44,86,0
2022-04-01,Albania,479,391,0,0,88,44,44,88,0
2022-04-02,Albania,554,475,0,0,79,40,39,79,0
2022-04-03,Albania,578,482,0,0,96,47,49,96,0
2022-04-04,Albania,423,333,0,0,90,46,44,90,0
2022-04-05,Albania,411,331,0,0,80,41,39,80,0
2022-04-06,Albania,473,382,0,0,91,44,47,91,0
2022-04-07,Albania,423,335,0,0,88,44,44,88,0
2022-04-08,Albania,583,491,0,0,92,46,46,92,0
2022-04-09,Albania,686,601,2,0,85,42,41,83,2
2022-04-10,Albania,670,570,0,0,100,49,51,100,0
2022-04-11,Albania,540,442,0,0,98,49,49,98,0
2022-04-12,Albania,502,413,0,0,89,45,44,89,0
2022-04-13,Albania,607,503,0,0,104,51,53,104,0
2022-04-14,Albania,557,454,0,0,103,52,51,103,0
2022-04-15,Albania,703,597,0,0,106,53,53,106,0
2022-04-16,Albania,752,658,0,0,94,48,46,94,0
2022-04-17,Albania,666,563,0,0,103,51,52,103,0
2022-04-18,Albania,528,415,0,0,113,56,57,113,0
2022-04-19,Albania,469,381,0,0,88,45,43,88,0
2022-04-20,Albania,576,460,0,0,116,57,59,116,0
2022-04-21,Albania,585,484,0,0,101,52,49,101,0
2022-04-22,Albania,639,522,0,0,117,56,61,117,0
2022-04-23,Albania,745,650,2,0,95,48,45,93,2
2022-04-24,Albania,810,701,0,0,109,53,56,109,0
2022-04-25,Albania,598,492,0,0,106,54,52,106,0
2022-04-26,Albania,540,444,0,0,96,48,48,96,0
2022-04-27,Albania,620,513,0,0,107,54,53,107,0
2022-04-28,Albania,551,442,0,0,109,53,56,109,0
2022-04-29,Albania,712,597,0,0,115,58,57,115,0
2022-04-30,Albania,821,721,2,0,100,50,48,98,2
2022-05-01,Albania,795,686,0,0,109,53,56,109,0
2022-05-02,Albania,615,513,0,0,102,52,50,102,0
2022-05-03,Albania,606,492,2,0,114,56,56,112,2
2022-05-04,Albania,602,489,0,0,113,57,56,113,0
2022-05-05,Albania,589,485,0,0,104,51,53,104,0
2022-05-06,Albania,797,685,0,0,112,57,55,112,0
2022-05-07,Albania,832,733,2,0,99,48,49,97,2
2022-05-08,Albania,797,692,0,0,105,52,53,105,0
2022-05-09,Albania,594,475,0,0,119,59,60,119,0
2022-05-10,Albania,591,472,3,1,119,58,58,116,2
2022-05-11,Albania,615,500,0,0,115,58,57,115,0
2022-05-12,Albania,580,471,0,0,109,55,54,109,0
2022-05-13,Albania,708,600,0,0,108,54,54,108,0
2022-05-14,Albania,889,788,2,0,101,49,50,99,2
2022-05-15,Albania,813,713,0,0,100,50,50,100,0
2022-05-16,Albania,649,529,0,0,120,61,59,120,0
2022-05-17,Albania,655,547,0,0,108,53,55,108,0
2022-05-18,Albania,676,556,0,0,120,60,60,120,0
2022-05-19,Albania,582,477,0,0,105,54,51,105,0
2022-05-20,Albania,800,682,0,0,118,56,62,118,0
2022-05-21,Albania,949,846,2,0,103,51,50,101,2
2022-05-22,Albania,888,785,0,0,103,51,52,103,0
2022-05-23,Albania,668,557,0,0,111,57,54,111,0
2022-05-24,Albania,718,572,2,0,146,69,75,144,2
2022-05-25,Albania,766,613,0,0,153,68,85,153,0
2022-05-26,Albania,791,611,0,0,180,101,79,180,0
2022-05-27,Albania,895,770,0,0,125,63,62,125,0
2022-05-28,Albania,1064,952,2,0,112,56,54,110,2
2022-05-29,Albania,938,844,0,0,94,48,46,94,0
2022-05-30,Albania,788,665,1,1,123,61,61,122,0
2022-05-31,Albania,800,682,2,0,118,57,59,116,2
2022-06-01,Albania,829,712,0,0,117,58,59,117,0
2022-06-02,Albania,792,679,1,1,113,56,56,112,0
2022-06-03,Albania,968,847,0,0,121,61,60,121,0
2022-06-04,Albania,1083,971,0,0,112,56,56,112,0
2022-06-05,Albania,993,885,1,0,108,54,53,107,1
2022-06-06,Albania,942,806,0,0,136,67,69,136,0
2022-06-07,Albania,865,746,0,0,119,60,59,119,0
2022-01-01,Armenia,116,54,0,0,62,30,32,62,0
2022-01-02,Armenia,133,67,0,0,66,31,35,66,0
2022-01-03,Armenia,120,56,0,0,64,32,32,64,0
2022-01-04,Armenia,113,55,0,0,58,29,29,58,0
2022-01-05,Armenia,107,48,0,0,59,29,30,59,0
2022-01-06,Armenia,134,58,0,0,76,41,35,76,0
2022-01-07,Armenia,140,67,0,0,73,36,37,73,0
2022-01-08,Armenia,142,63,0,0,79,38,41,79,0
2022-01-09,Armenia,145,64,0,0,81,39,42,81,0
2022-01-10,Armenia,113,49,0,0,64,34,30,64,0
2022-01-11,Armenia,114,54,0,0,60,31,29,60,0
2022-01-12,Armenia,106,57,0,0,49,25,24,49,0
2022-01-13,Armenia,132,77,0,0,55,29,26,55,0
2022-01-14,Armenia,136,75,0,0,61,30,31,61,0
2022-01-15,Armenia,112,55,0,0,57,27,30,57,0
2022-01-16,Armenia,119,62,0,0,57,29,28,57,0
2022-01-17,Armenia,100,54,0,0,46,24,22,46,0
2022-01-18,Armenia,91,49,0,0,42,20,22,42,0
2022-01-19,Armenia,106,58,0,0,48,23,25,48,0
2022-01-20,Armenia,109,58,0,0,51,27,24,51,0
2022-01-21,Armenia,103,58,0,0,45,23,22,45,0
2022-01-22,Armenia,100,47,0,0,53,25,28,53,0
2022-01-23,Armenia,94,40,0,0,54,27,27,54,0
2022-01-24,Armenia,81,36,0,0,45,23,22,45,0
2022-01-25,Armenia,83,44,0,0,39,20,19,39,0
2022-01-26,Armenia,91,51,0,0,40,19,21,40,0
2022-01-27,Armenia,99,53,0,0,46,24,22,46,0
2022-01-28,Armenia,108,63,0,0,45,22,23,45,0
2022-01-29,Armenia,100,46,0,0,54,27,27,54,0
2022-01-30,Armenia,99,45,0,0,54,27,27,54,0
2022-01-31,Armenia,94,45,0,0,49,25,24,49,0
2022-02-01,Armenia,96,49,0,0,47,23,24,47,0
2022-02-02,Armenia,91,42,0,0,49,24,25,49,0
2022-02-03,Armenia,101,59,0,0,42,23,19,42,0
2022-02-04,Armenia,107,59,0,0,48,23,25,48,0
2022-02-05,Armenia,106,48,0,0,58,27,31,58,0
2022-02-06,Armenia,100,45,0,0,55,28,27,55,0
2022-02-07,Armenia,99,41,0,0,58,30,28,58,0
2022-02-08,Armenia,80,45,0,0,35,19,16,35,0
2022-02-09,Armenia,74,37,0,0,37,17,20,37,0
2022-02-10,Armenia,98,52,0,0,46,24,22,46,0
2022-02-11,Armenia,101,52,0,0,49,24,25,49,0
2022-02-12,Armenia,110,55,0,0,55,26,29,55,0
2022-02-13,Armenia,112,52,0,0,60,29,31,60,0
2022-02-14,Armenia,95,42,0,0,53,27,26,53,0
2022-02-15,Armenia,109,63,0,0,46,25,21,46,0
2022-02-16,Armenia,89,49,0,0,40,19,21,40,0
2022-02-17,Armenia,101,49,0,0,52,25,27,52,0
2022-02-18,Armenia,115,62,0,0,53,27,26,53,0
2022-02-19,Armenia,125,67,0,0,58,28,30,58,0
2022-02-20,Armenia,124,68,0,0,56,29,27,56,0
2022-02-21,Armenia,93,35,0,0,58,29,29,58,0
2022-02-22,Armenia,103,62,0,0,41,21,20,41,0
2022-02-23,Armenia,90,52,0,0,38,19,19,38,0
2022-02-24,Armenia,102,56,0,0,46,25,21,46,0
2022-02-25,Armenia,112,72,0,0,40,19,21,40,0
2022-02-26,Armenia,124,77,0,0,47,23,24,47,0
2022-02-27,Armenia,107,58,0,0,49,24,25,49,0
2022-02-28,Armenia,133,79,0,0,54,26,28,54,0
2022-03-01,Armenia,139,91,0,0,48,25,23,48,0
2022-03-02,Armenia,162,89,0,0,73,37,36,73,0
2022-03-03,Armenia,163,103,0,0,60,28,32,60,0
2022-03-04,Armenia,216,106,0,0,110,55,55,110,0
2022-03-05,Armenia,206,106,0,0,100,48,52,100,0
2022-03-06,Armenia,189,88,0,0,101,51,50,101,0
2022-03-07,Armenia,172,83,0,0,89,45,44,89,0
2022-03-08,Armenia,166,91,0,0,75,39,36,75,0
2022-03-09,Armenia,169,103,0,0,66,32,34,66,0
2022-03-10,Armenia,156,99,0,0,57,28,29,57,0
2022-03-11,Armenia,161,93,0,0,68,34,34,68,0
2022-03-12,Armenia,156,89,0,0,67,34,33,67,0
2022-03-13,Armenia,152,83,0,0,69,34,35,69,0
2022-03-14,Armenia,145,101,0,0,44,23,21,44,0
2022-03-15,Armenia,161,117,0,0,44,23,21,44,0
2022-03-16,Armenia,177,115,0,0,62,31,31,62,0
2022-03-17,Armenia,166,109,0,0,57,28,29,57,0
2022-03-18,Armenia,188,118,0,0,70,35,35,70,0
2022-03-19,Armenia,183,117,0,0,66,33,33,66,0
2022-03-20,Armenia,168,101,0,0,67,34,33,67,0
2022-03-21,Armenia,175,114,0,0,61,31,30,61,0
2022-03-22,Armenia,161,106,0,0,55,27,28,55,0
2022-03-23,Armenia,185,113,0,0,72,36,36,72,0
2022-03-24,Armenia,178,117,0,0,61,31,30,61,0
2022-03-25,Armenia,175,117,0,0,58,28,30,58,0
2022-03-26,Armenia,199,130,0,0,69,35,34,69,0
2022-03-27,Armenia,165,93,0,0,72,35,37,72,0
2022-03-28,Armenia,159,90,0,0,69,35,34,69,0
2022-03-29,Armenia,164,104,0,0,60,28,32,60,0
2022-03-30,Armenia,159,115,0,0,44,23,21,44,0
2022-03-31,Armenia,162,114,0,0,48,23,25,48,0
2022-04-01,Armenia,177,99,0,0,78,39,39,78,0
2022-04-02,Armenia,183,106,0,0,77,40,37,77,0
2022-04-03,Armenia,150,89,0,0,61,31,30,61,0
2022-04-04,Armenia,158,89,0,0,69,35,34,69,0
2022-04-05,Armenia,167,97,0,0,70,35,35,70,0
2022-04-06,Armenia,151,91,0,0,60,30,30,60,0
2022-04-07,Armenia,169,98,0,0,71,34,37,71,0
2022-04-08,Armenia,172,103,0,0,69,36,33,69,0
2022-04-09,Armenia,194,115,0,0,79,39,40,79,0
2022-04-10,Armenia,182,101,0,0,81,39,42,81,0
2022-04-11,Armenia,166,91,0,0,75,37,38,75,0
2022-04-12,Armenia,176,107,0,0,69,36,33,69,0
2022-04-13,Armenia,157,96,0,0,61,31,30,61,0
2022-04-14,Armenia,173,103,0,0,70,36,34,70,0
2022-04-15,Armenia,168,93,0,0,75,37,38,75,0
2022-04-16,Armenia,180,104,0,0,76,37,39,76,0
2022-04-17,Armenia,163,90,0,0,73,36,37,73,0
2022-04-18,Armenia,167,88,0,0,79,41,38,79,0
2022-04-19,Armenia,179,101,0,0,78,39,39,78,0
2022-04-20,Armenia,172,93,0,0,79,40,39,79,0
2022-04-21,Armenia,170,100,0,0,70,34,36,70,0
2022-04-22,Armenia,193,108,1,1,85,42,42,84,0
2022-04-23,Armenia,189,103,0,0,86,43,43,86,0
2022-04-24,Armenia,170,87,0,0,83,41,42,83,0
2022-04-25,Armenia,170,96,0,0,74,38,36,74,0
2022-04-26,Armenia,185,110,0,0,75,35,40,75,0
2022-04-27,Armenia,160,98,0,0,62,30,32,62,0
2022-04-28,Armenia,207,119,0,0,88,42,46,88,0
2022-04-29,Armenia,225,134,0,0,91,48,43,91,0
2022-04-30,Armenia,271,160,0,0,111,57,54,111,0
2022-05-01,Armenia,224,136,0,0,88,43,45,88,0
2022-05-02,Armenia,202,114,0,0,88,45,43,88,0
2022-05-03,Armenia,221,141,0,0,80,38,42,80,0
2022-05-04,Armenia,222,145,0,0,77,40,37,77,0
2022-05-05,Armenia,230,143,0,0,87,43,44,87,0
2022-05-06,Armenia,214,134,0,0,80,39,41,80,0
2022-05-07,Armenia,229,136,0,0,93,47,46,93,0
2022-05-08,Armenia,198,113,0,0,85,43,42,85,0
2022-05-09,Armenia,205,112,0,0,93,47,46,93,0
2022-05-10,Armenia,234,133,0,0,101,50,51,101,0
2022-05-11,Armenia,203,120,0,0,83,42,41,83,0
2022-05-12,Armenia,210,128,0,0,82,41,41,82,0
2022-05-13,Armenia,216,131,0,0,85,42,43,85,0
2022-05-14,Armenia,213,120,0,0,93,47,46,93,0
2022-05-15,Armenia,193,109,0,0,84,43,41,84,0
2022-05-16,Armenia,180,102,0,0,78,39,39,78,0
2022-05-17,Armenia,211,131,0,0,80,39,41,80,0
2022-05-18,Armenia,182,106,0,0,76,39,37,76,0
2022-05-19,Armenia,227,143,0,0,84,41,43,84,0
2022-05-20,Armenia,207,126,0,0,81,39,42,81,0
2022-05-21,Armenia,240,143,0,0,97,50,47,97,0
2022-05-22,Armenia,214,123,0,0,91,43,48,91,0
2022-05-23,Armenia,212,120,0,0,92,48,44,92,0
2022-05-24,Armenia,240,151,0,0,89,46,43,89,0
2022-05-25,Armenia,230,153,0,0,77,38,39,77,0
2022-05-26,Armenia,240,150,0,0,90,43,47,90,0
2022-05-27,Armenia,229,145,0,0,84,43,41,84,0
2022-05-28,Armenia,257,164,0,0,93,47,46,93,0
2022-05-29,Armenia,225,137,0,0,88,43,45,88,0
2022-05-30,Armenia,220,136,0,0,84,44,40,84,0
2022-05-31,Armenia,248,167,0,0,81,39,42,81,0
2022-06-01,Armenia,219,130,0,0,89,43,46,89,0
2022-06-02,Armenia,253,164,0,0,89,46,43,89,0
2022-06-03,Armenia,239,152,0,0,87,42,45,87,0
2022-06-04,Armenia,308,189,0,0,119,59,60,119,0
2022-06-05,Armenia,241,140,0,0,101,50,51,101,0
2022-06-06,Armenia,253,153,0,0,100,51,49,100,0
2022-06-07,Armenia,275,180,0,0,95,49,46,95,0
2022-01-01,Austria,2030,1600,13,1,430,214,203,417,12
2022-01-02,Austria,3022,2205,19,1,817,406,392,798,18
2022-01-03,Austria,2627,1992,9,0,635,305,321,626,9
2022-01-04,Austria,2273,1780,33,2,493,233,227,460,31
2022-01-05,Austria,2336,1815,14,1,521,254,253,507,13
2022-01-06,Austria,2337,1850,15,1,487,238,234,472,14
2022-01-07,Austria,2686,2054,42,0,632,292,298,590,42
2022-01-08,Austria,2753,2068,16,0,685,331,338,669,16
2022-01-09,Austria,2878,2197,20,3,681,339,322,661,17
2022-01-10,Austria,2098,1607,17,1,491,232,242,474,16
2022-01-11,Austria,1844,1431,23,2,413,200,190,390,21
2022-01-12,Austria,1800,1326,47,3,474,211,216,427,44
2022-01-13,Austria,1677,1219,41,5,458,204,213,417,36
2022-01-14,Austria,2091,1516,44,1,575,268,263,531,43
2022-01-15,Austria,2082,1480,33,2,602,290,279,569,31
2022-01-16,Austria,2182,1606,11,0,576,283,282,565,11
2022-01-17,Austria,1789,1352,16,2,437,201,220,421,14
2022-01-18,Austria,1540,1186,9,0,354,178,167,345,9
2022-01-19,Austria,1658,1178,44,7,480,221,215,436,37
2022-01-20,Austria,1666,1253,18,0,413,195,200,395,18
2022-01-21,Austria,2042,1521,22,0,521,243,256,499,22
2022-01-22,Austria,1991,1464,18,0,527,258,251,509,18
2022-01-23,Austria,2038,1519,13,1,519,253,253,506,12
2022-01-24,Austria,1648,1198,11,0,450,216,223,439,11
2022-01-25,Austria,1430,1097,20,0,333,157,156,313,20
2022-01-26,Austria,1621,1165,25,2,456,218,213,431,23
2022-01-27,Austria,1626,1167,25,4,459,215,219,434,21
2022-01-28,Austria,2124,1617,17,0,507,250,240,490,17
2022-01-29,Austria,2012,1432,19,2,580,284,277,561,17
2022-01-30,Austria,1976,1477,9,2,499,243,247,490,7
2022-01-31,Austria,1731,1316,19,0,415,194,202,396,19
2022-02-01,Austria,1605,1250,15,1,355,171,169,340,14
2022-02-02,Austria,1606,1177,12,2,429,209,208,417,10
2022-02-03,Austria,1830,1351,32,1,479,224,223,447,31
2022-02-04,Austria,2205,1635,34,1,570,260,276,536,33
2022-02-05,Austria,2295,1655,38,5,640,308,294,602,33
2022-02-06,Austria,2193,1628,18,1,565,275,272,547,17
2022-02-07,Austria,1803,1363,19,4,440,206,215,421,15
2022-02-08,Austria,1626,1271,17,2,355,162,176,338,15
2022-02-09,Austria,1750,1241,33,5,509,241,235,476,28
2022-02-10,Austria,1919,1426,33,2,493,237,223,460,31
2022-02-11,Austria,2326,1735,23,1,591,281,287,568,22
2022-02-12,Austria,2487,1763,52,0,724,340,332,672,52
2022-02-13,Austria,2364,1720,30,3,644,300,314,614,27
2022-02-14,Austria,2028,1480,49,9,548,248,251,499,40
2022-02-15,Austria,1770,1423,8,0,347,171,168,339,8
2022-02-16,Austria,1888,1386,33,0,502,237,232,469,33
2022-02-17,Austria,1946,1490,12,1,456,218,226,444,11
2022-02-18,Austria,2375,1748,44,5,627,294,289,583,39
2022-02-19,Austria,2628,1887,29,0,741,363,349,712,29
2022-02-20,Austria,2466,1820,17,4,646,314,315,629,13
2022-02-21,Austria,2085,1585,10,1,500,235,255,490,9
2022-02-22,Austria,1884,1448,17,0,436,213,206,419,17
2022-02-23,Austria,1972,1446,22,1,526,252,252,504,21
2022-02-24,Austria,2132,1577,46,6,555,259,250,509,40
2022-02-25,Austria,2498,1879,31,2,619,290,298,588,29
2022-02-26,Austria,2562,1822,26,0,740,365,349,714,26
2022-02-27,Austria,2470,1812,24,0,658,308,326,634,24
2022-02-28,Austria,2186,1660,27,1,526,243,256,499,26
2022-03-01,Austria,2049,1586,30,3,463,222,211,433,27
2022-03-02,Austria,2162,1572,32,4,590,281,277,558,28
2022-03-03,Austria,2258,1716,28,1,542,257,257,514,27
2022-03-04,Austria,2724,2036,40,1,688,319,329,648,39
2022-03-05,Austria,2667,1920,26,1,747,367,354,721,25
2022-03-06,Austria,2615,1969,16,0,646,315,315,630,16
2022-03-07,Austria,2425,1849,24,1,576,277,275,552,23
2022-03-08,Austria,2080,1589,31,1,491,232,228,460,30
2022-03-09,Austria,2214,1660,32,1,554,264,258,522,31
2022-03-10,Austria,2276,1690,37,3,586,274,275,549,34
2022-03-11,Austria,2629,1944,26,2,685,329,330,659,24
2022-03-12,Austria,2518,1824,29,3,694,338,327,665,26
2022-03-13,Austria,2607,1941,28,0,666,310,328,638,28
2022-03-14,Austria,2400,1804,37,3,596,280,279,559,34
2022-03-15,Austria,2100,1630,32,2,470,223,215,438,30
2022-03-16,Austria,2317,1725,24,2,592,284,284,568,22
2022-03-17,Austria,2428,1825,28,0,603,285,290,575,28
2022-03-18,Austria,2797,2083,48,5,714,333,333,666,43
2022-03-19,Austria,2646,1954,38,2,692,335,319,654,36
2022-03-20,Austria,2750,2022,34,0,728,340,354,694,34
2022-03-21,Austria,2498,1873,37,0,625,286,302,588,37
2022-03-22,Austria,2067,1547,37,0,520,248,235,483,37
2022-03-23,Austria,2424,1782,41,1,642,302,299,601,40
2022-03-24,Austria,2531,1899,36,1,632,298,298,596,35
2022-03-25,Austria,2806,2097,40,0,709,331,338,669,40
2022-03-26,Austria,2683,1993,27,2,690,331,332,663,25
2022-03-27,Austria,3241,2507,26,1,734,353,355,708,25
2022-03-28,Austria,3093,2379,39,0,714,335,340,675,39
2022-03-29,Austria,2707,2143,27,1,564,274,263,537,26
2022-03-30,Austria,2920,2251,29,6,669,324,316,640,23
2022-03-31,Austria,3032,2351,25,3,681,328,328,656,22
2022-04-01,Austria,3271,2541,24,2,730,354,352,706,22
2022-04-02,Austria,3069,2456,22,3,613,292,299,591,19
2022-04-03,Austria,3352,2661,13,0,691,335,343,678,13
2022-04-04,Austria,3108,2426,35,2,682,325,322,647,33
2022-04-05,Austria,2813,2271,18,0,542,261,263,524,18
2022-04-06,Austria,3081,2397,36,2,684,329,319,648,34
2022-04-07,Austria,3302,2579,51,2,723,338,334,672,49
2022-04-08,Austria,3681,2850,33,1,831,401,397,798,32
2022-04-09,Austria,3641,2928,20,2,713,346,347,693,18
2022-04-10,Austria,3691,2963,25,1,728,351,352,703,24
2022-04-11,Austria,3380,2697,20,0,683,330,333,663,20
2022-04-12,Austria,3036,2460,26,0,576,274,276,550,26
2022-04-13,Austria,3330,2625,27,0,705,342,336,678,27
2022-04-14,Austria,3562,2826,41,2,736,348,347,695,39
2022-04-15,Austria,3573,2839,27,1,734,360,347,707,26
2022-04-16,Austria,3485,2834,19,2,651,313,319,632,17
2022-04-17,Austria,3573,2931,13,0,642,316,313,629,13
2022-04-18,Austria,3524,2795,22,0,729,351,356,707,22
2022-04-19,Austria,3131,2462,23,4,669,319,327,646,19
2022-04-20,Austria,3353,2638,36,3,715,341,338,679,33
2022-04-21,Austria,3429,2726,49,3,703,323,331,654,46
2022-04-22,Austria,3679,2939,29,2,740,358,353,711,27
2022-04-23,Austria,3646,3023,21,0,623,299,303,602,21
2022-04-24,Austria,3801,3071,28,0,730,345,357,702,28
2022-04-25,Austria,3535,2759,43,3,776,378,355,733,40
2022-04-26,Austria,3247,2602,21,2,645,311,313,624,19
2022-04-27,Austria,3452,2707,33,1,745,355,357,712,32
2022-04-28,Austria,3650,2863,40,2,787,369,378,747,38
2022-04-29,Austria,3867,3036,37,3,831,406,388,794,34
2022-04-30,Austria,3718,3067,20,2,651,305,326,631,18
2022-05-01,Austria,3972,3189,20,1,783,379,384,763,19
2022-05-02,Austria,3658,2903,27,1,755,365,363,728,26
2022-05-03,Austria,3624,2925,34,2,699,327,338,665,32
2022-05-04,Austria,3445,2717,23,2,728,361,344,705,21
2022-05-05,Austria,3683,2921,25,0,762,373,364,737,25
2022-05-06,Austria,3900,3075,44,0,825,386,395,781,44
2022-05-07,Austria,3935,3252,34,0,683,331,318,649,34
2022-05-08,Austria,4043,3250,27,0,793,378,388,766,27
2022-05-09,Austria,3701,2941,33,2,760,367,360,727,31
2022-05-10,Austria,3502,2792,34,3,710,335,341,676,31
2022-05-11,Austria,3568,2773,46,2,795,377,372,749,44
2022-05-12,Austria,3791,2970,47,3,821,391,383,774,44
2022-05-13,Austria,3995,3170,31,0,825,400,394,794,31
2022-05-14,Austria,4013,3288,46,0,725,339,340,679,46
2022-05-15,Austria,4198,3368,39,4,830,381,410,791,35
2022-05-16,Austria,3620,2818,21,1,802,394,387,781,20
2022-05-17,Austria,3554,2862,19,2,692,338,335,673,17
2022-05-18,Austria,3609,2795,46,4,814,375,393,768,42
2022-05-19,Austria,3863,3006,50,3,857,405,402,807,47
2022-05-20,Austria,4182,3316,46,3,866,418,402,820,43
2022-05-21,Austria,4131,3415,25,0,716,346,345,691,25
2022-05-22,Austria,4409,3555,45,3,854,399,410,809,42
2022-05-23,Austria,3904,3102,33,2,802,390,379,769,31
2022-05-24,Austria,4031,3284,38,2,747,351,358,709,36
2022-05-25,Austria,4405,3537,39,6,868,419,410,829,33
2022-05-26,Austria,4344,3500,40,0,844,406,398,804,40
2022-05-27,Austria,4146,3380,20,1,766,373,373,746,19
2022-05-28,Austria,4264,3491,30,1,773,372,371,743,29
2022-05-29,Austria,4519,3605,35,3,914,424,455,879,32
2022-05-30,Austria,4214,3330,46,9,884,423,415,838,37
2022-05-31,Austria,3908,3134,35,1,774,365,374,739,34
2022-06-01,Austria,3919,3053,43,4,866,414,409,823,39
2022-06-02,Austria,4125,3274,46,3,851,402,403,805,43
2022-06-03,Austria,4479,3550,37,4,929,457,435,892,33
2022-06-04,Austria,4538,3720,29,7,818,398,391,789,22
2022-06-05,Austria,4251,3471,27,4,780,380,373,753,23
2022-06-06,Austria,4314,3444,27,1,870,405,438,843,26
2022-06-07,Austria,4074,3249,25,1,825,402,398,800,24
2022-01-01,Belgium and Luxembourg,1880,1257,2,1,623,313,308,621,1
2022-01-02,Belgium and Luxembourg,2511,1626,8,0,885,440,437,877,8
2022-01-03,Belgium and Luxembourg,2407,1496,8,4,911,444,459,903,4
2022-01-04,Belgium and Luxembourg,2139,1347,11,7,792,389,392,781,4
2022-01-05,Belgium and Luxembourg,2169,1321,11,10,848,420,417,837,1
2022-01-06,Belgium and Luxembourg,2174,1369,22,9,805,392,391,783,13
2022-01-07,Belgium and Luxembourg,2387,1430,19,12,957,472,466,938,7
2022-01-08,Belgium and Luxembourg,2263,1518,7,1,745,368,370,738,6
2022-01-09,Belgium and Luxembourg,2419,1560,8,2,859,427,424,851,6
2022-01-10,Belgium and Luxembourg,1912,1177,17,10,735,351,367,718,7
2022-01-11,Belgium and Luxembourg,1775,1097,38,20,678,314,326,640,18
2022-01-12,Belgium and Luxembourg,1783,1096,20,5,687,336,331,667,15
2022-01-13,Belgium and Luxembourg,1726,1064,16,7,662,318,328,646,9
2022-01-14,Belgium and Luxembourg,1948,1144,14,8,804,410,380,790,6
2022-01-15,Belgium and Luxembourg,1775,1225,19,3,550,266,265,531,16
2022-01-16,Belgium and Luxembourg,1940,1214,14,2,726,356,356,712,12
2022-01-17,Belgium and Luxembourg,1742,1064,26,15,678,312,340,652,11
2022-01-18,Belgium and Luxembourg,1520,902,24,14,618,295,299,594,10
2022-01-19,Belgium and Luxembourg,1730,1012,24,5,718,354,340,694,19
2022-01-20,Belgium and Luxembourg,1696,1045,33,10,651,305,313,618,23
2022-01-21,Belgium and Luxembourg,1975,1163,19,14,812,406,387,793,5
2022-01-22,Belgium and Luxembourg,1802,1244,14,10,558,276,268,544,4
2022-01-23,Belgium and Luxembourg,1979,1268,11,3,711,349,351,700,8
2022-01-24,Belgium and Luxembourg,1714,1041,19,6,673,312,342,654,13
2022-01-25,Belgium and Luxembourg,1473,909,15,3,564,274,275,549,12
2022-01-26,Belgium and Luxembourg,1728,1024,16,4,704,347,341,688,12
2022-01-27,Belgium and Luxembourg,1730,1065,20,8,665,326,319,645,12
2022-01-28,Belgium and Luxembourg,1997,1182,13,7,815,412,390,802,6
2022-01-29,Belgium and Luxembourg,1749,1199,4,2,550,276,270,546,2
2022-01-30,Belgium and Luxembourg,1964,1254,4,0,710,356,350,706,4
2022-01-31,Belgium and Luxembourg,1668,998,6,1,670,310,354,664,5
2022-02-01,Belgium and Luxembourg,1697,1033,11,7,664,327,326,653,4
2022-02-02,Belgium and Luxembourg,1781,1027,26,12,754,363,365,728,14
2022-02-03,Belgium and Luxembourg,1866,1152,18,8,714,350,346,696,10
2022-02-04,Belgium and Luxembourg,2145,1290,19,6,855,425,411,836,13
2022-02-05,Belgium and Luxembourg,1995,1374,20,10,621,305,296,601,10
2022-02-06,Belgium and Luxembourg,2037,1327,6,2,710,350,354,704,4
2022-02-07,Belgium and Luxembourg,1896,1113,24,12,783,366,393,759,12
2022-02-08,Belgium and Luxembourg,1707,1028,27,12,679,329,323,652,15
2022-02-09,Belgium and Luxembourg,1891,1085,26,20,806,385,395,780,6
2022-02-10,Belgium and Luxembourg,2037,1210,31,14,827,399,397,796,17
2022-02-11,Belgium and Luxembourg,2306,1387,25,9,919,468,426,894,16
2022-02-12,Belgium and Luxembourg,2238,1539,13,3,699,341,345,686,10
2022-02-13,Belgium and Luxembourg,2197,1413,5,0,784,386,393,779,5
2022-02-14,Belgium and Luxembourg,2037,1256,13,5,781,371,397,768,8
2022-02-15,Belgium and Luxembourg,1827,1129,15,9,698,336,347,683,6
2022-02-16,Belgium and Luxembourg,1962,1186,22,9,776,372,382,754,13
2022-02-17,Belgium and Luxembourg,2115,1267,16,4,848,402,430,832,12
2022-02-18,Belgium and Luxembourg,2132,1243,10,0,889,467,412,879,10
2022-02-19,Belgium and Luxembourg,2362,1615,8,2,747,381,358,739,6
2022-02-20,Belgium and Luxembourg,2303,1499,6,0,804,392,406,798,6
2022-02-21,Belgium and Luxembourg,2124,1278,11,0,846,418,417,835,11
2022-02-22,Belgium and Luxembourg,1987,1232,34,14,755,352,369,721,20
2022-02-23,Belgium and Luxembourg,2094,1271,31,20,823,399,393,792,11
2022-02-24,Belgium and Luxembourg,2288,1392,28,13,896,425,443,868,15
2022-02-25,Belgium and Luxembourg,2496,1446,30,18,1050,526,494,1020,12
2022-02-26,Belgium and Luxembourg,2335,1513,21,9,822,409,392,801,12
2022-02-27,Belgium and Luxembourg,2377,1483,22,9,894,443,429,872,13
2022-02-28,Belgium and Luxembourg,2259,1398,30,15,861,403,428,831,15
2022-03-01,Belgium and Luxembourg,2200,1345,26,10,855,416,413,829,16
2022-03-02,Belgium and Luxembourg,2251,1364,28,12,887,430,429,859,16
2022-03-03,Belgium and Luxembourg,2385,1489,28,10,896,432,436,868,18
2022-03-04,Belgium and Luxembourg,2596,1588,45,14,1008,494,469,963,31
2022-03-05,Belgium and Luxembourg,2444,1620,25,9,824,399,400,799,16
2022-03-06,Belgium and Luxembourg,2524,1582,14,2,942,463,465,928,12
2022-03-07,Belgium and Luxembourg,2341,1432,25,16,909,431,453,884,9
2022-03-08,Belgium and Luxembourg,2159,1317,37,13,842,402,403,805,24
2022-03-09,Belgium and Luxembourg,2267,1382,16,13,885,430,439,869,3
2022-03-10,Belgium and Luxembourg,2409,1473,20,8,936,464,452,916,12
2022-03-11,Belgium and Luxembourg,2544,1591,19,9,953,477,457,934,10
2022-03-12,Belgium and Luxembourg,2338,1621,11,6,717,353,353,706,5
2022-03-13,Belgium and Luxembourg,2463,1619,5,1,844,423,416,839,4
2022-03-14,Belgium and Luxembourg,2317,1388,14,3,929,440,475,915,11
2022-03-15,Belgium and Luxembourg,2250,1374,17,10,876,432,427,859,7
2022-03-16,Belgium and Luxembourg,2347,1418,18,9,929,459,452,911,9
2022-03-17,Belgium and Luxembourg,2502,1584,25,13,918,455,438,893,12
2022-03-18,Belgium and Luxembourg,2598,1564,21,11,1034,502,511,1013,10
2022-03-19,Belgium and Luxembourg,2378,1651,13,6,727,364,350,714,7
2022-03-20,Belgium and Luxembourg,2516,1647,11,0,869,429,429,858,11
2022-03-21,Belgium and Luxembourg,2448,1500,20,11,948,451,477,928,9
2022-03-22,Belgium and Luxembourg,2188,1328,20,7,860,413,427,840,13
2022-03-23,Belgium and Luxembourg,2362,1452,24,11,910,433,453,886,13
2022-03-24,Belgium and Luxembourg,2584,1618,21,11,966,477,468,945,10
2022-03-25,Belgium and Luxembourg,2771,1707,28,14,1064,534,502,1036,14
2022-03-26,Belgium and Luxembourg,2413,1667,12,5,746,374,360,734,7
2022-03-27,Belgium and Luxembourg,2825,1931,8,4,894,448,438,886,4
2022-03-28,Belgium and Luxembourg,2860,1824,23,10,1036,499,514,1013,13
2022-03-29,Belgium and Luxembourg,2625,1683,20,10,942,453,469,922,10
2022-03-30,Belgium and Luxembourg,2796,1821,18,8,975,485,472,957,10
2022-03-31,Belgium and Luxembourg,2794,1834,9,3,960,481,470,951,6
2022-04-01,Belgium and Luxembourg,2926,1856,6,2,1070,538,526,1064,4
2022-04-02,Belgium and Luxembourg,2790,1911,13,10,879,445,421,866,3
2022-04-03,Belgium and Luxembourg,2907,1940,10,3,967,467,490,957,7
2022-04-04,Belgium and Luxembourg,2959,1960,15,8,999,482,502,984,7
2022-04-05,Belgium and Luxembourg,2647,1635,27,8,1012,488,497,985,19
2022-04-06,Belgium and Luxembourg,2879,1878,15,5,1001,488,498,986,10
2022-04-07,Belgium and Luxembourg,2841,1810,9,2,1031,523,499,1022,7
2022-04-08,Belgium and Luxembourg,3040,1954,17,9,1086,554,515,1069,8
2022-04-09,Belgium and Luxembourg,2703,1801,14,5,902,438,450,888,9
2022-04-10,Belgium and Luxembourg,2936,1953,9,2,983,484,490,974,7
2022-04-11,Belgium and Luxembourg,2802,1772,23,14,1030,488,519,1007,9
2022-04-12,Belgium and Luxembourg,2732,1746,16,9,986,491,479,970,7
2022-04-13,Belgium and Luxembourg,2897,1889,10,7,1008,497,501,998,3
2022-04-14,Belgium and Luxembourg,3003,1960,17,6,1043,519,507,1026,11
2022-04-15,Belgium and Luxembourg,2932,1890,13,9,1042,518,511,1029,4
2022-04-16,Belgium and Luxembourg,2620,1748,17,7,872,431,424,855,10
2022-04-17,Belgium and Luxembourg,2834,1878,8,2,956,471,477,948,6
2022-04-18,Belgium and Luxembourg,2953,1920,16,7,1033,489,528,1017,9
2022-04-19,Belgium and Luxembourg,2876,1851,21,11,1025,507,497,1004,10
2022-04-20,Belgium and Luxembourg,2845,1824,22,8,1021,497,502,999,14
2022-04-21,Belgium and Luxembourg,2967,1902,36,12,1065,515,514,1029,24
2022-04-22,Belgium and Luxembourg,2876,1898,24,10,978,489,465,954,14
2022-04-23,Belgium and Luxembourg,2561,1786,16,11,775,375,384,759,5
2022-04-24,Belgium and Luxembourg,2869,1981,5,3,888,446,437,883,2
2022-04-25,Belgium and Luxembourg,2862,1806,20,12,1056,510,526,1036,8
2022-04-26,Belgium and Luxembourg,2783,1759,17,9,1024,500,507,1007,8
2022-04-27,Belgium and Luxembourg,2934,1891,20,10,1043,510,513,1023,10
2022-04-28,Belgium and Luxembourg,3074,1973,28,18,1101,545,528,1073,10
2022-04-29,Belgium and Luxembourg,3093,1986,24,13,1107,559,524,1083,11
2022-04-30,Belgium and Luxembourg,2697,1833,14,4,864,428,422,850,10
2022-05-01,Belgium and Luxembourg,2912,1966,7,2,946,458,481,939,5
2022-05-02,Belgium and Luxembourg,3003,1947,21,11,1056,507,528,1035,10
2022-05-03,Belgium and Luxembourg,3032,1992,20,12,1040,512,508,1020,8
2022-05-04,Belgium and Luxembourg,3080,1992,29,15,1088,525,534,1059,14
2022-05-05,Belgium and Luxembourg,3210,2120,21,7,1090,532,537,1069,14
2022-05-06,Belgium and Luxembourg,3231,2072,23,10,1159,585,551,1136,13
2022-05-07,Belgium and Luxembourg,2861,1954,15,6,907,446,446,892,9
2022-05-08,Belgium and Luxembourg,3123,2114,7,0,1009,502,500,1002,7
2022-05-09,Belgium and Luxembourg,3046,1963,13,9,1083,524,546,1070,4
2022-05-10,Belgium and Luxembourg,2957,1908,16,6,1049,514,519,1033,10
2022-05-11,Belgium and Luxembourg,3060,1930,16,6,1130,560,554,1114,10
2022-05-12,Belgium and Luxembourg,3133,2031,18,9,1102,544,540,1084,9
2022-05-13,Belgium and Luxembourg,3222,2054,19,10,1168,586,563,1149,9
2022-05-14,Belgium and Luxembourg,2775,1889,15,5,886,431,440,871,10
2022-05-15,Belgium and Luxembourg,3089,2060,7,1,1029,505,517,1022,6
2022-05-16,Belgium and Luxembourg,3025,1911,25,12,1114,534,555,1089,13
2022-05-17,Belgium and Luxembourg,2945,1884,13,5,1061,518,530,1048,8
2022-05-18,Belgium and Luxembourg,3027,1929,9,6,1098,545,544,1089,3
2022-05-19,Belgium and Luxembourg,3151,2021,23,7,1130,558,549,1107,16
2022-05-20,Belgium and Luxembourg,2981,1863,11,2,1118,564,543,1107,9
2022-05-21,Belgium and Luxembourg,2984,2011,15,9,973,486,472,958,6
2022-05-22,Belgium and Luxembourg,3226,2200,9,3,1026,507,510,1017,6
2022-05-23,Belgium and Luxembourg,3018,1953,12,5,1065,510,543,1053,7
2022-05-24,Belgium and Luxembourg,3138,2059,17,5,1079,528,534,1062,12
2022-05-25,Belgium and Luxembourg,3422,2209,22,13,1213,600,591,1191,9
2022-05-26,Belgium and Luxembourg,3337,2236,15,6,1101,559,527,1086,9
2022-05-27,Belgium and Luxembourg,3237,2110,17,8,1127,561,549,1110,9
2022-05-28,Belgium and Luxembourg,2915,1974,14,5,941,463,464,927,9
2022-05-29,Belgium and Luxembourg,3316,2214,10,4,1102,525,567,1092,6
2022-05-30,Belgium and Luxembourg,3340,2147,20,6,1193,565,608,1173,14
2022-05-31,Belgium and Luxembourg,3058,1939,13,8,1119,569,537,1106,5
2022-06-01,Belgium and Luxembourg,3112,1991,20,15,1121,548,553,1101,5
2022-06-02,Belgium and Luxembourg,3225,2080,22,10,1145,560,563,1123,12
2022-06-03,Belgium and Luxembourg,3398,2223,16,8,1175,601,558,1159,8
2022-06-04,Belgium and Luxembourg,2896,1938,15,2,958,473,470,943,13
2022-06-05,Belgium and Luxembourg,3057,2086,5,1,971,478,488,966,4
2022-06-06,Belgium and Luxembourg,3308,2197,13,5,1111,525,573,1098,8
2022-06-07,Belgium and Luxembourg,3182,2047,16,7,1135,574,545,1119,9
2022-01-01,Bosnia-Herzegovina,775,729,0,0,46,23,23,46,0
2022-01-02,Bosnia-Herzegovina,924,895,0,0,29,13,16,29,0
2022-01-03,Bosnia-Herzegovina,822,760,2,0,62,30,30,60,2
2022-01-04,Bosnia-Herzegovina,769,702,0,0,67,34,33,67,0
2022-01-05,Bosnia-Herzegovina,735,682,0,0,53,26,27,53,0
2022-01-06,Bosnia-Herzegovina,737,696,0,0,41,21,20,41,0
2022-01-07,Bosnia-Herzegovina,813,747,0,0,66,33,33,66,0
2022-01-08,Bosnia-Herzegovina,944,887,0,0,57,29,28,57,0
2022-01-09,Bosnia-Herzegovina,905,861,0,0,44,22,22,44,0
2022-01-10,Bosnia-Herzegovina,634,599,0,0,35,17,18,35,0
2022-01-11,Bosnia-Herzegovina,569,528,0,0,41,20,21,41,0
2022-01-12,Bosnia-Herzegovina,562,530,1,1,32,15,16,31,0
2022-01-13,Bosnia-Herzegovina,546,516,0,0,30,16,14,30,0
2022-01-14,Bosnia-Herzegovina,665,620,0,0,45,22,23,45,0
2022-01-15,Bosnia-Herzegovina,686,660,0,0,26,15,11,26,0
2022-01-16,Bosnia-Herzegovina,644,611,0,0,33,17,16,33,0
2022-01-17,Bosnia-Herzegovina,564,530,0,0,34,17,17,34,0
2022-01-18,Bosnia-Herzegovina,480,449,1,1,31,15,15,30,0
2022-01-19,Bosnia-Herzegovina,487,465,0,0,22,11,11,22,0
2022-01-20,Bosnia-Herzegovina,469,437,0,0,32,16,16,32,0
2022-01-21,Bosnia-Herzegovina,584,543,0,0,41,21,20,41,0
2022-01-22,Bosnia-Herzegovina,624,602,0,0,22,11,11,22,0
2022-01-23,Bosnia-Herzegovina,634,606,0,0,28,14,14,28,0
2022-01-24,Bosnia-Herzegovina,528,500,0,0,28,14,14,28,0
2022-01-25,Bosnia-Herzegovina,440,413,0,0,27,14,13,27,0
2022-01-26,Bosnia-Herzegovina,461,446,0,0,15,7,8,15,0
2022-01-27,Bosnia-Herzegovina,500,474,0,0,26,13,13,26,0
2022-01-28,Bosnia-Herzegovina,615,583,0,0,32,16,16,32,0
2022-01-29,Bosnia-Herzegovina,662,639,0,0,23,11,12,23,0
2022-01-30,Bosnia-Herzegovina,617,585,0,0,32,16,16,32,0
2022-01-31,Bosnia-Herzegovina,531,498,0,0,33,17,16,33,0
2022-02-01,Bosnia-Herzegovina,529,498,0,0,31,15,16,31,0
2022-02-02,Bosnia-Herzegovina,500,475,0,0,25,11,14,25,0
2022-02-03,Bosnia-Herzegovina,521,492,1,0,29,16,12,28,1
2022-02-04,Bosnia-Herzegovina,659,627,0,0,32,16,16,32,0
2022-02-05,Bosnia-Herzegovina,697,675,0,0,22,11,11,22,0
2022-02-06,Bosnia-Herzegovina,646,617,0,0,29,14,15,29,0
2022-02-07,Bosnia-Herzegovina,546,521,0,0,25,13,12,25,0
2022-02-08,Bosnia-Herzegovina,553,521,0,0,32,15,17,32,0
2022-02-09,Bosnia-Herzegovina,518,494,0,0,24,11,13,24,0
2022-02-10,Bosnia-Herzegovina,547,517,1,0,30,16,13,29,1
2022-02-11,Bosnia-Herzegovina,636,602,0,0,34,17,17,34,0
2022-02-12,Bosnia-Herzegovina,669,643,0,0,26,13,13,26,0
2022-02-13,Bosnia-Herzegovina,642,616,0,0,26,13,13,26,0
2022-02-14,Bosnia-Herzegovina,574,546,0,0,28,14,14,28,0
2022-02-15,Bosnia-Herzegovina,516,477,0,0,39,19,20,39,0
2022-02-16,Bosnia-Herzegovina,523,497,0,0,26,13,13,26,0
2022-02-17,Bosnia-Herzegovina,548,521,0,0,27,14,13,27,0
2022-02-18,Bosnia-Herzegovina,693,657,0,0,36,18,18,36,0
2022-02-19,Bosnia-Herzegovina,729,700,0,0,29,14,15,29,0
2022-02-20,Bosnia-Herzegovina,710,686,0,0,24,12,12,24,0
2022-02-21,Bosnia-Herzegovina,614,583,0,0,31,16,15,31,0
2022-02-22,Bosnia-Herzegovina,568,533,0,0,35,17,18,35,0
2022-02-23,Bosnia-Herzegovina,577,553,0,0,24,11,13,24,0
2022-02-24,Bosnia-Herzegovina,594,563,0,0,31,14,17,31,0
2022-02-25,Bosnia-Herzegovina,720,680,0,0,40,21,19,40,0
2022-02-26,Bosnia-Herzegovina,750,718,0,0,32,16,16,32,0
2022-02-27,Bosnia-Herzegovina,720,687,0,0,33,17,16,33,0
2022-02-28,Bosnia-Herzegovina,648,613,0,0,35,18,17,35,0
2022-03-01,Bosnia-Herzegovina,655,610,0,0,45,22,23,45,0
2022-03-02,Bosnia-Herzegovina,623,588,2,0,35,16,17,33,2
2022-03-03,Bosnia-Herzegovina,684,649,2,0,35,16,17,33,2
2022-03-04,Bosnia-Herzegovina,789,737,0,0,52,27,25,52,0
2022-03-05,Bosnia-Herzegovina,796,756,0,0,40,20,20,40,0
2022-03-06,Bosnia-Herzegovina,752,725,0,0,27,13,14,27,0
2022-03-07,Bosnia-Herzegovina,702,657,0,0,45,22,23,45,0
2022-03-08,Bosnia-Herzegovina,648,604,0,0,44,23,21,44,0
2022-03-09,Bosnia-Herzegovina,662,628,2,0,34,15,17,32,2
2022-03-10,Bosnia-Herzegovina,680,640,2,0,40,20,18,38,2
2022-03-11,Bosnia-Herzegovina,713,664,0,0,49,24,25,49,0
2022-03-12,Bosnia-Herzegovina,792,751,0,0,41,21,20,41,0
2022-03-13,Bosnia-Herzegovina,743,714,0,0,29,15,14,29,0
2022-03-14,Bosnia-Herzegovina,700,651,0,0,49,24,25,49,0
2022-03-15,Bosnia-Herzegovina,652,608,1,1,44,22,21,43,0
2022-03-16,Bosnia-Herzegovina,668,634,0,0,34,16,18,34,0
2022-03-17,Bosnia-Herzegovina,643,607,0,0,36,18,18,36,0
2022-03-18,Bosnia-Herzegovina,762,708,2,0,54,27,25,52,2
2022-03-19,Bosnia-Herzegovina,814,778,0,0,36,18,18,36,0
2022-03-20,Bosnia-Herzegovina,789,757,0,0,32,16,16,32,0
2022-03-21,Bosnia-Herzegovina,682,640,0,0,42,20,22,42,0
2022-03-22,Bosnia-Herzegovina,621,574,0,0,47,25,22,47,0
2022-03-23,Bosnia-Herzegovina,699,662,0,0,37,17,20,37,0
2022-03-24,Bosnia-Herzegovina,697,658,2,0,39,19,18,37,2
2022-03-25,Bosnia-Herzegovina,781,734,0,0,47,23,24,47,0
2022-03-26,Bosnia-Herzegovina,844,800,0,0,44,22,22,44,0
2022-03-27,Bosnia-Herzegovina,1029,983,0,0,46,22,24,46,0
2022-03-28,Bosnia-Herzegovina,936,859,4,2,77,36,37,73,2
2022-03-29,Bosnia-Herzegovina,833,773,2,1,60,29,29,58,1
2022-03-30,Bosnia-Herzegovina,856,809,2,1,47,23,22,45,1
2022-03-31,Bosnia-Herzegovina,894,841,3,1,53,25,25,50,2
2022-04-01,Bosnia-Herzegovina,1065,990,1,0,75,37,37,74,1
2022-04-02,Bosnia-Herzegovina,1079,1038,1,0,41,20,20,40,1
2022-04-03,Bosnia-Herzegovina,1060,1011,0,0,49,25,24,49,0
2022-04-04,Bosnia-Herzegovina,933,861,0,0,72,36,36,72,0
2022-04-05,Bosnia-Herzegovina,864,807,1,0,57,28,28,56,1
2022-04-06,Bosnia-Herzegovina,928,884,0,0,44,22,22,44,0
2022-04-07,Bosnia-Herzegovina,919,875,0,0,44,22,22,44,0
2022-04-08,Bosnia-Herzegovina,1165,1095,0,0,70,35,35,70,0
2022-04-09,Bosnia-Herzegovina,1233,1192,0,0,41,21,20,41,0
2022-04-10,Bosnia-Herzegovina,1218,1169,0,0,49,25,24,49,0
2022-04-11,Bosnia-Herzegovina,1076,1005,1,1,71,34,36,70,0
2022-04-12,Bosnia-Herzegovina,946,893,0,0,53,27,26,53,0
2022-04-13,Bosnia-Herzegovina,1070,1010,2,0,60,29,29,58,2
2022-04-14,Bosnia-Herzegovina,1146,1088,0,0,58,29,29,58,0
2022-04-15,Bosnia-Herzegovina,1203,1133,0,0,70,35,35,70,0
2022-04-16,Bosnia-Herzegovina,1238,1191,0,0,47,24,23,47,0
2022-04-17,Bosnia-Herzegovina,1246,1194,0,0,52,26,26,52,0
2022-04-18,Bosnia-Herzegovina,1166,1101,0,0,65,31,34,65,0
2022-04-19,Bosnia-Herzegovina,1004,949,0,0,55,28,27,55,0
2022-04-20,Bosnia-Herzegovina,1104,1041,2,0,63,30,31,61,2
2022-04-21,Bosnia-Herzegovina,1135,1076,0,0,59,30,29,59,0
2022-04-22,Bosnia-Herzegovina,1177,1108,0,0,69,35,34,69,0
2022-04-23,Bosnia-Herzegovina,1313,1267,0,0,46,23,23,46,0
2022-04-24,Bosnia-Herzegovina,1306,1257,0,0,49,25,24,49,0
2022-04-25,Bosnia-Herzegovina,1105,1040,0,0,65,32,33,65,0
2022-04-26,Bosnia-Herzegovina,1007,948,0,0,59,29,30,59,0
2022-04-27,Bosnia-Herzegovina,1074,1010,2,0,64,32,30,62,2
2022-04-28,Bosnia-Herzegovina,1151,1081,2,0,70,33,35,68,2
2022-04-29,Bosnia-Herzegovina,1240,1168,0,0,72,36,36,72,0
2022-04-30,Bosnia-Herzegovina,1366,1307,0,0,59,30,29,59,0
2022-05-01,Bosnia-Herzegovina,1418,1353,0,0,65,33,32,65,0
2022-05-02,Bosnia-Herzegovina,1289,1221,1,0,68,33,34,67,1
2022-05-03,Bosnia-Herzegovina,1198,1136,0,0,62,31,31,62,0
2022-05-04,Bosnia-Herzegovina,1150,1085,0,0,65,32,33,65,0
2022-05-05,Bosnia-Herzegovina,1282,1218,0,0,64,32,32,64,0
2022-05-06,Bosnia-Herzegovina,1329,1248,0,0,81,41,40,81,0
2022-05-07,Bosnia-Herzegovina,1487,1435,0,0,52,26,26,52,0
2022-05-08,Bosnia-Herzegovina,1419,1355,0,0,64,32,32,64,0
2022-05-09,Bosnia-Herzegovina,1262,1192,0,0,70,35,35,70,0
2022-05-10,Bosnia-Herzegovina,1214,1150,0,0,64,31,33,64,0
2022-05-11,Bosnia-Herzegovina,1260,1189,0,0,71,36,35,71,0
2022-05-12,Bosnia-Herzegovina,1230,1158,0,0,72,36,36,72,0
2022-05-13,Bosnia-Herzegovina,1403,1321,0,0,82,41,41,82,0
2022-05-14,Bosnia-Herzegovina,1454,1393,0,0,61,31,30,61,0
2022-05-15,Bosnia-Herzegovina,1450,1385,0,0,65,33,32,65,0
2022-05-16,Bosnia-Herzegovina,1241,1172,2,2,69,33,34,67,0
2022-05-17,Bosnia-Herzegovina,1162,1102,5,1,60,27,28,55,4
2022-05-18,Bosnia-Herzegovina,1240,1171,0,0,69,35,34,69,0
2022-05-19,Bosnia-Herzegovina,1257,1183,0,0,74,37,37,74,0
2022-05-20,Bosnia-Herzegovina,1395,1310,4,0,85,40,41,81,4
2022-05-21,Bosnia-Herzegovina,1556,1501,0,0,55,28,27,55,0
2022-05-22,Bosnia-Herzegovina,1464,1397,1,0,67,34,32,66,1
2022-05-23,Bosnia-Herzegovina,1250,1185,0,0,65,32,33,65,0
2022-05-24,Bosnia-Herzegovina,1291,1226,2,0,65,31,32,63,2
2022-05-25,Bosnia-Herzegovina,1551,1481,2,0,70,34,34,68,2
2022-05-26,Bosnia-Herzegovina,1411,1340,1,0,71,35,35,70,1
2022-05-27,Bosnia-Herzegovina,1509,1426,0,0,83,41,42,83,0
2022-05-28,Bosnia-Herzegovina,1584,1532,0,0,52,26,26,52,0
2022-05-29,Bosnia-Herzegovina,1544,1481,0,0,63,31,32,63,0
2022-05-30,Bosnia-Herzegovina,1433,1356,0,0,77,38,39,77,0
2022-05-31,Bosnia-Herzegovina,1296,1229,1,0,67,34,32,66,1
2022-06-01,Bosnia-Herzegovina,1429,1347,0,0,82,41,41,82,0
2022-06-02,Bosnia-Herzegovina,1445,1379,1,1,66,32,33,65,0
2022-06-03,Bosnia-Herzegovina,1585,1487,0,0,98,50,48,98,0
2022-06-04,Bosnia-Herzegovina,1712,1654,2,0,58,27,29,56,2
2022-06-05,Bosnia-Herzegovina,1541,1469,0,0,72,37,35,72,0
2022-06-06,Bosnia-Herzegovina,1512,1433,1,0,79,39,39,78,1
2022-06-07,Bosnia-Herzegovina,1478,1408,0,0,70,34,36,70,0
2022-01-01,Bulgaria,1349,1228,2,0,121,59,60,119,2
2022-01-02,Bulgaria,1711,1490,7,0,221,103,111,214,7
2022-01-03,Bulgaria,1512,1315,7,0,197,92,98,190,7
2022-01-04,Bulgaria,1357,1189,8,2,168,80,80,160,6
2022-01-05,Bulgaria,1359,1189,7,0,170,80,83,163,7
2022-01-06,Bulgaria,1491,1331,5,0,160,78,77,155,5
2022-01-07,Bulgaria,1544,1385,8,0,159,78,73,151,8
2022-01-08,Bulgaria,1624,1441,4,0,183,88,91,179,4
2022-01-09,Bulgaria,1615,1455,6,0,160,75,79,154,6
2022-01-10,Bulgaria,1333,1203,14,3,130,59,57,116,11
2022-01-11,Bulgaria,1179,1055,13,3,124,55,56,111,10
2022-01-12,Bulgaria,1212,1097,13,1,115,53,49,102,12
2022-01-13,Bulgaria,1218,1109,8,0,109,51,50,101,8
2022-01-14,Bulgaria,1345,1220,11,0,125,58,56,114,11
2022-01-15,Bulgaria,1350,1218,2,0,132,63,67,130,2
2022-01-16,Bulgaria,1419,1295,8,0,124,59,57,116,8
2022-01-17,Bulgaria,1156,1042,6,2,114,53,55,108,4
2022-01-18,Bulgaria,1046,942,7,2,104,48,49,97,5
2022-01-19,Bulgaria,1119,1005,10,1,114,53,51,104,9
2022-01-20,Bulgaria,1166,1057,7,1,109,52,50,102,6
2022-01-21,Bulgaria,1263,1137,9,0,126,58,59,117,9
2022-01-22,Bulgaria,1314,1191,2,0,123,61,60,121,2
2022-01-23,Bulgaria,1371,1253,6,0,118,56,56,112,6
2022-01-24,Bulgaria,927,816,5,1,111,51,55,106,4
2022-01-25,Bulgaria,800,704,7,2,96,45,44,89,5
2022-01-26,Bulgaria,991,890,6,0,101,46,49,95,6
2022-01-27,Bulgaria,1171,1056,4,0,115,57,54,111,4
2022-01-28,Bulgaria,1273,1147,15,1,126,57,54,111,14
2022-01-29,Bulgaria,1322,1196,3,1,126,61,62,123,2
2022-01-30,Bulgaria,1318,1206,6,0,112,52,54,106,6
2022-01-31,Bulgaria,1147,1022,6,0,125,61,58,119,6
2022-02-01,Bulgaria,1077,979,6,0,98,45,47,92,6
2022-02-02,Bulgaria,1069,970,7,0,99,45,47,92,7
2022-02-03,Bulgaria,1221,1114,7,3,107,51,49,100,4
2022-02-04,Bulgaria,1257,1111,14,1,146,68,64,132,13
2022-02-05,Bulgaria,1373,1221,2,0,152,76,74,150,2
2022-02-06,Bulgaria,1396,1265,7,1,131,58,66,124,6
2022-02-07,Bulgaria,1149,1007,5,0,142,70,67,137,5
2022-02-08,Bulgaria,1041,940,5,0,101,48,48,96,5
2022-02-09,Bulgaria,1097,980,9,2,117,51,57,108,7
2022-02-10,Bulgaria,1245,1118,17,2,127,56,54,110,15
2022-02-11,Bulgaria,1363,1219,10,2,144,70,64,134,8
2022-02-12,Bulgaria,1468,1314,6,4,154,72,76,148,2
2022-02-13,Bulgaria,1514,1379,7,1,135,67,61,128,6
2022-02-14,Bulgaria,1362,1234,8,2,128,61,59,120,6
2022-02-15,Bulgaria,1299,1198,8,1,101,45,48,93,7
2022-02-16,Bulgaria,1286,1175,9,0,111,52,50,102,9
2022-02-17,Bulgaria,1382,1273,10,4,109,50,49,99,6
2022-02-18,Bulgaria,1462,1321,9,1,141,66,66,132,8
2022-02-19,Bulgaria,1681,1523,2,0,158,76,80,156,2
2022-02-20,Bulgaria,1651,1505,7,0,146,66,73,139,7
2022-02-21,Bulgaria,1337,1189,11,2,148,70,67,137,9
2022-02-22,Bulgaria,1314,1191,19,9,123,50,54,104,10
2022-02-23,Bulgaria,1299,1176,13,0,123,57,53,110,13
2022-02-24,Bulgaria,1391,1274,16,0,117,53,48,101,16
2022-02-25,Bulgaria,1481,1321,8,0,160,72,80,152,8
2022-02-26,Bulgaria,1638,1503,3,1,135,69,63,132,2
2022-02-27,Bulgaria,1557,1428,8,0,129,61,60,121,8
2022-02-28,Bulgaria,1453,1331,5,0,122,58,59,117,5
2022-03-01,Bulgaria,1388,1265,17,0,123,52,54,106,17
2022-03-02,Bulgaria,1464,1343,9,1,121,58,54,112,8
2022-03-03,Bulgaria,1535,1420,9,2,115,54,52,106,7
2022-03-04,Bulgaria,1672,1527,10,1,145,66,69,135,9
2022-03-05,Bulgaria,1789,1636,5,3,153,73,75,148,2
2022-03-06,Bulgaria,1712,1559,7,1,153,71,75,146,6
2022-03-07,Bulgaria,1523,1387,11,1,136,62,63,125,10
2022-03-08,Bulgaria,1395,1262,12,1,133,61,60,121,11
2022-03-09,Bulgaria,1448,1322,8,0,126,59,59,118,8
2022-03-10,Bulgaria,1433,1304,13,0,129,56,60,116,13
2022-03-11,Bulgaria,1535,1405,9,0,130,60,61,121,9
2022-03-12,Bulgaria,1497,1368,2,0,129,63,64,127,2
2022-03-13,Bulgaria,1590,1453,8,2,137,66,63,129,6
2022-03-14,Bulgaria,1367,1237,10,2,130,61,59,120,8
2022-03-15,Bulgaria,1375,1257,13,1,118,54,51,105,12
2022-03-16,Bulgaria,1409,1286,13,1,123,53,57,110,12
2022-03-17,Bulgaria,1533,1401,15,4,132,59,58,117,11
2022-03-18,Bulgaria,1624,1482,16,0,142,62,64,126,16
2022-03-19,Bulgaria,1657,1528,3,1,129,64,62,126,2
2022-03-20,Bulgaria,1666,1528,7,1,138,68,63,131,6
2022-03-21,Bulgaria,1454,1319,8,1,135,62,65,127,7
2022-03-22,Bulgaria,1272,1154,7,2,118,54,57,111,5
2022-03-23,Bulgaria,1461,1300,22,3,161,69,70,139,19
2022-03-24,Bulgaria,1544,1415,15,3,129,57,57,114,12
2022-03-25,Bulgaria,1652,1506,7,0,146,70,69,139,7
2022-03-26,Bulgaria,1751,1611,4,2,140,67,69,136,2
2022-03-27,Bulgaria,1825,1675,7,2,150,70,73,143,5
2022-03-28,Bulgaria,1707,1547,11,0,160,76,73,149,11
2022-03-29,Bulgaria,1639,1484,16,4,155,66,73,139,12
2022-03-30,Bulgaria,1703,1532,12,1,171,81,78,159,11
2022-03-31,Bulgaria,1781,1608,7,3,173,81,85,166,4
2022-04-01,Bulgaria,1950,1764,8,0,186,92,86,178,8
2022-04-02,Bulgaria,2082,1899,3,0,183,94,86,180,3
2022-04-03,Bulgaria,2044,1886,5,0,158,76,77,153,5
2022-04-04,Bulgaria,1771,1605,8,1,166,81,77,158,7
2022-04-05,Bulgaria,1695,1548,4,0,147,71,72,143,4
2022-04-06,Bulgaria,1836,1676,7,1,160,76,77,153,6
2022-04-07,Bulgaria,1954,1768,5,1,186,91,90,181,4
2022-04-08,Bulgaria,2084,1885,9,2,199,97,93,190,7
2022-04-09,Bulgaria,2195,2011,4,0,184,88,92,180,4
2022-04-10,Bulgaria,2167,1983,12,5,184,83,89,172,7
2022-04-11,Bulgaria,1907,1734,6,0,173,84,83,167,6
2022-04-12,Bulgaria,1805,1628,8,2,177,83,86,169,6
2022-04-13,Bulgaria,1851,1669,16,1,182,83,83,166,15
2022-04-14,Bulgaria,1984,1790,16,3,194,90,88,178,13
2022-04-15,Bulgaria,2138,1949,10,1,189,92,87,179,9
2022-04-16,Bulgaria,2218,2048,2,0,170,84,84,168,2
2022-04-17,Bulgaria,2161,1986,7,0,175,83,85,168,7
2022-04-18,Bulgaria,2063,1859,16,0,204,92,96,188,16
2022-04-19,Bulgaria,1984,1794,9,3,190,91,90,181,6
2022-04-20,Bulgaria,1961,1778,10,2,183,87,86,173,8
2022-04-21,Bulgaria,2009,1807,17,4,202,96,89,185,13
2022-04-22,Bulgaria,2217,2005,17,2,212,103,92,195,15
2022-04-23,Bulgaria,2359,2179,2,0,180,87,91,178,2
2022-04-24,Bulgaria,2252,2082,8,2,170,78,84,162,6
2022-04-25,Bulgaria,2039,1846,10,2,193,91,92,183,8
2022-04-26,Bulgaria,1948,1750,17,3,198,87,94,181,14
2022-04-27,Bulgaria,1984,1797,10,1,187,89,88,177,9
2022-04-28,Bulgaria,2069,1879,11,0,190,94,85,179,11
2022-04-29,Bulgaria,2198,1997,13,0,201,96,92,188,13
2022-04-30,Bulgaria,2436,2242,5,3,194,93,96,189,2
2022-05-01,Bulgaria,2387,2196,8,0,191,91,92,183,8
2022-05-02,Bulgaria,2078,1871,12,1,207,95,100,195,11
2022-05-03,Bulgaria,2062,1862,9,1,200,97,94,191,8
2022-05-04,Bulgaria,2067,1864,27,4,203,87,89,176,23
2022-05-05,Bulgaria,2104,1899,11,3,205,100,94,194,8
2022-05-06,Bulgaria,2195,2000,13,2,195,91,91,182,11
2022-05-07,Bulgaria,2387,2196,3,0,191,91,97,188,3
2022-05-08,Bulgaria,2354,2165,9,1,189,88,92,180,8
2022-05-09,Bulgaria,2046,1825,19,4,221,102,100,202,15
2022-05-10,Bulgaria,1996,1800,9,2,196,94,93,187,7
2022-05-11,Bulgaria,2002,1821,17,3,181,82,82,164,14
2022-05-12,Bulgaria,2088,1901,17,2,187,83,87,170,15
2022-05-13,Bulgaria,2252,2035,11,0,217,104,102,206,11
2022-05-14,Bulgaria,2465,2271,4,1,194,97,93,190,3
2022-05-15,Bulgaria,2398,2213,9,0,185,85,91,176,9
2022-05-16,Bulgaria,2107,1892,11,3,215,101,103,204,8
2022-05-17,Bulgaria,1998,1806,11,4,192,90,91,181,7
2022-05-18,Bulgaria,2066,1883,10,2,183,92,81,173,8
2022-05-19,Bulgaria,2165,1954,15,2,211,96,100,196,13
2022-05-20,Bulgaria,2321,2092,8,0,229,110,111,221,8
2022-05-21,Bulgaria,2531,2324,5,1,207,99,103,202,4
2022-05-22,Bulgaria,2477,2282,8,1,195,95,92,187,7
2022-05-23,Bulgaria,2194,1990,10,2,204,96,98,194,8
2022-05-24,Bulgaria,2175,1962,8,2,213,103,102,205,6
2022-05-25,Bulgaria,2306,2100,10,0,206,101,95,196,10
2022-05-26,Bulgaria,2350,2114,15,2,236,110,111,221,13
2022-05-27,Bulgaria,2458,2213,9,1,245,116,120,236,8
2022-05-28,Bulgaria,2646,2442,6,1,204,102,96,198,5
2022-05-29,Bulgaria,2668,2463,16,4,205,93,96,189,12
2022-05-30,Bulgaria,2272,2062,12,2,210,99,99,198,10
2022-05-31,Bulgaria,2247,2031,17,2,216,99,100,199,15
2022-06-01,Bulgaria,2182,1974,9,2,208,100,99,199,7
2022-06-02,Bulgaria,2381,2148,14,2,233,111,108,219,12
2022-06-03,Bulgaria,2636,2369,7,0,267,126,134,260,7
2022-06-04,Bulgaria,2835,2618,9,0,217,109,99,208,9
2022-06-05,Bulgaria,2715,2488,11,0,227,107,109,216,11
2022-06-06,Bulgaria,2451,2229,7,0,222,110,105,215,7
2022-06-07,Bulgaria,2394,2145,7,1,249,118,124,242,6
2022-01-01,Croatia,1209,1130,10,0,79,34,35,69,10
2022-01-02,Croatia,1552,1425,16,1,127,56,55,111,15
2022-01-03,Croatia,1348,1190,30,2,158,64,64,128,28
2022-01-04,Croatia,1254,1131,22,0,123,51,50,101,22
2022-01-05,Croatia,1218,1105,18,0,113,48,47,95,18
2022-01-06,Croatia,1211,1098,21,0,113,46,46,92,21
2022-01-07,Croatia,1355,1219,28,1,136,53,55,108,27
2022-01-08,Croatia,1459,1353,12,0,106,49,45,94,12
2022-01-09,Croatia,1464,1338,17,0,126,55,54,109,17
2022-01-10,Croatia,1037,921,24,0,116,49,43,92,24
2022-01-11,Croatia,921,838,11,0,83,34,38,72,11
2022-01-12,Croatia,874,778,18,0,96,41,37,78,18
2022-01-13,Croatia,875,772,22,1,103,40,41,81,21
2022-01-14,Croatia,1091,972,21,2,119,45,53,98,19
2022-01-15,Croatia,1066,973,17,1,93,37,39,76,16
2022-01-16,Croatia,1079,969,18,1,110,48,44,92,17
2022-01-17,Croatia,924,799,28,0,125,50,47,97,28
2022-01-18,Croatia,788,699,21,0,89,33,35,68,21
2022-01-19,Croatia,774,681,19,0,93,39,35,74,19
2022-01-20,Croatia,814,697,23,0,117,46,48,94,23
2022-01-21,Croatia,986,867,22,0,119,48,49,97,22
2022-01-22,Croatia,993,910,13,0,83,34,36,70,13
2022-01-23,Croatia,1047,937,17,0,110,47,46,93,17
2022-01-24,Croatia,852,733,25,0,119,49,45,94,25
2022-01-25,Croatia,715,616,24,1,99,36,39,75,23
2022-01-26,Croatia,757,646,19,0,111,48,44,92,19
2022-01-27,Croatia,795,688,27,4,107,40,40,80,23
2022-01-28,Croatia,1002,893,20,0,109,45,44,89,20
2022-01-29,Croatia,997,913,14,0,84,33,37,70,14
2022-01-30,Croatia,995,889,21,3,106,43,42,85,18
2022-01-31,Croatia,867,753,25,0,114,44,45,89,25
2022-02-01,Croatia,840,739,19,1,101,42,40,82,18
2022-02-02,Croatia,791,689,22,1,102,41,39,80,21
2022-02-03,Croatia,842,716,26,3,126,48,52,100,23
2022-02-04,Croatia,1110,978,21,0,132,55,56,111,21
2022-02-05,Croatia,1088,992,16,3,96,38,42,80,13
2022-02-06,Croatia,1080,964,17,1,116,49,50,99,16
2022-02-07,Croatia,927,805,22,0,122,50,50,100,22
2022-02-08,Croatia,869,762,18,3,107,46,43,89,15
2022-02-09,Croatia,830,721,21,2,109,44,44,88,19
2022-02-10,Croatia,924,804,21,0,120,50,49,99,21
2022-02-11,Croatia,1078,954,23,0,124,50,51,101,23
2022-02-12,Croatia,1129,1046,12,0,83,34,37,71,12
2022-02-13,Croatia,1109,988,15,0,121,55,51,106,15
2022-02-14,Croatia,939,823,27,1,116,44,45,89,26
2022-02-15,Croatia,862,752,23,1,110,40,47,87,22
2022-02-16,Croatia,862,753,20,0,109,46,43,89,20
2022-02-17,Croatia,911,796,22,0,115,48,45,93,22
2022-02-18,Croatia,1126,990,27,0,136,56,53,109,27
2022-02-19,Croatia,1181,1064,17,0,117,48,52,100,17
2022-02-20,Croatia,1177,1068,16,0,109,48,45,93,16
2022-02-21,Croatia,1003,883,22,0,120,50,48,98,22
2022-02-22,Croatia,913,803,20,0,110,45,45,90,20
2022-02-23,Croatia,940,832,22,0,108,42,44,86,22
2022-02-24,Croatia,978,850,27,2,128,50,51,101,25
2022-02-25,Croatia,1190,1048,25,0,142,58,59,117,25
2022-02-26,Croatia,1208,1107,15,0,101,45,41,86,15
2022-02-27,Croatia,1195,1081,17,0,114,49,48,97,17
2022-02-28,Croatia,1074,937,24,0,137,58,55,113,24
2022-03-01,Croatia,1037,918,24,0,119,47,48,95,24
2022-03-02,Croatia,978,865,20,1,113,45,48,93,19
2022-03-03,Croatia,1121,979,24,0,142,58,60,118,24
2022-03-04,Croatia,1294,1145,24,0,149,63,62,125,24
2022-03-05,Croatia,1270,1164,13,0,106,44,49,93,13
2022-03-06,Croatia,1243,1124,18,0,119,51,50,101,18
2022-03-07,Croatia,1135,998,25,0,137,56,56,112,25
2022-03-08,Croatia,1054,944,22,1,110,43,45,88,21
2022-03-09,Croatia,1038,921,22,0,117,48,47,95,22
2022-03-10,Croatia,1081,954,23,0,127,51,53,104,23
2022-03-11,Croatia,1223,1079,27,0,144,57,60,117,27
2022-03-12,Croatia,1270,1166,15,0,104,45,44,89,15
2022-03-13,Croatia,1263,1142,18,0,121,54,49,103,18
2022-03-14,Croatia,1190,1043,22,0,147,63,62,125,22
2022-03-15,Croatia,1060,938,25,0,122,46,51,97,25
2022-03-16,Croatia,1079,953,23,1,126,53,50,103,22
2022-03-17,Croatia,1064,935,22,0,129,52,55,107,22
2022-03-18,Croatia,1257,1106,23,0,151,67,61,128,23
2022-03-19,Croatia,1298,1189,15,0,109,43,51,94,15
2022-03-20,Croatia,1286,1160,15,0,126,55,56,111,15
2022-03-21,Croatia,1129,978,29,1,151,63,59,122,28
2022-03-22,Croatia,1031,916,22,1,115,46,47,93,21
2022-03-23,Croatia,1114,979,22,1,135,56,57,113,21
2022-03-24,Croatia,1150,1002,22,0,148,65,61,126,22
2022-03-25,Croatia,1304,1153,22,0,151,59,70,129,22
2022-03-26,Croatia,1337,1199,18,1,138,55,65,120,17
2022-03-27,Croatia,1732,1531,15,0,201,99,87,186,15
2022-03-28,Croatia,1475,1292,27,1,183,80,76,156,26
2022-03-29,Croatia,1328,1158,22,1,170,75,73,148,21
2022-03-30,Croatia,1386,1208,15,1,178,83,80,163,14
2022-03-31,Croatia,1441,1258,22,1,183,80,81,161,21
2022-04-01,Croatia,1652,1450,27,0,202,86,89,175,27
2022-04-02,Croatia,1655,1461,17,0,194,90,87,177,17
2022-04-03,Croatia,1731,1518,21,0,213,96,96,192,21
2022-04-04,Croatia,1487,1291,28,0,196,85,83,168,28
2022-04-05,Croatia,1354,1179,24,1,175,75,76,151,23
2022-04-06,Croatia,1465,1282,22,1,183,79,82,161,21
2022-04-07,Croatia,1514,1305,28,1,209,91,90,181,27
2022-04-08,Croatia,1823,1611,37,0,212,88,87,175,37
2022-04-09,Croatia,1969,1710,18,0,259,119,122,241,18
2022-04-10,Croatia,1948,1711,20,0,237,108,109,217,20
2022-04-11,Croatia,1696,1483,28,0,213,92,93,185,28
2022-04-12,Croatia,1564,1377,23,3,187,82,82,164,20
2022-04-13,Croatia,1728,1503,24,0,225,100,101,201,24
2022-04-14,Croatia,1812,1546,35,2,266,112,119,231,33
2022-04-15,Croatia,1968,1734,30,0,234,98,106,204,30
2022-04-16,Croatia,2065,1800,18,0,265,123,124,247,18
2022-04-17,Croatia,2028,1798,20,0,230,110,100,210,20
2022-04-18,Croatia,1868,1616,32,0,252,114,106,220,32
2022-04-19,Croatia,1610,1386,26,0,224,96,102,198,26
2022-04-20,Croatia,1736,1520,19,0,216,100,97,197,19
2022-04-21,Croatia,1858,1601,30,2,257,111,116,227,28
2022-04-22,Croatia,1913,1690,34,2,223,95,94,189,32
2022-04-23,Croatia,2147,1853,23,2,294,141,130,271,21
2022-04-24,Croatia,2193,1911,22,3,282,131,129,260,19
2022-04-25,Croatia,1852,1621,30,0,231,101,100,201,30
2022-04-26,Croatia,1636,1412,25,1,224,98,101,199,24
2022-04-27,Croatia,1742,1509,23,0,233,104,106,210,23
2022-04-28,Croatia,1855,1571,36,0,284,121,127,248,36
2022-04-29,Croatia,2013,1747,37,1,266,110,119,229,36
2022-04-30,Croatia,2306,1974,23,1,332,151,158,309,22
2022-05-01,Croatia,2342,2016,21,0,326,159,146,305,21
2022-05-02,Croatia,2011,1764,27,0,247,109,111,220,27
2022-05-03,Croatia,1917,1665,17,0,252,116,119,235,17
2022-05-04,Croatia,1877,1611,24,0,266,124,118,242,24
2022-05-05,Croatia,1991,1708,25,1,283,128,130,258,24
2022-05-06,Croatia,2179,1921,23,0,258,122,113,235,23
2022-05-07,Croatia,2504,2128,21,1,376,172,183,355,20
2022-05-08,Croatia,2412,2088,20,1,324,156,148,304,19
2022-05-09,Croatia,1975,1735,26,1,240,107,107,214,25
2022-05-10,Croatia,1951,1677,28,1,274,119,127,246,27
2022-05-11,Croatia,2051,1761,27,0,290,127,136,263,27
2022-05-12,Croatia,2024,1723,26,2,301,137,138,275,24
2022-05-13,Croatia,2250,1965,28,0,285,130,127,257,28
2022-05-14,Croatia,2472,2079,20,0,393,183,190,373,20
2022-05-15,Croatia,2494,2151,20,0,343,167,156,323,20
2022-05-16,Croatia,2040,1769,26,0,271,124,121,245,26
2022-05-17,Croatia,2023,1748,19,0,275,128,128,256,19
2022-05-18,Croatia,2039,1747,22,1,292,133,137,270,21
2022-05-19,Croatia,2077,1746,26,0,331,153,152,305,26
2022-05-20,Croatia,2302,2007,30,0,295,128,137,265,30
2022-05-21,Croatia,2762,2291,25,0,471,222,224,446,25
2022-05-22,Croatia,2583,2199,24,0,384,187,173,360,24
2022-05-23,Croatia,2093,1809,29,1,284,123,132,255,28
2022-05-24,Croatia,2151,1854,21,0,297,139,137,276,21
2022-05-25,Croatia,2417,2092,21,0,325,149,155,304,21
2022-05-26,Croatia,2353,1997,20,1,356,159,177,336,19
2022-05-27,Croatia,2484,2176,33,1,308,137,138,275,32
2022-05-28,Croatia,2812,2353,24,0,459,217,218,435,24
2022-05-29,Croatia,2786,2350,22,2,436,220,194,414,20
2022-05-30,Croatia,2330,2059,25,0,271,123,123,246,25
2022-05-31,Croatia,2161,1842,20,0,319,151,148,299,20
2022-06-01,Croatia,2331,1972,22,0,359,166,171,337,22
2022-06-02,Croatia,2450,2063,31,1,387,178,178,356,30
2022-06-03,Croatia,2672,2311,29,2,361,157,175,332,27
2022-06-04,Croatia,3012,2477,30,1,535,249,256,505,29
2022-06-05,Croatia,2761,2309,27,0,452,216,209,425,27
2022-06-06,Croatia,2550,2192,28,1,358,171,159,330,27
2022-06-07,Croatia,2485,2107,26,0,378,175,177,352,26
2022-01-01,Cyprus,772,640,0,0,132,67,65,132,0
2022-01-02,Cyprus,983,807,2,2,176,87,87,174,0
2022-01-03,Cyprus,768,628,7,6,140,65,68,133,1
2022-01-04,Cyprus,737,615,6,6,122,57,59,116,0
2022-01-05,Cyprus,744,592,6,6,152,76,70,146,0
2022-01-06,Cyprus,843,701,4,4,142,67,71,138,0
2022-01-07,Cyprus,743,586,4,4,157,76,77,153,0
2022-01-08,Cyprus,886,717,1,1,169,86,82,168,0
2022-01-09,Cyprus,936,756,4,4,180,86,90,176,0
2022-01-10,Cyprus,651,538,4,4,113,54,55,109,0
2022-01-11,Cyprus,592,502,7,7,90,44,39,83,0
2022-01-12,Cyprus,648,536,7,7,112,53,52,105,0
2022-01-13,Cyprus,714,615,3,3,99,48,48,96,0
2022-01-14,Cyprus,631,510,7,5,121,58,56,114,2
2022-01-15,Cyprus,714,613,1,1,101,50,50,100,0
2022-01-16,Cyprus,793,667,6,4,126,61,59,120,2
2022-01-17,Cyprus,600,498,4,4,102,45,53,98,0
2022-01-18,Cyprus,584,497,9,6,87,41,37,78,3
2022-01-19,Cyprus,595,490,5,5,105,51,49,100,0
2022-01-20,Cyprus,664,566,6,6,98,47,45,92,0
2022-01-21,Cyprus,589,482,6,4,107,49,52,101,2
2022-01-22,Cyprus,702,600,0,0,102,52,50,102,0
2022-01-23,Cyprus,753,639,6,4,114,54,54,108,2
2022-01-24,Cyprus,503,401,8,6,102,45,49,94,2
2022-01-25,Cyprus,448,378,6,6,70,31,33,64,0
2022-01-26,Cyprus,547,442,6,6,105,50,49,99,0
2022-01-27,Cyprus,691,599,4,4,92,43,45,88,0
2022-01-28,Cyprus,593,486,6,3,107,54,47,101,3
2022-01-29,Cyprus,661,574,0,0,87,43,44,87,0
2022-01-30,Cyprus,735,618,5,3,117,56,56,112,2
2022-01-31,Cyprus,588,486,7,6,102,44,51,95,1
2022-02-01,Cyprus,591,497,7,5,94,44,43,87,2
2022-02-02,Cyprus,604,491,7,7,113,55,51,106,0
2022-02-03,Cyprus,663,563,5,5,100,49,46,95,0
2022-02-04,Cyprus,615,497,10,7,118,55,53,108,3
2022-02-05,Cyprus,703,594,2,0,109,52,55,107,2
2022-02-06,Cyprus,773,649,4,2,124,62,58,120,2
2022-02-07,Cyprus,572,483,5,5,89,42,42,84,0
2022-02-08,Cyprus,581,488,7,5,93,42,44,86,2
2022-02-09,Cyprus,626,504,6,6,122,59,57,116,0
2022-02-10,Cyprus,676,559,6,6,117,52,59,111,0
2022-02-11,Cyprus,623,483,8,6,140,66,66,132,2
2022-02-12,Cyprus,723,597,0,0,126,66,60,126,0
2022-02-13,Cyprus,803,656,5,2,147,70,72,142,3
2022-02-14,Cyprus,620,506,7,7,114,53,54,107,0
2022-02-15,Cyprus,616,495,11,9,121,54,56,110,2
2022-02-16,Cyprus,643,506,10,9,137,63,64,127,1
2022-02-17,Cyprus,702,593,6,6,109,51,52,103,0
2022-02-18,Cyprus,678,547,9,7,131,59,63,122,2
2022-02-19,Cyprus,766,633,2,2,133,68,63,131,0
2022-02-20,Cyprus,834,691,5,3,143,68,70,138,2
2022-02-21,Cyprus,632,502,9,8,130,60,61,121,1
2022-02-22,Cyprus,621,514,5,5,107,50,52,102,0
2022-02-23,Cyprus,658,535,2,2,123,60,61,121,0
2022-02-24,Cyprus,684,559,7,7,125,58,60,118,0
2022-02-25,Cyprus,685,556,12,10,129,59,58,117,2
2022-02-26,Cyprus,722,577,5,5,145,69,71,140,0
2022-02-27,Cyprus,790,639,6,4,151,76,69,145,2
2022-02-28,Cyprus,662,529,12,10,133,62,59,121,2
2022-03-01,Cyprus,655,539,7,7,116,51,58,109,0
2022-03-02,Cyprus,747,593,7,7,154,77,70,147,0
2022-03-03,Cyprus,767,652,1,1,115,57,57,114,0
2022-03-04,Cyprus,757,585,11,9,172,78,83,161,2
2022-03-05,Cyprus,773,635,3,3,138,70,65,135,0
2022-03-06,Cyprus,853,705,7,5,148,68,73,141,2
2022-03-07,Cyprus,743,623,5,5,120,58,57,115,0
2022-03-08,Cyprus,666,533,9,7,133,61,63,124,2
2022-03-09,Cyprus,725,562,10,10,163,79,74,153,0
2022-03-10,Cyprus,687,571,4,4,116,54,58,112,0
2022-03-11,Cyprus,680,543,7,5,137,64,66,130,2
2022-03-12,Cyprus,756,613,3,3,143,70,70,140,0
2022-03-13,Cyprus,755,609,6,4,146,74,66,140,2
2022-03-14,Cyprus,731,592,5,4,139,65,69,134,1
2022-03-15,Cyprus,705,595,7,7,110,52,51,103,0
2022-03-16,Cyprus,757,601,6,6,156,75,75,150,0
2022-03-17,Cyprus,776,650,7,6,126,61,58,119,1
2022-03-18,Cyprus,703,568,11,7,135,61,63,124,4
2022-03-19,Cyprus,756,600,6,2,156,76,74,150,4
2022-03-20,Cyprus,813,663,6,4,150,74,70,144,2
2022-03-21,Cyprus,699,588,7,7,111,52,52,104,0
2022-03-22,Cyprus,645,532,7,7,113,54,52,106,0
2022-03-23,Cyprus,721,570,7,7,151,69,75,144,0
2022-03-24,Cyprus,799,665,8,8,134,64,62,126,0
2022-03-25,Cyprus,717,588,7,5,129,60,62,122,2
2022-03-26,Cyprus,750,608,5,5,142,71,66,137,0
2022-03-27,Cyprus,819,654,5,5,165,78,82,160,0
2022-03-28,Cyprus,753,587,7,7,166,79,80,159,0
2022-03-29,Cyprus,737,585,10,10,152,68,74,142,0
2022-03-30,Cyprus,790,592,9,8,198,96,93,189,1
2022-03-31,Cyprus,825,653,8,7,172,84,80,164,1
2022-04-01,Cyprus,758,578,9,7,180,82,89,171,2
2022-04-02,Cyprus,810,644,0,0,166,85,81,166,0
2022-04-03,Cyprus,867,675,4,4,192,90,98,188,0
2022-04-04,Cyprus,766,574,5,5,192,97,90,187,0
2022-04-05,Cyprus,706,568,8,8,138,67,63,130,0
2022-04-06,Cyprus,833,614,8,8,219,104,107,211,0
2022-04-07,Cyprus,853,688,9,9,165,79,77,156,0
2022-04-08,Cyprus,816,618,11,9,198,93,94,187,2
2022-04-09,Cyprus,821,631,5,4,190,90,95,185,1
2022-04-10,Cyprus,938,717,6,6,221,108,107,215,0
2022-04-11,Cyprus,850,637,9,9,213,105,99,204,0
2022-04-12,Cyprus,806,654,8,8,152,72,72,144,0
2022-04-13,Cyprus,919,686,8,8,233,113,112,225,0
2022-04-14,Cyprus,1076,862,10,9,214,97,107,204,1
2022-04-15,Cyprus,940,711,6,5,229,107,116,223,1
2022-04-16,Cyprus,954,722,2,2,232,119,111,230,0
2022-04-17,Cyprus,1005,778,7,5,227,108,112,220,2
2022-04-18,Cyprus,900,671,8,8,229,113,108,221,0
2022-04-19,Cyprus,858,685,10,8,173,77,86,163,2
2022-04-20,Cyprus,966,718,9,9,248,120,119,239,0
2022-04-21,Cyprus,968,750,6,5,218,107,105,212,1
2022-04-22,Cyprus,859,654,7,5,205,101,97,198,2
2022-04-23,Cyprus,1007,765,1,0,242,126,115,241,1
2022-04-24,Cyprus,1043,835,3,1,208,103,102,205,2
2022-04-25,Cyprus,912,688,8,8,224,106,110,216,0
2022-04-26,Cyprus,811,638,10,8,173,82,81,163,2
2022-04-27,Cyprus,891,656,9,9,235,112,114,226,0
2022-04-28,Cyprus,967,766,9,8,201,96,96,192,1
2022-04-29,Cyprus,869,663,8,7,206,100,98,198,1
2022-04-30,Cyprus,953,725,5,5,228,111,112,223,0
2022-05-01,Cyprus,1073,827,8,5,246,120,118,238,3
2022-05-02,Cyprus,963,716,8,7,247,120,119,239,1
2022-05-03,Cyprus,904,733,14,11,171,78,79,157,3
2022-05-04,Cyprus,930,687,9,9,243,117,117,234,0
2022-05-05,Cyprus,1027,812,10,9,215,98,107,205,1
2022-05-06,Cyprus,986,773,7,6,213,106,100,206,1
2022-05-07,Cyprus,1037,802,2,1,235,117,116,233,1
2022-05-08,Cyprus,1045,802,6,3,243,120,117,237,3
2022-05-09,Cyprus,959,726,8,8,233,111,114,225,0
2022-05-10,Cyprus,852,677,11,9,175,82,82,164,2
2022-05-11,Cyprus,893,664,8,8,229,111,110,221,0
2022-05-12,Cyprus,967,741,9,8,226,107,110,217,1
2022-05-13,Cyprus,845,635,9,7,210,97,104,201,2
2022-05-14,Cyprus,860,633,2,1,227,115,110,225,1
2022-05-15,Cyprus,1020,775,5,2,245,123,117,240,3
2022-05-16,Cyprus,922,683,6,6,239,115,118,233,0
2022-05-17,Cyprus,815,642,11,9,173,80,82,162,2
2022-05-18,Cyprus,914,658,6,5,256,125,125,250,1
2022-05-19,Cyprus,944,721,6,3,223,107,110,217,3
2022-05-20,Cyprus,860,631,11,9,229,108,110,218,2
2022-05-21,Cyprus,867,628,2,2,239,121,116,237,0
2022-05-22,Cyprus,997,755,6,3,242,117,119,236,3
2022-05-23,Cyprus,886,638,6,5,248,122,120,242,1
2022-05-24,Cyprus,877,680,9,7,197,94,94,188,2
2022-05-25,Cyprus,968,702,9,8,266,127,130,257,1
2022-05-26,Cyprus,995,746,6,5,249,121,122,243,1
2022-05-27,Cyprus,853,619,10,8,234,112,112,224,2
2022-05-28,Cyprus,900,652,2,2,248,125,121,246,0
2022-05-29,Cyprus,1015,767,5,2,248,121,122,243,3
2022-05-30,Cyprus,966,697,8,8,269,129,132,261,0
2022-05-31,Cyprus,895,690,8,6,205,103,94,197,2
2022-06-01,Cyprus,930,664,5,5,266,130,131,261,0
2022-06-02,Cyprus,1045,796,7,5,249,120,122,242,2
2022-06-03,Cyprus,917,674,7,7,243,116,120,236,0
2022-06-04,Cyprus,932,674,2,2,258,130,126,256,0
2022-06-05,Cyprus,964,705,4,2,259,127,128,255,2
2022-06-06,Cyprus,1012,742,3,3,270,135,132,267,0
2022-06-07,Cyprus,947,729,5,5,218,106,107,213,0
2022-01-01,Czech Republic,1004,838,0,0,166,86,80,166,0
2022-01-02,Czech Republic,1567,1233,3,0,334,162,169,331,3
2022-01-03,Czech Republic,1468,1203,11,5,265,126,128,254,6
2022-01-04,Czech Republic,1135,938,10,5,197,94,93,187,5
2022-01-05,Czech Republic,1140,958,13,5,182,78,91,169,8
2022-01-06,Czech Republic,1173,957,21,6,216,99,96,195,15
2022-01-07,Czech Republic,1372,1099,28,7,273,126,119,245,21
2022-01-08,Czech Republic,1225,1050,10,5,175,85,80,165,5
2022-01-09,Czech Republic,1435,1170,7,0,265,124,134,258,7
2022-01-10,Czech Republic,1164,960,5,1,204,99,100,199,4
2022-01-11,Czech Republic,950,786,21,9,164,67,76,143,12
2022-01-12,Czech Republic,959,767,17,8,192,87,88,175,9
2022-01-13,Czech Republic,954,761,26,11,193,87,80,167,15
2022-01-14,Czech Republic,1145,909,22,8,236,113,101,214,14
2022-01-15,Czech Republic,980,841,8,6,139,66,65,131,2
2022-01-16,Czech Republic,1092,870,8,2,222,95,119,214,6
2022-01-17,Czech Republic,952,772,5,1,180,92,83,175,4
2022-01-18,Czech Republic,826,649,20,6,177,75,82,157,14
2022-01-19,Czech Republic,865,671,27,12,194,84,83,167,15
2022-01-20,Czech Republic,910,726,8,3,184,89,87,176,5
2022-01-21,Czech Republic,1062,836,22,11,226,105,99,204,11
2022-01-22,Czech Republic,986,848,14,5,138,61,63,124,9
2022-01-23,Czech Republic,1012,819,6,1,193,92,95,187,5
2022-01-24,Czech Republic,924,740,7,1,184,87,90,177,6
2022-01-25,Czech Republic,721,582,11,1,139,65,63,128,10
2022-01-26,Czech Republic,830,667,17,6,163,72,74,146,11
2022-01-27,Czech Republic,941,740,21,6,201,91,89,180,15
2022-01-28,Czech Republic,1115,902,17,3,213,102,94,196,14
2022-01-29,Czech Republic,968,838,3,1,130,63,64,127,2
2022-01-30,Czech Republic,1037,846,2,0,191,93,96,189,2
2022-01-31,Czech Republic,986,799,17,8,187,84,86,170,9
2022-02-01,Czech Republic,912,751,15,5,161,73,73,146,10
2022-02-02,Czech Republic,931,743,11,3,188,88,89,177,8
2022-02-03,Czech Republic,993,776,16,5,217,104,97,201,11
2022-02-04,Czech Republic,1170,905,29,15,265,125,111,236,14
2022-02-05,Czech Republic,1040,892,13,7,148,66,69,135,6
2022-02-06,Czech Republic,1128,903,5,1,225,104,116,220,4
2022-02-07,Czech Republic,1068,868,18,9,200,93,89,182,9
2022-02-08,Czech Republic,864,680,33,11,184,77,74,151,22
2022-02-09,Czech Republic,996,757,30,16,239,107,102,209,14
2022-02-10,Czech Republic,1084,839,34,16,245,108,103,211,18
2022-02-11,Czech Republic,1261,998,20,6,263,127,116,243,14
2022-02-12,Czech Republic,1167,981,17,11,186,82,87,169,6
2022-02-13,Czech Republic,1233,962,19,8,271,120,132,252,11
2022-02-14,Czech Republic,1140,904,22,10,236,105,109,214,12
2022-02-15,Czech Republic,1013,804,21,12,209,96,92,188,9
2022-02-16,Czech Republic,1002,780,26,11,222,97,99,196,15
2022-02-17,Czech Republic,1044,860,5,0,184,90,89,179,5
2022-02-18,Czech Republic,1252,961,19,8,291,141,131,272,11
2022-02-19,Czech Republic,1215,1036,5,2,179,88,86,174,3
2022-02-20,Czech Republic,1242,1013,4,2,229,106,119,225,2
2022-02-21,Czech Republic,1118,890,5,1,228,112,111,223,4
2022-02-22,Czech Republic,952,769,14,8,183,83,86,169,6
2022-02-23,Czech Republic,1017,781,29,14,236,103,104,207,15
2022-02-24,Czech Republic,1116,877,35,17,239,104,100,204,18
2022-02-25,Czech Republic,1334,1045,24,11,289,137,128,265,13
2022-02-26,Czech Republic,1179,1009,4,1,170,85,81,166,3
2022-02-27,Czech Republic,1254,998,9,4,256,118,129,247,5
2022-02-28,Czech Republic,1183,902,33,9,281,124,124,248,24
2022-03-01,Czech Republic,1051,833,37,14,218,91,90,181,23
2022-03-02,Czech Republic,1177,927,22,10,250,115,113,228,12
2022-03-03,Czech Republic,1163,895,29,16,268,116,123,239,13
2022-03-04,Czech Republic,1418,1116,14,5,302,149,139,288,9
2022-03-05,Czech Republic,1244,1060,7,4,184,89,88,177,3
2022-03-06,Czech Republic,1289,1034,11,6,255,116,128,244,5
2022-03-07,Czech Republic,1287,1033,20,8,254,118,116,234,12
2022-03-08,Czech Republic,1108,898,28,19,210,90,92,182,9
2022-03-09,Czech Republic,1166,900,32,14,266,116,118,234,18
2022-03-10,Czech Republic,1219,951,27,14,268,125,116,241,13
2022-03-11,Czech Republic,1391,1081,21,16,310,145,144,289,5
2022-03-12,Czech Republic,1184,1009,13,6,175,80,82,162,7
2022-03-13,Czech Republic,1310,1040,8,3,270,127,135,262,5
2022-03-14,Czech Republic,1227,974,23,13,253,114,116,230,10
2022-03-15,Czech Republic,1139,915,27,16,224,99,98,197,11
2022-03-16,Czech Republic,1223,965,35,13,258,117,106,223,22
2022-03-17,Czech Republic,1298,1047,31,16,251,108,112,220,15
2022-03-18,Czech Republic,1499,1198,22,10,301,144,135,279,12
2022-03-19,Czech Republic,1221,1045,6,4,176,83,87,170,2
2022-03-20,Czech Republic,1364,1091,12,6,273,127,134,261,6
2022-03-21,Czech Republic,1332,1081,16,8,251,113,122,235,8
2022-03-22,Czech Republic,1126,904,28,14,222,101,93,194,14
2022-03-23,Czech Republic,1249,975,23,8,274,129,122,251,15
2022-03-24,Czech Republic,1316,1024,29,13,292,135,128,263,16
2022-03-25,Czech Republic,1557,1220,29,20,337,156,152,308,9
2022-03-26,Czech Republic,1255,1085,5,3,170,84,81,165,2
2022-03-27,Czech Republic,1469,1197,9,2,272,127,136,263,7
2022-03-28,Czech Republic,1500,1198,21,12,302,137,144,281,9
2022-03-29,Czech Republic,1389,1123,25,16,266,121,120,241,9
2022-03-30,Czech Republic,1416,1143,15,9,273,131,127,258,6
2022-03-31,Czech Republic,1531,1243,11,2,288,137,140,277,9
2022-04-01,Czech Republic,1661,1321,15,7,340,166,159,325,8
2022-04-02,Czech Republic,1452,1265,3,3,187,93,91,184,0
2022-04-03,Czech Republic,1555,1278,9,8,277,125,143,268,1
2022-04-04,Czech Republic,1580,1246,24,13,334,158,152,310,11
2022-04-05,Czech Republic,1380,1138,5,3,242,122,115,237,2
2022-04-06,Czech Republic,1542,1254,26,11,288,129,133,262,15
2022-04-07,Czech Republic,1623,1319,14,10,304,146,144,290,4
2022-04-08,Czech Republic,1782,1420,14,4,362,177,171,348,10
2022-04-09,Czech Republic,1618,1418,1,0,200,104,95,199,1
2022-04-10,Czech Republic,1726,1445,8,5,281,129,144,273,3
2022-04-11,Czech Republic,1725,1398,21,13,327,154,152,306,8
2022-04-12,Czech Republic,1559,1279,25,12,280,129,126,255,13
2022-04-13,Czech Republic,1717,1367,25,11,350,165,160,325,14
2022-04-14,Czech Republic,1841,1464,25,12,377,181,171,352,13
2022-04-15,Czech Republic,1755,1411,16,10,344,172,156,328,6
2022-04-16,Czech Republic,1499,1291,9,4,208,94,105,199,5
2022-04-17,Czech Republic,1624,1344,9,5,280,132,139,271,4
2022-04-18,Czech Republic,1693,1335,9,2,358,169,180,349,7
2022-04-19,Czech Republic,1623,1353,13,8,270,131,126,257,5
2022-04-20,Czech Republic,1704,1400,17,9,304,140,147,287,8
2022-04-21,Czech Republic,1744,1427,20,12,317,150,147,297,8
2022-04-22,Czech Republic,1857,1501,23,20,356,169,164,333,3
2022-04-23,Czech Republic,1638,1431,10,5,207,100,97,197,5
2022-04-24,Czech Republic,1731,1438,6,2,293,132,155,287,4
2022-04-25,Czech Republic,1718,1412,10,5,306,152,144,296,5
2022-04-26,Czech Republic,1588,1311,25,15,277,132,120,252,10
2022-04-27,Czech Republic,1654,1347,9,5,307,149,149,298,4
2022-04-28,Czech Republic,1813,1464,29,13,349,159,161,320,16
2022-04-29,Czech Republic,1972,1564,21,4,408,195,192,387,17
2022-04-30,Czech Republic,1649,1397,7,4,252,122,123,245,3
2022-05-01,Czech Republic,1879,1572,12,5,307,139,156,295,7
2022-05-02,Czech Republic,1743,1414,10,5,329,162,157,319,5
2022-05-03,Czech Republic,1634,1363,16,7,271,128,127,255,9
2022-05-04,Czech Republic,1777,1475,19,11,302,143,140,283,8
2022-05-05,Czech Republic,1822,1490,20,10,332,159,153,312,10
2022-05-06,Czech Republic,1901,1531,28,11,370,175,167,342,17
2022-05-07,Czech Republic,1694,1460,8,5,234,109,117,226,3
2022-05-08,Czech Republic,1910,1581,13,6,329,152,164,316,7
2022-05-09,Czech Republic,1830,1467,27,13,363,168,168,336,14
2022-05-10,Czech Republic,1585,1286,17,9,299,149,133,282,8
2022-05-11,Czech Republic,1674,1338,21,14,336,157,158,315,7
2022-05-12,Czech Republic,1752,1408,25,13,344,154,165,319,12
2022-05-13,Czech Republic,1857,1475,22,12,382,187,173,360,10
2022-05-14,Czech Republic,1763,1510,8,1,253,124,121,245,7
2022-05-15,Czech Republic,1918,1573,15,6,345,154,176,330,9
2022-05-16,Czech Republic,1803,1460,18,12,343,164,161,325,6
2022-05-17,Czech Republic,1610,1293,19,8,317,152,146,298,11
2022-05-18,Czech Republic,1758,1391,33,10,367,173,161,334,23
2022-05-19,Czech Republic,1828,1453,32,12,375,174,169,343,20
2022-05-20,Czech Republic,1941,1555,21,14,386,184,181,365,7
2022-05-21,Czech Republic,1770,1499,7,2,271,134,130,264,5
2022-05-22,Czech Republic,1905,1563,10,3,342,154,178,332,7
2022-05-23,Czech Republic,1913,1589,8,6,324,161,155,316,2
2022-05-24,Czech Republic,1744,1454,22,7,290,130,138,268,15
2022-05-25,Czech Republic,1844,1480,23,2,364,173,168,341,21
2022-05-26,Czech Republic,1842,1495,16,7,347,168,163,331,9
2022-05-27,Czech Republic,1860,1485,20,7,375,185,170,355,13
2022-05-28,Czech Republic,1848,1569,8,2,279,134,137,271,6
2022-05-29,Czech Republic,2065,1709,7,5,356,171,178,349,2
2022-05-30,Czech Republic,1973,1601,23,11,372,172,177,349,12
2022-05-31,Czech Republic,1878,1531,34,14,347,152,161,313,20
2022-06-01,Czech Republic,1872,1495,17,5,377,186,174,360,12
2022-06-02,Czech Republic,2002,1603,23,10,399,192,184,376,13
2022-06-03,Czech Republic,2141,1719,21,15,422,204,197,401,6
2022-06-04,Czech Republic,1965,1665,8,5,300,148,144,292,3
2022-06-05,Czech Republic,2159,1785,13,4,374,166,195,361,9
2022-06-06,Czech Republic,1972,1571,20,2,401,193,188,381,18
2022-06-07,Czech Republic,1920,1567,9,4,353,173,171,344,5
2022-01-01,Denmark,863,519,20,0,344,159,165,324,20
2022-01-02,Denmark,1363,735,78,1,628,281,269,550,77
2022-01-03,Denmark,1329,643,109,14,686,289,288,577,95
2022-01-04,Denmark,1171,617,79,9,554,237,238,475,70
2022-01-05,Denmark,1166,597,71,4,569,250,248,498,67
2022-01-06,Denmark,1165,610,97,18,555,230,228,458,79
2022-01-07,Denmark,1301,687,83,5,614,262,269,531,78
2022-01-08,Denmark,1089,660,39,3,429,191,199,390,36
2022-01-09,Denmark,1225,704,55,0,521,232,234,466,55
2022-01-10,Denmark,1082,563,81,11,519,226,212,438,70
2022-01-11,Denmark,953,497,75,6,456,189,192,381,69
2022-01-12,Denmark,974,521,92,9,453,182,179,361,83
2022-01-13,Denmark,997,514,116,18,483,183,184,367,98
2022-01-14,Denmark,1089,557,94,12,532,220,218,438,82
2022-01-15,Denmark,944,563,40,6,381,168,173,341,34
2022-01-16,Denmark,1063,588,68,2,475,197,210,407,66
2022-01-17,Denmark,1029,534,92,17,495,206,197,403,75
2022-01-18,Denmark,903,487,97,11,416,163,156,319,86
2022-01-19,Denmark,950,495,105,11,455,174,176,350,94
2022-01-20,Denmark,970,517,86,8,453,186,181,367,78
2022-01-21,Denmark,1113,569,98,14,544,219,227,446,84
2022-01-22,Denmark,919,523,61,10,396,169,166,335,51
2022-01-23,Denmark,1041,564,71,6,477,198,208,406,65
2022-01-24,Denmark,1016,542,108,17,474,187,179,366,91
2022-01-25,Denmark,851,420,106,23,431,157,168,325,83
2022-01-26,Denmark,934,468,106,14,466,183,177,360,92
2022-01-27,Denmark,989,531,102,8,458,181,175,356,94
2022-01-28,Denmark,1075,545,102,23,530,213,215,428,79
2022-01-29,Denmark,903,544,32,3,359,162,165,327,29
2022-01-30,Denmark,1013,546,58,3,467,202,207,409,55
2022-01-31,Denmark,966,481,87,18,485,205,193,398,69
2022-02-01,Denmark,899,455,89,4,444,178,177,355,85
2022-02-02,Denmark,1013,522,102,20,491,194,195,389,82
2022-02-03,Denmark,994,502,87,8,492,204,201,405,79
2022-02-04,Denmark,1129,532,95,13,597,246,256,502,82
2022-02-05,Denmark,993,562,52,11,431,187,192,379,41
2022-02-06,Denmark,1095,585,59,4,510,224,227,451,55
2022-02-07,Denmark,1018,478,100,19,540,227,213,440,81
2022-02-08,Denmark,904,438,102,19,466,181,183,364,83
2022-02-09,Denmark,1010,487,100,14,523,207,216,423,86
2022-02-10,Denmark,1044,498,103,16,546,220,223,443,87
2022-02-11,Denmark,1193,549,90,14,644,283,271,554,76
2022-02-12,Denmark,1098,599,44,9,499,224,231,455,35
2022-02-13,Denmark,1122,593,58,3,529,238,233,471,55
2022-02-14,Denmark,1083,545,94,14,538,224,220,444,80
2022-02-15,Denmark,948,480,92,16,468,191,185,376,76
2022-02-16,Denmark,1025,509,98,15,516,207,211,418,83
2022-02-17,Denmark,1045,519,93,6,526,218,215,433,87
2022-02-18,Denmark,1186,551,88,14,635,268,279,547,74
2022-02-19,Denmark,1189,687,35,1,502,232,235,467,34
2022-02-20,Denmark,1206,643,68,2,563,247,248,495,66
2022-02-21,Denmark,1089,525,92,9,564,237,235,472,83
2022-02-22,Denmark,994,473,94,22,521,213,214,427,72
2022-02-23,Denmark,1097,543,112,27,554,222,220,442,85
2022-02-24,Denmark,1095,534,99,21,561,232,230,462,78
2022-02-25,Denmark,1224,588,95,15,636,270,271,541,80
2022-02-26,Denmark,1119,617,43,7,502,226,233,459,36
2022-02-27,Denmark,1216,626,77,9,590,257,256,513,68
2022-02-28,Denmark,1178,565,115,25,613,250,248,498,90
2022-03-01,Denmark,1022,477,109,18,545,216,220,436,91
2022-03-02,Denmark,1125,535,115,20,590,234,241,475,95
2022-03-03,Denmark,1143,528,130,27,615,245,240,485,103
2022-03-04,Denmark,1223,553,106,23,670,283,281,564,83
2022-03-05,Denmark,1064,566,44,4,498,227,227,454,40
2022-03-06,Denmark,1152,586,68,7,566,248,250,498,61
2022-03-07,Denmark,1158,513,123,18,645,262,260,522,105
2022-03-08,Denmark,1006,456,105,23,550,225,220,445,82
2022-03-09,Denmark,1113,531,105,19,582,235,242,477,86
2022-03-10,Denmark,1096,489,104,10,607,254,249,503,94
2022-03-11,Denmark,1258,582,96,19,676,288,292,580,77
2022-03-12,Denmark,1085,592,43,5,493,223,227,450,38
2022-03-13,Denmark,1211,630,69,9,581,254,258,512,60
2022-03-14,Denmark,1237,570,114,17,667,280,273,553,97
2022-03-15,Denmark,1042,458,119,16,584,234,231,465,103
2022-03-16,Denmark,1125,531,116,20,594,237,241,478,96
2022-03-17,Denmark,1135,500,117,12,635,257,261,518,105
2022-03-18,Denmark,1272,560,104,18,712,303,305,608,86
2022-03-19,Denmark,1063,552,53,9,511,229,229,458,44
2022-03-20,Denmark,1160,571,70,5,589,258,261,519,65
2022-03-21,Denmark,1228,540,126,27,688,285,277,562,99
2022-03-22,Denmark,1013,457,94,14,556,234,228,462,80
2022-03-23,Denmark,1133,537,105,20,596,246,245,491,85
2022-03-24,Denmark,1099,466,112,16,633,260,261,521,96
2022-03-25,Denmark,1300,584,112,22,716,298,306,604,90
2022-03-26,Denmark,1035,518,48,11,517,232,237,469,37
2022-03-27,Denmark,1303,599,85,5,704,307,312,619,80
2022-03-28,Denmark,1375,593,131,30,782,332,319,651,101
2022-03-29,Denmark,1268,542,118,19,726,304,304,608,99
2022-03-30,Denmark,1317,613,90,10,704,309,305,614,80
2022-03-31,Denmark,1391,603,119,22,788,332,337,669,97
2022-04-01,Denmark,1430,620,117,20,810,345,348,693,97
2022-04-02,Denmark,1084,541,44,6,543,244,255,499,38
2022-04-03,Denmark,1329,614,77,5,715,321,317,638,72
2022-04-04,Denmark,1355,593,109,5,762,329,324,653,104
2022-04-05,Denmark,1279,544,116,15,735,312,307,619,101
2022-04-06,Denmark,1397,628,113,6,769,323,333,656,107
2022-04-07,Denmark,1491,648,135,15,843,359,349,708,120
2022-04-08,Denmark,1546,672,120,14,874,378,376,754,106
2022-04-09,Denmark,1239,602,68,3,637,284,285,569,65
2022-04-10,Denmark,1357,612,72,0,745,337,336,673,72
2022-04-11,Denmark,1425,623,109,14,802,347,346,693,95
2022-04-12,Denmark,1341,566,108,25,775,336,331,667,83
2022-04-13,Denmark,1395,640,108,23,755,325,322,647,85
2022-04-14,Denmark,1329,599,86,15,730,320,324,644,71
2022-04-15,Denmark,1281,617,74,11,664,293,297,590,63
2022-04-16,Denmark,1168,563,66,14,605,269,270,539,52
2022-04-17,Denmark,1330,620,67,5,710,322,321,643,62
2022-04-18,Denmark,1488,688,93,8,800,350,357,707,85
2022-04-19,Denmark,1452,653,115,18,799,341,343,684,97
2022-04-20,Denmark,1471,676,113,25,795,343,339,682,88
2022-04-21,Denmark,1465,642,108,19,823,359,356,715,89
2022-04-22,Denmark,1523,650,125,20,873,376,372,748,105
2022-04-23,Denmark,1139,537,51,10,602,270,281,551,41
2022-04-24,Denmark,1401,642,80,10,759,339,340,679,70
2022-04-25,Denmark,1480,628,129,28,852,362,361,723,101
2022-04-26,Denmark,1398,596,124,21,802,341,337,678,103
2022-04-27,Denmark,1436,640,129,23,796,334,333,667,106
2022-04-28,Denmark,1510,662,129,24,848,362,357,719,105
2022-04-29,Denmark,1531,692,125,11,839,361,353,714,114
2022-04-30,Denmark,1127,540,43,3,587,265,279,544,40
2022-05-01,Denmark,1398,633,82,2,765,337,346,683,80
2022-05-02,Denmark,1484,634,124,15,850,368,358,726,109
2022-05-03,Denmark,1440,597,127,14,843,355,361,716,113
2022-05-04,Denmark,1484,668,124,21,816,349,343,692,103
2022-05-05,Denmark,1558,666,131,14,892,383,378,761,117
2022-05-06,Denmark,1607,685,143,14,922,384,395,779,129
2022-05-07,Denmark,1231,556,60,10,675,304,311,615,50
2022-05-08,Denmark,1413,603,81,9,810,362,367,729,72
2022-05-09,Denmark,1546,686,124,18,860,376,360,736,106
2022-05-10,Denmark,1429,613,125,22,816,345,346,691,103
2022-05-11,Denmark,1503,668,135,16,835,352,348,700,119
2022-05-12,Denmark,1595,677,143,22,918,386,389,775,121
2022-05-13,Denmark,1561,688,103,4,873,382,388,770,99
2022-05-14,Denmark,1257,587,55,8,670,305,310,615,47
2022-05-15,Denmark,1495,671,90,10,824,365,369,734,80
2022-05-16,Denmark,1527,633,124,20,894,385,385,770,104
2022-05-17,Denmark,1411,598,127,20,813,343,343,686,107
2022-05-18,Denmark,1542,667,139,25,875,370,366,736,114
2022-05-19,Denmark,1581,658,146,11,923,391,386,777,135
2022-05-20,Denmark,1608,673,135,14,935,397,403,800,121
2022-05-21,Denmark,1329,623,56,5,706,321,329,650,51
2022-05-22,Denmark,1508,663,83,4,845,378,384,762,79
2022-05-23,Denmark,1567,649,129,15,918,400,389,789,114
2022-05-24,Denmark,1490,657,122,14,833,354,357,711,108
2022-05-25,Denmark,1669,773,124,13,896,386,386,772,111
2022-05-26,Denmark,1488,696,92,4,792,353,347,700,88
2022-05-27,Denmark,1473,693,93,2,780,343,344,687,91
2022-05-28,Denmark,1267,608,54,2,659,303,302,605,52
2022-05-29,Denmark,1580,720,88,4,860,385,387,772,84
2022-05-30,Denmark,1643,723,123,11,920,404,393,797,112
2022-05-31,Denmark,1513,660,132,11,853,356,365,721,121
2022-06-01,Denmark,1589,688,126,14,901,387,388,775,112
2022-06-02,Denmark,1597,670,157,17,927,387,383,770,140
2022-06-03,Denmark,1665,701,141,9,964,409,414,823,132
2022-06-04,Denmark,1277,588,58,4,689,315,316,631,54
2022-06-05,Denmark,1453,639,79,6,814,367,368,735,73
2022-06-06,Denmark,1584,719,113,8,865,379,373,752,105
2022-06-07,Denmark,1577,703,130,19,874,369,375,744,111
2022-01-01,Estonia,363,299,0,0,64,32,32,64,0
2022-01-02,Estonia,427,346,8,1,81,37,36,73,7
2022-01-03,Estonia,392,315,6,0,77,34,37,71,6
2022-01-04,Estonia,367,271,9,3,96,45,42,87,6
2022-01-05,Estonia,401,311,9,1,90,41,40,81,8
2022-01-06,Estonia,368,280,12,4,88,39,37,76,8
2022-01-07,Estonia,443,348,9,1,95,42,44,86,8
2022-01-08,Estonia,386,315,4,0,71,33,34,67,4
2022-01-09,Estonia,447,354,5,1,93,43,45,88,4
2022-01-10,Estonia,402,310,10,2,92,39,43,82,8
2022-01-11,Estonia,369,287,11,4,82,34,37,71,7
2022-01-12,Estonia,403,309,16,5,94,42,36,78,11
2022-01-13,Estonia,399,295,15,3,104,44,45,89,12
2022-01-14,Estonia,406,310,10,2,96,42,44,86,8
2022-01-15,Estonia,387,310,8,2,77,36,33,69,6
2022-01-16,Estonia,381,299,4,0,82,39,39,78,4
2022-01-17,Estonia,322,253,8,0,69,31,30,61,8
2022-01-18,Estonia,350,265,11,3,85,39,35,74,8
2022-01-19,Estonia,378,298,11,3,80,35,34,69,8
2022-01-20,Estonia,339,261,9,3,78,32,37,69,6
2022-01-21,Estonia,377,295,8,0,82,37,37,74,8
2022-01-22,Estonia,380,310,6,2,70,34,30,64,4
2022-01-23,Estonia,386,306,8,4,80,36,36,72,4
2022-01-24,Estonia,359,279,10,2,80,33,37,70,8
2022-01-25,Estonia,340,260,13,5,80,33,34,67,8
2022-01-26,Estonia,377,297,13,7,80,33,34,67,6
2022-01-27,Estonia,352,272,8,0,80,35,37,72,8
2022-01-28,Estonia,375,285,9,1,90,40,41,81,8
2022-01-29,Estonia,387,331,8,4,56,25,23,48,4
2022-01-30,Estonia,358,279,2,0,79,39,38,77,2
2022-01-31,Estonia,354,274,8,0,80,35,37,72,8
2022-02-01,Estonia,293,222,12,3,71,29,30,59,9
2022-02-02,Estonia,375,291,13,5,84,36,35,71,8
2022-02-03,Estonia,328,240,13,5,88,38,37,75,8
2022-02-04,Estonia,358,269,10,1,89,40,39,79,9
2022-02-05,Estonia,323,253,6,2,70,31,33,64,4
2022-02-06,Estonia,337,264,6,2,73,32,35,67,4
2022-02-07,Estonia,292,221,7,1,71,34,30,64,6
2022-02-08,Estonia,317,239,11,3,78,35,32,67,8
2022-02-09,Estonia,345,277,13,5,68,28,27,55,8
2022-02-10,Estonia,347,256,13,5,91,38,40,78,8
2022-02-11,Estonia,372,278,11,3,94,41,42,83,8
2022-02-12,Estonia,361,291,7,2,70,33,30,63,5
2022-02-13,Estonia,353,279,5,1,74,36,33,69,4
2022-02-14,Estonia,320,243,9,1,77,32,36,68,8
2022-02-15,Estonia,321,241,13,5,80,35,32,67,8
2022-02-16,Estonia,371,291,10,2,80,33,37,70,8
2022-02-17,Estonia,325,239,8,0,86,37,41,78,8
2022-02-18,Estonia,410,306,10,2,104,47,47,94,8
2022-02-19,Estonia,363,294,4,0,69,33,32,65,4
2022-02-20,Estonia,372,296,6,2,76,36,34,70,4
2022-02-21,Estonia,328,248,9,1,80,34,37,71,8
2022-02-22,Estonia,326,244,10,2,82,36,36,72,8
2022-02-23,Estonia,351,268,11,3,83,37,35,72,8
2022-02-24,Estonia,356,272,9,1,84,39,36,75,8
2022-02-25,Estonia,385,292,9,1,93,41,43,84,8
2022-02-26,Estonia,373,303,6,1,70,31,33,64,5
2022-02-27,Estonia,302,222,4,0,80,37,39,76,4
2022-02-28,Estonia,306,218,16,6,88,36,36,72,10
2022-03-01,Estonia,325,229,16,6,96,39,41,80,10
2022-03-02,Estonia,354,258,14,5,96,40,42,82,9
2022-03-03,Estonia,337,234,17,8,103,44,42,86,9
2022-03-04,Estonia,389,279,17,9,110,47,46,93,8
2022-03-05,Estonia,356,282,7,3,74,34,33,67,4
2022-03-06,Estonia,375,283,5,1,92,43,44,87,4
2022-03-07,Estonia,364,267,12,4,97,44,41,85,8
2022-03-08,Estonia,347,261,9,1,86,39,38,77,8
2022-03-09,Estonia,357,264,14,6,93,41,38,79,8
2022-03-10,Estonia,359,260,13,5,99,42,44,86,8
2022-03-11,Estonia,360,263,11,3,97,43,43,86,8
2022-03-12,Estonia,337,273,6,2,64,30,28,58,4
2022-03-13,Estonia,357,270,9,4,87,41,37,78,5
2022-03-14,Estonia,338,247,13,5,91,38,40,78,8
2022-03-15,Estonia,310,226,15,7,84,34,35,69,8
2022-03-16,Estonia,316,229,12,4,87,39,36,75,8
2022-03-17,Estonia,321,225,15,7,96,41,40,81,8
2022-03-18,Estonia,344,242,13,5,102,46,43,89,8
2022-03-19,Estonia,309,250,7,5,59,26,26,52,2
2022-03-20,Estonia,341,264,4,0,77,37,36,73,4
2022-03-21,Estonia,312,226,13,5,86,37,36,73,8
2022-03-22,Estonia,296,217,10,4,79,34,35,69,6
2022-03-23,Estonia,317,223,14,6,94,39,41,80,8
2022-03-24,Estonia,328,225,19,11,103,42,42,84,8
2022-03-25,Estonia,345,243,13,5,102,43,46,89,8
2022-03-26,Estonia,306,243,4,0,63,31,28,59,4
2022-03-27,Estonia,333,234,5,1,99,50,44,94,4
2022-03-28,Estonia,332,240,11,3,92,41,40,81,8
2022-03-29,Estonia,296,206,13,5,90,37,40,77,8
2022-03-30,Estonia,323,209,12,3,114,50,52,102,9
2022-03-31,Estonia,314,206,14,3,108,45,49,94,11
2022-04-01,Estonia,367,251,16,5,116,50,50,100,11
2022-04-02,Estonia,291,216,8,4,75,34,33,67,4
2022-04-03,Estonia,341,250,7,2,91,42,42,84,5
2022-04-04,Estonia,334,244,12,3,90,40,38,78,9
2022-04-05,Estonia,283,196,10,2,87,40,37,77,8
2022-04-06,Estonia,338,234,11,3,104,46,47,93,8
2022-04-07,Estonia,312,214,12,4,98,42,44,86,8
2022-04-08,Estonia,366,245,16,6,121,50,55,105,10
2022-04-09,Estonia,313,231,7,3,82,39,36,75,4
2022-04-10,Estonia,322,231,5,1,91,44,42,86,4
2022-04-11,Estonia,366,249,17,9,117,48,52,100,8
2022-04-12,Estonia,314,211,11,5,103,45,47,92,6
2022-04-13,Estonia,356,249,11,3,107,48,48,96,8
2022-04-14,Estonia,358,243,12,3,115,52,51,103,9
2022-04-15,Estonia,379,271,13,5,108,47,48,95,8
2022-04-16,Estonia,334,247,8,4,87,41,38,79,4
2022-04-17,Estonia,335,249,6,2,86,39,41,80,4
2022-04-18,Estonia,367,263,11,3,104,48,45,93,8
2022-04-19,Estonia,333,225,14,6,108,47,47,94,8
2022-04-20,Estonia,342,234,15,7,108,47,46,93,8
2022-04-21,Estonia,335,224,11,3,111,51,49,100,8
2022-04-22,Estonia,396,281,14,5,115,49,52,101,9
2022-04-23,Estonia,350,258,9,5,92,42,41,83,4
2022-04-24,Estonia,377,270,9,4,107,49,49,98,5
2022-04-25,Estonia,349,241,12,4,108,48,48,96,8
2022-04-26,Estonia,341,229,12,4,112,49,51,100,8
2022-04-27,Estonia,346,234,11,3,112,50,51,101,8
2022-04-28,Estonia,358,251,11,3,107,46,50,96,8
2022-04-29,Estonia,429,299,13,4,130,60,57,117,9
2022-04-30,Estonia,363,277,11,7,86,39,36,75,4
2022-05-01,Estonia,417,314,7,3,103,45,51,96,4
2022-05-02,Estonia,416,300,13,5,116,51,52,103,8
2022-05-03,Estonia,384,266,15,4,118,53,50,103,11
2022-05-04,Estonia,396,279,17,6,117,51,49,100,11
2022-05-05,Estonia,419,290,14,6,129,57,58,115,8
2022-05-06,Estonia,452,320,15,7,132,60,57,117,8
2022-05-07,Estonia,401,312,7,3,89,43,39,82,4
2022-05-08,Estonia,417,309,7,3,108,48,53,101,4
2022-05-09,Estonia,424,301,19,11,123,53,51,104,8
2022-05-10,Estonia,419,305,12,4,114,51,51,102,8
2022-05-11,Estonia,427,314,16,8,113,49,48,97,8
2022-05-12,Estonia,399,281,16,8,118,50,52,102,8
2022-05-13,Estonia,440,306,16,7,134,61,57,118,9
2022-05-14,Estonia,384,294,9,5,90,40,41,81,4
2022-05-15,Estonia,442,329,6,1,113,52,55,107,5
2022-05-16,Estonia,413,286,16,8,127,51,60,111,8
2022-05-17,Estonia,379,259,17,9,120,52,51,103,8
2022-05-18,Estonia,422,303,15,7,119,53,51,104,8
2022-05-19,Estonia,413,284,18,10,129,55,56,111,8
2022-05-20,Estonia,420,295,18,9,125,56,51,107,9
2022-05-21,Estonia,408,314,7,3,94,45,42,87,4
2022-05-22,Estonia,408,309,9,4,99,44,46,90,5
2022-05-23,Estonia,416,294,15,7,122,51,56,107,8
2022-05-24,Estonia,395,263,15,8,132,59,58,117,7
2022-05-25,Estonia,443,308,19,11,135,58,58,116,8
2022-05-26,Estonia,414,282,22,14,132,56,54,110,8
2022-05-27,Estonia,441,312,17,9,129,58,54,112,8
2022-05-28,Estonia,393,305,5,1,88,42,41,83,4
2022-05-29,Estonia,442,330,11,7,112,51,50,101,4
2022-05-30,Estonia,424,297,17,8,127,55,55,110,9
2022-05-31,Estonia,408,284,18,10,124,53,53,106,8
2022-06-01,Estonia,416,294,14,6,122,56,52,108,8
2022-06-02,Estonia,429,309,11,1,120,53,56,109,10
2022-06-03,Estonia,470,349,16,8,121,53,52,105,8
2022-06-04,Estonia,423,334,11,7,89,40,38,78,4
2022-06-05,Estonia,472,355,12,8,117,50,55,105,4
2022-06-06,Estonia,449,328,17,9,121,54,50,104,8
2022-06-07,Estonia,438,314,18,9,124,52,54,106,9
2022-01-01,Finland,398,75,59,5,323,132,132,264,54
2022-01-02,Finland,593,123,92,0,470,186,192,378,92
2022-01-03,Finland,492,126,78,0,366,149,139,288,78
2022-01-04,Finland,482,114,85,1,368,143,140,283,84
2022-01-05,Finland,506,132,87,1,374,143,144,287,86
2022-01-06,Finland,452,110,69,0,342,133,140,273,69
2022-01-07,Finland,503,124,90,0,379,146,143,289,90
2022-01-08,Finland,465,90,65,0,375,153,157,310,65
2022-01-09,Finland,545,138,79,1,407,162,166,328,78
2022-01-10,Finland,534,135,117,1,399,145,137,282,116
2022-01-11,Finland,507,136,107,0,371,133,131,264,107
2022-01-12,Finland,483,103,108,0,380,137,135,272,108
2022-01-13,Finland,499,131,110,1,368,125,133,258,109
2022-01-14,Finland,501,127,117,1,374,130,127,257,116
2022-01-15,Finland,419,84,53,2,335,142,140,282,51
2022-01-16,Finland,481,122,80,1,359,134,145,279,79
2022-01-17,Finland,464,126,101,3,338,121,116,237,98
2022-01-18,Finland,493,121,106,0,372,132,134,266,106
2022-01-19,Finland,490,114,117,1,376,133,126,259,116
2022-01-20,Finland,468,113,105,3,355,127,123,250,102
2022-01-21,Finland,501,133,111,0,368,127,130,257,111
2022-01-22,Finland,407,80,55,0,327,135,137,272,55
2022-01-23,Finland,455,117,75,1,338,130,133,263,74
2022-01-24,Finland,462,112,117,0,350,117,116,233,117
2022-01-25,Finland,454,103,102,2,351,125,124,249,100
2022-01-26,Finland,477,128,94,0,349,129,126,255,94
2022-01-27,Finland,458,107,97,0,351,127,127,254,97
2022-01-28,Finland,491,123,110,0,368,131,127,258,110
2022-01-29,Finland,432,84,58,1,348,142,148,290,57
2022-01-30,Finland,453,102,79,0,351,137,135,272,79
2022-01-31,Finland,471,121,102,2,350,123,125,248,100
2022-02-01,Finland,453,103,117,1,350,118,115,233,116
2022-02-02,Finland,486,131,106,0,355,126,123,249,106
2022-02-03,Finland,479,115,111,0,364,127,126,253,111
2022-02-04,Finland,469,126,99,0,343,122,122,244,99
2022-02-05,Finland,412,77,64,1,335,133,138,271,63
2022-02-06,Finland,454,106,76,0,348,137,135,272,76
2022-02-07,Finland,452,107,108,0,345,118,119,237,108
2022-02-08,Finland,440,108,94,1,332,115,123,238,93
2022-02-09,Finland,461,111,100,0,350,127,123,250,100
2022-02-10,Finland,497,111,110,1,386,139,137,276,109
2022-02-11,Finland,506,121,114,1,385,138,133,271,113
2022-02-12,Finland,439,84,69,0,355,140,146,286,69
2022-02-13,Finland,479,121,77,0,358,139,142,281,77
2022-02-14,Finland,449,112,107,0,337,117,113,230,107
2022-02-15,Finland,443,102,93,1,341,121,127,248,92
2022-02-16,Finland,484,118,92,1,366,141,133,274,91
2022-02-17,Finland,455,113,94,1,342,125,123,248,93
2022-02-18,Finland,520,123,112,0,397,140,145,285,112
2022-02-19,Finland,442,74,72,0,368,148,148,296,72
2022-02-20,Finland,493,116,81,2,377,146,150,296,79
2022-02-21,Finland,453,105,106,0,348,123,119,242,106
2022-02-22,Finland,477,107,96,1,370,141,133,274,95
2022-02-23,Finland,486,118,103,3,368,129,136,265,100
2022-02-24,Finland,462,100,100,0,362,131,131,262,100
2022-02-25,Finland,490,117,98,0,373,137,138,275,98
2022-02-26,Finland,472,102,70,0,370,147,153,300,70
2022-02-27,Finland,605,237,81,0,368,139,148,287,81
2022-02-28,Finland,474,141,108,0,333,114,111,225,108
2022-03-01,Finland,500,127,112,3,373,132,129,261,109
2022-03-02,Finland,516,123,115,4,393,139,139,278,111
2022-03-03,Finland,473,110,112,4,363,125,126,251,108
2022-03-04,Finland,550,141,135,0,409,137,137,274,135
2022-03-05,Finland,447,92,62,0,355,149,144,293,62
2022-03-06,Finland,497,131,87,0,366,140,139,279,87
2022-03-07,Finland,474,129,99,0,345,124,122,246,99
2022-03-08,Finland,483,121,107,0,362,129,126,255,107
2022-03-09,Finland,497,130,113,0,367,125,129,254,113
2022-03-10,Finland,534,124,131,1,410,144,135,279,130
2022-03-11,Finland,516,136,111,1,380,129,140,269,110
2022-03-12,Finland,426,86,67,0,340,136,137,273,67
2022-03-13,Finland,506,143,87,0,363,139,137,276,87
2022-03-14,Finland,489,120,113,1,369,134,122,256,112
2022-03-15,Finland,443,79,107,0,364,127,130,257,107
2022-03-16,Finland,498,119,127,5,379,127,125,252,122
2022-03-17,Finland,500,126,123,2,374,121,130,251,121
2022-03-18,Finland,514,135,115,0,379,132,132,264,115
2022-03-19,Finland,428,71,74,1,357,141,142,283,73
2022-03-20,Finland,491,135,83,0,356,137,136,273,83
2022-03-21,Finland,472,107,109,1,365,132,124,256,108
2022-03-22,Finland,464,87,118,1,377,125,134,259,117
2022-03-23,Finland,453,110,106,2,343,120,117,237,104
2022-03-24,Finland,482,120,128,0,362,121,113,234,128
2022-03-25,Finland,497,115,111,0,382,131,140,271,111
2022-03-26,Finland,423,83,69,0,340,133,138,271,69
2022-03-27,Finland,498,122,90,0,376,145,141,286,90
2022-03-28,Finland,542,121,108,1,421,157,156,313,107
2022-03-29,Finland,507,93,106,1,414,153,155,308,105
2022-03-30,Finland,548,114,107,1,434,165,162,327,106
2022-03-31,Finland,529,112,114,1,417,150,153,303,113
2022-04-01,Finland,575,143,120,1,432,156,156,312,119
2022-04-02,Finland,393,72,48,0,321,135,138,273,48
2022-04-03,Finland,479,119,71,0,360,141,148,289,71
2022-04-04,Finland,556,126,108,0,430,160,162,322,108
2022-04-05,Finland,479,96,106,2,383,141,136,277,104
2022-04-06,Finland,566,133,118,0,433,158,157,315,118
2022-04-07,Finland,601,126,134,0,475,171,170,341,134
2022-04-08,Finland,591,137,118,2,454,171,165,336,116
2022-04-09,Finland,432,89,57,1,343,144,142,286,56
2022-04-10,Finland,490,130,68,0,360,143,149,292,68
2022-04-11,Finland,550,123,106,2,427,160,161,321,104
2022-04-12,Finland,524,94,113,2,430,158,159,317,111
2022-04-13,Finland,552,133,107,1,419,157,155,312,106
2022-04-14,Finland,555,113,123,0,442,162,157,319,123
2022-04-15,Finland,506,124,77,0,382,151,154,305,77
2022-04-16,Finland,403,80,49,0,323,138,136,274,49
2022-04-17,Finland,477,139,60,0,338,137,141,278,60
2022-04-18,Finland,499,122,77,0,377,150,150,300,77
2022-04-19,Finland,567,112,126,1,455,164,165,329,125
2022-04-20,Finland,567,139,105,0,428,161,162,323,105
2022-04-21,Finland,582,134,114,0,448,168,166,334,114
2022-04-22,Finland,573,132,107,0,441,167,167,334,107
2022-04-23,Finland,406,81,44,0,325,139,142,281,44
2022-04-24,Finland,529,147,65,0,382,156,161,317,65
2022-04-25,Finland,542,124,102,0,418,161,155,316,102
2022-04-26,Finland,525,107,97,0,418,160,161,321,97
2022-04-27,Finland,587,146,111,0,441,167,163,330,111
2022-04-28,Finland,576,145,110,0,431,160,161,321,110
2022-04-29,Finland,622,165,107,0,457,177,173,350,107
2022-04-30,Finland,423,112,40,0,311,135,136,271,40
2022-05-01,Finland,549,157,65,0,392,161,166,327,65
2022-05-02,Finland,621,143,115,0,478,181,182,363,115
2022-05-03,Finland,592,145,104,0,447,175,168,343,104
2022-05-04,Finland,629,160,127,1,469,169,173,342,126
2022-05-05,Finland,643,152,119,0,491,187,185,372,119
2022-05-06,Finland,675,175,122,0,500,188,190,378,122
2022-05-07,Finland,456,111,44,0,345,150,151,301,44
2022-05-08,Finland,557,154,65,0,403,167,171,338,65
2022-05-09,Finland,648,169,120,1,479,182,177,359,119
2022-05-10,Finland,632,154,125,3,478,177,176,353,122
2022-05-11,Finland,649,176,123,0,473,173,177,350,123
2022-05-12,Finland,634,141,125,1,493,183,185,368,124
2022-05-13,Finland,655,146,127,1,509,193,189,382,126
2022-05-14,Finland,452,94,55,1,358,154,149,303,54
2022-05-15,Finland,566,148,73,1,418,170,175,345,72
2022-05-16,Finland,621,126,115,0,495,188,192,380,115
2022-05-17,Finland,580,114,110,1,466,182,174,356,109
2022-05-18,Finland,655,160,134,3,495,179,182,361,131
2022-05-19,Finland,684,153,128,3,531,202,201,403,125
2022-05-20,Finland,653,175,120,1,478,178,180,358,119
2022-05-21,Finland,460,97,48,3,363,159,156,315,45
2022-05-22,Finland,576,165,72,3,411,170,169,339,69
2022-05-23,Finland,658,164,120,3,494,190,184,374,117
2022-05-24,Finland,577,126,102,3,451,172,177,349,99
2022-05-25,Finland,655,169,115,4,486,187,184,371,111
2022-05-26,Finland,587,150,63,0,437,188,186,374,63
2022-05-27,Finland,618,162,110,0,456,170,176,346,110
2022-05-28,Finland,466,108,50,0,358,154,154,308,50
2022-05-29,Finland,583,165,69,0,418,171,178,349,69
2022-05-30,Finland,664,170,109,0,494,196,189,385,109
2022-05-31,Finland,604,144,112,0,460,176,172,348,112
2022-06-01,Finland,618,153,107,0,465,180,178,358,107
2022-06-02,Finland,661,174,111,1,487,187,189,376,110
2022-06-03,Finland,652,183,111,0,469,181,177,358,111
2022-06-04,Finland,483,119,50,0,364,157,157,314,50
2022-06-05,Finland,571,169,66,1,402,166,170,336,65
2022-06-06,Finland,652,184,112,5,468,177,179,356,107
2022-06-07,Finland,632,163,121,5,469,173,175,348,116
2022-01-01,France,5447,3065,455,1,2382,969,958,1927,454
2022-01-02,France,7188,3774,842,1,3414,1279,1293,2572,841
2022-01-03,France,6681,3463,915,14,3218,1147,1156,2303,901
2022-01-04,France,5824,3044,825,14,2780,971,984,1955,811
2022-01-05,France,5414,2858,812,22,2556,871,873,1744,790
2022-01-06,France,5498,2864,817,19,2634,912,905,1817,798
2022-01-07,France,5968,3161,835,25,2807,1007,965,1972,810
2022-01-08,France,5758,3550,399,4,2208,899,910,1809,395
2022-01-09,France,6306,3659,525,6,2647,1076,1046,2122,519
2022-01-10,France,5144,2580,855,24,2564,847,862,1709,831
2022-01-11,France,4376,1997,892,26,2379,731,756,1487,866
2022-01-12,France,4402,2036,896,35,2366,738,732,1470,861
2022-01-13,France,4513,2076,897,33,2437,761,779,1540,864
2022-01-14,France,5344,2565,948,32,2779,935,896,1831,916
2022-01-15,France,4531,2662,433,13,1869,703,733,1436,420
2022-01-16,France,4995,2760,537,4,2235,857,841,1698,533
2022-01-17,France,4774,2228,920,24,2546,798,828,1626,896
2022-01-18,France,3997,1802,822,33,2195,686,687,1373,789
2022-01-19,France,4224,1829,938,27,2395,721,736,1457,911
2022-01-20,France,4551,2018,967,34,2533,785,781,1566,933
2022-01-21,France,5334,2504,962,30,2830,928,940,1868,932
2022-01-22,France,4639,2662,443,17,1977,754,780,1534,426
2022-01-23,France,5084,2755,556,4,2329,895,878,1773,552
2022-01-24,France,4699,2168,972,22,2531,768,791,1559,950
2022-01-25,France,3799,1715,761,28,2084,668,655,1323,733
2022-01-26,France,4262,1889,914,23,2373,741,718,1459,891
2022-01-27,France,4438,2069,861,28,2369,760,748,1508,833
2022-01-28,France,5339,2567,964,25,2772,912,896,1808,939
2022-01-29,France,4669,2738,431,9,1931,737,763,1500,422
2022-01-30,France,5323,2915,593,4,2408,927,888,1815,589
2022-01-31,France,4672,2269,856,14,2403,763,784,1547,842
2022-02-01,France,4426,2093,844,25,2333,740,749,1489,819
2022-02-02,France,4580,2195,912,28,2385,728,745,1473,884
2022-02-03,France,4992,2348,957,19,2644,848,839,1687,938
2022-02-04,France,5726,2784,1007,22,2942,982,953,1935,985
2022-02-05,France,5339,3117,532,11,2222,849,841,1690,521
2022-02-06,France,5580,3114,573,3,2466,940,953,1893,570
2022-02-07,France,5536,2657,984,18,2879,938,957,1895,966
2022-02-08,France,4849,2223,974,17,2626,839,813,1652,957
2022-02-09,France,5033,2356,951,24,2677,857,869,1726,927
2022-02-10,France,5676,2706,1029,21,2970,969,972,1941,1008
2022-02-11,France,6732,3388,1031,21,3344,1169,1144,2313,1010
2022-02-12,France,6411,3686,563,11,2725,1064,1098,2162,552
2022-02-13,France,6244,3408,627,7,2836,1109,1100,2209,620
2022-02-14,France,5798,2883,840,17,2915,1031,1044,2075,823
2022-02-15,France,5096,2428,843,22,2668,918,907,1825,821
2022-02-16,France,5246,2482,887,16,2764,938,939,1877,871
2022-02-17,France,5819,2780,976,26,3039,1031,1032,2063,950
2022-02-18,France,6211,3004,989,20,3207,1110,1108,2218,969
2022-02-19,France,6811,3847,606,8,2964,1178,1180,2358,598
2022-02-20,France,6791,3725,629,4,3066,1229,1208,2437,625
2022-02-21,France,5916,2975,832,15,2941,1035,1074,2109,817
2022-02-22,France,5450,2534,965,31,2916,978,973,1951,934
2022-02-23,France,5642,2706,984,28,2936,971,981,1952,956
2022-02-24,France,6092,2931,1038,22,3161,1061,1062,2123,1016
2022-02-25,France,6975,3474,1045,23,3501,1253,1203,2456,1022
2022-02-26,France,6682,3753,604,9,2929,1140,1185,2325,595
2022-02-27,France,6942,3768,675,6,3174,1245,1254,2499,669
2022-02-28,France,6446,3169,1011,25,3277,1112,1154,2266,986
2022-03-01,France,5804,2774,1008,52,3030,1008,1014,2022,956
2022-03-02,France,5910,2832,996,50,3078,1046,1036,2082,946
2022-03-03,France,6369,3103,1064,64,3266,1107,1095,2202,1000
2022-03-04,France,7126,3568,1097,54,3558,1231,1230,2461,1043
2022-03-05,France,6724,3852,559,15,2872,1148,1165,2313,544
2022-03-06,France,6985,3831,695,12,3154,1238,1221,2459,683
2022-03-07,France,6441,3192,986,28,3249,1118,1145,2263,958
2022-03-08,France,5904,2877,998,46,3027,1021,1008,2029,952
2022-03-09,France,6046,2867,1082,56,3179,1055,1042,2097,1026
2022-03-10,France,6546,3174,1128,80,3372,1102,1142,2244,1048
2022-03-11,France,6969,3496,972,54,3473,1279,1222,2501,918
2022-03-12,France,6494,3742,520,19,2752,1098,1134,2232,501
2022-03-13,France,6763,3728,618,11,3035,1207,1210,2417,607
2022-03-14,France,6649,3228,1088,37,3421,1151,1182,2333,1051
2022-03-15,France,6069,2869,1082,38,3200,1044,1074,2118,1044
2022-03-16,France,6178,2886,1126,50,3292,1087,1079,2166,1076
2022-03-17,France,6554,3142,1126,41,3412,1152,1134,2286,1085
2022-03-18,France,7172,3519,1087,30,3653,1301,1265,2566,1057
2022-03-19,France,6622,3846,543,10,2776,1091,1142,2233,533
2022-03-20,France,7064,3828,734,13,3236,1274,1228,2502,721
2022-03-21,France,6570,3230,1022,52,3340,1154,1164,2318,970
2022-03-22,France,5990,2867,1076,55,3123,1024,1023,2047,1021
2022-03-23,France,6118,2908,1028,46,3210,1077,1105,2182,982
2022-03-24,France,6538,3167,1108,44,3371,1141,1122,2263,1064
2022-03-25,France,7300,3609,1106,53,3691,1306,1279,2585,1053
2022-03-26,France,6665,3863,509,14,2802,1141,1152,2293,495
2022-03-27,France,7742,4439,714,5,3303,1309,1280,2589,709
2022-03-28,France,7566,4003,1009,44,3563,1266,1288,2554,965
2022-03-29,France,7315,3802,1071,65,3513,1227,1215,2442,1006
2022-03-30,France,7206,3741,1073,40,3465,1186,1206,2392,1033
2022-03-31,France,7636,4065,1014,40,3571,1271,1286,2557,974
2022-04-01,France,8062,4459,872,22,3603,1369,1362,2731,850
2022-04-02,France,7783,4800,496,12,2983,1244,1243,2487,484
2022-04-03,France,7999,4711,653,8,3288,1320,1315,2635,645
2022-04-04,France,7872,4286,984,24,3586,1288,1314,2602,960
2022-04-05,France,7328,3904,993,31,3424,1204,1227,2431,962
2022-04-06,France,7560,4023,1042,21,3537,1254,1241,2495,1021
2022-04-07,France,7888,4236,983,20,3652,1331,1338,2669,963
2022-04-08,France,8526,4637,992,27,3889,1450,1447,2897,965
2022-04-09,France,8452,5069,598,18,3383,1404,1381,2785,580
2022-04-10,France,8330,4798,753,9,3532,1394,1385,2779,744
2022-04-11,France,7956,4214,1076,33,3742,1319,1347,2666,1043
2022-04-12,France,7738,4170,1003,35,3568,1282,1283,2565,968
2022-04-13,France,8126,4314,1093,67,3812,1356,1363,2719,1026
2022-04-14,France,8805,4591,1213,39,4214,1473,1528,3001,1174
2022-04-15,France,8829,4646,1234,34,4183,1485,1464,2949,1200
2022-04-16,France,8545,4983,725,19,3562,1423,1414,2837,706
2022-04-17,France,8111,4611,672,13,3500,1429,1399,2828,659
2022-04-18,France,8537,4757,874,15,3780,1439,1467,2906,859
2022-04-19,France,8155,4305,1032,34,3850,1408,1410,2818,998
2022-04-20,France,7869,4208,1003,24,3661,1330,1328,2658,979
2022-04-21,France,8344,4435,1069,38,3909,1414,1426,2840,1031
2022-04-22,France,8779,4558,1125,40,4221,1553,1543,3096,1085
2022-04-23,France,8393,4888,633,10,3505,1441,1431,2872,623
2022-04-24,France,8577,4812,763,12,3765,1502,1500,3002,751
2022-04-25,France,8296,4337,1054,59,3959,1443,1462,2905,995
2022-04-26,France,8023,4138,1070,46,3885,1408,1407,2815,1024
2022-04-27,France,7983,4105,1055,39,3878,1417,1406,2823,1016
2022-04-28,France,8522,4434,1140,41,4088,1467,1481,2948,1099
2022-04-29,France,9007,4663,1155,27,4344,1577,1612,3189,1128
2022-04-30,France,8541,4905,732,16,3636,1466,1438,2904,716
2022-05-01,France,8806,5014,807,16,3792,1500,1485,2985,791
2022-05-02,France,8690,4609,1136,32,4081,1459,1486,2945,1104
2022-05-03,France,8270,4400,1023,30,3870,1427,1420,2847,993
2022-05-04,France,8415,4527,1063,81,3888,1402,1423,2825,982
2022-05-05,France,8826,4671,1154,43,4155,1496,1505,3001,1111
2022-05-06,France,9282,4939,1131,26,4343,1590,1622,3212,1105
2022-05-07,France,8876,5195,741,11,3681,1466,1474,2940,730
2022-05-08,France,9055,5145,864,7,3910,1548,1498,3046,857
2022-05-09,France,8699,4646,1055,39,4053,1481,1517,2998,1016
2022-05-10,France,8286,4428,1043,38,3858,1400,1415,2815,1005
2022-05-11,France,8449,4551,1066,37,3898,1418,1414,2832,1029
2022-05-12,France,9036,4721,1208,61,4315,1533,1574,3107,1147
2022-05-13,France,9295,4895,1228,44,4400,1568,1604,3172,1184
2022-05-14,France,8838,5228,714,22,3610,1466,1430,2896,692
2022-05-15,France,8989,5144,788,18,3845,1546,1511,3057,770
2022-05-16,France,8999,4763,1181,41,4236,1516,1539,3055,1140
2022-05-17,France,8534,4622,1091,56,3912,1408,1413,2821,1035
2022-05-18,France,8708,4657,1147,43,4051,1447,1457,2904,1104
2022-05-19,France,9428,5062,1240,61,4366,1550,1576,3126,1179
2022-05-20,France,9456,5003,1209,46,4453,1616,1628,3244,1163
2022-05-21,France,9117,5397,712,18,3720,1502,1506,3008,694
2022-05-22,France,9346,5374,791,6,3972,1605,1576,3181,785
2022-05-23,France,9084,4907,1112,18,4177,1518,1547,3065,1094
2022-05-24,France,8900,4746,1135,38,4154,1496,1523,3019,1097
2022-05-25,France,9540,4886,1286,23,4654,1675,1693,3368,1263
2022-05-26,France,9547,5214,931,19,4333,1675,1727,3402,912
2022-05-27,France,9574,5227,838,17,4347,1714,1795,3509,821
2022-05-28,France,9741,5526,759,20,4215,1668,1788,3456,739
2022-05-29,France,10421,5465,1128,13,4956,2009,1819,3828,1115
2022-05-30,France,9926,4961,1276,32,4965,1890,1799,3689,1244
2022-05-31,France,9192,4892,1158,29,4300,1563,1579,3142,1129
2022-06-01,France,9126,4739,1174,44,4387,1597,1616,3213,1130
2022-06-02,France,9646,5003,1228,41,4643,1673,1742,3415,1187
2022-06-03,France,10080,5281,1268,33,4799,1740,1791,3531,1235
2022-06-04,France,9549,5626,748,6,3923,1591,1584,3175,742
2022-06-05,France,9538,5493,720,14,4045,1702,1623,3325,706
2022-06-06,France,9958,5446,1034,24,4512,1742,1736,3478,1010
2022-06-07,France,9544,5122,1223,45,4422,1606,1593,3199,1178
2022-01-01,Georgia,181,107,0,0,74,37,37,74,0
2022-01-02,Georgia,258,157,0,0,101,50,51,101,0
2022-01-03,Georgia,245,153,2,0,92,47,43,90,2
2022-01-04,Georgia,211,119,0,0,92,45,47,92,0
2022-01-05,Georgia,219,129,2,0,90,44,44,88,2
2022-01-06,Georgia,205,131,0,0,74,34,40,74,0
2022-01-07,Georgia,234,138,2,0,96,48,46,94,2
2022-01-08,Georgia,222,134,1,0,88,45,42,87,1
2022-01-09,Georgia,239,147,0,0,92,47,45,92,0
2022-01-10,Georgia,212,144,2,0,68,32,34,66,2
2022-01-11,Georgia,199,121,0,0,78,40,38,78,0
2022-01-12,Georgia,197,114,2,0,83,39,42,81,2
2022-01-13,Georgia,222,133,0,0,89,45,44,89,0
2022-01-14,Georgia,226,134,2,0,92,44,46,90,2
2022-01-15,Georgia,211,134,0,0,77,38,39,77,0
2022-01-16,Georgia,201,116,0,0,85,41,44,85,0
2022-01-17,Georgia,204,131,2,0,73,38,33,71,2
2022-01-18,Georgia,171,100,0,0,71,37,34,71,0
2022-01-19,Georgia,196,119,2,0,77,36,39,75,2
2022-01-20,Georgia,190,110,0,0,80,40,40,80,0
2022-01-21,Georgia,214,120,2,0,94,46,46,92,2
2022-01-22,Georgia,208,129,0,0,79,39,40,79,0
2022-01-23,Georgia,191,115,0,0,76,39,37,76,0
2022-01-24,Georgia,179,118,3,1,61,31,27,58,2
2022-01-25,Georgia,135,71,0,0,64,30,34,64,0
2022-01-26,Georgia,165,86,2,0,79,38,39,77,2
2022-01-27,Georgia,200,114,0,0,86,43,43,86,0
2022-01-28,Georgia,185,102,2,0,83,41,40,81,2
2022-01-29,Georgia,218,131,2,0,87,43,42,85,2
2022-01-30,Georgia,211,128,0,0,83,42,41,83,0
2022-01-31,Georgia,182,118,2,0,64,30,32,62,2
2022-02-01,Georgia,176,106,0,0,70,37,33,70,0
2022-02-02,Georgia,184,111,2,0,73,32,39,71,2
2022-02-03,Georgia,188,105,0,0,83,41,42,83,0
2022-02-04,Georgia,193,106,2,0,87,42,43,85,2
2022-02-05,Georgia,196,117,0,0,79,41,38,79,0
2022-02-06,Georgia,197,114,0,0,83,41,42,83,0
2022-02-07,Georgia,178,116,2,0,62,31,29,60,2
2022-02-08,Georgia,151,87,0,0,64,32,32,64,0
2022-02-09,Georgia,178,108,2,0,70,33,35,68,2
2022-02-10,Georgia,167,98,0,0,69,36,33,69,0
2022-02-11,Georgia,205,115,2,0,90,43,45,88,2
2022-02-12,Georgia,204,122,2,2,82,41,39,80,0
2022-02-13,Georgia,206,121,0,0,85,42,43,85,0
2022-02-14,Georgia,179,121,2,0,58,28,28,56,2
2022-02-15,Georgia,170,98,0,0,72,36,36,72,0
2022-02-16,Georgia,184,113,2,0,71,34,35,69,2
2022-02-17,Georgia,192,113,1,1,79,40,38,78,0
2022-02-18,Georgia,214,123,2,0,91,43,46,89,2
2022-02-19,Georgia,206,123,0,0,83,41,42,83,0
2022-02-20,Georgia,220,127,0,0,93,46,47,93,0
2022-02-21,Georgia,186,117,2,0,69,35,32,67,2
2022-02-22,Georgia,188,114,0,0,74,38,36,74,0
2022-02-23,Georgia,203,126,2,0,77,36,39,75,2
2022-02-24,Georgia,239,153,1,1,86,42,43,85,0
2022-02-25,Georgia,271,185,2,0,86,44,40,84,2
2022-02-26,Georgia,337,246,0,0,91,44,47,91,0
2022-02-27,Georgia,335,236,1,0,99,48,50,98,1
2022-02-28,Georgia,310,242,2,0,68,35,31,66,2
2022-03-01,Georgia,291,219,0,0,72,35,37,72,0
2022-03-02,Georgia,305,214,2,0,91,44,45,89,2
2022-03-03,Georgia,326,229,0,0,97,49,48,97,0
2022-03-04,Georgia,370,255,2,0,115,54,59,113,2
2022-03-05,Georgia,380,281,0,0,99,49,50,99,0
2022-03-06,Georgia,356,249,0,0,107,53,54,107,0
2022-03-07,Georgia,347,256,2,0,91,46,43,89,2
2022-03-08,Georgia,301,208,0,0,93,47,46,93,0
2022-03-09,Georgia,303,206,2,0,97,48,47,95,2
2022-03-10,Georgia,298,202,0,0,96,47,49,96,0
2022-03-11,Georgia,281,181,4,2,100,50,46,96,2
2022-03-12,Georgia,305,215,0,0,90,43,47,90,0
2022-03-13,Georgia,254,161,1,0,93,44,48,92,1
2022-03-14,Georgia,251,188,0,0,63,33,30,63,0
2022-03-15,Georgia,260,184,0,0,76,38,38,76,0
2022-03-16,Georgia,295,202,0,0,93,47,46,93,0
2022-03-17,Georgia,296,185,3,1,111,49,59,108,2
2022-03-18,Georgia,291,196,0,0,95,50,45,95,0
2022-03-19,Georgia,306,218,0,0,88,45,43,88,0
2022-03-20,Georgia,309,216,0,0,93,47,46,93,0
2022-03-21,Georgia,278,202,0,0,76,40,36,76,0
2022-03-22,Georgia,281,194,0,0,87,42,45,87,0
2022-03-23,Georgia,295,209,0,0,86,43,43,86,0
2022-03-24,Georgia,329,229,0,0,100,48,52,100,0
2022-03-25,Georgia,287,199,0,0,88,44,44,88,0
2022-03-26,Georgia,322,226,0,0,96,48,48,96,0
2022-03-27,Georgia,316,218,0,0,98,50,48,98,0
2022-03-28,Georgia,290,196,0,0,94,48,46,94,0
2022-03-29,Georgia,296,203,0,0,93,45,48,93,0
2022-03-30,Georgia,312,206,0,0,106,51,55,106,0
2022-03-31,Georgia,320,212,1,0,108,55,52,107,1
2022-04-01,Georgia,310,215,2,1,95,48,45,93,1
2022-04-02,Georgia,303,216,0,0,87,44,43,87,0
2022-04-03,Georgia,310,211,2,0,99,46,51,97,2
2022-04-04,Georgia,290,212,0,0,78,40,38,78,0
2022-04-05,Georgia,284,189,1,0,95,48,46,94,1
2022-04-06,Georgia,291,212,0,0,79,38,41,79,0
2022-04-07,Georgia,304,210,0,0,94,48,46,94,0
2022-04-08,Georgia,288,204,0,0,84,41,43,84,0
2022-04-09,Georgia,292,211,0,0,81,41,40,81,0
2022-04-10,Georgia,309,214,0,0,95,46,49,95,0
2022-04-11,Georgia,270,194,2,0,76,36,38,74,2
2022-04-12,Georgia,279,197,0,0,82,42,40,82,0
2022-04-13,Georgia,285,211,2,0,74,35,37,72,2
2022-04-14,Georgia,345,239,0,0,106,52,54,106,0
2022-04-15,Georgia,310,221,2,0,89,46,41,87,2
2022-04-16,Georgia,293,208,0,0,85,42,43,85,0
2022-04-17,Georgia,313,211,2,0,102,49,51,100,2
2022-04-18,Georgia,263,192,2,0,71,37,32,69,2
2022-04-19,Georgia,298,207,2,0,91,45,44,89,2
2022-04-20,Georgia,267,197,2,0,70,33,35,68,2
2022-04-21,Georgia,323,227,0,0,96,47,49,96,0
2022-04-22,Georgia,315,215,3,1,100,48,49,97,2
2022-04-23,Georgia,322,231,0,0,91,46,45,91,0
2022-04-24,Georgia,329,220,3,1,109,52,54,106,2
2022-04-25,Georgia,276,197,2,0,79,40,37,77,2
2022-04-26,Georgia,296,204,0,0,92,47,45,92,0
2022-04-27,Georgia,299,212,2,0,87,40,45,85,2
2022-04-28,Georgia,346,244,2,1,102,51,49,100,1
2022-04-29,Georgia,334,232,3,0,102,50,49,99,3
2022-04-30,Georgia,383,252,7,1,131,61,63,124,6
2022-05-01,Georgia,379,242,2,0,137,67,68,135,2
2022-05-02,Georgia,304,197,2,0,107,52,53,105,2
2022-05-03,Georgia,320,216,1,0,104,52,51,103,1
2022-05-04,Georgia,320,212,2,0,108,54,52,106,2
2022-05-05,Georgia,341,222,0,0,119,59,60,119,0
2022-05-06,Georgia,325,219,2,0,106,50,54,104,2
2022-05-07,Georgia,323,215,0,0,108,55,53,108,0
2022-05-08,Georgia,335,230,0,0,105,54,51,105,0
2022-05-09,Georgia,318,217,2,0,101,49,50,99,2
2022-05-10,Georgia,320,218,0,0,102,53,49,102,0
2022-05-11,Georgia,329,236,2,0,93,42,49,91,2
2022-05-12,Georgia,368,252,0,0,116,59,57,116,0
2022-05-13,Georgia,324,227,2,0,97,48,47,95,2
2022-05-14,Georgia,329,235,0,0,94,47,47,94,0
2022-05-15,Georgia,358,249,2,0,109,52,55,107,2
2022-05-16,Georgia,326,213,3,1,113,56,54,110,2
2022-05-17,Georgia,327,220,1,0,107,55,51,106,1
2022-05-18,Georgia,340,247,0,0,93,43,50,93,0
2022-05-19,Georgia,371,256,2,1,115,58,55,113,1
2022-05-20,Georgia,318,224,4,1,94,45,45,90,3
2022-05-21,Georgia,341,238,1,0,103,52,50,102,1
2022-05-22,Georgia,359,249,3,1,110,53,54,107,2
2022-05-23,Georgia,361,249,2,0,112,57,53,110,2
2022-05-24,Georgia,329,217,0,0,112,55,57,112,0
2022-05-25,Georgia,348,247,1,0,101,50,50,100,1
2022-05-26,Georgia,382,265,3,0,117,56,58,114,3
2022-05-27,Georgia,323,231,5,0,92,41,46,87,5
2022-05-28,Georgia,347,254,0,0,93,47,46,93,0
2022-05-29,Georgia,388,272,2,0,116,57,57,114,2
2022-05-30,Georgia,365,266,2,0,99,47,50,97,2
2022-05-31,Georgia,341,234,0,0,107,54,53,107,0
2022-06-01,Georgia,328,233,2,0,95,49,44,93,2
2022-06-02,Georgia,375,267,0,0,108,53,55,108,0
2022-06-03,Georgia,364,258,2,0,106,53,51,104,2
2022-06-04,Georgia,388,268,2,0,120,58,60,118,2
2022-06-05,Georgia,377,270,2,0,107,53,52,105,2
2022-06-06,Georgia,376,271,2,0,105,52,51,103,2
2022-06-07,Georgia,341,227,4,0,114,56,54,110,4
2022-01-01,Germany,4589,2217,184,5,2372,1122,1066,2188,179
2022-01-02,Germany,6631,3105,370,5,3526,1569,1587,3156,365
2022-01-03,Germany,6288,2862,382,16,3426,1522,1522,3044,366
2022-01-04,Germany,5552,2408,375,19,3144,1374,1395,2769,356
2022-01-05,Germany,5527,2436,361,23,3091,1364,1366,2730,338
2022-01-06,Germany,5596,2423,477,24,3173,1344,1352,2696,453
2022-01-07,Germany,6158,2793,359,18,3365,1515,1491,3006,341
2022-01-08,Germany,5789,2727,302,11,3062,1388,1372,2760,291
2022-01-09,Germany,6280,2979,330,5,3301,1473,1498,2971,325
2022-01-10,Germany,5308,2234,413,10,3074,1303,1358,2661,403
2022-01-11,Germany,4643,1892,467,21,2751,1158,1126,2284,446
2022-01-12,Germany,4570,1866,451,27,2704,1118,1135,2253,424
2022-01-13,Germany,4629,1854,491,31,2775,1154,1130,2284,460
2022-01-14,Germany,5265,2167,462,23,3098,1325,1311,2636,439
2022-01-15,Germany,4615,2142,292,16,2473,1096,1085,2181,276
2022-01-16,Germany,4895,2265,314,5,2630,1146,1170,2316,309
2022-01-17,Germany,4616,1920,401,13,2696,1127,1168,2295,388
2022-01-18,Germany,4185,1671,462,23,2514,1026,1026,2052,439
2022-01-19,Germany,4361,1742,524,29,2619,1046,1049,2095,495
2022-01-20,Germany,4520,1785,495,23,2735,1125,1115,2240,472
2022-01-21,Germany,5238,2184,491,21,3054,1292,1271,2563,470
2022-01-22,Germany,4449,2140,245,6,2309,1036,1028,2064,239
2022-01-23,Germany,4942,2287,396,13,2655,1122,1137,2259,383
2022-01-24,Germany,4527,1893,470,14,2634,1052,1112,2164,456
2022-01-25,Germany,3878,1517,470,34,2361,947,944,1891,436
2022-01-26,Germany,4281,1776,441,16,2505,1039,1025,2064,425
2022-01-27,Germany,4532,1830,501,20,2702,1111,1090,2201,481
2022-01-28,Germany,5354,2186,567,24,3168,1305,1296,2601,543
2022-01-29,Germany,4544,2144,254,14,2400,1077,1069,2146,240
2022-01-30,Germany,4833,2167,369,7,2666,1149,1148,2297,362
2022-01-31,Germany,4502,1877,389,12,2625,1093,1143,2236,377
2022-02-01,Germany,4395,1786,401,13,2609,1114,1094,2208,388
2022-02-02,Germany,4613,1837,550,33,2776,1105,1121,2226,517
2022-02-03,Germany,4909,1981,572,32,2928,1185,1171,2356,540
2022-02-04,Germany,5563,2293,538,18,3270,1378,1354,2732,520
2022-02-05,Germany,5074,2357,427,18,2717,1150,1140,2290,409
2022-02-06,Germany,5158,2431,303,3,2727,1193,1231,2424,300
2022-02-07,Germany,4981,2062,498,22,2919,1192,1229,2421,476
2022-02-08,Germany,4532,1802,535,39,2730,1100,1095,2195,496
2022-02-09,Germany,4941,1940,633,38,3001,1196,1172,2368,595
2022-02-10,Germany,5266,2164,594,17,3102,1249,1259,2508,577
2022-02-11,Germany,6021,2530,541,19,3491,1508,1442,2950,522
2022-02-12,Germany,5682,2690,497,20,2992,1263,1232,2495,477
2022-02-13,Germany,5599,2563,466,21,3036,1257,1313,2570,445
2022-02-14,Germany,5274,2264,487,13,3010,1248,1275,2523,474
2022-02-15,Germany,4800,1938,554,25,2862,1142,1166,2308,529
2022-02-16,Germany,4903,2018,468,28,2885,1211,1206,2417,440
2022-02-17,Germany,4858,2113,313,4,2745,1210,1222,2432,309
2022-02-18,Germany,5575,2372,405,27,3203,1411,1387,2798,378
2022-02-19,Germany,5710,2844,276,12,2866,1317,1273,2590,264
2022-02-20,Germany,5673,2656,288,6,3017,1357,1372,2729,282
2022-02-21,Germany,5218,2253,412,8,2965,1251,1302,2553,404
2022-02-22,Germany,4951,2051,540,37,2900,1188,1172,2360,503
2022-02-23,Germany,5345,2108,672,51,3237,1290,1275,2565,621
2022-02-24,Germany,5573,2290,578,24,3283,1357,1348,2705,554
2022-02-25,Germany,6133,2664,478,30,3469,1503,1488,2991,448
2022-02-26,Germany,5883,2829,432,33,3054,1325,1297,2622,399
2022-02-27,Germany,6003,2725,462,24,3278,1402,1414,2816,438
2022-02-28,Germany,5783,2374,591,26,3409,1392,1426,2818,565
2022-03-01,Germany,5403,2123,594,32,3280,1336,1350,2686,562
2022-03-02,Germany,5596,2254,607,33,3342,1381,1354,2735,574
2022-03-03,Germany,5802,2358,646,32,3444,1398,1400,2798,614
2022-03-04,Germany,6617,2733,635,27,3884,1638,1611,3249,608
2022-03-05,Germany,5905,2743,447,27,3162,1373,1342,2715,420
2022-03-06,Germany,6229,2811,463,23,3418,1471,1484,2955,440
2022-03-07,Germany,6024,2535,552,23,3489,1450,1487,2937,529
2022-03-08,Germany,5419,2203,590,35,3216,1301,1325,2626,555
2022-03-09,Germany,5746,2294,642,35,3452,1405,1405,2810,607
2022-03-10,Germany,5965,2386,668,29,3579,1459,1452,2911,639
2022-03-11,Germany,6573,2698,620,29,3875,1651,1604,3255,591
2022-03-12,Germany,5703,2600,415,29,3103,1339,1349,2688,386
2022-03-13,Germany,6151,2771,455,15,3380,1462,1463,2925,440
2022-03-14,Germany,5972,2595,581,44,3377,1374,1422,2796,537
2022-03-15,Germany,5336,2195,539,32,3141,1321,1281,2602,507
2022-03-16,Germany,5824,2307,658,34,3517,1421,1438,2859,624
2022-03-17,Germany,6002,2422,662,40,3580,1473,1445,2918,622
2022-03-18,Germany,6850,2820,713,35,4030,1641,1676,3317,678
2022-03-19,Germany,5851,2703,412,23,3148,1394,1342,2736,389
2022-03-20,Germany,6298,2816,449,16,3482,1496,1537,3033,433
2022-03-21,Germany,6252,2626,617,34,3626,1493,1516,3009,583
2022-03-22,Germany,5262,2234,532,42,3028,1235,1261,2496,490
2022-03-23,Germany,6035,2434,672,42,3601,1492,1437,2929,630
2022-03-24,Germany,6233,2467,688,43,3766,1538,1540,3078,645
2022-03-25,Germany,6886,2861,658,34,4025,1693,1674,3367,624
2022-03-26,Germany,5920,2652,450,17,3268,1420,1398,2818,433
2022-03-27,Germany,7032,3195,485,13,3837,1666,1686,3352,472
2022-03-28,Germany,7195,3091,733,46,4104,1654,1717,3371,687
2022-03-29,Germany,6568,2711,694,39,3857,1594,1569,3163,655
2022-03-30,Germany,6917,2887,696,29,4030,1661,1673,3334,667
2022-03-31,Germany,7168,2986,648,27,4182,1793,1741,3534,621
2022-04-01,Germany,7541,3191,573,15,4350,1874,1903,3777,558
2022-04-02,Germany,6607,3021,406,22,3586,1602,1578,3180,384
2022-04-03,Germany,7257,3241,474,14,4016,1770,1772,3542,460
2022-04-04,Germany,7181,3054,591,25,4127,1738,1798,3536,566
2022-04-05,Germany,6781,2879,613,31,3902,1637,1652,3289,582
2022-04-06,Germany,7381,3143,735,51,4238,1775,1728,3503,684
2022-04-07,Germany,7511,3209,566,19,4302,1862,1874,3736,547
2022-04-08,Germany,8233,3435,679,35,4798,2061,2058,4119,644
2022-04-09,Germany,7385,3326,380,16,4059,1855,1824,3679,364
2022-04-10,Germany,7871,3527,463,15,4344,1942,1939,3881,448
2022-04-11,Germany,7843,3304,738,60,4539,1897,1904,3801,678
2022-04-12,Germany,7361,3036,745,45,4325,1790,1790,3580,700
2022-04-13,Germany,7939,3279,777,39,4660,1965,1918,3883,738
2022-04-14,Germany,8069,3360,663,37,4709,2042,2004,4046,626
2022-04-15,Germany,7801,3386,524,17,4415,1945,1946,3891,507
2022-04-16,Germany,7086,3226,434,25,3860,1714,1712,3426,409
2022-04-17,Germany,7405,3448,381,17,3957,1779,1797,3576,364
2022-04-18,Germany,7704,3487,507,19,4217,1825,1885,3710,488
2022-04-19,Germany,7554,3136,687,33,4418,1868,1863,3731,654
2022-04-20,Germany,7799,3262,678,28,4537,1937,1922,3859,650
2022-04-21,Germany,7974,3351,664,26,4623,1973,1986,3959,638
2022-04-22,Germany,8321,3434,697,25,4887,2081,2109,4190,672
2022-04-23,Germany,7402,3207,512,16,4195,1846,1837,3683,496
2022-04-24,Germany,8051,3564,503,17,4487,1962,2022,3984,486
2022-04-25,Germany,8069,3392,753,33,4677,1944,1980,3924,720
2022-04-26,Germany,7658,3149,732,34,4509,1861,1916,3777,698
2022-04-27,Germany,8094,3337,862,36,4757,1960,1935,3895,826
2022-04-28,Germany,8564,3543,897,33,5021,2073,2051,4124,864
2022-04-29,Germany,8755,3554,862,36,5201,2183,2156,4339,826
2022-04-30,Germany,7439,3296,499,15,4143,1852,1792,3644,484
2022-05-01,Germany,8158,3706,516,12,4452,1963,1973,3936,504
2022-05-02,Germany,8284,3531,734,34,4753,1991,2028,4019,700
2022-05-03,Germany,7974,3401,748,37,4573,1910,1915,3825,711
2022-05-04,Germany,8139,3396,806,23,4743,1977,1960,3937,783
2022-05-05,Germany,8471,3483,820,31,4988,2104,2064,4168,789
2022-05-06,Germany,8855,3656,807,28,5199,2202,2190,4392,779
2022-05-07,Germany,7706,3477,515,15,4229,1878,1836,3714,500
2022-05-08,Germany,8378,3779,551,18,4599,2014,2034,4048,533
2022-05-09,Germany,8352,3531,725,42,4821,2024,2072,4096,683
2022-05-10,Germany,7984,3348,782,40,4636,1921,1933,3854,742
2022-05-11,Germany,8250,3417,799,31,4833,2026,2008,4034,768
2022-05-12,Germany,8598,3530,850,42,5068,2125,2093,4218,808
2022-05-13,Germany,8861,3649,806,29,5212,2219,2187,4406,777
2022-05-14,Germany,7970,3564,558,12,4406,1924,1924,3848,546
2022-05-15,Germany,8583,3820,628,14,4763,2039,2096,4135,614
2022-05-16,Germany,8284,3444,689,26,4840,2064,2087,4151,663
2022-05-17,Germany,8129,3345,854,29,4784,1973,1957,3930,825
2022-05-18,Germany,8419,3458,815,22,4961,2096,2050,4146,793
2022-05-19,Germany,8575,3530,784,24,5045,2114,2147,4261,760
2022-05-20,Germany,8687,3620,657,23,5067,2221,2189,4410,634
2022-05-21,Germany,8020,3596,499,20,4424,1970,1955,3925,479
2022-05-22,Germany,8635,3867,571,8,4768,2075,2122,4197,563
2022-05-23,Germany,8381,3583,658,27,4798,2060,2080,4140,631
2022-05-24,Germany,8368,3563,748,28,4805,2034,2023,4057,720
2022-05-25,Germany,9130,3771,840,41,5359,2286,2233,4519,799
2022-05-26,Germany,8593,3843,537,16,4750,2155,2058,4213,521
2022-05-27,Germany,8486,3761,530,19,4725,2113,2082,4195,511
2022-05-28,Germany,7979,3644,437,14,4335,1955,1943,3898,423
2022-05-29,Germany,8955,4049,542,10,4906,2119,2245,4364,532
2022-05-30,Germany,9093,3821,815,43,5272,2209,2248,4457,772
2022-05-31,Germany,8571,3530,770,21,5041,2132,2139,4271,749
2022-06-01,Germany,8642,3464,784,27,5178,2220,2174,4394,757
2022-06-02,Germany,8981,3700,810,36,5281,2233,2238,4471,774
2022-06-03,Germany,9393,3925,742,20,5468,2383,2343,4726,722
2022-06-04,Germany,8309,3689,482,17,4620,2094,2044,4138,465
2022-06-05,Germany,8185,3789,362,12,4396,2021,2013,4034,350
2022-06-06,Germany,8775,3900,560,16,4875,2100,2215,4315,544
2022-06-07,Germany,8700,3594,764,31,5106,2171,2171,4342,733
2022-01-01,Greece,1256,893,139,0,363,110,114,224,139
2022-01-02,Greece,1560,969,235,1,591,180,176,356,234
2022-01-03,Greece,1424,801,247,9,623,190,186,376,238
2022-01-04,Greece,1272,733,242,19,539,147,150,297,223
2022-01-05,Greece,1352,780,252,16,572,160,160,320,236
2022-01-06,Greece,1327,799,217,1,528,155,156,311,216
2022-01-07,Greece,1356,743,250,11,613,183,180,363,239
2022-01-08,Greece,1448,901,235,5,547,152,160,312,230
2022-01-09,Greece,1454,880,228,7,574,181,165,346,221
2022-01-10,Greece,1175,625,229,15,550,159,162,321,214
2022-01-11,Greece,993,579,199,10,414,101,114,215,189
2022-01-12,Greece,1018,574,203,9,444,122,119,241,194
2022-01-13,Greece,973,550,217,13,423,107,99,206,204
2022-01-14,Greece,1145,640,228,9,505,136,141,277,219
2022-01-15,Greece,1115,721,192,7,394,102,100,202,185
2022-01-16,Greece,1219,732,221,5,487,136,130,266,216
2022-01-17,Greece,1009,516,225,14,493,133,135,268,211
2022-01-18,Greece,919,529,215,19,390,84,91,175,196
2022-01-19,Greece,924,523,214,14,401,94,93,187,200
2022-01-20,Greece,975,549,230,13,426,99,97,196,217
2022-01-21,Greece,1114,609,218,7,505,143,144,287,211
2022-01-22,Greece,1038,693,170,9,345,87,88,175,161
2022-01-23,Greece,1093,664,183,2,429,123,123,246,181
2022-01-24,Greece,735,473,101,9,262,73,88,161,92
2022-01-25,Greece,627,445,75,10,182,59,48,107,65
2022-01-26,Greece,861,510,176,15,351,89,86,175,161
2022-01-27,Greece,978,553,222,11,425,100,103,203,211
2022-01-28,Greece,1141,621,245,8,520,136,139,275,237
2022-01-29,Greece,1036,680,180,5,356,90,86,176,175
2022-01-30,Greece,1171,710,205,8,461,129,127,256,197
2022-01-31,Greece,982,550,224,20,432,106,102,208,204
2022-02-01,Greece,967,547,210,15,420,104,106,210,195
2022-02-02,Greece,928,553,190,12,375,96,89,185,178
2022-02-03,Greece,997,574,213,17,423,101,109,210,196
2022-02-04,Greece,1136,631,231,15,505,136,138,274,216
2022-02-05,Greece,1142,744,213,6,398,92,93,185,207
2022-02-06,Greece,1211,729,216,4,482,138,128,266,212
2022-02-07,Greece,1044,548,228,11,496,130,138,268,217
2022-02-08,Greece,934,554,190,24,380,95,95,190,166
2022-02-09,Greece,1059,599,247,31,460,104,109,213,216
2022-02-10,Greece,1106,636,245,17,470,110,115,225,228
2022-02-11,Greece,1232,657,270,12,575,153,152,305,258
2022-02-12,Greece,1210,797,201,5,413,107,105,212,196
2022-02-13,Greece,1286,769,227,5,517,149,141,290,222
2022-02-14,Greece,1106,554,263,19,552,141,148,289,244
2022-02-15,Greece,971,543,221,20,428,105,102,207,201
2022-02-16,Greece,1090,618,244,23,472,115,113,228,221
2022-02-17,Greece,1119,617,253,23,502,124,125,249,230
2022-02-18,Greece,1288,712,256,14,576,157,163,320,242
2022-02-19,Greece,1325,877,215,11,448,124,109,233,204
2022-02-20,Greece,1388,865,228,11,523,148,147,295,217
2022-02-21,Greece,1174,629,261,23,545,139,145,284,238
2022-02-22,Greece,1057,633,217,20,424,104,103,207,197
2022-02-23,Greece,1098,655,220,21,443,108,115,223,199
2022-02-24,Greece,1166,689,248,14,477,116,113,229,234
2022-02-25,Greece,1391,810,279,19,581,150,152,302,260
2022-02-26,Greece,1376,913,226,7,463,118,119,237,219
2022-02-27,Greece,1469,927,222,5,542,162,158,320,217
2022-02-28,Greece,1225,683,251,17,542,144,147,291,234
2022-03-01,Greece,1175,710,246,29,465,109,110,219,217
2022-03-02,Greece,1268,762,259,13,506,121,126,247,246
2022-03-03,Greece,1334,785,279,22,549,137,133,270,257
2022-03-04,Greece,1460,840,254,15,620,183,183,366,239
2022-03-05,Greece,1401,967,186,5,434,122,126,248,181
2022-03-06,Greece,1426,928,193,5,498,156,149,305,188
2022-03-07,Greece,1290,724,238,9,566,158,170,328,229
2022-03-08,Greece,1221,745,231,24,476,121,124,245,207
2022-03-09,Greece,1301,794,251,30,507,125,131,256,221
2022-03-10,Greece,1310,806,245,20,504,133,126,259,225
2022-03-11,Greece,1365,819,233,13,546,154,159,313,220
2022-03-12,Greece,1361,933,196,6,428,117,115,232,190
2022-03-13,Greece,1482,939,222,3,543,164,157,321,219
2022-03-14,Greece,1330,799,240,15,531,145,146,291,225
2022-03-15,Greece,1278,784,243,32,494,127,124,251,211
2022-03-16,Greece,1351,831,240,30,520,141,139,280,210
2022-03-17,Greece,1345,826,241,18,519,136,142,278,223
2022-03-18,Greece,1419,823,250,16,596,169,177,346,234
2022-03-19,Greece,1470,1003,197,7,467,136,134,270,190
2022-03-20,Greece,1568,997,227,4,571,179,165,344,223
2022-03-21,Greece,1361,776,244,19,585,161,180,341,225
2022-03-22,Greece,1230,761,225,21,469,119,125,244,204
2022-03-23,Greece,1394,856,252,31,538,143,143,286,221
2022-03-24,Greece,1471,864,269,19,607,165,173,338,250
2022-03-25,Greece,1405,873,194,3,532,170,168,338,191
2022-03-26,Greece,1515,1054,189,8,461,137,135,272,181
2022-03-27,Greece,1804,1086,230,5,718,242,246,488,225
2022-03-28,Greece,1651,893,295,13,758,233,230,463,282
2022-03-29,Greece,1551,874,260,23,677,209,208,417,237
2022-03-30,Greece,1685,955,290,22,730,220,220,440,268
2022-03-31,Greece,1625,940,270,19,685,204,211,415,251
2022-04-01,Greece,1793,1009,278,25,784,256,250,506,253
2022-04-02,Greece,1891,1138,242,5,753,257,254,511,237
2022-04-03,Greece,1902,1106,241,3,796,282,273,555,238
2022-04-04,Greece,1695,921,308,22,774,230,236,466,286
2022-04-05,Greece,1603,899,266,22,704,223,215,438,244
2022-04-06,Greece,1712,959,277,21,753,234,242,476,256
2022-04-07,Greece,1660,933,279,18,727,226,222,448,261
2022-04-08,Greece,2055,1136,315,21,919,304,300,604,294
2022-04-09,Greece,2245,1323,223,5,922,352,347,699,218
2022-04-10,Greece,2230,1273,248,6,957,355,354,709,242
2022-04-11,Greece,1849,1021,318,14,828,253,257,510,304
2022-04-12,Greece,1763,948,309,25,815,253,253,506,284
2022-04-13,Greece,1903,1045,284,19,858,288,286,574,265
2022-04-14,Greece,2006,1050,331,27,956,314,311,625,304
2022-04-15,Greece,2149,1164,330,13,985,328,327,655,317
2022-04-16,Greece,2405,1351,261,5,1054,393,400,793,256
2022-04-17,Greece,2316,1275,264,13,1041,387,390,777,251
2022-04-18,Greece,2118,1110,370,13,1008,323,315,638,357
2022-04-19,Greece,1882,994,326,25,888,285,277,562,301
2022-04-20,Greece,2018,1097,317,15,921,299,305,604,302
2022-04-21,Greece,2055,1057,335,9,998,327,336,663,326
2022-04-22,Greece,2150,1120,307,3,1030,360,363,723,304
2022-04-23,Greece,2509,1357,259,4,1152,434,459,893,255
2022-04-24,Greece,2367,1277,189,3,1090,460,441,901,186
2022-04-25,Greece,2091,1086,327,0,1005,340,338,678,327
2022-04-26,Greece,2009,1025,328,8,984,327,329,656,320
2022-04-27,Greece,2064,1084,312,12,980,337,331,668,300
2022-04-28,Greece,2105,1091,338,16,1014,345,331,676,322
2022-04-29,Greece,2268,1171,340,11,1097,371,386,757,329
2022-04-30,Greece,2631,1365,286,7,1266,486,494,980,279
2022-05-01,Greece,2683,1295,282,4,1388,558,548,1106,278
2022-05-02,Greece,2276,1100,320,1,1176,425,431,856,319
2022-05-03,Greece,2300,1123,318,12,1177,432,427,859,306
2022-05-04,Greece,2233,1106,309,20,1127,409,409,818,289
2022-05-05,Greece,2291,1112,347,24,1179,416,416,832,323
2022-05-06,Greece,2567,1233,342,9,1334,491,501,992,333
2022-05-07,Greece,2868,1410,273,12,1458,589,596,1185,261
2022-05-08,Greece,2804,1336,298,8,1468,587,583,1170,290
2022-05-09,Greece,2332,1088,364,15,1244,438,442,880,349
2022-05-10,Greece,2308,1119,343,23,1189,425,421,846,320
2022-05-11,Greece,2301,1144,316,14,1157,419,422,841,302
2022-05-12,Greece,2350,1121,367,25,1229,425,437,862,342
2022-05-13,Greece,2490,1101,360,17,1389,518,511,1029,343
2022-05-14,Greece,2799,1304,280,13,1495,604,611,1215,267
2022-05-15,Greece,2909,1347,297,3,1562,631,634,1265,294
2022-05-16,Greece,2385,1091,369,14,1294,465,460,925,355
2022-05-17,Greece,2361,1107,354,17,1254,446,454,900,337
2022-05-18,Greece,2431,1185,338,12,1246,453,455,908,326
2022-05-19,Greece,2414,1089,354,19,1325,489,482,971,335
2022-05-20,Greece,2682,1165,361,9,1517,589,567,1156,352
2022-05-21,Greece,3038,1351,323,8,1687,675,689,1364,315
2022-05-22,Greece,2994,1310,324,6,1684,687,673,1360,318
2022-05-23,Greece,2492,1078,381,10,1414,517,516,1033,371
2022-05-24,Greece,2607,1171,372,18,1436,526,538,1064,354
2022-05-25,Greece,2735,1233,375,30,1502,561,566,1127,345
2022-05-26,Greece,2772,1248,392,21,1524,568,564,1132,371
2022-05-27,Greece,2847,1210,382,12,1637,625,630,1255,370
2022-05-28,Greece,3214,1381,337,6,1833,740,756,1496,331
2022-05-29,Greece,3222,1347,369,9,1875,762,744,1506,360
2022-05-30,Greece,2755,1171,400,11,1584,589,595,1184,389
2022-05-31,Greece,2700,1135,384,20,1565,596,585,1181,364
2022-06-01,Greece,2813,1063,412,15,1750,666,672,1338,397
2022-06-02,Greece,3016,1258,443,15,1758,654,661,1315,428
2022-06-03,Greece,3160,1273,422,14,1887,727,738,1465,408
2022-06-04,Greece,3447,1401,365,7,2046,830,851,1681,358
2022-06-05,Greece,3502,1466,411,6,2036,826,799,1625,405
2022-06-06,Greece,3156,1308,455,16,1848,703,690,1393,439
2022-06-07,Greece,3092,1284,430,33,1808,684,694,1378,397
2022-01-01,Hungary,1347,1159,0,0,188,93,95,188,0
2022-01-02,Hungary,1753,1477,1,0,276,135,140,275,1
2022-01-03,Hungary,1586,1345,0,0,241,123,118,241,0
2022-01-04,Hungary,1462,1232,2,1,230,113,115,228,1
2022-01-05,Hungary,1542,1299,8,2,243,116,119,235,6
2022-01-06,Hungary,1485,1276,4,1,209,103,102,205,3
2022-01-07,Hungary,1722,1450,6,5,272,135,131,266,1
2022-01-08,Hungary,1657,1445,0,0,212,107,105,212,0
2022-01-09,Hungary,1707,1460,0,0,247,121,126,247,0
2022-01-10,Hungary,1404,1185,4,4,219,111,104,215,0
2022-01-11,Hungary,1239,1047,3,0,192,93,96,189,3
2022-01-12,Hungary,1211,1026,10,4,185,86,89,175,6
2022-01-13,Hungary,1166,989,2,2,177,87,88,175,0
2022-01-14,Hungary,1369,1135,4,1,234,114,116,230,3
2022-01-15,Hungary,1299,1121,3,1,178,85,90,175,2
2022-01-16,Hungary,1395,1164,4,3,231,112,115,227,1
2022-01-17,Hungary,1185,977,3,0,208,106,99,205,3
2022-01-18,Hungary,1075,900,5,2,175,86,84,170,3
2022-01-19,Hungary,1070,888,4,3,182,90,88,178,1
2022-01-20,Hungary,1166,970,3,1,196,94,99,193,2
2022-01-21,Hungary,1320,1081,4,1,239,117,118,235,3
2022-01-22,Hungary,1249,1078,5,2,171,86,80,166,3
2022-01-23,Hungary,1345,1127,3,0,218,101,114,215,3
2022-01-24,Hungary,1045,845,7,2,200,103,90,193,5
2022-01-25,Hungary,933,768,1,1,165,79,85,164,0
2022-01-26,Hungary,1038,850,2,1,188,93,93,186,1
2022-01-27,Hungary,1146,960,3,0,186,95,88,183,3
2022-01-28,Hungary,1347,1099,3,1,248,121,124,245,2
2022-01-29,Hungary,1254,1097,1,1,157,80,76,156,0
2022-01-30,Hungary,1311,1097,1,0,214,98,115,213,1
2022-01-31,Hungary,1153,940,3,0,213,109,101,210,3
2022-02-01,Hungary,1121,936,3,1,185,95,87,182,2
2022-02-02,Hungary,1084,880,7,3,204,99,98,197,4
2022-02-03,Hungary,1208,998,7,2,210,102,101,203,5
2022-02-04,Hungary,1325,1071,3,1,254,125,126,251,2
2022-02-05,Hungary,1299,1132,0,0,167,84,83,167,0
2022-02-06,Hungary,1367,1132,1,0,235,115,119,234,1
2022-02-07,Hungary,1176,936,1,0,240,120,119,239,1
2022-02-08,Hungary,1098,917,2,2,181,89,90,179,0
2022-02-09,Hungary,1116,911,4,1,205,103,98,201,3
2022-02-10,Hungary,1235,1038,3,3,197,98,96,194,0
2022-02-11,Hungary,1437,1184,2,0,253,124,127,251,2
2022-02-12,Hungary,1422,1221,4,1,201,100,97,197,3
2022-02-13,Hungary,1504,1249,2,0,255,123,130,253,2
2022-02-14,Hungary,1371,1126,3,2,245,124,118,242,1
2022-02-15,Hungary,1296,1097,2,0,199,100,97,197,2
2022-02-16,Hungary,1252,1036,5,3,216,103,108,211,2
2022-02-17,Hungary,1320,1097,4,1,223,112,107,219,3
2022-02-18,Hungary,1433,1165,6,3,268,129,133,262,3
2022-02-19,Hungary,1464,1287,1,0,177,90,86,176,1
2022-02-20,Hungary,1528,1288,0,0,240,116,124,240,0
2022-02-21,Hungary,1322,1098,0,0,224,115,109,224,0
2022-02-22,Hungary,1275,1073,5,3,202,100,97,197,2
2022-02-23,Hungary,1261,1029,2,1,232,113,117,230,1
2022-02-24,Hungary,1504,1268,6,4,236,113,117,230,2
2022-02-25,Hungary,1712,1426,4,0,286,143,139,282,4
2022-02-26,Hungary,1649,1460,0,0,189,98,91,189,0
2022-02-27,Hungary,1703,1473,3,0,230,109,118,227,3
2022-02-28,Hungary,1563,1303,3,1,260,130,127,257,2
2022-03-01,Hungary,1487,1266,3,0,221,106,112,218,3
2022-03-02,Hungary,1580,1322,1,0,258,129,128,257,1
2022-03-03,Hungary,1667,1428,3,2,239,117,119,236,1
2022-03-04,Hungary,1841,1545,3,0,296,151,142,293,3
2022-03-05,Hungary,1811,1597,0,0,214,109,105,214,0
2022-03-06,Hungary,1872,1598,1,0,274,129,144,273,1
2022-03-07,Hungary,1692,1433,7,1,259,129,123,252,6
2022-03-08,Hungary,1538,1292,1,1,246,123,122,245,0
2022-03-09,Hungary,1612,1342,5,1,270,132,133,265,4
2022-03-10,Hungary,1608,1373,4,3,235,118,113,231,1
2022-03-11,Hungary,1802,1511,2,0,291,138,151,289,2
2022-03-12,Hungary,1658,1448,0,0,210,109,101,210,0
2022-03-13,Hungary,1770,1532,0,0,238,117,121,238,0
2022-03-14,Hungary,1574,1344,4,0,230,119,107,226,4
2022-03-15,Hungary,1534,1334,1,0,200,97,102,199,1
2022-03-16,Hungary,1611,1371,2,1,240,117,121,238,1
2022-03-17,Hungary,1675,1454,3,3,221,112,106,218,0
2022-03-18,Hungary,1872,1599,2,0,273,138,133,271,2
2022-03-19,Hungary,1761,1540,2,0,221,110,109,219,2
2022-03-20,Hungary,1835,1583,0,0,252,118,134,252,0
2022-03-21,Hungary,1647,1392,2,0,255,127,126,253,2
2022-03-22,Hungary,1490,1254,7,1,236,120,109,229,6
2022-03-23,Hungary,1648,1397,4,2,251,123,124,247,2
2022-03-24,Hungary,1704,1469,4,4,235,115,116,231,0
2022-03-25,Hungary,1852,1562,3,1,290,147,140,287,2
2022-03-26,Hungary,1856,1652,2,0,204,100,102,202,2
2022-03-27,Hungary,1970,1687,3,0,283,139,141,280,3
2022-03-28,Hungary,1876,1587,1,0,289,146,142,288,1
2022-03-29,Hungary,1835,1580,2,1,255,124,129,253,1
2022-03-30,Hungary,1929,1612,6,3,317,156,155,311,3
2022-03-31,Hungary,1977,1698,5,1,279,140,134,274,4
2022-04-01,Hungary,2117,1810,3,2,307,153,151,304,1
2022-04-02,Hungary,2208,1991,4,0,217,103,110,213,4
2022-04-03,Hungary,2211,1940,0,0,271,132,139,271,0
2022-04-04,Hungary,2002,1702,1,0,300,152,147,299,1
2022-04-05,Hungary,1984,1720,3,2,264,133,128,261,1
2022-04-06,Hungary,2046,1740,3,1,306,151,152,303,2
2022-04-07,Hungary,2125,1830,1,1,295,146,148,294,0
2022-04-08,Hungary,2294,1967,1,0,327,162,164,326,1
2022-04-09,Hungary,2326,2099,1,0,227,114,112,226,1
2022-04-10,Hungary,2347,2051,1,0,296,145,150,295,1
2022-04-11,Hungary,2181,1851,4,1,330,166,160,326,3
2022-04-12,Hungary,2081,1792,2,1,289,143,144,287,1
2022-04-13,Hungary,2130,1821,2,2,309,153,154,307,0
2022-04-14,Hungary,2275,1952,7,3,323,159,157,316,4
2022-04-15,Hungary,2356,2030,1,0,326,165,160,325,1
2022-04-16,Hungary,2322,2097,0,0,225,109,116,225,0
2022-04-17,Hungary,2363,2071,0,0,292,143,149,292,0
2022-04-18,Hungary,2273,1969,0,0,304,152,152,304,0
2022-04-19,Hungary,2236,1929,4,3,307,151,152,303,1
2022-04-20,Hungary,2176,1869,6,3,307,152,149,301,3
2022-04-21,Hungary,2184,1868,2,2,316,157,157,314,0
2022-04-22,Hungary,2393,2071,1,0,322,159,162,321,1
2022-04-23,Hungary,2436,2198,1,0,238,124,113,237,1
2022-04-24,Hungary,2443,2167,0,0,276,134,142,276,0
2022-04-25,Hungary,2258,1942,0,0,316,159,157,316,0
2022-04-26,Hungary,2242,1949,2,1,293,147,144,291,1
2022-04-27,Hungary,2272,1967,1,1,305,150,154,304,0
2022-04-28,Hungary,2373,2060,1,0,313,155,157,312,1
2022-04-29,Hungary,2507,2170,4,3,337,169,164,333,1
2022-04-30,Hungary,2582,2336,2,0,246,119,125,244,2
2022-05-01,Hungary,2661,2368,1,0,293,145,147,292,1
2022-05-02,Hungary,2374,2052,3,3,322,160,159,319,0
2022-05-03,Hungary,2371,2073,1,0,298,150,147,297,1
2022-05-04,Hungary,2407,2067,6,4,340,163,171,334,2
2022-05-05,Hungary,2463,2144,5,4,319,159,155,314,1
2022-05-06,Hungary,2518,2178,8,4,340,169,163,332,4
2022-05-07,Hungary,2594,2344,1,1,250,123,126,249,0
2022-05-08,Hungary,2666,2355,1,1,311,156,154,310,0
2022-05-09,Hungary,2398,2064,4,1,334,168,162,330,3
2022-05-10,Hungary,2319,2025,3,1,294,144,147,291,2
2022-05-11,Hungary,2270,1949,6,3,321,160,155,315,3
2022-05-12,Hungary,2379,2059,4,3,320,157,159,316,1
2022-05-13,Hungary,2580,2241,3,2,339,166,170,336,1
2022-05-14,Hungary,2702,2442,3,2,260,127,130,257,1
2022-05-15,Hungary,2667,2349,2,1,318,158,158,316,1
2022-05-16,Hungary,2455,2118,3,1,337,169,165,334,2
2022-05-17,Hungary,2317,2020,1,0,297,150,146,296,1
2022-05-18,Hungary,2409,2077,3,2,332,165,164,329,1
2022-05-19,Hungary,2472,2157,2,1,315,158,155,313,1
2022-05-20,Hungary,2622,2287,3,1,335,168,164,332,2
2022-05-21,Hungary,2790,2549,0,0,241,121,120,241,0
2022-05-22,Hungary,2701,2403,2,0,298,144,152,296,2
2022-05-23,Hungary,2506,2173,4,0,333,168,161,329,4
2022-05-24,Hungary,2437,2137,0,0,300,147,153,300,0
2022-05-25,Hungary,2563,2232,0,0,331,168,163,331,0
2022-05-26,Hungary,2654,2350,6,4,304,147,151,298,2
2022-05-27,Hungary,2751,2425,2,1,326,160,164,324,1
2022-05-28,Hungary,2873,2620,2,0,253,130,121,251,2
2022-05-29,Hungary,2873,2569,1,0,304,145,158,303,1
2022-05-30,Hungary,2631,2298,5,2,333,162,166,328,3
2022-05-31,Hungary,2637,2318,2,2,319,159,158,317,0
2022-06-01,Hungary,2571,2230,2,0,341,174,165,339,2
2022-06-02,Hungary,2828,2515,4,2,313,156,153,309,2
2022-06-03,Hungary,2923,2561,0,0,362,183,179,362,0
2022-06-04,Hungary,3073,2807,1,0,266,132,133,265,1
2022-06-05,Hungary,3076,2761,3,3,315,152,160,312,0
2022-06-06,Hungary,2768,2433,3,1,335,170,162,332,2
2022-06-07,Hungary,2786,2459,1,0,327,160,166,326,1
2022-01-01,Ireland,854,407,9,1,447,219,219,438,8
2022-01-02,Ireland,1158,546,10,2,612,299,303,602,8
2022-01-03,Ireland,1120,536,10,2,584,286,288,574,8
2022-01-04,Ireland,952,446,17,4,506,245,244,489,13
2022-01-05,Ireland,1109,572,20,5,537,257,260,517,15
2022-01-06,Ireland,984,477,16,4,507,248,243,491,12
2022-01-07,Ireland,1028,442,16,4,586,283,287,570,12
2022-01-08,Ireland,877,357,10,2,520,255,255,510,8
2022-01-09,Ireland,1100,496,11,0,604,296,297,593,11
2022-01-10,Ireland,917,513,19,7,404,192,193,385,12
2022-01-11,Ireland,704,400,20,7,304,141,143,284,13
2022-01-12,Ireland,752,427,21,7,325,155,149,304,14
2022-01-13,Ireland,806,455,21,7,351,165,165,330,14
2022-01-14,Ireland,967,534,23,10,433,203,207,410,13
2022-01-15,Ireland,940,559,10,3,381,184,187,371,7
2022-01-16,Ireland,1065,602,13,5,463,224,226,450,8
2022-01-17,Ireland,753,354,23,12,399,193,183,376,11
2022-01-18,Ireland,779,453,22,9,326,152,152,304,13
2022-01-19,Ireland,772,456,20,7,316,146,150,296,13
2022-01-20,Ireland,772,430,19,3,342,164,159,323,16
2022-01-21,Ireland,938,487,18,6,451,216,217,433,12
2022-01-22,Ireland,922,536,13,5,386,184,189,373,8
2022-01-23,Ireland,965,518,9,3,447,221,217,438,6
2022-01-24,Ireland,904,492,21,10,412,199,192,391,11
2022-01-25,Ireland,721,412,19,9,309,146,144,290,10
2022-01-26,Ireland,705,392,17,8,313,145,151,296,9
2022-01-27,Ireland,772,401,16,9,371,180,175,355,7
2022-01-28,Ireland,849,394,25,10,455,211,219,430,15
2022-01-29,Ireland,749,370,15,9,379,179,185,364,6
2022-01-30,Ireland,773,312,17,10,461,222,222,444,7
2022-01-31,Ireland,754,350,17,9,404,194,193,387,8
2022-02-01,Ireland,810,390,30,15,420,196,194,390,15
2022-02-02,Ireland,820,394,20,10,426,207,199,406,10
2022-02-03,Ireland,856,394,22,9,462,216,224,440,13
2022-02-04,Ireland,958,381,22,10,577,274,281,555,12
2022-02-05,Ireland,850,387,6,2,463,230,227,457,4
2022-02-06,Ireland,1003,457,13,5,546,265,268,533,8
2022-02-07,Ireland,934,438,15,5,496,246,235,481,10
2022-02-08,Ireland,907,507,17,9,400,193,190,383,8
2022-02-09,Ireland,881,455,13,5,426,203,210,413,8
2022-02-10,Ireland,957,510,12,4,447,218,217,435,8
2022-02-11,Ireland,1068,470,18,5,598,289,291,580,13
2022-02-12,Ireland,952,442,16,9,510,247,247,494,7
2022-02-13,Ireland,995,429,18,7,566,271,277,548,11
2022-02-14,Ireland,893,366,24,9,527,254,249,503,15
2022-02-15,Ireland,780,331,27,9,449,214,208,422,18
2022-02-16,Ireland,806,376,6,0,430,210,214,424,6
2022-02-17,Ireland,890,411,14,10,479,235,230,465,4
2022-02-18,Ireland,883,384,8,1,499,239,252,491,7
2022-02-19,Ireland,1041,488,8,1,553,276,269,545,7
2022-02-20,Ireland,928,383,4,0,545,271,270,541,4
2022-02-21,Ireland,953,431,14,4,522,254,254,508,10
2022-02-22,Ireland,902,450,13,6,452,223,216,439,7
2022-02-23,Ireland,844,377,9,2,467,227,231,458,7
2022-02-24,Ireland,955,462,10,8,493,240,243,483,2
2022-02-25,Ireland,1165,547,23,2,618,294,301,595,21
2022-02-26,Ireland,998,483,12,2,515,253,250,503,10
2022-02-27,Ireland,1003,432,14,4,571,278,279,557,10
2022-02-28,Ireland,1085,511,28,6,574,279,267,546,22
2022-03-01,Ireland,1079,558,32,9,521,244,245,489,23
2022-03-02,Ireland,1055,510,27,5,545,257,261,518,22
2022-03-03,Ireland,1057,497,26,6,560,271,263,534,20
2022-03-04,Ireland,1178,529,35,6,649,300,314,614,29
2022-03-05,Ireland,1143,586,11,3,557,275,271,546,8
2022-03-06,Ireland,1170,572,12,2,598,289,297,586,10
2022-03-07,Ireland,1205,614,18,5,591,288,285,573,13
2022-03-08,Ireland,909,407,14,5,502,247,241,488,9
2022-03-09,Ireland,918,380,21,5,538,261,256,517,16
2022-03-10,Ireland,1175,615,28,7,560,268,264,532,21
2022-03-11,Ireland,1119,475,27,6,644,309,308,617,21
2022-03-12,Ireland,973,424,16,2,549,264,269,533,14
2022-03-13,Ireland,1053,407,20,5,646,310,316,626,15
2022-03-14,Ireland,1256,629,24,3,627,304,299,603,21
2022-03-15,Ireland,1124,582,24,5,542,259,259,518,19
2022-03-16,Ireland,1085,513,23,3,572,273,276,549,20
2022-03-17,Ireland,1103,550,21,5,553,263,269,532,16
2022-03-18,Ireland,1334,662,21,5,672,320,331,651,16
2022-03-19,Ireland,1204,616,16,2,588,287,285,572,14
2022-03-20,Ireland,1249,561,23,6,688,334,331,665,17
2022-03-21,Ireland,1243,618,19,2,625,308,298,606,17
2022-03-22,Ireland,1025,512,21,5,513,246,246,492,16
2022-03-23,Ireland,1051,504,23,5,547,258,266,524,18
2022-03-24,Ireland,1176,623,17,3,553,270,266,536,14
2022-03-25,Ireland,1289,629,18,3,660,322,320,642,15
2022-03-26,Ireland,1175,636,12,2,539,262,265,527,10
2022-03-27,Ireland,1427,698,9,1,729,357,363,720,8
2022-03-28,Ireland,1400,664,13,2,736,364,359,723,11
2022-03-29,Ireland,1410,700,12,2,710,354,344,698,10
2022-03-30,Ireland,1415,668,12,2,747,367,368,735,10
2022-03-31,Ireland,1415,671,16,6,744,361,367,728,10
2022-04-01,Ireland,1519,729,14,3,790,389,387,776,11
2022-04-02,Ireland,1431,772,16,0,659,323,320,643,16
2022-04-03,Ireland,1398,672,8,0,726,356,362,718,8
2022-04-04,Ireland,1474,702,20,2,772,379,373,752,18
2022-04-05,Ireland,1449,722,21,4,727,351,355,706,17
2022-04-06,Ireland,1312,551,25,1,761,369,367,736,24
2022-04-07,Ireland,1425,666,20,2,759,369,370,739,18
2022-04-08,Ireland,1508,702,22,2,806,384,400,784,20
2022-04-09,Ireland,1388,688,13,3,700,346,341,687,10
2022-04-10,Ireland,1618,847,20,5,771,375,376,751,15
2022-04-11,Ireland,1394,651,22,4,743,363,358,721,18
2022-04-12,Ireland,1387,644,22,5,743,366,355,721,17
2022-04-13,Ireland,1378,624,24,4,754,363,367,730,20
2022-04-14,Ireland,1499,734,27,7,765,367,371,738,20
2022-04-15,Ireland,1466,663,19,6,803,389,395,784,13
2022-04-16,Ireland,1388,716,14,4,672,331,327,658,10
2022-04-17,Ireland,1311,586,12,4,725,360,353,713,8
2022-04-18,Ireland,1351,580,10,1,771,381,380,761,9
2022-04-19,Ireland,1337,589,13,1,748,363,372,735,12
2022-04-20,Ireland,1447,682,13,2,765,378,374,752,11
2022-04-21,Ireland,1393,629,13,2,764,376,375,751,11
2022-04-22,Ireland,1592,759,16,3,833,409,408,817,13
2022-04-23,Ireland,1363,675,12,3,688,337,339,676,9
2022-04-24,Ireland,1566,788,11,3,778,380,387,767,8
2022-04-25,Ireland,1545,737,20,4,808,392,396,788,16
2022-04-26,Ireland,1458,702,16,3,756,370,370,740,13
2022-04-27,Ireland,1595,800,21,4,795,391,383,774,17
2022-04-28,Ireland,1571,798,25,3,773,373,375,748,22
2022-04-29,Ireland,1440,597,16,2,843,415,412,827,14
2022-04-30,Ireland,1381,688,17,5,693,336,340,676,12
2022-05-01,Ireland,1454,648,13,4,806,398,395,793,9
2022-05-02,Ireland,1524,735,9,0,789,390,390,780,9
2022-05-03,Ireland,1383,634,11,0,749,366,372,738,11
2022-05-04,Ireland,1505,716,15,2,789,394,380,774,13
2022-05-05,Ireland,1539,781,14,0,758,370,374,744,14
2022-05-06,Ireland,1675,822,14,3,853,417,422,839,11
2022-05-07,Ireland,1560,833,10,1,727,357,360,717,9
2022-05-08,Ireland,1556,757,11,1,799,394,394,788,10
2022-05-09,Ireland,1447,639,12,1,808,396,400,796,11
2022-05-10,Ireland,1484,714,12,0,770,378,380,758,12
2022-05-11,Ireland,1473,677,11,1,796,398,387,785,10
2022-05-12,Ireland,1480,669,12,1,811,397,402,799,11
2022-05-13,Ireland,1559,693,13,2,866,424,429,853,11
2022-05-14,Ireland,1546,830,13,2,716,351,352,703,11
2022-05-15,Ireland,1536,722,15,3,814,401,398,799,12
2022-05-16,Ireland,1558,746,11,0,812,402,399,801,11
2022-05-17,Ireland,1481,704,15,3,777,383,379,762,12
2022-05-18,Ireland,1552,743,15,2,809,394,400,794,13
2022-05-19,Ireland,1501,669,18,5,832,408,406,814,13
2022-05-20,Ireland,1486,614,14,2,872,428,430,858,12
2022-05-21,Ireland,1554,810,14,2,744,365,365,730,12
2022-05-22,Ireland,1760,938,13,3,822,400,409,809,10
2022-05-23,Ireland,1629,795,15,3,834,415,404,819,12
2022-05-24,Ireland,1544,744,15,3,800,398,387,785,12
2022-05-25,Ireland,1602,775,20,8,827,400,407,807,12
2022-05-26,Ireland,1555,703,20,9,852,411,421,832,11
2022-05-27,Ireland,1718,813,20,3,905,440,445,885,17
2022-05-28,Ireland,1544,780,13,2,764,374,377,751,11
2022-05-29,Ireland,1681,825,14,4,856,428,414,842,10
2022-05-30,Ireland,1701,842,13,1,859,423,423,846,12
2022-05-31,Ireland,1594,784,18,4,810,397,395,792,14
2022-06-01,Ireland,1442,590,16,3,852,415,421,836,13
2022-06-02,Ireland,1614,802,19,4,812,395,398,793,15
2022-06-03,Ireland,1642,767,16,2,875,431,428,859,14
2022-06-04,Ireland,1592,826,16,2,766,378,372,750,14
2022-06-05,Ireland,1560,731,13,2,829,413,403,816,11
2022-06-06,Ireland,1455,599,12,3,856,419,425,844,9
2022-06-07,Ireland,1536,714,15,2,822,401,406,807,13
2022-01-01,Israel,272,106,22,0,166,68,76,144,22
2022-01-02,Israel,358,73,60,1,285,109,116,225,59
2022-01-03,Israel,324,81,45,5,243,101,97,198,40
2022-01-04,Israel,291,76,35,0,215,90,90,180,35
2022-01-05,Israel,293,73,43,3,220,90,87,177,40
2022-01-06,Israel,346,67,48,1,279,118,113,231,47
2022-01-07,Israel,256,101,26,7,155,63,66,129,19
2022-01-08,Israel,292,111,21,0,181,80,80,160,21
2022-01-09,Israel,376,78,50,2,298,124,124,248,48
2022-01-10,Israel,261,58,39,2,203,84,80,164,37
2022-01-11,Israel,237,56,45,3,181,67,69,136,42
2022-01-12,Israel,281,52,52,4,229,88,89,177,48
2022-01-13,Israel,324,59,42,2,265,113,110,223,40
2022-01-14,Israel,224,83,9,1,141,64,68,132,8
2022-01-15,Israel,238,92,14,0,146,66,66,132,14
2022-01-16,Israel,339,60,36,3,279,120,123,243,33
2022-01-17,Israel,301,56,53,11,245,99,93,192,42
2022-01-18,Israel,265,50,39,5,215,90,86,176,34
2022-01-19,Israel,272,50,43,1,222,89,90,179,42
2022-01-20,Israel,334,53,47,2,281,117,117,234,45
2022-01-21,Israel,242,79,12,0,163,74,77,151,12
2022-01-22,Israel,267,88,24,2,179,75,80,155,22
2022-01-23,Israel,337,57,43,3,280,118,119,237,40
2022-01-24,Israel,237,51,32,3,186,84,70,154,29
2022-01-25,Israel,213,35,31,1,178,77,70,147,30
2022-01-26,Israel,248,49,31,1,199,81,87,168,30
2022-01-27,Israel,341,57,39,1,284,117,128,245,38
2022-01-28,Israel,238,87,8,0,151,71,72,143,8
2022-01-29,Israel,239,81,16,0,158,69,73,142,16
2022-01-30,Israel,339,64,44,4,275,118,113,231,40
2022-01-31,Israel,265,52,39,9,213,88,86,174,30
2022-02-01,Israel,283,59,42,3,224,93,89,182,39
2022-02-02,Israel,298,58,45,6,240,99,96,195,39
2022-02-03,Israel,347,59,44,2,288,119,125,244,42
2022-02-04,Israel,263,80,11,0,183,83,89,172,11
2022-02-05,Israel,280,92,21,1,188,86,81,167,20
2022-02-06,Israel,369,58,52,7,311,129,130,259,45
2022-02-07,Israel,321,67,34,4,254,113,107,220,30
2022-02-08,Israel,293,58,39,2,235,100,96,196,37
2022-02-09,Israel,304,51,51,3,253,95,107,202,48
2022-02-10,Israel,382,63,40,1,319,137,142,279,39
2022-02-11,Israel,276,95,14,0,181,85,82,167,14
2022-02-12,Israel,302,85,25,1,217,96,96,192,24
2022-02-13,Israel,383,58,51,1,325,136,138,274,50
2022-02-14,Israel,323,57,33,7,266,119,114,233,26
2022-02-15,Israel,336,62,43,2,274,117,114,231,41
2022-02-16,Israel,337,59,58,7,278,107,113,220,51
2022-02-17,Israel,402,61,54,3,341,143,144,287,51
2022-02-18,Israel,310,89,18,1,221,109,94,203,17
2022-02-19,Israel,301,92,30,1,209,87,92,179,29
2022-02-20,Israel,388,61,46,2,327,134,147,281,44
2022-02-21,Israel,345,58,49,6,287,121,117,238,43
2022-02-22,Israel,347,66,49,5,281,121,111,232,44
2022-02-23,Israel,346,56,47,2,290,119,124,243,45
2022-02-24,Israel,398,63,52,0,335,139,144,283,52
2022-02-25,Israel,315,104,16,1,211,101,94,195,15
2022-02-26,Israel,296,97,22,0,199,91,86,177,22
2022-02-27,Israel,405,68,65,3,337,131,141,272,62
2022-02-28,Israel,365,65,47,2,300,128,125,253,45
2022-03-01,Israel,354,58,36,0,296,134,126,260,36
2022-03-02,Israel,388,69,58,6,319,131,130,261,52
2022-03-03,Israel,452,64,69,1,388,161,158,319,68
2022-03-04,Israel,351,122,15,0,229,106,108,214,15
2022-03-05,Israel,349,100,29,0,249,104,116,220,29
2022-03-06,Israel,450,64,56,2,386,167,163,330,54
2022-03-07,Israel,428,83,54,4,345,144,147,291,50
2022-03-08,Israel,404,66,57,2,338,140,141,281,55
2022-03-09,Israel,425,80,52,7,345,147,146,293,45
2022-03-10,Israel,437,38,61,1,399,168,170,338,60
2022-03-11,Israel,344,124,19,0,220,104,97,201,19
2022-03-12,Israel,338,106,28,0,232,97,107,204,28
2022-03-13,Israel,453,71,50,4,382,169,163,332,46
2022-03-14,Israel,436,90,48,5,346,154,144,298,43
2022-03-15,Israel,415,66,51,2,349,145,153,298,49
2022-03-16,Israel,433,87,50,4,346,146,150,296,46
2022-03-17,Israel,470,78,40,2,392,173,179,352,38
2022-03-18,Israel,362,117,16,1,245,122,107,229,15
2022-03-19,Israel,376,109,29,1,267,112,126,238,28
2022-03-20,Israel,503,68,48,3,435,194,193,387,45
2022-03-21,Israel,470,85,74,9,385,160,151,311,65
2022-03-22,Israel,413,64,53,1,349,149,147,296,52
2022-03-23,Israel,442,70,56,4,372,153,163,316,52
2022-03-24,Israel,497,69,55,1,428,186,187,373,54
2022-03-25,Israel,372,122,12,0,250,126,112,238,12
2022-03-26,Israel,379,111,29,0,268,112,127,239,29
2022-03-27,Israel,503,73,48,0,430,188,194,382,48
2022-03-28,Israel,481,58,58,6,423,188,177,365,52
2022-03-29,Israel,460,81,47,4,379,170,162,332,43
2022-03-30,Israel,428,57,37,3,371,165,169,334,34
2022-03-31,Israel,507,68,50,2,439,193,196,389,48
2022-04-01,Israel,382,103,19,3,279,134,126,260,16
2022-04-02,Israel,375,93,26,0,282,121,135,256,26
2022-04-03,Israel,523,83,41,1,440,199,200,399,40
2022-04-04,Israel,468,78,34,3,390,177,179,356,31
2022-04-05,Israel,448,70,59,3,378,162,157,319,56
2022-04-06,Israel,481,49,56,7,432,189,187,376,49
2022-04-07,Israel,552,68,59,3,484,214,211,425,56
2022-04-08,Israel,440,106,21,5,334,162,151,313,16
2022-04-09,Israel,387,100,28,1,287,121,138,259,27
2022-04-10,Israel,547,64,54,6,483,215,214,429,48
2022-04-11,Israel,554,74,63,6,480,209,208,417,57
2022-04-12,Israel,528,71,44,2,457,205,208,413,42
2022-04-13,Israel,568,54,54,5,514,217,243,460,49
2022-04-14,Israel,718,88,62,0,630,291,277,568,62
2022-04-15,Israel,535,124,35,0,411,185,191,376,35
2022-04-16,Israel,465,104,16,0,361,180,165,345,16
2022-04-17,Israel,635,85,37,0,550,259,254,513,37
2022-04-18,Israel,553,86,28,1,467,224,215,439,27
2022-04-19,Israel,548,106,33,1,442,202,207,409,32
2022-04-20,Israel,568,92,36,0,476,214,226,440,36
2022-04-21,Israel,596,98,37,0,498,227,234,461,37
2022-04-22,Israel,449,91,11,1,358,173,174,347,10
2022-04-23,Israel,584,98,35,0,486,224,227,451,35
2022-04-24,Israel,696,67,53,1,629,297,279,576,52
2022-04-25,Israel,581,83,56,6,498,224,218,442,50
2022-04-26,Israel,500,78,44,3,422,192,186,378,41
2022-04-27,Israel,489,67,43,5,422,192,187,379,38
2022-04-28,Israel,588,89,49,6,499,227,223,450,43
2022-04-29,Israel,425,119,15,0,306,146,145,291,15
2022-04-30,Israel,403,117,21,0,286,128,137,265,21
2022-05-01,Israel,601,99,56,4,502,221,225,446,52
2022-05-02,Israel,612,117,51,4,495,225,219,444,47
2022-05-03,Israel,552,113,33,3,439,205,201,406,30
2022-05-04,Israel,497,108,24,0,389,182,183,365,24
2022-05-05,Israel,552,121,18,2,431,205,208,413,16
2022-05-06,Israel,484,152,12,0,332,162,158,320,12
2022-05-07,Israel,496,152,31,0,344,148,165,313,31
2022-05-08,Israel,639,96,57,4,543,245,241,486,53
2022-05-09,Israel,566,93,40,6,473,224,209,433,34
2022-05-10,Israel,494,91,35,6,403,183,185,368,29
2022-05-11,Israel,512,86,46,3,426,186,194,380,43
2022-05-12,Israel,576,98,45,1,478,219,214,433,44
2022-05-13,Israel,421,125,11,0,296,147,138,285,11
2022-05-14,Israel,379,90,26,0,289,123,140,263,26
2022-05-15,Israel,586,89,57,7,497,221,219,440,50
2022-05-16,Israel,526,95,53,8,431,193,185,378,45
2022-05-17,Israel,486,86,37,3,400,183,180,363,34
2022-05-18,Israel,494,67,48,5,427,188,191,379,43
2022-05-19,Israel,574,93,41,0,481,224,216,440,41
2022-05-20,Israel,420,112,15,1,308,150,143,293,14
2022-05-21,Israel,380,95,25,2,285,124,136,260,23
2022-05-22,Israel,566,78,43,2,488,219,226,445,41
2022-05-23,Israel,509,81,37,2,428,198,193,391,35
2022-05-24,Israel,515,100,40,4,415,186,189,375,36
2022-05-25,Israel,516,73,36,2,443,198,209,407,34
2022-05-26,Israel,593,102,44,0,491,229,218,447,44
2022-05-27,Israel,402,104,12,0,298,154,132,286,12
2022-05-28,Israel,393,96,27,0,297,128,142,270,27
2022-05-29,Israel,574,83,49,7,491,217,225,442,42
2022-05-30,Israel,547,80,41,11,467,213,213,426,30
2022-05-31,Israel,534,98,43,11,436,194,199,393,32
2022-06-01,Israel,514,44,57,8,470,207,206,413,49
2022-06-02,Israel,651,99,49,4,552,254,249,503,45
2022-06-03,Israel,476,115,25,0,361,172,164,336,25
2022-06-04,Israel,377,118,6,1,259,121,132,253,5
2022-06-05,Israel,502,118,20,0,384,182,182,364,20
2022-06-06,Israel,606,74,58,6,532,235,239,474,52
2022-06-07,Israel,550,100,41,1,450,208,201,409,40
2022-01-01,Italy,2992,1080,507,4,1912,701,704,1405,503
2022-01-02,Italy,4057,1428,678,9,2629,979,972,1951,669
2022-01-03,Italy,3888,1217,746,11,2671,965,960,1925,735
2022-01-04,Italy,3344,1046,716,19,2298,795,787,1582,697
2022-01-05,Italy,3262,975,725,35,2287,780,782,1562,690
2022-01-06,Italy,3190,981,671,16,2209,776,762,1538,655
2022-01-07,Italy,3653,1119,725,15,2534,882,927,1809,710
2022-01-08,Italy,3443,1200,614,9,2243,814,815,1629,605
2022-01-09,Italy,3852,1268,695,7,2584,943,946,1889,688
2022-01-10,Italy,2952,865,675,16,2087,715,697,1412,659
2022-01-11,Italy,2317,724,536,14,1593,530,527,1057,522
2022-01-12,Italy,2346,758,571,17,1588,503,514,1017,554
2022-01-13,Italy,2449,750,590,14,1699,556,553,1109,576
2022-01-14,Italy,3029,927,647,17,2102,713,742,1455,630
2022-01-15,Italy,2563,968,465,15,1595,573,557,1130,450
2022-01-16,Italy,2881,985,564,17,1896,658,674,1332,547
2022-01-17,Italy,2653,793,627,15,1860,629,604,1233,612
2022-01-18,Italy,2249,714,534,25,1535,496,505,1001,509
2022-01-19,Italy,2250,718,568,27,1532,485,479,964,541
2022-01-20,Italy,2451,738,591,38,1713,562,560,1122,553
2022-01-21,Italy,2926,883,624,14,2043,701,718,1419,610
2022-01-22,Italy,2465,902,475,10,1563,549,539,1088,465
2022-01-23,Italy,2854,948,569,14,1906,666,671,1337,555
2022-01-24,Italy,2521,724,618,35,1797,594,585,1179,583
2022-01-25,Italy,2115,597,526,26,1518,495,497,992,500
2022-01-26,Italy,2210,713,536,24,1497,484,477,961,512
2022-01-27,Italy,2375,725,555,30,1650,549,546,1095,525
2022-01-28,Italy,2964,934,649,18,2030,670,711,1381,631
2022-01-29,Italy,2477,905,462,13,1572,563,547,1110,449
2022-01-30,Italy,2911,1032,575,12,1879,657,647,1304,563
2022-01-31,Italy,2630,767,590,27,1863,636,637,1273,563
2022-02-01,Italy,2412,686,541,22,1726,590,595,1185,519
2022-02-02,Italy,2452,729,576,23,1723,574,573,1147,553
2022-02-03,Italy,2680,781,608,33,1899,645,646,1291,575
2022-02-04,Italy,3235,949,704,32,2286,775,807,1582,672
2022-02-05,Italy,2737,971,470,6,1766,649,647,1296,464
2022-02-06,Italy,3131,1073,579,7,2058,741,738,1479,572
2022-02-07,Italy,2980,891,629,14,2089,732,728,1460,615
2022-02-08,Italy,2529,741,547,31,1788,632,609,1241,516
2022-02-09,Italy,2650,805,589,40,1845,615,641,1256,549
2022-02-10,Italy,2892,881,608,40,2011,700,703,1403,568
2022-02-11,Italy,3497,1013,715,34,2484,873,896,1769,681
2022-02-12,Italy,3067,1060,508,15,2007,751,748,1499,493
2022-02-13,Italy,3243,1077,586,12,2166,793,787,1580,574
2022-02-14,Italy,3160,900,640,16,2260,807,813,1620,624
2022-02-15,Italy,2724,802,586,18,1922,673,663,1336,568
2022-02-16,Italy,2754,801,627,25,1953,655,671,1326,602
2022-02-17,Italy,2940,860,637,33,2080,728,715,1443,604
2022-02-18,Italy,3512,1104,745,23,2408,818,845,1663,722
2022-02-19,Italy,3236,1169,528,26,2067,768,771,1539,502
2022-02-20,Italy,3475,1224,629,24,2251,815,807,1622,605
2022-02-21,Italy,3255,1013,671,22,2242,788,783,1571,649
2022-02-22,Italy,2775,840,564,32,1935,680,691,1371,532
2022-02-23,Italy,2896,878,641,45,2018,689,688,1377,596
2022-02-24,Italy,3127,948,662,45,2179,755,762,1517,617
2022-02-25,Italy,3667,1148,751,33,2519,873,895,1768,718
2022-02-26,Italy,3274,1213,533,31,2061,768,760,1528,502
2022-02-27,Italy,3525,1224,639,27,2301,837,825,1662,612
2022-02-28,Italy,3385,1047,685,35,2338,837,816,1653,650
2022-03-01,Italy,3051,903,640,44,2148,758,750,1508,596
2022-03-02,Italy,3048,939,635,23,2109,728,746,1474,612
2022-03-03,Italy,3333,994,705,34,2339,817,817,1634,671
2022-03-04,Italy,3826,1174,773,26,2652,921,958,1879,747
2022-03-05,Italy,3362,1201,552,22,2161,817,792,1609,530
2022-03-06,Italy,3645,1239,640,18,2406,881,885,1766,622
2022-03-07,Italy,3566,1056,737,28,2510,891,882,1773,709
2022-03-08,Italy,3020,949,608,31,2071,735,728,1463,577
2022-03-09,Italy,3185,966,653,26,2219,778,788,1566,627
2022-03-10,Italy,3411,1002,741,26,2409,825,843,1668,715
2022-03-11,Italy,3813,1146,757,26,2667,955,955,1910,731
2022-03-12,Italy,3292,1192,527,11,2100,784,789,1573,516
2022-03-13,Italy,3692,1249,646,12,2443,902,895,1797,634
2022-03-14,Italy,3563,1152,684,24,2411,872,855,1727,660
2022-03-15,Italy,3152,1023,620,24,2129,754,755,1509,596
2022-03-16,Italy,3232,1004,668,26,2228,774,786,1560,642
2022-03-17,Italy,3374,1055,689,17,2319,809,821,1630,672
2022-03-18,Italy,3866,1219,740,24,2647,949,958,1907,716
2022-03-19,Italy,3419,1235,531,13,2184,829,824,1653,518
2022-03-20,Italy,3769,1299,643,13,2470,918,909,1827,630
2022-03-21,Italy,3580,1087,719,23,2493,892,882,1774,696
2022-03-22,Italy,3115,960,633,26,2155,768,754,1522,607
2022-03-23,Italy,3273,1007,659,22,2266,797,810,1607,637
2022-03-24,Italy,3504,1049,706,36,2455,866,883,1749,670
2022-03-25,Italy,3911,1191,759,27,2720,969,992,1961,732
2022-03-26,Italy,3449,1231,542,19,2218,856,820,1676,523
2022-03-27,Italy,4425,1503,744,17,2922,1090,1088,2178,727
2022-03-28,Italy,4327,1317,827,27,3010,1099,1084,2183,800
2022-03-29,Italy,4027,1205,780,30,2822,1018,1024,2042,750
2022-03-30,Italy,4035,1228,771,20,2807,1011,1025,2036,751
2022-03-31,Italy,4262,1269,833,28,2993,1079,1081,2160,805
2022-04-01,Italy,4599,1429,844,24,3170,1153,1173,2326,820
2022-04-02,Italy,4365,1584,691,13,2781,1045,1045,2090,678
2022-04-03,Italy,4662,1582,757,13,3080,1165,1158,2323,744
2022-04-04,Italy,4455,1326,836,24,3129,1153,1140,2293,812
2022-04-05,Italy,4180,1251,808,30,2929,1054,1067,2121,778
2022-04-06,Italy,4310,1300,805,25,3010,1106,1099,2205,780
2022-04-07,Italy,4480,1325,844,26,3155,1152,1159,2311,818
2022-04-08,Italy,5004,1629,881,33,3375,1223,1271,2494,848
2022-04-09,Italy,4811,1871,680,16,2940,1133,1127,2260,664
2022-04-10,Italy,4916,1720,773,15,3196,1215,1208,2423,758
2022-04-11,Italy,4610,1499,803,26,3111,1162,1146,2308,777
2022-04-12,Italy,4520,1423,843,33,3097,1126,1128,2254,810
2022-04-13,Italy,4820,1561,891,26,3259,1173,1195,2368,865
2022-04-14,Italy,5154,1696,933,36,3458,1266,1259,2525,897
2022-04-15,Italy,5199,1741,890,19,3458,1273,1295,2568,871
2022-04-16,Italy,4907,1892,700,17,3015,1168,1147,2315,683
2022-04-17,Italy,4708,1697,687,10,3011,1157,1167,2324,677
2022-04-18,Italy,5047,1720,833,17,3327,1253,1241,2494,816
2022-04-19,Italy,4827,1472,911,32,3355,1206,1238,2444,879
2022-04-20,Italy,4822,1534,911,29,3288,1184,1193,2377,882
2022-04-21,Italy,4828,1495,869,29,3333,1233,1231,2464,840
2022-04-22,Italy,5182,1638,895,22,3544,1313,1336,2649,873
2022-04-23,Italy,5126,1951,733,15,3175,1237,1205,2442,718
2022-04-24,Italy,5207,1922,764,14,3285,1281,1240,2521,750
2022-04-25,Italy,4926,1605,837,19,3321,1234,1250,2484,818
2022-04-26,Italy,4619,1434,858,24,3185,1163,1164,2327,834
2022-04-27,Italy,4702,1468,886,39,3234,1170,1178,2348,847
2022-04-28,Italy,4979,1572,927,49,3407,1234,1246,2480,878
2022-04-29,Italy,5346,1751,919,33,3595,1336,1340,2676,886
2022-04-30,Italy,5118,2018,702,13,3100,1207,1191,2398,689
2022-05-01,Italy,5303,1969,786,18,3334,1270,1278,2548,768
2022-05-02,Italy,5107,1663,896,25,3444,1281,1267,2548,871
2022-05-03,Italy,4892,1670,833,29,3222,1196,1193,2389,804
2022-05-04,Italy,4933,1623,864,31,3310,1218,1228,2446,833
2022-05-05,Italy,5093,1666,896,38,3427,1273,1258,2531,858
2022-05-06,Italy,5569,1907,916,18,3662,1362,1384,2746,898
2022-05-07,Italy,5444,2191,743,13,3253,1260,1250,2510,730
2022-05-08,Italy,5513,2080,802,14,3433,1314,1317,2631,788
2022-05-09,Italy,5166,1714,867,24,3452,1297,1288,2585,843
2022-05-10,Italy,4860,1611,850,39,3249,1187,1212,2399,811
2022-05-11,Italy,5145,1732,895,29,3413,1247,1271,2518,866
2022-05-12,Italy,5379,1815,948,52,3564,1310,1306,2616,896
2022-05-13,Italy,5581,1873,933,29,3708,1359,1416,2775,904
2022-05-14,Italy,5392,2080,757,19,3312,1280,1275,2555,738
2022-05-15,Italy,5623,2038,841,18,3585,1397,1347,2744,823
2022-05-16,Italy,5458,1885,927,30,3573,1337,1309,2646,897
2022-05-17,Italy,4914,1634,868,43,3280,1205,1207,2412,825
2022-05-18,Italy,5106,1659,885,39,3447,1275,1287,2562,846
2022-05-19,Italy,5364,1800,953,42,3564,1290,1321,2611,911
2022-05-20,Italy,5662,2002,947,32,3660,1339,1374,2713,915
2022-05-21,Italy,5663,2304,789,15,3359,1289,1281,2570,774
2022-05-22,Italy,5784,2169,845,16,3615,1389,1381,2770,829
2022-05-23,Italy,5525,1922,940,39,3603,1331,1332,2663,901
2022-05-24,Italy,5134,1729,871,32,3405,1280,1254,2534,839
2022-05-25,Italy,5672,2001,889,24,3671,1374,1408,2782,865
2022-05-26,Italy,5766,2040,933,31,3726,1361,1432,2793,902
2022-05-27,Italy,5932,2143,979,35,3789,1404,1406,2810,944
2022-05-28,Italy,5909,2400,832,10,3509,1337,1340,2677,822
2022-05-29,Italy,6397,2539,894,17,3858,1511,1453,2964,877
2022-05-30,Italy,5894,2171,927,26,3723,1419,1377,2796,901
2022-05-31,Italy,5487,1894,915,40,3593,1325,1353,2678,875
2022-06-01,Italy,5628,1824,1000,35,3804,1410,1394,2804,965
2022-06-02,Italy,5752,2087,884,13,3665,1392,1389,2781,871
2022-06-03,Italy,6119,2270,897,18,3849,1440,1512,2952,879
2022-06-04,Italy,6175,2447,900,9,3728,1401,1427,2828,891
2022-06-05,Italy,6307,2389,974,13,3918,1477,1467,2944,961
2022-06-06,Italy,6307,2264,991,27,4043,1553,1499,3052,964
2022-06-07,Italy,5804,2024,953,29,3780,1414,1413,2827,924
2022-01-01,Latvia,561,431,0,0,130,64,66,130,0
2022-01-02,Latvia,737,564,0,0,173,89,84,173,0
2022-01-03,Latvia,664,500,0,0,164,81,83,164,0
2022-01-04,Latvia,593,468,0,0,125,61,64,125,0
2022-01-05,Latvia,633,484,0,0,149,73,76,149,0
2022-01-06,Latvia,596,451,1,0,145,73,71,144,1
2022-01-07,Latvia,659,498,2,1,161,79,80,159,1
2022-01-08,Latvia,647,506,1,1,141,69,71,140,0
2022-01-09,Latvia,780,611,0,0,169,86,83,169,0
2022-01-10,Latvia,621,480,1,1,141,65,75,140,0
2022-01-11,Latvia,544,451,0,0,93,47,46,93,0
2022-01-12,Latvia,566,458,0,0,108,55,53,108,0
2022-01-13,Latvia,576,450,6,4,126,60,60,120,2
2022-01-14,Latvia,594,465,0,0,129,66,63,129,0
2022-01-15,Latvia,574,458,2,2,116,56,58,114,0
2022-01-16,Latvia,616,480,0,0,136,67,69,136,0
2022-01-17,Latvia,508,399,0,0,109,52,57,109,0
2022-01-18,Latvia,496,390,6,6,106,50,50,100,0
2022-01-19,Latvia,549,441,6,5,108,52,50,102,1
2022-01-20,Latvia,487,392,0,0,95,46,49,95,0
2022-01-21,Latvia,572,454,0,0,118,61,57,118,0
2022-01-22,Latvia,560,447,0,0,113,56,57,113,0
2022-01-23,Latvia,622,485,0,0,137,69,68,137,0
2022-01-24,Latvia,517,408,0,0,109,54,55,109,0
2022-01-25,Latvia,469,378,2,2,91,41,48,89,0
2022-01-26,Latvia,531,446,0,0,85,43,42,85,0
2022-01-27,Latvia,520,416,1,1,104,51,52,103,0
2022-01-28,Latvia,557,447,0,0,110,59,51,110,0
2022-01-29,Latvia,589,460,0,0,129,59,70,129,0
2022-01-30,Latvia,588,455,1,1,133,70,62,132,0
2022-01-31,Latvia,558,443,0,0,115,53,62,115,0
2022-02-01,Latvia,471,390,2,2,81,37,42,79,0
2022-02-02,Latvia,507,422,0,0,85,47,38,85,0
2022-02-03,Latvia,509,408,4,4,101,47,50,97,0
2022-02-04,Latvia,521,406,0,0,115,61,54,115,0
2022-02-05,Latvia,528,421,0,0,107,53,54,107,0
2022-02-06,Latvia,577,437,0,0,140,69,71,140,0
2022-02-07,Latvia,475,361,4,4,114,56,54,110,0
2022-02-08,Latvia,433,360,1,1,73,35,37,72,0
2022-02-09,Latvia,496,404,11,11,92,43,38,81,0
2022-02-10,Latvia,517,406,5,5,111,51,55,106,0
2022-02-11,Latvia,553,415,3,3,138,71,64,135,0
2022-02-12,Latvia,555,435,0,0,120,57,63,120,0
2022-02-13,Latvia,592,440,1,1,152,77,74,151,0
2022-02-14,Latvia,489,372,2,2,117,54,61,115,0
2022-02-15,Latvia,456,366,8,8,90,42,40,82,0
2022-02-16,Latvia,518,428,1,1,90,46,43,89,0
2022-02-17,Latvia,507,396,0,0,111,55,56,111,0
2022-02-18,Latvia,617,465,2,1,152,76,74,150,1
2022-02-19,Latvia,624,495,0,0,129,64,65,129,0
2022-02-20,Latvia,627,473,1,1,154,76,77,153,0
2022-02-21,Latvia,511,385,0,0,126,62,64,126,0
2022-02-22,Latvia,490,395,0,0,95,43,52,95,0
2022-02-23,Latvia,530,420,3,3,110,56,51,107,0
2022-02-24,Latvia,591,462,7,7,129,63,59,122,0
2022-02-25,Latvia,604,460,1,1,144,74,69,143,0
2022-02-26,Latvia,642,491,1,1,151,73,77,150,0
2022-02-27,Latvia,455,311,1,1,144,72,71,143,0
2022-02-28,Latvia,408,289,5,5,119,55,59,114,0
2022-03-01,Latvia,404,302,3,3,102,51,48,99,0
2022-03-02,Latvia,415,310,8,8,105,49,48,97,0
2022-03-03,Latvia,410,302,5,5,108,51,52,103,0
2022-03-04,Latvia,482,341,5,5,141,69,67,136,0
2022-03-05,Latvia,461,331,2,2,130,63,65,128,0
2022-03-06,Latvia,469,336,0,0,133,68,65,133,0
2022-03-07,Latvia,432,302,4,4,130,59,67,126,0
2022-03-08,Latvia,407,311,4,4,96,48,44,92,0
2022-03-09,Latvia,397,297,5,5,100,49,46,95,0
2022-03-10,Latvia,430,306,3,3,124,61,60,121,0
2022-03-11,Latvia,452,316,4,4,136,68,64,132,0
2022-03-12,Latvia,418,299,3,3,119,57,59,116,0
2022-03-13,Latvia,439,306,1,1,133,69,63,132,0
2022-03-14,Latvia,431,299,4,3,132,62,66,128,1
2022-03-15,Latvia,373,274,3,3,99,47,49,96,0
2022-03-16,Latvia,378,263,5,5,115,56,54,110,0
2022-03-17,Latvia,388,273,7,7,115,54,54,108,0
2022-03-18,Latvia,435,290,4,3,145,70,71,141,1
2022-03-19,Latvia,386,273,0,0,113,54,59,113,0
2022-03-20,Latvia,424,292,0,0,132,69,63,132,0
2022-03-21,Latvia,377,248,3,3,129,61,65,126,0
2022-03-22,Latvia,355,254,5,5,101,47,49,96,0
2022-03-23,Latvia,374,256,4,4,118,58,56,114,0
2022-03-24,Latvia,387,270,5,5,117,55,57,112,0
2022-03-25,Latvia,411,267,3,3,144,71,70,141,0
2022-03-26,Latvia,391,278,0,0,113,55,58,113,0
2022-03-27,Latvia,410,266,1,1,144,76,67,143,0
2022-03-28,Latvia,413,274,2,2,139,67,70,137,0
2022-03-29,Latvia,368,248,3,3,120,59,58,117,0
2022-03-30,Latvia,404,256,3,3,148,73,72,145,0
2022-03-31,Latvia,417,264,3,3,153,77,73,150,0
2022-04-01,Latvia,465,296,5,5,169,81,83,164,0
2022-04-02,Latvia,386,262,0,0,124,61,63,124,0
2022-04-03,Latvia,438,285,0,0,153,78,75,153,0
2022-04-04,Latvia,415,268,0,0,147,71,76,147,0
2022-04-05,Latvia,366,241,0,0,125,64,61,125,0
2022-04-06,Latvia,424,275,4,4,149,72,73,145,0
2022-04-07,Latvia,423,250,4,4,173,85,84,169,0
2022-04-08,Latvia,461,289,0,0,172,88,84,172,0
2022-04-09,Latvia,407,275,1,1,132,65,66,131,0
2022-04-10,Latvia,415,267,0,0,148,75,73,148,0
2022-04-11,Latvia,436,272,6,6,164,77,81,158,0
2022-04-12,Latvia,412,270,5,4,142,69,68,137,1
2022-04-13,Latvia,450,283,6,5,167,80,81,161,1
2022-04-14,Latvia,453,289,2,2,164,83,79,162,0
2022-04-15,Latvia,461,300,1,1,161,80,80,160,0
2022-04-16,Latvia,417,293,1,1,124,61,62,123,0
2022-04-17,Latvia,448,290,1,0,158,82,75,157,1
2022-04-18,Latvia,467,305,0,0,162,78,84,162,0
2022-04-19,Latvia,436,275,4,4,161,81,76,157,0
2022-04-20,Latvia,420,258,2,2,162,80,80,160,0
2022-04-21,Latvia,443,276,3,1,167,81,83,164,2
2022-04-22,Latvia,493,326,2,2,167,83,82,165,0
2022-04-23,Latvia,424,294,0,0,130,63,67,130,0
2022-04-24,Latvia,459,308,0,0,151,77,74,151,0
2022-04-25,Latvia,455,289,5,5,166,78,83,161,0
2022-04-26,Latvia,449,285,3,3,164,80,81,161,0
2022-04-27,Latvia,432,271,2,2,161,79,80,159,0
2022-04-28,Latvia,485,305,3,3,180,90,87,177,0
2022-04-29,Latvia,526,357,2,1,169,83,84,167,1
2022-04-30,Latvia,448,318,0,0,130,65,65,130,0
2022-05-01,Latvia,531,371,1,1,160,80,79,159,0
2022-05-02,Latvia,503,335,2,2,168,81,85,166,0
2022-05-03,Latvia,491,328,4,4,163,80,79,159,0
2022-05-04,Latvia,471,320,0,0,151,78,73,151,0
2022-05-05,Latvia,509,343,7,7,166,80,79,159,0
2022-05-06,Latvia,559,386,2,2,173,85,86,171,0
2022-05-07,Latvia,495,351,2,2,144,71,71,142,0
2022-05-08,Latvia,519,356,1,1,163,81,81,162,0
2022-05-09,Latvia,535,348,2,2,187,92,93,185,0
2022-05-10,Latvia,523,355,5,3,168,82,81,163,2
2022-05-11,Latvia,523,364,2,2,159,81,76,157,0
2022-05-12,Latvia,514,347,1,1,167,86,80,166,0
2022-05-13,Latvia,559,370,1,1,189,89,99,188,0
2022-05-14,Latvia,483,331,3,1,152,73,76,149,2
2022-05-15,Latvia,551,386,1,1,165,81,83,164,0
2022-05-16,Latvia,513,336,5,5,177,88,84,172,0
2022-05-17,Latvia,486,329,8,7,157,73,76,149,1
2022-05-18,Latvia,500,344,6,5,156,76,74,150,1
2022-05-19,Latvia,534,353,8,8,181,83,90,173,0
2022-05-20,Latvia,537,350,5,5,187,93,89,182,0
2022-05-21,Latvia,495,351,0,0,144,71,73,144,0
2022-05-22,Latvia,534,367,4,4,167,82,81,163,0
2022-05-23,Latvia,515,335,9,9,180,85,86,171,0
2022-05-24,Latvia,495,337,7,7,158,77,74,151,0
2022-05-25,Latvia,533,357,12,11,176,83,81,164,1
2022-05-26,Latvia,531,350,6,6,181,86,89,175,0
2022-05-27,Latvia,544,366,4,4,178,85,89,174,0
2022-05-28,Latvia,489,343,3,3,146,72,71,143,0
2022-05-29,Latvia,557,387,2,2,170,82,86,168,0
2022-05-30,Latvia,539,356,3,3,183,95,85,180,0
2022-05-31,Latvia,498,341,7,6,157,73,77,150,1
2022-06-01,Latvia,521,351,3,3,170,82,85,167,0
2022-06-02,Latvia,559,379,6,6,180,90,84,174,0
2022-06-03,Latvia,594,400,5,5,194,93,96,189,0
2022-06-04,Latvia,529,380,2,2,149,72,75,147,0
2022-06-05,Latvia,584,418,0,0,166,84,82,166,0
2022-06-06,Latvia,558,378,4,4,180,87,89,176,0
2022-06-07,Latvia,552,390,4,3,162,80,78,158,1
2022-01-01,Lithuania,572,456,3,1,116,57,56,113,2
2022-01-02,Lithuania,766,634,2,1,132,63,67,130,1
2022-01-03,Lithuania,679,560,0,0,119,60,59,119,0
2022-01-04,Lithuania,606,471,4,4,135,64,67,131,0
2022-01-05,Lithuania,647,526,5,5,121,60,56,116,0
2022-01-06,Lithuania,621,498,3,3,123,58,62,120,0
2022-01-07,Lithuania,674,552,4,4,122,58,60,118,0
2022-01-08,Lithuania,697,573,1,1,124,64,59,123,0
2022-01-09,Lithuania,777,650,1,1,127,59,67,126,0
2022-01-10,Lithuania,641,537,3,3,104,53,48,101,0
2022-01-11,Lithuania,569,453,8,7,116,53,55,108,1
2022-01-12,Lithuania,576,482,5,5,94,43,46,89,0
2022-01-13,Lithuania,573,464,2,2,109,55,52,107,0
2022-01-14,Lithuania,596,493,0,0,103,50,53,103,0
2022-01-15,Lithuania,604,499,1,1,105,54,50,104,0
2022-01-16,Lithuania,619,526,1,1,93,44,48,92,0
2022-01-17,Lithuania,516,424,3,1,92,46,43,89,2
2022-01-18,Lithuania,492,389,7,7,103,47,49,96,0
2022-01-19,Lithuania,536,460,2,2,76,37,37,74,0
2022-01-20,Lithuania,525,421,2,2,104,48,54,102,0
2022-01-21,Lithuania,592,474,0,0,118,63,55,118,0
2022-01-22,Lithuania,591,488,2,2,103,52,49,101,0
2022-01-23,Lithuania,587,493,2,2,94,46,46,92,0
2022-01-24,Lithuania,490,404,1,1,86,41,44,85,0
2022-01-25,Lithuania,475,380,4,4,95,46,45,91,0
2022-01-26,Lithuania,555,476,2,2,79,38,39,77,0
2022-01-27,Lithuania,515,427,3,3,88,42,43,85,0
2022-01-28,Lithuania,571,467,5,5,104,49,50,99,0
2022-01-29,Lithuania,611,507,2,2,104,52,50,102,0
2022-01-30,Lithuania,566,473,1,1,93,43,49,92,0
2022-01-31,Lithuania,562,468,0,0,94,47,47,94,0
2022-02-01,Lithuania,518,391,6,6,127,60,61,121,0
2022-02-02,Lithuania,510,423,6,6,87,40,41,81,0
2022-02-03,Lithuania,578,462,8,7,116,53,55,108,1
2022-02-04,Lithuania,552,443,2,2,109,55,52,107,0
2022-02-05,Lithuania,578,458,2,1,120,61,57,118,1
2022-02-06,Lithuania,573,479,4,3,94,44,46,90,1
2022-02-07,Lithuania,496,389,5,5,107,50,52,102,0
2022-02-08,Lithuania,474,352,8,5,122,54,60,114,3
2022-02-09,Lithuania,503,400,9,7,103,51,43,94,2
2022-02-10,Lithuania,543,427,9,7,116,55,52,107,2
2022-02-11,Lithuania,593,466,3,2,127,61,63,124,1
2022-02-12,Lithuania,592,464,7,6,128,63,58,121,1
2022-02-13,Lithuania,590,489,3,3,101,48,50,98,0
2022-02-14,Lithuania,486,381,3,3,105,52,50,102,0
2022-02-15,Lithuania,490,369,6,5,121,58,57,115,1
2022-02-16,Lithuania,501,426,4,3,75,36,35,71,1
2022-02-17,Lithuania,534,433,1,1,101,49,51,100,0
2022-02-18,Lithuania,598,471,7,6,127,56,64,120,1
2022-02-19,Lithuania,674,543,2,2,131,68,61,129,0
2022-02-20,Lithuania,626,528,1,1,98,46,51,97,0
2022-02-21,Lithuania,526,419,4,3,107,51,52,103,1
2022-02-22,Lithuania,517,397,6,5,120,58,56,114,1
2022-02-23,Lithuania,532,429,3,3,103,50,50,100,0
2022-02-24,Lithuania,639,530,3,3,109,53,53,106,0
2022-02-25,Lithuania,683,557,3,3,126,61,62,123,0
2022-02-26,Lithuania,628,501,4,4,127,64,59,123,0
2022-02-27,Lithuania,378,275,4,3,103,46,53,99,1
2022-02-28,Lithuania,356,240,6,3,116,57,53,110,3
2022-03-01,Lithuania,344,228,8,7,116,54,54,108,1
2022-03-02,Lithuania,338,235,9,9,103,44,50,94,0
2022-03-03,Lithuania,382,263,10,8,119,55,54,109,2
2022-03-04,Lithuania,407,273,4,3,134,65,65,130,1
2022-03-05,Lithuania,376,251,2,2,125,63,60,123,0
2022-03-06,Lithuania,372,267,4,3,105,48,53,101,1
2022-03-07,Lithuania,345,231,3,3,114,55,56,111,0
2022-03-08,Lithuania,342,215,6,4,127,61,60,121,2
2022-03-09,Lithuania,319,227,5,4,92,44,43,87,1
2022-03-10,Lithuania,351,239,7,5,112,53,52,105,2
2022-03-11,Lithuania,378,248,8,6,130,62,60,122,2
2022-03-12,Lithuania,335,218,6,5,117,57,54,111,1
2022-03-13,Lithuania,342,238,4,3,104,48,52,100,1
2022-03-14,Lithuania,355,228,4,3,127,61,62,123,1
2022-03-15,Lithuania,305,183,2,1,122,61,59,120,1
2022-03-16,Lithuania,310,208,5,5,102,49,48,97,0
2022-03-17,Lithuania,318,199,7,7,119,57,55,112,0
2022-03-18,Lithuania,373,239,10,8,134,63,61,124,2
2022-03-19,Lithuania,306,195,3,3,111,54,54,108,0
2022-03-20,Lithuania,338,222,6,4,116,53,57,110,2
2022-03-21,Lithuania,324,199,7,5,125,57,61,118,2
2022-03-22,Lithuania,316,184,7,5,132,63,62,125,2
2022-03-23,Lithuania,312,199,7,4,113,56,50,106,3
2022-03-24,Lithuania,327,213,5,5,114,52,57,109,0
2022-03-25,Lithuania,352,218,5,2,134,65,64,129,3
2022-03-26,Lithuania,337,205,6,5,132,67,59,126,1
2022-03-27,Lithuania,341,212,5,3,129,60,64,124,2
2022-03-28,Lithuania,357,216,3,3,141,68,70,138,0
2022-03-29,Lithuania,349,216,6,5,133,61,66,127,1
2022-03-30,Lithuania,367,227,12,11,140,61,67,128,1
2022-03-31,Lithuania,386,229,6,6,157,77,74,151,0
2022-04-01,Lithuania,397,234,4,4,163,82,77,159,0
2022-04-02,Lithuania,376,230,3,3,146,73,70,143,0
2022-04-03,Lithuania,371,231,4,3,140,67,69,136,1
2022-04-04,Lithuania,354,221,8,7,133,62,63,125,1
2022-04-05,Lithuania,355,213,9,8,142,70,63,133,1
2022-04-06,Lithuania,358,219,7,6,139,64,68,132,1
2022-04-07,Lithuania,374,228,9,7,146,67,70,137,2
2022-04-08,Lithuania,408,252,6,5,156,74,76,150,1
2022-04-09,Lithuania,385,238,3,3,147,73,71,144,0
2022-04-10,Lithuania,360,220,3,1,140,70,67,137,2
2022-04-11,Lithuania,380,237,12,10,143,65,66,131,2
2022-04-12,Lithuania,398,239,9,8,159,74,76,150,1
2022-04-13,Lithuania,406,247,10,10,159,77,72,149,0
2022-04-14,Lithuania,398,244,9,7,154,71,74,145,2
2022-04-15,Lithuania,430,277,4,4,153,74,75,149,0
2022-04-16,Lithuania,390,249,4,4,141,69,68,137,0
2022-04-17,Lithuania,383,249,5,5,134,64,65,129,0
2022-04-18,Lithuania,405,266,7,7,139,67,65,132,0
2022-04-19,Lithuania,413,254,12,10,159,75,72,147,2
2022-04-20,Lithuania,390,235,8,6,155,74,73,147,2
2022-04-21,Lithuania,395,238,5,4,157,75,77,152,1
2022-04-22,Lithuania,421,259,5,4,162,78,79,157,1
2022-04-23,Lithuania,415,269,4,4,146,72,70,142,0
2022-04-24,Lithuania,409,265,3,3,144,69,72,141,0
2022-04-25,Lithuania,411,262,5,4,149,71,73,144,1
2022-04-26,Lithuania,449,274,9,8,175,84,82,166,1
2022-04-27,Lithuania,411,255,12,8,156,69,75,144,4
2022-04-28,Lithuania,452,280,11,8,172,83,78,161,3
2022-04-29,Lithuania,496,339,8,8,157,73,76,149,0
2022-04-30,Lithuania,470,314,1,1,156,79,76,155,0
2022-05-01,Lithuania,493,338,3,2,155,73,79,152,1
2022-05-02,Lithuania,456,306,7,7,150,71,72,143,0
2022-05-03,Lithuania,492,321,8,7,171,81,82,163,1
2022-05-04,Lithuania,452,295,10,8,157,73,74,147,2
2022-05-05,Lithuania,490,320,11,7,170,82,77,159,4
2022-05-06,Lithuania,509,346,10,9,163,75,78,153,1
2022-05-07,Lithuania,502,333,3,1,169,85,81,166,2
2022-05-08,Lithuania,480,333,3,3,147,71,73,144,0
2022-05-09,Lithuania,509,351,11,10,158,72,75,147,1
2022-05-10,Lithuania,535,346,8,8,189,89,92,181,0
2022-05-11,Lithuania,494,337,8,5,157,76,73,149,3
2022-05-12,Lithuania,493,311,7,5,182,87,88,175,2
2022-05-13,Lithuania,516,345,10,7,171,81,80,161,3
2022-05-14,Lithuania,488,329,5,4,159,76,78,154,1
2022-05-15,Lithuania,485,339,2,1,146,72,72,144,1
2022-05-16,Lithuania,481,327,4,4,154,75,75,150,0
2022-05-17,Lithuania,482,311,7,5,171,84,80,164,2
2022-05-18,Lithuania,462,308,10,9,154,70,74,144,1
2022-05-19,Lithuania,527,358,7,6,169,82,80,162,1
2022-05-20,Lithuania,516,352,4,3,164,81,79,160,1
2022-05-21,Lithuania,490,331,2,2,159,79,78,157,0
2022-05-22,Lithuania,513,354,5,4,159,75,79,154,1
2022-05-23,Lithuania,504,340,7,5,164,80,77,157,2
2022-05-24,Lithuania,500,331,6,6,169,78,85,163,0
2022-05-25,Lithuania,489,328,9,9,161,78,74,152,0
2022-05-26,Lithuania,522,347,5,3,175,86,84,170,2
2022-05-27,Lithuania,531,370,6,5,161,76,79,155,1
2022-05-28,Lithuania,521,357,1,0,164,80,83,163,1
2022-05-29,Lithuania,538,381,2,1,157,79,76,155,1
2022-05-30,Lithuania,522,362,3,3,160,78,79,157,0
2022-05-31,Lithuania,533,355,6,5,178,89,83,172,1
2022-06-01,Lithuania,505,334,6,6,171,83,82,165,0
2022-06-02,Lithuania,541,373,8,8,168,81,79,160,0
2022-06-03,Lithuania,579,405,7,7,174,84,83,167,0
2022-06-04,Lithuania,551,389,3,3,162,79,80,159,0
2022-06-05,Lithuania,574,408,4,2,166,82,80,162,2
2022-06-06,Lithuania,547,378,9,8,169,78,82,160,1
2022-06-07,Lithuania,559,376,10,9,183,86,87,173,1
2022-01-01,Malta,212,121,0,0,91,46,45,91,0
2022-01-02,Malta,247,125,0,0,122,61,61,122,0
2022-01-03,Malta,239,108,1,1,131,64,66,130,0
2022-01-04,Malta,211,112,0,0,99,48,51,99,0
2022-01-05,Malta,220,126,0,0,94,48,46,94,0
2022-01-06,Malta,195,113,1,1,82,40,41,81,0
2022-01-07,Malta,216,103,0,0,113,55,58,113,0
2022-01-08,Malta,208,101,2,2,107,53,52,105,0
2022-01-09,Malta,233,117,1,1,116,55,60,115,0
2022-01-10,Malta,174,115,0,0,59,29,30,59,0
2022-01-11,Malta,163,106,3,3,57,25,29,54,0
2022-01-12,Malta,157,97,0,0,60,31,29,60,0
2022-01-13,Malta,138,91,2,2,47,24,21,45,0
2022-01-14,Malta,157,93,0,0,64,32,32,64,0
2022-01-15,Malta,189,123,0,0,66,34,32,66,0
2022-01-16,Malta,180,120,1,1,60,29,30,59,0
2022-01-17,Malta,164,106,3,3,58,27,28,55,0
2022-01-18,Malta,163,108,3,3,55,25,27,52,0
2022-01-19,Malta,158,98,3,3,60,29,28,57,0
2022-01-20,Malta,156,107,2,2,49,23,24,47,0
2022-01-21,Malta,169,106,3,3,63,30,30,60,0
2022-01-22,Malta,174,111,3,3,63,31,29,60,0
2022-01-23,Malta,163,110,0,0,53,26,27,53,0
2022-01-24,Malta,145,98,3,3,47,22,22,44,0
2022-01-25,Malta,123,81,1,1,42,19,22,41,0
2022-01-26,Malta,145,80,0,0,65,30,35,65,0
2022-01-27,Malta,146,104,2,2,42,23,17,40,0
2022-01-28,Malta,169,110,1,1,59,30,28,58,0
2022-01-29,Malta,141,96,0,0,45,23,22,45,0
2022-01-30,Malta,176,124,0,0,52,26,26,52,0
2022-01-31,Malta,163,110,0,0,53,26,27,53,0
2022-02-01,Malta,169,110,0,0,59,30,29,59,0
2022-02-02,Malta,172,101,0,0,71,35,36,71,0
2022-02-03,Malta,161,105,0,0,56,28,28,56,0
2022-02-04,Malta,173,93,0,0,80,39,41,80,0
2022-02-05,Malta,163,97,0,0,66,34,32,66,0
2022-02-06,Malta,170,102,1,1,68,33,34,67,0
2022-02-07,Malta,201,128,1,1,73,35,37,72,0
2022-02-08,Malta,176,106,1,1,70,33,36,69,0
2022-02-09,Malta,184,111,1,1,73,34,38,72,0
2022-02-10,Malta,200,114,2,2,86,45,39,84,0
2022-02-11,Malta,196,119,2,2,77,39,36,75,0
2022-02-12,Malta,190,110,1,1,80,41,38,79,0
2022-02-13,Malta,201,123,1,1,78,37,40,77,0
2022-02-14,Malta,196,120,2,2,76,35,39,74,0
2022-02-15,Malta,176,110,2,2,66,31,33,64,0
2022-02-16,Malta,180,96,0,0,84,43,41,84,0
2022-02-17,Malta,160,91,1,1,69,33,35,68,0
2022-02-18,Malta,231,127,3,3,104,50,51,101,0
2022-02-19,Malta,210,125,4,4,85,41,40,81,0
2022-02-20,Malta,193,122,1,1,71,36,34,70,0
2022-02-21,Malta,193,113,1,1,80,40,39,79,0
2022-02-22,Malta,184,117,1,1,67,33,33,66,0
2022-02-23,Malta,185,112,3,3,73,35,35,70,0
2022-02-24,Malta,194,101,4,4,93,45,44,89,0
2022-02-25,Malta,205,110,3,3,95,44,48,92,0
2022-02-26,Malta,211,122,1,1,89,46,42,88,0
2022-02-27,Malta,231,146,1,1,85,41,43,84,0
2022-02-28,Malta,214,134,2,2,80,41,37,78,0
2022-03-01,Malta,202,131,1,1,71,35,35,70,0
2022-03-02,Malta,231,137,1,1,94,47,46,93,0
2022-03-03,Malta,228,134,2,2,94,42,50,92,0
2022-03-04,Malta,235,128,1,1,107,57,49,106,0
2022-03-05,Malta,224,135,0,0,89,42,47,89,0
2022-03-06,Malta,241,140,1,1,101,49,51,100,0
2022-03-07,Malta,241,129,1,1,112,57,54,111,0
2022-03-08,Malta,218,136,1,1,82,39,42,81,0
2022-03-09,Malta,234,134,0,0,100,51,49,100,0
2022-03-10,Malta,229,136,0,0,93,47,46,93,0
2022-03-11,Malta,224,125,1,1,99,50,48,98,0
2022-03-12,Malta,223,115,1,1,108,54,53,107,0
2022-03-13,Malta,245,138,0,0,107,52,55,107,0
2022-03-14,Malta,239,135,0,0,104,52,52,104,0
2022-03-15,Malta,209,122,2,2,87,42,43,85,0
2022-03-16,Malta,201,107,1,1,94,50,43,93,0
2022-03-17,Malta,208,114,1,1,94,43,50,93,0
2022-03-18,Malta,221,112,1,1,109,55,53,108,0
2022-03-19,Malta,221,113,0,0,108,54,54,108,0
2022-03-20,Malta,235,128,0,0,107,52,55,107,0
2022-03-21,Malta,269,162,1,1,107,54,52,106,0
2022-03-22,Malta,240,147,2,2,93,42,49,91,0
2022-03-23,Malta,238,136,3,3,102,50,49,99,0
2022-03-24,Malta,250,156,4,4,94,46,44,90,0
2022-03-25,Malta,264,143,5,5,121,55,61,116,0
2022-03-26,Malta,239,126,1,1,113,56,56,112,0
2022-03-27,Malta,285,147,0,0,138,74,64,138,0
2022-03-28,Malta,291,146,0,0,145,69,76,145,0
2022-03-29,Malta,268,145,4,4,123,61,58,119,0
2022-03-30,Malta,266,121,2,2,145,72,71,143,0
2022-03-31,Malta,281,127,0,0,154,75,79,154,0
2022-04-01,Malta,290,146,1,1,144,72,71,143,0
2022-04-02,Malta,289,146,1,1,143,71,71,142,0
2022-04-03,Malta,284,144,3,3,140,70,67,137,0
2022-04-04,Malta,262,126,0,0,136,70,66,136,0
2022-04-05,Malta,237,120,1,1,117,55,61,116,0
2022-04-06,Malta,266,124,2,2,142,72,68,140,0
2022-04-07,Malta,272,117,1,1,155,77,77,154,0
2022-04-08,Malta,289,126,3,3,163,79,81,160,0
2022-04-09,Malta,275,126,3,3,149,74,72,146,0
2022-04-10,Malta,268,134,1,1,134,65,68,133,0
2022-04-11,Malta,255,115,5,5,140,71,64,135,0
2022-04-12,Malta,256,125,2,2,131,64,65,129,0
2022-04-13,Malta,305,151,0,0,154,74,80,154,0
2022-04-14,Malta,291,128,1,1,163,82,80,162,0
2022-04-15,Malta,281,131,0,0,150,75,75,150,0
2022-04-16,Malta,268,126,0,0,142,70,72,142,0
2022-04-17,Malta,310,163,1,1,147,72,74,146,0
2022-04-18,Malta,282,134,0,0,148,78,70,148,0
2022-04-19,Malta,273,137,2,2,136,64,70,134,0
2022-04-20,Malta,275,130,2,2,145,72,71,143,0
2022-04-21,Malta,305,138,0,0,167,81,86,167,0
2022-04-22,Malta,298,142,2,2,156,79,75,154,0
2022-04-23,Malta,289,140,2,2,149,73,74,147,0
2022-04-24,Malta,281,145,0,0,136,66,70,136,0
2022-04-25,Malta,288,131,2,2,157,79,76,155,0
2022-04-26,Malta,236,106,1,1,130,65,64,129,0
2022-04-27,Malta,246,102,0,0,144,71,73,144,0
2022-04-28,Malta,301,138,0,0,163,85,78,163,0
2022-04-29,Malta,272,122,1,1,150,75,74,149,0
2022-04-30,Malta,277,126,1,1,151,74,76,150,0
2022-05-01,Malta,276,142,0,0,134,64,70,134,0
2022-05-02,Malta,282,138,0,0,144,73,71,144,0
2022-05-03,Malta,257,139,2,2,118,57,59,116,0
2022-05-04,Malta,271,119,3,3,152,74,75,149,0
2022-05-05,Malta,284,130,0,0,154,77,77,154,0
2022-05-06,Malta,276,125,0,0,151,77,74,151,0
2022-05-07,Malta,285,140,0,0,145,72,73,145,0
2022-05-08,Malta,302,155,0,0,147,71,76,147,0
2022-05-09,Malta,279,139,0,0,140,72,68,140,0
2022-05-10,Malta,257,127,0,0,130,67,63,130,0
2022-05-11,Malta,284,131,1,1,153,75,77,152,0
2022-05-12,Malta,293,129,1,1,164,79,84,163,0
2022-05-13,Malta,269,119,1,1,150,74,75,149,0
2022-05-14,Malta,285,141,2,2,144,71,71,142,0
2022-05-15,Malta,307,155,1,1,152,77,74,151,0
2022-05-16,Malta,274,129,1,1,145,73,71,144,0
2022-05-17,Malta,257,131,1,1,126,60,65,125,0
2022-05-18,Malta,267,117,2,2,150,76,72,148,0
2022-05-19,Malta,281,129,1,1,152,77,74,151,0
2022-05-20,Malta,280,126,2,2,154,72,80,152,0
2022-05-21,Malta,274,129,0,0,145,75,70,145,0
2022-05-22,Malta,282,142,1,1,140,69,70,139,0
2022-05-23,Malta,281,137,2,2,144,72,70,142,0
2022-05-24,Malta,243,120,1,1,123,61,61,122,0
2022-05-25,Malta,275,125,1,1,150,74,75,149,0
2022-05-26,Malta,287,127,0,0,160,83,77,160,0
2022-05-27,Malta,263,116,0,0,147,71,76,147,0
2022-05-28,Malta,280,131,1,1,149,73,75,148,0
2022-05-29,Malta,304,148,1,1,156,78,77,155,0
2022-05-30,Malta,295,142,1,1,153,77,75,152,0
2022-05-31,Malta,237,115,2,2,122,59,61,120,0
2022-06-01,Malta,273,112,1,1,161,78,82,160,0
2022-06-02,Malta,311,136,3,3,175,84,88,172,0
2022-06-03,Malta,280,117,1,1,163,83,79,162,0
2022-06-04,Malta,297,151,1,1,146,73,72,145,0
2022-06-05,Malta,317,157,1,1,160,78,81,159,0
2022-06-06,Malta,285,136,1,1,149,77,71,148,0
2022-06-07,Malta,268,135,1,1,133,65,67,132,0
2022-01-01,Moldova,71,35,0,0,36,17,19,36,0
2022-01-02,Moldova,116,47,0,0,69,36,33,69,0
2022-01-03,Moldova,110,50,0,0,60,30,30,60,0
2022-01-04,Moldova,94,46,0,0,48,23,25,48,0
2022-01-05,Moldova,94,44,0,0,50,26,24,50,0
2022-01-06,Moldova,86,31,0,0,55,26,29,55,0
2022-01-07,Moldova,100,31,0,0,69,35,34,69,0
2022-01-08,Moldova,119,66,0,0,53,26,27,53,0
2022-01-09,Moldova,116,48,0,0,68,34,34,68,0
2022-01-10,Moldova,100,45,0,0,55,28,27,55,0
2022-01-11,Moldova,68,22,0,0,46,23,23,46,0
2022-01-12,Moldova,70,29,0,0,41,22,19,41,0
2022-01-13,Moldova,84,37,0,0,47,22,25,47,0
2022-01-14,Moldova,93,37,0,0,56,28,28,56,0
2022-01-15,Moldova,84,36,0,0,48,21,27,48,0
2022-01-16,Moldova,89,29,0,0,60,31,29,60,0
2022-01-17,Moldova,90,46,0,0,44,22,22,44,0
2022-01-18,Moldova,73,28,1,0,45,21,23,44,1
2022-01-19,Moldova,60,31,0,0,29,16,13,29,0
2022-01-20,Moldova,73,29,0,0,44,22,22,44,0
2022-01-21,Moldova,96,35,0,0,61,31,30,61,0
2022-01-22,Moldova,75,40,0,0,35,17,18,35,0
2022-01-23,Moldova,78,28,0,0,50,26,24,50,0
2022-01-24,Moldova,81,45,0,0,36,17,19,36,0
2022-01-25,Moldova,54,24,0,0,30,15,15,30,0
2022-01-26,Moldova,66,36,0,0,30,16,14,30,0
2022-01-27,Moldova,67,30,0,0,37,17,20,37,0
2022-01-28,Moldova,82,29,0,0,53,27,26,53,0
2022-01-29,Moldova,76,41,0,0,35,17,18,35,0
2022-01-30,Moldova,75,31,0,0,44,23,21,44,0
2022-01-31,Moldova,82,45,0,0,37,17,20,37,0
2022-02-01,Moldova,73,39,0,0,34,17,17,34,0
2022-02-02,Moldova,59,29,0,0,30,16,14,30,0
2022-02-03,Moldova,66,30,0,0,36,17,19,36,0
2022-02-04,Moldova,84,33,0,0,51,26,25,51,0
2022-02-05,Moldova,84,49,0,0,35,17,18,35,0
2022-02-06,Moldova,72,31,0,0,41,21,20,41,0
2022-02-07,Moldova,81,38,0,0,43,20,23,43,0
2022-02-08,Moldova,58,26,0,0,32,16,16,32,0
2022-02-09,Moldova,63,38,0,0,25,14,11,25,0
2022-02-10,Moldova,64,27,0,0,37,17,20,37,0
2022-02-11,Moldova,95,37,0,0,58,30,28,58,0
2022-02-12,Moldova,76,40,0,0,36,17,19,36,0
2022-02-13,Moldova,74,30,0,0,44,21,23,44,0
2022-02-14,Moldova,90,48,0,0,42,21,21,42,0
2022-02-15,Moldova,54,26,0,0,28,14,14,28,0
2022-02-16,Moldova,68,31,0,0,37,17,20,37,0
2022-02-17,Moldova,66,26,1,1,40,18,21,39,0
2022-02-18,Moldova,90,32,0,0,58,33,25,58,0
2022-02-19,Moldova,71,35,0,0,36,16,20,36,0
2022-02-20,Moldova,72,23,0,0,49,25,24,49,0
2022-02-21,Moldova,80,37,0,0,43,21,22,43,0
2022-02-22,Moldova,67,30,0,0,37,18,19,37,0
2022-02-23,Moldova,68,37,0,0,31,17,14,31,0
2022-02-24,Moldova,21,6,0,0,15,5,10,15,0
2022-02-25,Moldova,12,1,0,0,11,8,3,11,0
2022-02-26,Moldova,6,1,0,0,5,4,1,5,0
2022-02-27,Moldova,3,0,0,0,3,2,1,3,0
2022-02-28,Moldova,9,0,0,0,9,4,5,9,0
2022-03-01,Moldova,6,0,0,0,6,3,3,6,0
2022-03-02,Moldova,6,0,0,0,6,3,3,6,0
2022-03-03,Moldova,7,0,0,0,7,3,4,7,0
2022-03-04,Moldova,6,1,0,0,5,3,2,5,0
2022-03-05,Moldova,5,0,0,0,5,3,2,5,0
2022-03-06,Moldova,3,0,0,0,3,2,1,3,0
2022-03-07,Moldova,7,1,0,0,6,3,3,6,0
2022-03-08,Moldova,8,0,0,0,8,4,4,8,0
2022-03-09,Moldova,7,0,0,0,7,3,4,7,0
2022-03-10,Moldova,8,0,0,0,8,4,4,8,0
2022-03-11,Moldova,12,0,0,0,12,6,6,12,0
2022-03-12,Moldova,4,0,1,0,4,2,1,3,1
2022-03-13,Moldova,6,0,1,0,6,3,2,5,1
2022-03-14,Moldova,12,0,0,0,12,5,7,12,0
2022-03-15,Moldova,10,0,0,0,10,5,5,10,0
2022-03-16,Moldova,16,0,0,0,16,9,7,16,0
2022-03-17,Moldova,9,0,0,0,9,5,4,9,0
2022-03-18,Moldova,6,1,0,0,5,2,3,5,0
2022-03-19,Moldova,2,0,0,0,2,1,1,2,0
2022-03-20,Moldova,6,1,0,0,5,3,2,5,0
2022-03-21,Moldova,12,0,0,0,12,6,6,12,0
2022-03-22,Moldova,13,1,0,0,12,6,6,12,0
2022-03-23,Moldova,10,0,0,0,10,5,5,10,0
2022-03-24,Moldova,15,0,0,0,15,8,7,15,0
2022-03-25,Moldova,12,-1,0,0,13,6,7,13,0
2022-03-26,Moldova,7,1,0,0,6,3,3,6,0
2022-03-27,Moldova,17,0,0,0,17,9,8,17,0
2022-03-28,Moldova,9,1,0,0,8,4,4,8,0
2022-03-29,Moldova,4,0,0,0,4,2,2,4,0
2022-03-30,Moldova,19,-1,0,0,20,10,10,20,0
2022-03-31,Moldova,28,0,0,0,28,13,15,28,0
2022-04-01,Moldova,28,1,0,0,27,14,13,27,0
2022-04-02,Moldova,18,1,0,0,17,9,8,17,0
2022-04-03,Moldova,25,-2,0,0,27,13,14,27,0
2022-04-04,Moldova,22,2,0,0,20,10,10,20,0
2022-04-05,Moldova,16,0,0,0,16,7,9,16,0
2022-04-06,Moldova,20,1,0,0,19,11,8,19,0
2022-04-07,Moldova,43,0,0,0,43,21,22,43,0
2022-04-08,Moldova,33,-1,0,0,34,17,17,34,0
2022-04-09,Moldova,27,1,0,0,26,13,13,26,0
2022-04-10,Moldova,26,-1,0,0,27,13,14,27,0
2022-04-11,Moldova,28,2,0,0,26,14,12,26,0
2022-04-12,Moldova,21,-1,0,0,22,10,12,22,0
2022-04-13,Moldova,25,-1,0,0,26,13,13,26,0
2022-04-14,Moldova,32,1,0,0,31,15,16,31,0
2022-04-15,Moldova,44,0,0,0,44,23,21,44,0
2022-04-16,Moldova,23,3,0,0,20,10,10,20,0
2022-04-17,Moldova,33,0,0,0,33,16,17,33,0
2022-04-18,Moldova,31,0,0,0,31,15,16,31,0
2022-04-19,Moldova,19,-1,0,0,20,10,10,20,0
2022-04-20,Moldova,31,1,0,0,30,16,14,30,0
2022-04-21,Moldova,35,0,0,0,35,16,19,35,0
2022-04-22,Moldova,41,-4,0,0,45,23,22,45,0
2022-04-23,Moldova,31,5,0,0,26,13,13,26,0
2022-04-24,Moldova,38,-1,0,0,39,20,19,39,0
2022-04-25,Moldova,29,1,0,0,28,13,15,28,0
2022-04-26,Moldova,25,-1,0,0,26,13,13,26,0
2022-04-27,Moldova,39,-1,1,1,40,21,18,39,0
2022-04-28,Moldova,36,2,0,0,34,17,17,34,0
2022-04-29,Moldova,42,-2,0,0,44,22,22,44,0
2022-04-30,Moldova,31,1,0,0,30,16,14,30,0
2022-05-01,Moldova,45,0,0,0,45,22,23,45,0
2022-05-02,Moldova,34,0,0,0,34,17,17,34,0
2022-05-03,Moldova,36,-1,0,0,37,18,19,37,0
2022-05-04,Moldova,40,2,0,0,38,19,19,38,0
2022-05-05,Moldova,41,-1,0,0,42,21,21,42,0
2022-05-06,Moldova,43,0,0,0,43,22,21,43,0
2022-05-07,Moldova,41,1,0,0,40,20,20,40,0
2022-05-08,Moldova,43,-1,0,0,44,21,23,44,0
2022-05-09,Moldova,31,3,0,0,28,15,13,28,0
2022-05-10,Moldova,37,-1,0,0,38,19,19,38,0
2022-05-11,Moldova,27,-1,0,0,28,14,14,28,0
2022-05-12,Moldova,39,1,1,1,38,18,19,37,0
2022-05-13,Moldova,46,-1,0,0,47,24,23,47,0
2022-05-14,Moldova,37,3,0,0,34,17,17,34,0
2022-05-15,Moldova,40,-2,0,0,42,20,22,42,0
2022-05-16,Moldova,27,2,0,0,25,13,12,25,0
2022-05-17,Moldova,38,0,0,0,38,18,20,38,0
2022-05-18,Moldova,31,-1,0,0,32,17,15,32,0
2022-05-19,Moldova,35,0,0,0,35,17,18,35,0
2022-05-20,Moldova,43,-2,0,0,45,23,22,45,0
2022-05-21,Moldova,40,1,0,0,39,18,21,39,0
2022-05-22,Moldova,38,1,0,0,37,19,18,37,0
2022-05-23,Moldova,31,1,0,0,30,15,15,30,0
2022-05-24,Moldova,38,0,0,0,38,19,19,38,0
2022-05-25,Moldova,36,1,0,0,35,19,16,35,0
2022-05-26,Moldova,40,0,0,0,40,19,21,40,0
2022-05-27,Moldova,47,-3,0,0,50,24,26,50,0
2022-05-28,Moldova,47,4,0,0,43,23,20,43,0
2022-05-29,Moldova,47,0,0,0,47,22,25,47,0
2022-05-30,Moldova,35,0,0,0,35,18,17,35,0
2022-05-31,Moldova,57,0,1,1,57,28,28,56,0
2022-06-01,Moldova,53,-1,1,1,54,27,26,53,0
2022-06-02,Moldova,46,-3,0,0,49,24,25,49,0
2022-06-03,Moldova,57,1,0,0,56,28,28,56,0
2022-06-04,Moldova,53,2,0,0,51,28,23,51,0
2022-06-05,Moldova,44,-2,0,0,46,21,25,46,0
2022-06-06,Moldova,57,2,0,0,55,27,28,55,0
2022-06-07,Moldova,54,-1,0,0,55,28,27,55,0
2022-01-01,Morocco,1060,985,38,0,75,20,17,37,38
2022-01-02,Morocco,1014,909,54,0,105,29,22,51,54
2022-01-03,Morocco,866,789,40,0,77,19,18,37,40
2022-01-04,Morocco,880,775,45,0,105,30,30,60,45
2022-01-05,Morocco,800,705,40,2,95,26,29,55,38
2022-01-06,Morocco,789,683,44,3,106,33,29,62,41
2022-01-07,Morocco,838,705,65,3,133,33,35,68,62
2022-01-08,Morocco,1204,1129,23,1,75,28,24,52,22
2022-01-09,Morocco,984,873,48,0,111,31,32,63,48
2022-01-10,Morocco,714,616,42,6,98,29,27,56,36
2022-01-11,Morocco,646,555,35,1,91,27,29,56,34
2022-01-12,Morocco,608,494,50,3,114,33,31,64,47
2022-01-13,Morocco,583,491,39,1,92,26,27,53,38
2022-01-14,Morocco,665,548,50,2,117,33,34,67,48
2022-01-15,Morocco,918,844,31,0,74,21,22,43,31
2022-01-16,Morocco,755,652,48,0,103,27,28,55,48
2022-01-17,Morocco,581,481,46,3,100,28,26,54,43
2022-01-18,Morocco,563,466,34,2,97,29,34,63,32
2022-01-19,Morocco,566,454,44,0,112,36,32,68,44
2022-01-20,Morocco,565,456,48,1,109,30,31,61,47
2022-01-21,Morocco,642,519,50,2,123,38,35,73,48
2022-01-22,Morocco,952,863,27,0,89,33,29,62,27
2022-01-23,Morocco,735,638,37,1,97,29,31,60,36
2022-01-24,Morocco,552,473,37,3,79,21,21,42,34
2022-01-25,Morocco,552,450,45,2,102,28,29,57,43
2022-01-26,Morocco,569,443,50,2,126,36,40,76,48
2022-01-27,Morocco,569,456,56,0,113,32,25,57,56
2022-01-28,Morocco,612,495,47,1,117,36,34,70,46
2022-01-29,Morocco,898,816,25,0,82,29,28,57,25
2022-01-30,Morocco,737,636,42,0,101,32,27,59,42
2022-01-31,Morocco,562,453,48,1,109,30,31,61,47
2022-02-01,Morocco,589,497,37,2,92,28,27,55,35
2022-02-02,Morocco,567,474,52,2,93,21,20,41,50
2022-02-03,Morocco,623,534,47,1,89,21,21,42,46
2022-02-04,Morocco,649,566,48,1,83,18,17,35,47
2022-02-05,Morocco,998,931,25,0,67,21,21,42,25
2022-02-06,Morocco,786,712,44,0,74,16,14,30,44
2022-02-07,Morocco,822,544,57,1,278,115,106,221,56
2022-02-08,Morocco,810,520,58,2,290,113,119,232,56
2022-02-09,Morocco,807,502,57,2,305,122,126,248,55
2022-02-10,Morocco,918,580,67,2,338,139,132,271,65
2022-02-11,Morocco,978,624,68,2,354,143,143,286,66
2022-02-12,Morocco,1316,964,50,0,352,154,148,302,50
2022-02-13,Morocco,1072,732,60,1,340,140,140,280,59
2022-02-14,Morocco,877,549,50,7,328,132,146,278,43
2022-02-15,Morocco,879,589,53,3,290,122,115,237,50
2022-02-16,Morocco,782,486,59,2,296,116,121,237,57
2022-02-17,Morocco,886,561,57,1,325,135,133,268,56
2022-02-18,Morocco,1018,620,67,0,398,165,166,331,67
2022-02-19,Morocco,1346,964,40,0,382,177,165,342,40
2022-02-20,Morocco,1146,778,58,0,368,152,158,310,58
2022-02-21,Morocco,943,576,55,4,367,154,158,312,51
2022-02-22,Morocco,877,577,48,0,300,127,125,252,48
2022-02-23,Morocco,851,523,64,5,328,131,133,264,59
2022-02-24,Morocco,938,602,42,1,336,151,143,294,41
2022-02-25,Morocco,1047,627,68,4,420,178,174,352,64
2022-02-26,Morocco,1424,1033,49,0,391,173,169,342,49
2022-02-27,Morocco,1149,769,57,0,380,160,163,323,57
2022-02-28,Morocco,1014,612,70,8,402,163,169,332,62
2022-03-01,Morocco,989,612,64,3,377,158,155,313,61
2022-03-02,Morocco,921,558,61,5,363,150,152,302,56
2022-03-03,Morocco,1058,662,65,6,396,168,163,331,59
2022-03-04,Morocco,1131,666,59,3,465,199,207,406,56
2022-03-05,Morocco,1521,1058,48,1,463,214,201,415,47
2022-03-06,Morocco,1284,836,62,0,448,191,195,386,62
2022-03-07,Morocco,1081,630,72,4,451,185,194,379,68
2022-03-08,Morocco,1008,610,66,6,398,172,160,332,60
2022-03-09,Morocco,919,538,60,2,381,160,161,321,58
2022-03-10,Morocco,1058,654,64,3,404,172,168,340,61
2022-03-11,Morocco,1115,628,71,4,487,205,211,416,67
2022-03-12,Morocco,1468,1034,51,1,434,193,190,383,50
2022-03-13,Morocco,1242,789,60,2,453,197,196,393,58
2022-03-14,Morocco,968,546,52,1,422,183,187,370,51
2022-03-15,Morocco,980,609,56,0,371,158,157,315,56
2022-03-16,Morocco,940,577,53,1,363,152,158,310,52
2022-03-17,Morocco,1024,654,48,0,370,165,157,322,48
2022-03-18,Morocco,1121,655,68,1,466,198,200,398,67
2022-03-19,Morocco,1493,1054,49,0,439,198,192,390,49
2022-03-20,Morocco,1234,788,59,0,446,195,192,387,59
2022-03-21,Morocco,1083,632,67,1,451,183,201,384,66
2022-03-22,Morocco,986,601,67,2,385,164,154,318,65
2022-03-23,Morocco,939,564,63,1,375,155,157,312,62
2022-03-24,Morocco,1022,630,58,0,392,171,163,334,58
2022-03-25,Morocco,1156,670,67,1,486,213,206,419,66
2022-03-26,Morocco,1512,1038,55,0,474,207,212,419,55
2022-03-27,Morocco,1256,745,59,1,511,224,228,452,58
2022-03-28,Morocco,984,533,61,1,451,191,199,390,60
2022-03-29,Morocco,1078,605,52,2,473,210,211,421,50
2022-03-30,Morocco,1040,575,61,0,465,202,202,404,61
2022-03-31,Morocco,1184,675,71,0,509,228,210,438,71
2022-04-01,Morocco,1170,646,72,1,524,218,234,452,71
2022-04-02,Morocco,1472,973,46,1,499,232,221,453,45
2022-04-03,Morocco,1284,791,63,0,493,216,214,430,63
2022-04-04,Morocco,1044,585,59,2,459,203,197,400,57
2022-04-05,Morocco,1051,639,53,2,412,180,179,359,51
2022-04-06,Morocco,978,594,53,4,384,161,170,331,49
2022-04-07,Morocco,1143,722,52,5,421,186,183,369,47
2022-04-08,Morocco,1202,711,75,2,491,208,208,416,73
2022-04-09,Morocco,1517,1034,43,2,483,224,216,440,41
2022-04-10,Morocco,1336,851,54,0,485,212,219,431,54
2022-04-11,Morocco,1084,640,58,5,444,194,192,386,53
2022-04-12,Morocco,1124,710,59,7,414,179,176,355,52
2022-04-13,Morocco,1072,646,59,5,426,181,186,367,54
2022-04-14,Morocco,1207,704,79,7,503,211,213,424,72
2022-04-15,Morocco,1139,644,78,4,495,208,209,417,74
2022-04-16,Morocco,1462,954,50,2,508,232,226,458,48
2022-04-17,Morocco,1356,838,61,3,518,228,229,457,58
2022-04-18,Morocco,1123,674,47,1,449,202,200,402,46
2022-04-19,Morocco,1093,672,49,7,421,185,187,372,42
2022-04-20,Morocco,1048,620,61,6,428,185,182,367,55
2022-04-21,Morocco,1151,711,57,10,440,187,196,383,47
2022-04-22,Morocco,1118,637,76,7,481,206,199,405,69
2022-04-23,Morocco,1445,968,51,3,477,218,208,426,48
2022-04-24,Morocco,1336,815,59,3,521,231,231,462,56
2022-04-25,Morocco,1075,621,55,6,454,197,202,399,49
2022-04-26,Morocco,1064,660,58,6,404,175,171,346,52
2022-04-27,Morocco,1028,601,77,8,427,174,176,350,69
2022-04-28,Morocco,1085,643,59,9,442,192,191,383,50
2022-04-29,Morocco,1073,578,68,8,495,215,212,427,60
2022-04-30,Morocco,1386,853,54,0,533,241,238,479,54
2022-05-01,Morocco,1189,669,65,1,520,224,231,455,64
2022-05-02,Morocco,1003,570,49,0,433,191,193,384,49
2022-05-03,Morocco,1058,602,46,0,456,207,203,410,46
2022-05-04,Morocco,1009,548,65,2,461,195,201,396,63
2022-05-05,Morocco,1124,637,50,4,487,219,218,437,46
2022-05-06,Morocco,1086,566,67,2,520,225,228,453,65
2022-05-07,Morocco,1317,772,51,1,545,250,244,494,50
2022-05-08,Morocco,1204,655,67,1,549,240,242,482,66
2022-05-09,Morocco,1098,564,92,10,534,221,221,442,82
2022-05-10,Morocco,1089,589,74,16,500,206,220,426,58
2022-05-11,Morocco,1057,545,71,9,512,229,212,441,62
2022-05-12,Morocco,1128,624,55,4,504,224,225,449,51
2022-05-13,Morocco,1089,569,70,2,520,224,226,450,68
2022-05-14,Morocco,1305,771,60,0,534,242,232,474,60
2022-05-15,Morocco,1186,646,73,2,540,234,233,467,71
2022-05-16,Morocco,1076,583,59,6,493,210,224,434,53
2022-05-17,Morocco,1057,594,59,0,463,207,197,404,59
2022-05-18,Morocco,1020,581,61,3,439,188,190,378,58
2022-05-19,Morocco,1091,608,68,9,483,205,210,415,59
2022-05-20,Morocco,1058,534,80,0,524,219,225,444,80
2022-05-21,Morocco,1313,774,54,0,539,248,237,485,54
2022-05-22,Morocco,1166,641,59,0,525,238,228,466,59
2022-05-23,Morocco,1054,581,65,9,473,199,209,408,56
2022-05-24,Morocco,1064,586,64,8,478,207,207,414,56
2022-05-25,Morocco,1028,558,63,4,470,204,203,407,59
2022-05-26,Morocco,1131,615,92,4,516,205,219,424,88
2022-05-27,Morocco,1091,570,69,2,521,231,221,452,67
2022-05-28,Morocco,1239,733,50,0,506,227,229,456,50
2022-05-29,Morocco,1187,649,58,0,538,243,237,480,58
2022-05-30,Morocco,1079,593,61,2,486,208,217,425,59
2022-05-31,Morocco,1113,628,56,1,485,217,212,429,55
2022-06-01,Morocco,1015,527,63,1,488,218,207,425,62
2022-06-02,Morocco,1111,620,67,4,491,210,214,424,63
2022-06-03,Morocco,1072,550,74,3,522,225,223,448,71
2022-06-04,Morocco,1232,712,54,1,520,236,230,466,53
2022-06-05,Morocco,1199,655,72,0,544,236,236,472,72
2022-06-06,Morocco,1086,573,61,4,513,225,227,452,57
2022-06-07,Morocco,1100,617,64,4,483,208,211,419,60
2022-01-01,Netherlands,2043,1080,3,1,963,497,463,960,2
2022-01-02,Netherlands,2735,1454,7,1,1281,630,644,1274,6
2022-01-03,Netherlands,2700,1387,58,13,1313,634,621,1255,45
2022-01-04,Netherlands,2426,1232,52,13,1194,574,568,1142,39
2022-01-05,Netherlands,2481,1292,47,14,1189,569,573,1142,33
2022-01-06,Netherlands,2394,1181,59,15,1213,578,576,1154,44
2022-01-07,Netherlands,2653,1335,51,16,1318,632,635,1267,35
2022-01-08,Netherlands,2471,1313,20,2,1158,569,569,1138,18
2022-01-09,Netherlands,2636,1372,17,0,1264,619,628,1247,17
2022-01-10,Netherlands,2166,1052,71,12,1114,526,517,1043,59
2022-01-11,Netherlands,1875,842,68,15,1033,484,481,965,53
2022-01-12,Netherlands,1826,897,29,3,929,451,449,900,26
2022-01-13,Netherlands,1877,902,54,7,975,470,451,921,47
2022-01-14,Netherlands,2150,1048,59,15,1102,512,531,1043,44
2022-01-15,Netherlands,1918,995,16,8,923,452,455,907,8
2022-01-16,Netherlands,2160,1067,26,5,1093,529,538,1067,21
2022-01-17,Netherlands,1934,873,74,26,1061,496,491,987,48
2022-01-18,Netherlands,1618,796,36,13,822,396,390,786,23
2022-01-19,Netherlands,1782,835,64,20,947,441,442,883,44
2022-01-20,Netherlands,1890,866,57,20,1024,491,476,967,37
2022-01-21,Netherlands,2138,1022,61,17,1116,524,531,1055,44
2022-01-22,Netherlands,1868,953,15,1,915,450,450,900,14
2022-01-23,Netherlands,2143,1058,22,5,1085,530,533,1063,17
2022-01-24,Netherlands,1917,884,41,8,1033,499,493,992,33
2022-01-25,Netherlands,1619,779,60,20,840,384,396,780,40
2022-01-26,Netherlands,1749,857,46,19,892,425,421,846,27
2022-01-27,Netherlands,1849,844,71,14,1005,475,459,934,57
2022-01-28,Netherlands,2094,978,49,10,1116,533,534,1067,39
2022-01-29,Netherlands,1842,910,10,2,932,455,467,922,8
2022-01-30,Netherlands,2099,980,15,0,1119,547,557,1104,15
2022-01-31,Netherlands,1705,889,27,8,816,401,388,789,19
2022-02-01,Netherlands,1834,894,50,11,940,450,440,890,39
2022-02-02,Netherlands,1926,934,64,21,992,462,466,928,43
2022-02-03,Netherlands,2004,957,62,16,1047,497,488,985,46
2022-02-04,Netherlands,2269,1111,26,3,1158,563,569,1132,23
2022-02-05,Netherlands,2147,1121,33,9,1026,495,498,993,24
2022-02-06,Netherlands,2265,1154,9,5,1111,548,554,1102,4
2022-02-07,Netherlands,2169,1056,50,11,1113,527,536,1063,39
2022-02-08,Netherlands,1882,929,65,14,953,443,445,888,51
2022-02-09,Netherlands,1982,990,60,14,992,465,467,932,46
2022-02-10,Netherlands,2212,1075,77,16,1137,541,519,1060,61
2022-02-11,Netherlands,2547,1273,57,19,1274,600,617,1217,38
2022-02-12,Netherlands,2322,1237,47,16,1085,525,513,1038,31
2022-02-13,Netherlands,2412,1231,22,5,1181,574,585,1159,17
2022-02-14,Netherlands,2263,1130,43,12,1133,545,545,1090,31
2022-02-15,Netherlands,1982,987,52,11,995,470,473,943,41
2022-02-16,Netherlands,2069,1053,61,15,1016,473,482,955,46
2022-02-17,Netherlands,2148,1009,43,3,1139,556,540,1096,40
2022-02-18,Netherlands,2000,1156,15,2,844,407,422,829,13
2022-02-19,Netherlands,2503,1305,18,5,1198,591,589,1180,13
2022-02-20,Netherlands,2379,1304,10,2,1075,524,541,1065,8
2022-02-21,Netherlands,2101,1119,28,1,982,483,471,954,27
2022-02-22,Netherlands,2079,1033,58,15,1046,492,496,988,43
2022-02-23,Netherlands,2204,1056,74,20,1148,541,533,1074,54
2022-02-24,Netherlands,2359,1107,68,10,1252,592,592,1184,58
2022-02-25,Netherlands,2689,1312,61,20,1377,656,660,1316,41
2022-02-26,Netherlands,2434,1209,37,10,1225,588,600,1188,27
2022-02-27,Netherlands,2641,1357,34,6,1284,618,632,1250,28
2022-02-28,Netherlands,2474,1205,65,17,1269,606,598,1204,48
2022-03-01,Netherlands,2219,1093,71,26,1126,531,524,1055,45
2022-03-02,Netherlands,2367,1213,68,28,1154,542,544,1086,40
2022-03-03,Netherlands,2419,1194,65,20,1225,584,576,1160,45
2022-03-04,Netherlands,2755,1428,68,25,1327,625,634,1259,43
2022-03-05,Netherlands,2409,1235,26,8,1174,568,580,1148,18
2022-03-06,Netherlands,2673,1416,21,3,1257,614,622,1236,18
2022-03-07,Netherlands,2544,1260,64,22,1284,615,605,1220,42
2022-03-08,Netherlands,2243,1112,61,17,1131,530,540,1070,44
2022-03-09,Netherlands,2346,1193,57,15,1153,551,545,1096,42
2022-03-10,Netherlands,2497,1194,69,19,1303,629,605,1234,50
2022-03-11,Netherlands,2764,1391,63,21,1373,655,655,1310,42
2022-03-12,Netherlands,2380,1230,33,9,1150,552,565,1117,24
2022-03-13,Netherlands,2649,1369,21,3,1280,623,636,1259,18
2022-03-14,Netherlands,2581,1280,55,14,1301,625,621,1246,41
2022-03-15,Netherlands,2289,1104,84,23,1185,547,554,1101,61
2022-03-16,Netherlands,2421,1214,69,16,1207,568,570,1138,53
2022-03-17,Netherlands,2444,1156,70,13,1288,621,597,1218,57
2022-03-18,Netherlands,2886,1495,56,13,1391,676,659,1335,43
2022-03-19,Netherlands,2454,1280,35,9,1174,566,573,1139,26
2022-03-20,Netherlands,2716,1426,18,1,1290,626,646,1272,17
2022-03-21,Netherlands,2674,1325,75,25,1349,634,640,1274,50
2022-03-22,Netherlands,2341,1136,75,20,1205,564,566,1130,55
2022-03-23,Netherlands,2540,1273,74,15,1267,590,603,1193,59
2022-03-24,Netherlands,2563,1229,78,17,1334,643,613,1256,61
2022-03-25,Netherlands,2892,1467,68,12,1425,674,683,1357,56
2022-03-26,Netherlands,2442,1269,36,9,1173,565,572,1137,27
2022-03-27,Netherlands,2866,1503,22,6,1363,667,674,1341,16
2022-03-28,Netherlands,2983,1516,45,13,1467,710,712,1422,32
2022-03-29,Netherlands,2824,1493,60,13,1331,634,637,1271,47
2022-03-30,Netherlands,2892,1545,64,15,1347,640,643,1283,49
2022-03-31,Netherlands,2855,1484,32,5,1371,671,668,1339,27
2022-04-01,Netherlands,2999,1554,52,4,1445,701,692,1393,48
2022-04-02,Netherlands,2770,1525,24,6,1245,618,603,1221,18
2022-04-03,Netherlands,3009,1591,16,1,1418,696,706,1402,15
2022-04-04,Netherlands,2985,1563,47,3,1422,685,690,1375,44
2022-04-05,Netherlands,2833,1489,63,11,1344,641,640,1281,52
2022-04-06,Netherlands,3026,1611,54,7,1415,692,669,1361,47
2022-04-07,Netherlands,2956,1548,52,6,1408,676,680,1356,46
2022-04-08,Netherlands,3210,1694,52,11,1516,743,721,1464,41
2022-04-09,Netherlands,2787,1529,15,5,1258,616,627,1243,10
2022-04-10,Netherlands,3088,1684,17,2,1404,689,698,1387,15
2022-04-11,Netherlands,3075,1622,74,18,1453,698,681,1379,56
2022-04-12,Netherlands,2983,1575,76,15,1408,656,676,1332,61
2022-04-13,Netherlands,3092,1641,66,13,1451,695,690,1385,53
2022-04-14,Netherlands,3155,1618,70,10,1537,733,734,1467,60
2022-04-15,Netherlands,3110,1598,53,12,1512,733,726,1459,41
2022-04-16,Netherlands,2775,1471,44,14,1304,632,628,1260,30
2022-04-17,Netherlands,2973,1595,24,8,1378,676,678,1354,16
2022-04-18,Netherlands,3086,1626,46,7,1460,699,715,1414,39
2022-04-19,Netherlands,3020,1606,78,13,1414,665,671,1336,65
2022-04-20,Netherlands,3040,1595,61,11,1445,696,688,1384,50
2022-04-21,Netherlands,3120,1549,66,9,1571,750,755,1505,57
2022-04-22,Netherlands,3197,1615,58,7,1582,769,755,1524,51
2022-04-23,Netherlands,2793,1527,28,1,1266,617,621,1238,27
2022-04-24,Netherlands,3182,1714,24,1,1468,719,725,1444,23
2022-04-25,Netherlands,3227,1626,65,7,1601,775,761,1536,58
2022-04-26,Netherlands,3109,1570,71,10,1539,725,743,1468,61
2022-04-27,Netherlands,3226,1707,42,3,1519,747,730,1477,39
2022-04-28,Netherlands,3312,1638,60,11,1674,805,809,1614,49
2022-04-29,Netherlands,3350,1666,50,5,1684,815,819,1634,45
2022-04-30,Netherlands,2956,1501,27,3,1455,708,720,1428,24
2022-05-01,Netherlands,3241,1678,21,3,1563,770,772,1542,18
2022-05-02,Netherlands,3392,1732,53,7,1660,805,802,1607,46
2022-05-03,Netherlands,3320,1726,61,9,1594,768,765,1533,52
2022-05-04,Netherlands,3396,1774,66,7,1622,786,770,1556,59
2022-05-05,Netherlands,3440,1806,62,9,1634,785,787,1572,53
2022-05-06,Netherlands,3445,1769,50,9,1676,812,814,1626,41
2022-05-07,Netherlands,3135,1607,27,6,1528,748,753,1501,21
2022-05-08,Netherlands,3335,1712,17,5,1623,792,814,1606,12
2022-05-09,Netherlands,3397,1726,63,16,1671,806,802,1608,47
2022-05-10,Netherlands,3212,1621,71,16,1591,756,764,1520,55
2022-05-11,Netherlands,3373,1758,60,15,1615,785,770,1555,45
2022-05-12,Netherlands,3339,1695,61,14,1644,798,785,1583,47
2022-05-13,Netherlands,3471,1743,67,16,1728,832,829,1661,51
2022-05-14,Netherlands,3150,1691,23,6,1459,725,711,1436,17
2022-05-15,Netherlands,3329,1712,21,4,1617,784,812,1596,17
2022-05-16,Netherlands,3409,1745,50,9,1664,804,810,1614,41
2022-05-17,Netherlands,3278,1674,64,17,1604,766,774,1540,47
2022-05-18,Netherlands,3382,1758,61,11,1624,793,770,1563,50
2022-05-19,Netherlands,3390,1749,49,6,1641,800,792,1592,43
2022-05-20,Netherlands,3399,1761,49,10,1638,796,793,1589,39
2022-05-21,Netherlands,3060,1596,24,3,1464,719,721,1440,21
2022-05-22,Netherlands,3335,1767,21,5,1568,770,777,1547,16
2022-05-23,Netherlands,3318,1738,55,14,1580,762,763,1525,41
2022-05-24,Netherlands,3289,1674,67,18,1615,771,777,1548,49
2022-05-25,Netherlands,3532,1831,62,18,1701,827,812,1639,44
2022-05-26,Netherlands,3429,1754,61,7,1675,807,807,1614,54
2022-05-27,Netherlands,3499,1828,63,14,1671,808,800,1608,49
2022-05-28,Netherlands,3133,1702,20,6,1431,703,708,1411,14
2022-05-29,Netherlands,3430,1828,24,4,1602,774,804,1578,20
2022-05-30,Netherlands,3541,1847,58,16,1694,819,817,1636,42
2022-05-31,Netherlands,3371,1748,62,18,1623,779,782,1561,44
2022-06-01,Netherlands,3388,1761,54,15,1627,797,776,1573,39
2022-06-02,Netherlands,3512,1812,63,12,1700,823,814,1637,51
2022-06-03,Netherlands,3571,1888,48,20,1683,819,816,1635,28
2022-06-04,Netherlands,3124,1775,30,10,1349,654,665,1319,20
2022-06-05,Netherlands,3372,1884,12,2,1488,736,740,1476,10
2022-06-06,Netherlands,3493,1825,36,1,1668,805,827,1632,35
2022-06-07,Netherlands,3441,1822,64,16,1619,772,783,1555,48
2022-01-01,North Macedonia,378,339,0,0,39,19,20,39,0
2022-01-02,North Macedonia,454,404,0,0,50,25,25,50,0
2022-01-03,North Macedonia,411,363,0,0,48,24,24,48,0
2022-01-04,North Macedonia,360,309,0,0,51,26,25,51,0
2022-01-05,North Macedonia,383,337,0,0,46,23,23,46,0
2022-01-06,North Macedonia,356,311,0,0,45,23,22,45,0
2022-01-07,North Macedonia,388,342,0,0,46,23,23,46,0
2022-01-08,North Macedonia,457,408,0,0,49,24,25,49,0
2022-01-09,North Macedonia,422,376,0,0,46,23,23,46,0
2022-01-10,North Macedonia,321,280,0,0,41,23,18,41,0
2022-01-11,North Macedonia,285,243,0,0,42,20,22,42,0
2022-01-12,North Macedonia,280,247,0,0,33,16,17,33,0
2022-01-13,North Macedonia,249,220,0,0,29,15,14,29,0
2022-01-14,North Macedonia,285,249,0,0,36,18,18,36,0
2022-01-15,North Macedonia,292,260,0,0,32,16,16,32,0
2022-01-16,North Macedonia,308,280,0,0,28,14,14,28,0
2022-01-17,North Macedonia,280,240,0,0,40,21,19,40,0
2022-01-18,North Macedonia,211,185,0,0,26,13,13,26,0
2022-01-19,North Macedonia,222,199,0,0,23,11,12,23,0
2022-01-20,North Macedonia,218,197,0,0,21,11,10,21,0
2022-01-21,North Macedonia,260,229,0,0,31,15,16,31,0
2022-01-22,North Macedonia,276,247,0,0,29,15,14,29,0
2022-01-23,North Macedonia,289,260,0,0,29,14,15,29,0
2022-01-24,North Macedonia,226,204,0,0,22,12,10,22,0
2022-01-25,North Macedonia,181,165,0,0,16,7,9,16,0
2022-01-26,North Macedonia,224,197,0,0,27,14,13,27,0
2022-01-27,North Macedonia,228,204,0,0,24,12,12,24,0
2022-01-28,North Macedonia,297,263,0,0,34,17,17,34,0
2022-01-29,North Macedonia,298,272,0,0,26,13,13,26,0
2022-01-30,North Macedonia,285,257,0,0,28,13,15,28,0
2022-01-31,North Macedonia,253,225,0,0,28,15,13,28,0
2022-02-01,North Macedonia,230,199,0,0,31,15,16,31,0
2022-02-02,North Macedonia,217,194,0,0,23,11,12,23,0
2022-02-03,North Macedonia,248,223,0,0,25,14,11,25,0
2022-02-04,North Macedonia,317,283,0,0,34,17,17,34,0
2022-02-05,North Macedonia,301,273,0,0,28,13,15,28,0
2022-02-06,North Macedonia,316,285,0,0,31,15,16,31,0
2022-02-07,North Macedonia,260,229,0,0,31,16,15,31,0
2022-02-08,North Macedonia,255,229,0,0,26,13,13,26,0
2022-02-09,North Macedonia,243,213,0,0,30,14,16,30,0
2022-02-10,North Macedonia,247,216,0,0,31,17,14,31,0
2022-02-11,North Macedonia,288,252,0,0,36,18,18,36,0
2022-02-12,North Macedonia,302,276,0,0,26,12,14,26,0
2022-02-13,North Macedonia,299,270,0,0,29,14,15,29,0
2022-02-14,North Macedonia,255,222,0,0,33,18,15,33,0
2022-02-15,North Macedonia,219,192,0,0,27,13,14,27,0
2022-02-16,North Macedonia,251,227,0,0,24,12,12,24,0
2022-02-17,North Macedonia,268,245,0,0,23,12,11,23,0
2022-02-18,North Macedonia,327,294,0,0,33,17,16,33,0
2022-02-19,North Macedonia,355,327,0,0,28,13,15,28,0
2022-02-20,North Macedonia,336,306,0,0,30,15,15,30,0
2022-02-21,North Macedonia,293,253,0,0,40,21,19,40,0
2022-02-22,North Macedonia,262,232,0,0,30,14,16,30,0
2022-02-23,North Macedonia,298,274,0,0,24,12,12,24,0
2022-02-24,North Macedonia,299,277,0,0,22,11,11,22,0
2022-02-25,North Macedonia,366,334,0,0,32,17,15,32,0
2022-02-26,North Macedonia,331,302,0,0,29,14,15,29,0
2022-02-27,North Macedonia,344,316,0,0,28,14,14,28,0
2022-02-28,North Macedonia,291,258,0,0,33,17,16,33,0
2022-03-01,North Macedonia,302,272,0,0,30,14,16,30,0
2022-03-02,North Macedonia,298,276,0,0,22,11,11,22,0
2022-03-03,North Macedonia,344,317,0,0,27,14,13,27,0
2022-03-04,North Macedonia,382,343,0,0,39,20,19,39,0
2022-03-05,North Macedonia,376,347,0,0,29,14,15,29,0
2022-03-06,North Macedonia,382,353,0,0,29,14,15,29,0
2022-03-07,North Macedonia,340,306,0,0,34,18,16,34,0
2022-03-08,North Macedonia,306,273,0,0,33,16,17,33,0
2022-03-09,North Macedonia,332,304,0,0,28,14,14,28,0
2022-03-10,North Macedonia,345,325,0,0,20,10,10,20,0
2022-03-11,North Macedonia,351,311,0,0,40,20,20,40,0
2022-03-12,North Macedonia,372,343,0,0,29,14,15,29,0
2022-03-13,North Macedonia,380,350,0,0,30,14,16,30,0
2022-03-14,North Macedonia,377,334,0,0,43,22,21,43,0
2022-03-15,North Macedonia,347,311,0,0,36,17,19,36,0
2022-03-16,North Macedonia,363,329,0,0,34,16,18,34,0
2022-03-17,North Macedonia,338,302,0,0,36,21,15,36,0
2022-03-18,North Macedonia,389,342,0,0,47,23,24,47,0
2022-03-19,North Macedonia,403,370,0,0,33,17,16,33,0
2022-03-20,North Macedonia,393,360,0,0,33,16,17,33,0
2022-03-21,North Macedonia,385,343,0,0,42,21,21,42,0
2022-03-22,North Macedonia,330,290,0,0,40,21,19,40,0
2022-03-23,North Macedonia,406,376,0,0,30,14,16,30,0
2022-03-24,North Macedonia,371,345,0,0,26,14,12,26,0
2022-03-25,North Macedonia,407,365,0,0,42,21,21,42,0
2022-03-26,North Macedonia,409,373,0,0,36,17,19,36,0
2022-03-27,North Macedonia,523,478,0,0,45,22,23,45,0
2022-03-28,North Macedonia,473,428,1,0,45,23,21,44,1
2022-03-29,North Macedonia,454,402,0,0,52,25,27,52,0
2022-03-30,North Macedonia,472,427,0,0,45,22,23,45,0
2022-03-31,North Macedonia,450,421,0,0,29,16,13,29,0
2022-04-01,North Macedonia,522,480,0,0,42,20,22,42,0
2022-04-02,North Macedonia,539,491,0,0,48,24,24,48,0
2022-04-03,North Macedonia,519,470,0,0,49,23,26,49,0
2022-04-04,North Macedonia,487,436,0,0,51,26,25,51,0
2022-04-05,North Macedonia,460,408,0,0,52,26,26,52,0
2022-04-06,North Macedonia,464,422,0,0,42,20,22,42,0
2022-04-07,North Macedonia,449,412,0,0,37,20,17,37,0
2022-04-08,North Macedonia,600,561,0,0,39,19,20,39,0
2022-04-09,North Macedonia,691,639,0,0,52,27,25,52,0
2022-04-10,North Macedonia,610,561,0,0,49,24,25,49,0
2022-04-11,North Macedonia,561,517,0,0,44,22,22,44,0
2022-04-12,North Macedonia,529,485,0,0,44,22,22,44,0
2022-04-13,North Macedonia,610,557,0,0,53,26,27,53,0
2022-04-14,North Macedonia,637,594,0,0,43,22,21,43,0
2022-04-15,North Macedonia,600,550,0,0,50,25,25,50,0
2022-04-16,North Macedonia,698,649,0,0,49,24,25,49,0
2022-04-17,North Macedonia,658,613,0,0,45,23,22,45,0
2022-04-18,North Macedonia,605,556,0,0,49,25,24,49,0
2022-04-19,North Macedonia,513,468,1,0,45,22,22,44,1
2022-04-20,North Macedonia,549,498,0,0,51,25,26,51,0
2022-04-21,North Macedonia,565,520,0,0,45,21,24,45,0
2022-04-22,North Macedonia,575,530,0,0,45,24,21,45,0
2022-04-23,North Macedonia,711,666,0,0,45,22,23,45,0
2022-04-24,North Macedonia,659,611,0,0,48,24,24,48,0
2022-04-25,North Macedonia,533,485,0,0,48,23,25,48,0
2022-04-26,North Macedonia,539,490,0,0,49,25,24,49,0
2022-04-27,North Macedonia,584,538,0,0,46,23,23,46,0
2022-04-28,North Macedonia,643,598,0,0,45,23,22,45,0
2022-04-29,North Macedonia,632,588,0,0,44,22,22,44,0
2022-04-30,North Macedonia,777,725,0,0,52,26,26,52,0
2022-05-01,North Macedonia,785,738,0,0,47,23,24,47,0
2022-05-02,North Macedonia,692,647,0,0,45,23,22,45,0
2022-05-03,North Macedonia,668,619,0,0,49,25,24,49,0
2022-05-04,North Macedonia,647,602,0,0,45,23,22,45,0
2022-05-05,North Macedonia,761,705,0,0,56,26,30,56,0
2022-05-06,North Macedonia,695,645,0,0,50,25,25,50,0
2022-05-07,North Macedonia,885,834,0,0,51,24,27,51,0
2022-05-08,North Macedonia,817,770,0,0,47,24,23,47,0
2022-05-09,North Macedonia,743,697,0,0,46,23,23,46,0
2022-05-10,North Macedonia,737,681,0,0,56,28,28,56,0
2022-05-11,North Macedonia,721,669,0,0,52,26,26,52,0
2022-05-12,North Macedonia,725,672,2,0,53,26,25,51,2
2022-05-13,North Macedonia,793,744,0,0,49,26,23,49,0
2022-05-14,North Macedonia,885,824,0,0,61,33,28,61,0
2022-05-15,North Macedonia,849,801,0,0,48,24,24,48,0
2022-05-16,North Macedonia,672,625,0,0,47,24,23,47,0
2022-05-17,North Macedonia,731,682,2,0,49,24,23,47,2
2022-05-18,North Macedonia,733,687,0,0,46,23,23,46,0
2022-05-19,North Macedonia,723,681,0,0,42,21,21,42,0
2022-05-20,North Macedonia,742,692,0,0,50,25,25,50,0
2022-05-21,North Macedonia,908,863,0,0,45,21,24,45,0
2022-05-22,North Macedonia,852,799,0,0,53,26,27,53,0
2022-05-23,North Macedonia,660,610,1,0,50,26,23,49,1
2022-05-24,North Macedonia,705,652,0,0,53,27,26,53,0
2022-05-25,North Macedonia,833,775,0,0,58,28,30,58,0
2022-05-26,North Macedonia,812,757,0,0,55,28,27,55,0
2022-05-27,North Macedonia,850,802,0,0,48,24,24,48,0
2022-05-28,North Macedonia,914,868,0,0,46,23,23,46,0
2022-05-29,North Macedonia,868,810,0,0,58,29,29,58,0
2022-05-30,North Macedonia,759,702,0,0,57,28,29,57,0
2022-05-31,North Macedonia,827,769,1,0,58,27,30,57,1
2022-06-01,North Macedonia,892,826,0,0,66,35,31,66,0
2022-06-02,North Macedonia,869,805,0,0,64,31,33,64,0
2022-06-03,North Macedonia,910,849,0,0,61,30,31,61,0
2022-06-04,North Macedonia,985,929,0,0,56,27,29,56,0
2022-06-05,North Macedonia,933,863,0,0,70,35,35,70,0
2022-06-06,North Macedonia,869,802,0,0,67,34,33,67,0
2022-06-07,North Macedonia,884,818,1,0,66,30,35,65,1
2022-01-01,Norway,655,157,181,3,498,157,160,317,178
2022-01-02,Norway,1297,248,613,3,1049,213,223,436,610
2022-01-03,Norway,1443,190,831,3,1253,215,207,422,828
2022-01-04,Norway,1298,175,744,17,1123,190,189,379,727
2022-01-05,Norway,1340,177,756,15,1163,204,203,407,741
2022-01-06,Norway,1447,180,846,18,1267,212,209,421,828
2022-01-07,Norway,1448,249,795,10,1199,202,202,404,785
2022-01-08,Norway,782,196,248,8,586,172,166,338,240
2022-01-09,Norway,1206,254,581,2,952,183,188,371,579
2022-01-10,Norway,1268,193,755,10,1075,162,158,320,745
2022-01-11,Norway,1189,196,695,2,993,148,150,298,693
2022-01-12,Norway,1093,164,632,15,929,146,151,297,617
2022-01-13,Norway,1218,204,664,20,1014,175,175,350,644
2022-01-14,Norway,1249,193,720,15,1056,165,171,336,705
2022-01-15,Norway,718,179,252,14,539,147,140,287,238
2022-01-16,Norway,917,210,414,11,707,146,147,293,403
2022-01-17,Norway,1234,195,730,16,1039,156,153,309,714
2022-01-18,Norway,1123,153,717,16,970,124,129,253,701
2022-01-19,Norway,1075,139,681,12,936,125,130,255,669
2022-01-20,Norway,1181,176,703,15,1005,148,154,302,688
2022-01-21,Norway,1297,186,763,16,1111,176,172,348,747
2022-01-22,Norway,680,174,240,12,506,136,130,266,228
2022-01-23,Norway,988,192,504,7,796,140,152,292,497
2022-01-24,Norway,1145,152,679,17,993,159,155,314,662
2022-01-25,Norway,1053,123,684,14,930,123,123,246,670
2022-01-26,Norway,1152,150,732,18,1002,133,137,270,714
2022-01-27,Norway,1147,142,692,9,1005,155,158,313,683
2022-01-28,Norway,1255,165,750,12,1090,171,169,340,738
2022-01-29,Norway,607,162,188,4,445,132,125,257,184
2022-01-30,Norway,940,147,501,11,793,143,149,292,490
2022-01-31,Norway,1150,151,704,20,999,145,150,295,684
2022-02-01,Norway,1080,139,676,16,941,134,131,265,660
2022-02-02,Norway,1213,174,728,22,1039,158,153,311,706
2022-02-03,Norway,1241,134,751,11,1107,177,179,356,740
2022-02-04,Norway,1123,170,638,21,953,154,161,315,617
2022-02-05,Norway,691,148,262,10,543,143,138,281,252
2022-02-06,Norway,1063,210,534,11,853,156,163,319,523
2022-02-07,Norway,1267,145,782,18,1122,174,166,340,764
2022-02-08,Norway,1127,151,697,18,976,137,142,279,679
2022-02-09,Norway,1077,139,652,17,938,143,143,286,635
2022-02-10,Norway,1175,149,699,28,1026,162,165,327,671
2022-02-11,Norway,1253,134,761,32,1119,180,178,358,729
2022-02-12,Norway,737,157,266,11,580,161,153,314,255
2022-02-13,Norway,1095,176,567,21,919,170,182,352,546
2022-02-14,Norway,1215,146,719,6,1069,176,174,350,713
2022-02-15,Norway,1215,162,756,23,1053,148,149,297,733
2022-02-16,Norway,1262,184,754,16,1078,161,163,324,738
2022-02-17,Norway,1306,160,780,22,1146,183,183,366,758
2022-02-18,Norway,1383,165,798,23,1218,208,212,420,775
2022-02-19,Norway,808,187,275,11,621,177,169,346,264
2022-02-20,Norway,1133,205,573,8,928,176,179,355,565
2022-02-21,Norway,1310,152,810,12,1158,174,174,348,798
2022-02-22,Norway,1213,134,764,11,1079,158,157,315,753
2022-02-23,Norway,1221,151,735,14,1070,164,171,335,721
2022-02-24,Norway,1246,159,731,29,1087,176,180,356,702
2022-02-25,Norway,1412,154,805,14,1258,228,225,453,791
2022-02-26,Norway,802,131,294,13,671,187,190,377,281
2022-02-27,Norway,1105,172,532,11,933,195,206,401,521
2022-02-28,Norway,1394,144,851,16,1250,202,197,399,835
2022-03-01,Norway,1281,133,798,15,1148,174,176,350,783
2022-03-02,Norway,1325,131,809,18,1194,194,191,385,791
2022-03-03,Norway,1397,170,844,13,1227,192,191,383,831
2022-03-04,Norway,1435,154,830,17,1281,224,227,451,813
2022-03-05,Norway,748,125,275,6,623,175,173,348,269
2022-03-06,Norway,1189,160,632,14,1029,191,206,397,618
2022-03-07,Norway,1391,129,850,25,1262,210,202,412,825
2022-03-08,Norway,1296,118,819,24,1178,180,179,359,795
2022-03-09,Norway,1317,133,819,19,1184,178,187,365,800
2022-03-10,Norway,1375,102,873,11,1273,201,199,400,862
2022-03-11,Norway,1447,153,843,11,1294,224,227,451,832
2022-03-12,Norway,803,159,291,14,644,179,174,353,277
2022-03-13,Norway,1229,179,644,12,1050,195,211,406,632
2022-03-14,Norway,1481,154,896,29,1327,217,214,431,867
2022-03-15,Norway,1357,139,863,29,1218,177,178,355,834
2022-03-16,Norway,1355,139,840,17,1216,184,192,376,823
2022-03-17,Norway,1440,154,879,9,1286,205,202,407,870
2022-03-18,Norway,1471,130,876,25,1341,231,234,465,851
2022-03-19,Norway,749,110,290,10,639,174,175,349,280
2022-03-20,Norway,1158,123,636,14,1035,197,202,399,622
2022-03-21,Norway,1427,140,860,19,1287,214,213,427,841
2022-03-22,Norway,1350,100,884,20,1250,181,185,366,864
2022-03-23,Norway,1415,117,883,18,1298,212,203,415,865
2022-03-24,Norway,1408,115,884,20,1293,206,203,409,864
2022-03-25,Norway,1473,143,855,21,1330,235,240,475,834
2022-03-26,Norway,829,135,312,10,694,196,186,382,302
2022-03-27,Norway,1265,133,654,17,1132,230,248,478,637
2022-03-28,Norway,1605,124,969,24,1481,259,253,512,945
2022-03-29,Norway,1446,109,901,24,1337,219,217,436,877
2022-03-30,Norway,1602,143,950,24,1459,252,257,509,926
2022-03-31,Norway,1675,159,1005,29,1516,255,256,511,976
2022-04-01,Norway,1642,159,917,22,1483,286,280,566,895
2022-04-02,Norway,886,119,338,20,767,216,213,429,318
2022-04-03,Norway,1304,149,662,23,1155,244,249,493,639
2022-04-04,Norway,1608,159,941,18,1449,252,256,508,923
2022-04-05,Norway,1556,111,959,31,1445,241,245,486,928
2022-04-06,Norway,1688,154,975,23,1534,277,282,559,952
2022-04-07,Norway,1737,202,995,11,1535,269,271,540,984
2022-04-08,Norway,1733,185,958,27,1548,296,294,590,931
2022-04-09,Norway,939,161,329,14,778,228,221,449,315
2022-04-10,Norway,1263,157,587,14,1106,259,260,519,573
2022-04-11,Norway,1487,153,815,28,1334,261,258,519,787
2022-04-12,Norway,1476,145,824,28,1331,252,255,507,796
2022-04-13,Norway,1478,152,807,20,1326,259,260,519,787
2022-04-14,Norway,1233,164,577,9,1069,247,245,492,568
2022-04-15,Norway,886,150,239,7,736,247,250,497,232
2022-04-16,Norway,808,138,228,12,670,222,220,442,216
2022-04-17,Norway,1205,144,556,5,1061,248,257,505,551
2022-04-18,Norway,1503,193,767,10,1310,270,273,543,757
2022-04-19,Norway,1681,159,989,11,1522,265,268,533,978
2022-04-20,Norway,1689,144,1003,28,1545,270,272,542,975
2022-04-21,Norway,1732,160,1036,30,1572,269,267,536,1006
2022-04-22,Norway,1734,150,982,29,1584,300,302,602,953
2022-04-23,Norway,877,132,334,13,745,209,202,411,321
2022-04-24,Norway,1350,146,683,12,1204,254,267,521,671
2022-04-25,Norway,1718,156,1000,26,1562,289,273,562,974
2022-04-26,Norway,1680,156,987,19,1524,267,270,537,968
2022-04-27,Norway,1674,135,976,24,1539,279,284,563,952
2022-04-28,Norway,1712,147,998,25,1565,283,284,567,973
2022-04-29,Norway,1688,166,957,16,1522,282,283,565,941
2022-04-30,Norway,928,143,362,20,785,214,209,423,342
2022-05-01,Norway,1364,160,676,8,1204,258,270,528,668
2022-05-02,Norway,1689,155,977,16,1534,281,276,557,961
2022-05-03,Norway,1710,153,1018,25,1557,269,270,539,993
2022-05-04,Norway,1760,166,1023,17,1594,281,290,571,1006
2022-05-05,Norway,1827,195,1041,21,1632,295,296,591,1020
2022-05-06,Norway,1743,174,944,18,1569,311,314,625,926
2022-05-07,Norway,920,118,330,16,802,240,232,472,314
2022-05-08,Norway,1401,128,716,16,1273,278,279,557,700
2022-05-09,Norway,1747,164,1002,25,1583,289,292,581,977
2022-05-10,Norway,1718,139,1019,13,1579,281,279,560,1006
2022-05-11,Norway,1707,136,1002,13,1571,283,286,569,989
2022-05-12,Norway,1788,166,1030,26,1622,293,299,592,1004
2022-05-13,Norway,1750,149,990,21,1601,310,301,611,969
2022-05-14,Norway,945,139,336,17,806,236,234,470,319
2022-05-15,Norway,1402,172,665,13,1230,279,286,565,652
2022-05-16,Norway,1666,166,919,14,1500,293,288,581,905
2022-05-17,Norway,1127,150,539,7,977,215,223,438,532
2022-05-18,Norway,1769,169,1025,19,1600,290,285,575,1006
2022-05-19,Norway,1769,170,1002,25,1599,299,298,597,977
2022-05-20,Norway,1779,166,989,36,1613,312,312,624,953
2022-05-21,Norway,1013,154,350,21,859,260,249,509,329
2022-05-22,Norway,1429,149,682,9,1280,298,300,598,673
2022-05-23,Norway,1780,169,1023,29,1611,295,293,588,994
2022-05-24,Norway,1778,194,1034,22,1584,275,275,550,1012
2022-05-25,Norway,1824,211,1006,29,1613,298,309,607,977
2022-05-26,Norway,1477,188,716,4,1289,286,287,573,712
2022-05-27,Norway,1568,181,831,22,1387,279,277,556,809
2022-05-28,Norway,988,137,349,14,851,251,251,502,335
2022-05-29,Norway,1485,177,718,18,1308,289,301,590,700
2022-05-30,Norway,1855,212,1033,20,1643,306,304,610,1013
2022-05-31,Norway,1769,186,1026,22,1583,278,279,557,1004
2022-06-01,Norway,1790,158,1007,22,1632,312,313,625,985
2022-06-02,Norway,1816,181,1013,18,1635,310,312,622,995
2022-06-03,Norway,1791,160,984,24,1631,329,318,647,960
2022-06-04,Norway,1014,122,325,13,892,282,285,567,312
2022-06-05,Norway,1321,147,575,15,1174,298,301,599,560
2022-06-06,Norway,1606,163,826,12,1443,309,308,617,814
2022-06-07,Norway,1786,184,994,18,1602,301,307,608,976
2022-01-01,Poland,1410,791,44,3,619,288,287,575,41
2022-01-02,Poland,1983,1099,58,4,884,417,409,826,54
2022-01-03,Poland,1792,888,76,2,904,411,417,828,74
2022-01-04,Poland,1588,835,98,12,753,322,333,655,86
2022-01-05,Poland,1610,833,100,15,777,342,335,677,85
2022-01-06,Poland,1520,760,70,2,760,347,343,690,68
2022-01-07,Poland,1794,919,97,18,875,389,389,778,79
2022-01-08,Poland,1747,991,65,11,756,344,347,691,54
2022-01-09,Poland,1950,1096,67,9,854,392,395,787,58
2022-01-10,Poland,1606,870,106,27,736,312,318,630,79
2022-01-11,Poland,1332,740,113,18,592,234,245,479,95
2022-01-12,Poland,1349,722,112,26,627,266,249,515,86
2022-01-13,Poland,1352,744,91,6,608,256,261,517,85
2022-01-14,Poland,1550,856,91,8,694,298,305,603,83
2022-01-15,Poland,1484,889,97,34,595,250,248,498,63
2022-01-16,Poland,1472,851,73,13,621,275,273,548,60
2022-01-17,Poland,1386,740,78,5,646,279,289,568,73
2022-01-18,Poland,1228,671,124,27,557,214,219,433,97
2022-01-19,Poland,1223,682,112,23,541,219,210,429,89
2022-01-20,Poland,1256,691,80,4,565,243,242,485,76
2022-01-21,Poland,1476,827,97,15,649,277,275,552,82
2022-01-22,Poland,1314,782,67,3,532,233,232,465,64
2022-01-23,Poland,1367,782,62,5,585,262,261,523,57
2022-01-24,Poland,1259,644,84,13,615,256,275,531,71
2022-01-25,Poland,1068,575,85,11,493,205,203,408,74
2022-01-26,Poland,1182,663,84,10,519,214,221,435,74
2022-01-27,Poland,1288,681,93,11,607,262,252,514,82
2022-01-28,Poland,1486,830,77,8,656,292,287,579,69
2022-01-29,Poland,1377,836,61,5,541,239,241,480,56
2022-01-30,Poland,1369,800,45,1,569,263,261,524,44
2022-01-31,Poland,1319,710,81,15,609,260,268,528,66
2022-02-01,Poland,1200,660,83,14,540,233,224,457,69
2022-02-02,Poland,1230,655,84,8,575,243,248,491,76
2022-02-03,Poland,1341,705,95,26,636,274,267,541,69
2022-02-04,Poland,1510,786,86,16,724,317,321,638,70
2022-02-05,Poland,1370,768,61,7,602,274,267,541,54
2022-02-06,Poland,1415,761,53,8,654,297,304,601,45
2022-02-07,Poland,1342,648,84,16,694,300,310,610,68
2022-02-08,Poland,1174,626,74,12,548,238,236,474,62
2022-02-09,Poland,1280,665,87,23,615,265,263,528,64
2022-02-10,Poland,1384,684,93,19,700,303,304,607,74
2022-02-11,Poland,1599,817,95,18,782,340,347,687,77
2022-02-12,Poland,1508,797,95,20,711,306,310,616,75
2022-02-13,Poland,1549,812,75,19,737,330,332,662,56
2022-02-14,Poland,1444,688,104,24,756,323,329,652,80
2022-02-15,Poland,1274,650,94,22,624,266,264,530,72
2022-02-16,Poland,1337,688,102,27,649,270,277,547,75
2022-02-17,Poland,1278,670,59,9,608,282,267,549,50
2022-02-18,Poland,1587,829,109,19,758,322,327,649,90
2022-02-19,Poland,1500,883,48,1,617,287,282,569,47
2022-02-20,Poland,1563,851,59,7,712,321,332,653,52
2022-02-21,Poland,1410,707,70,3,703,313,320,633,67
2022-02-22,Poland,1271,646,104,21,625,259,262,521,83
2022-02-23,Poland,1297,669,78,8,628,274,276,550,70
2022-02-24,Poland,1423,737,118,36,686,289,279,568,82
2022-02-25,Poland,1606,817,104,30,789,338,347,685,74
2022-02-26,Poland,1336,695,69,18,641,290,282,572,51
2022-02-27,Poland,1277,556,72,16,721,320,329,649,56
2022-02-28,Poland,1277,481,127,37,796,327,342,669,90
2022-03-01,Poland,1168,441,120,22,727,308,299,607,98
2022-03-02,Poland,1180,418,133,31,762,311,318,629,102
2022-03-03,Poland,1276,483,113,27,793,346,334,680,86
2022-03-04,Poland,1461,576,108,14,885,392,385,777,94
2022-03-05,Poland,1334,598,66,9,736,339,331,670,57
2022-03-06,Poland,1348,546,68,11,802,367,367,734,57
2022-03-07,Poland,1314,454,126,24,860,356,378,734,102
2022-03-08,Poland,1186,436,145,27,750,318,287,605,118
2022-03-09,Poland,1167,427,101,17,740,310,329,639,84
2022-03-10,Poland,1287,457,120,20,830,358,352,710,100
2022-03-11,Poland,1406,531,98,15,875,386,391,777,83
2022-03-12,Poland,1289,546,84,19,743,330,329,659,65
2022-03-13,Poland,1322,528,69,10,794,363,362,725,59
2022-03-14,Poland,1344,484,106,19,860,370,384,754,87
2022-03-15,Poland,1175,449,100,15,726,317,309,626,85
2022-03-16,Poland,1124,384,114,19,740,311,315,626,95
2022-03-17,Poland,1215,405,123,15,810,346,341,687,108
2022-03-18,Poland,1448,512,112,22,936,415,409,824,90
2022-03-19,Poland,1227,518,73,14,709,319,317,636,59
2022-03-20,Poland,1296,498,68,12,798,362,368,730,56
2022-03-21,Poland,1296,436,102,14,860,374,384,758,88
2022-03-22,Poland,1147,427,101,21,720,311,308,619,80
2022-03-23,Poland,1213,405,112,29,808,349,347,696,83
2022-03-24,Poland,1253,430,110,24,823,357,356,713,86
2022-03-25,Poland,1444,536,113,22,908,398,397,795,91
2022-03-26,Poland,1312,543,89,16,769,346,334,680,73
2022-03-27,Poland,1366,540,80,9,826,369,377,746,71
2022-03-28,Poland,1377,484,109,9,893,390,394,784,100
2022-03-29,Poland,1371,476,124,20,895,387,384,771,104
2022-03-30,Poland,1347,507,123,13,840,360,357,717,110
2022-03-31,Poland,1464,522,107,12,942,422,413,835,95
2022-04-01,Poland,1443,553,106,9,890,391,393,784,97
2022-04-02,Poland,1394,616,61,5,778,358,359,717,56
2022-04-03,Poland,1425,598,75,10,827,372,380,752,65
2022-04-04,Poland,1362,500,109,16,862,380,373,753,93
2022-04-05,Poland,1349,516,100,12,833,369,364,733,88
2022-04-06,Poland,1362,510,120,22,852,369,363,732,98
2022-04-07,Poland,1482,522,121,17,960,420,419,839,104
2022-04-08,Poland,1445,518,111,10,927,399,417,816,101
2022-04-09,Poland,1367,531,84,11,836,381,371,752,73
2022-04-10,Poland,1306,442,84,14,864,392,388,780,70
2022-04-11,Poland,1416,480,141,20,936,395,400,795,121
2022-04-12,Poland,1391,507,108,17,884,389,387,776,91
2022-04-13,Poland,1412,473,131,25,939,403,405,808,106
2022-04-14,Poland,1510,501,119,25,1009,449,441,890,94
2022-04-15,Poland,1535,595,105,10,940,418,417,835,95
2022-04-16,Poland,1404,617,65,3,787,364,358,722,62
2022-04-17,Poland,1376,587,62,1,789,365,362,727,61
2022-04-18,Poland,1442,590,75,0,852,386,391,777,75
2022-04-19,Poland,1454,556,107,14,898,391,400,791,93
2022-04-20,Poland,1384,461,134,35,923,389,400,789,99
2022-04-21,Poland,1426,460,118,19,966,425,423,848,99
2022-04-22,Poland,1531,547,132,29,984,436,416,852,103
2022-04-23,Poland,1425,585,82,12,840,370,388,758,70
2022-04-24,Poland,1523,638,70,8,885,402,413,815,62
2022-04-25,Poland,1528,552,127,22,976,426,423,849,105
2022-04-26,Poland,1575,593,141,28,982,424,417,841,113
2022-04-27,Poland,1521,529,130,30,992,432,430,862,100
2022-04-28,Poland,1617,503,149,31,1114,485,480,965,118
2022-04-29,Poland,1715,602,144,27,1113,478,491,969,117
2022-04-30,Poland,1714,733,89,24,981,457,435,892,65
2022-05-01,Poland,1734,720,92,1,1014,462,460,922,91
2022-05-02,Poland,1605,655,111,11,950,422,417,839,100
2022-05-03,Poland,1634,671,99,4,963,425,439,864,95
2022-05-04,Poland,1682,642,153,33,1040,440,447,887,120
2022-05-05,Poland,1749,645,136,22,1104,486,482,968,114
2022-05-06,Poland,1782,682,148,18,1100,479,473,952,130
2022-05-07,Poland,1791,777,98,20,1014,454,462,916,78
2022-05-08,Poland,1798,752,110,12,1046,466,470,936,98
2022-05-09,Poland,1754,681,149,21,1073,464,460,924,128
2022-05-10,Poland,1738,697,148,21,1041,448,445,893,127
2022-05-11,Poland,1751,698,157,21,1053,441,455,896,136
2022-05-12,Poland,1830,700,160,26,1130,487,483,970,134
2022-05-13,Poland,1888,765,164,27,1123,482,477,959,137
2022-05-14,Poland,1852,862,83,12,990,454,453,907,71
2022-05-15,Poland,1839,785,103,12,1054,481,470,951,91
2022-05-16,Poland,1740,688,157,25,1052,451,444,895,132
2022-05-17,Poland,1671,666,124,13,1005,440,441,881,111
2022-05-18,Poland,1686,657,154,23,1029,437,438,875,131
2022-05-19,Poland,1808,710,141,22,1098,482,475,957,119
2022-05-20,Poland,1886,789,130,16,1097,480,487,967,114
2022-05-21,Poland,1848,874,85,8,974,443,446,889,77
2022-05-22,Poland,1844,807,111,12,1037,467,459,926,99
2022-05-23,Poland,1814,743,163,24,1071,452,456,908,139
2022-05-24,Poland,1749,700,152,28,1049,449,448,897,124
2022-05-25,Poland,1737,727,132,19,1010,437,441,878,113
2022-05-26,Poland,1876,780,139,18,1096,479,478,957,121
2022-05-27,Poland,1896,782,149,28,1114,477,488,965,121
2022-05-28,Poland,1898,900,93,20,998,457,448,905,73
2022-05-29,Poland,1964,891,109,12,1073,485,479,964,97
2022-05-30,Poland,1879,781,147,16,1098,474,477,951,131
2022-05-31,Poland,1810,752,135,16,1058,459,464,923,119
2022-06-01,Poland,1794,697,133,17,1097,481,483,964,116
2022-06-02,Poland,1950,730,150,20,1220,538,532,1070,130
2022-06-03,Poland,2070,843,149,17,1227,537,541,1078,132
2022-06-04,Poland,2004,942,85,9,1062,492,485,977,76
2022-06-05,Poland,2019,886,109,13,1133,509,515,1024,96
2022-06-06,Poland,1943,782,155,20,1161,504,502,1006,135
2022-06-07,Poland,1900,790,139,22,1110,488,483,971,117
2022-01-01,Portugal,1760,926,106,1,834,372,356,728,105
2022-01-02,Portugal,1892,938,164,0,954,391,399,790,164
2022-01-03,Portugal,1786,820,143,0,966,404,419,823,143
2022-01-04,Portugal,1661,890,120,0,771,323,328,651,120
2022-01-05,Portugal,1560,838,121,0,722,312,289,601,121
2022-01-06,Portugal,1510,777,125,1,733,304,304,608,124
2022-01-07,Portugal,1684,846,132,1,838,351,355,706,131
2022-01-08,Portugal,1992,1146,116,1,846,366,364,730,115
2022-01-09,Portugal,1841,987,116,0,854,365,373,738,116
2022-01-10,Portugal,1451,746,120,2,705,294,291,585,118
2022-01-11,Portugal,1204,670,116,4,534,197,221,418,112
2022-01-12,Portugal,1196,646,114,6,550,235,201,436,108
2022-01-13,Portugal,1142,601,113,4,541,206,222,428,109
2022-01-14,Portugal,1405,687,133,6,718,304,281,585,127
2022-01-15,Portugal,1613,944,106,5,669,275,288,563,101
2022-01-16,Portugal,1489,766,125,9,723,302,296,598,116
2022-01-17,Portugal,1296,611,123,4,685,275,287,562,119
2022-01-18,Portugal,1096,608,93,1,488,189,206,395,92
2022-01-19,Portugal,1157,618,121,2,539,221,197,418,119
2022-01-20,Portugal,1168,630,113,7,538,204,221,425,106
2022-01-21,Portugal,1409,687,135,5,722,297,290,587,130
2022-01-22,Portugal,1595,939,108,4,656,269,279,548,104
2022-01-23,Portugal,1491,795,112,0,696,298,286,584,112
2022-01-24,Portugal,1289,593,128,6,696,276,292,568,122
2022-01-25,Portugal,1105,604,107,7,501,194,200,394,100
2022-01-26,Portugal,1172,642,104,2,530,229,197,426,102
2022-01-27,Portugal,1182,642,105,2,540,211,224,435,103
2022-01-28,Portugal,1402,675,134,6,727,303,290,593,128
2022-01-29,Portugal,1673,1011,108,3,662,276,278,554,105
2022-01-30,Portugal,1543,826,115,8,717,303,299,602,107
2022-01-31,Portugal,1347,672,117,4,675,268,290,558,113
2022-02-01,Portugal,1181,649,100,4,532,208,224,432,96
2022-02-02,Portugal,1180,609,112,13,571,243,216,459,99
2022-02-03,Portugal,1277,667,115,8,610,246,249,495,107
2022-02-04,Portugal,1625,866,120,5,759,323,316,639,115
2022-02-05,Portugal,1936,1198,104,2,738,315,319,634,102
2022-02-06,Portugal,1703,967,106,3,736,311,319,630,103
2022-02-07,Portugal,1471,710,116,1,761,313,332,645,115
2022-02-08,Portugal,1223,667,102,6,556,230,224,454,96
2022-02-09,Portugal,1268,654,110,7,614,258,246,504,103
2022-02-10,Portugal,1404,702,114,5,702,291,297,588,109
2022-02-11,Portugal,1593,763,128,3,830,356,346,702,125
2022-02-12,Portugal,1907,1053,108,3,854,375,371,746,105
2022-02-13,Portugal,1634,813,124,7,821,346,351,697,117
2022-02-14,Portugal,1527,711,123,2,816,344,349,693,121
2022-02-15,Portugal,1297,678,107,5,619,251,261,512,102
2022-02-16,Portugal,1362,690,118,7,672,289,265,554,111
2022-02-17,Portugal,1447,723,118,3,724,300,306,606,115
2022-02-18,Portugal,1645,809,129,3,836,360,347,707,126
2022-02-19,Portugal,2137,1235,112,4,902,392,398,790,108
2022-02-20,Portugal,1833,976,112,8,857,373,372,745,104
2022-02-21,Portugal,1596,750,117,0,846,357,372,729,117
2022-02-22,Portugal,1437,767,120,7,670,264,286,550,113
2022-02-23,Portugal,1502,783,130,3,719,304,285,589,127
2022-02-24,Portugal,1610,809,121,4,801,349,331,680,117
2022-02-25,Portugal,1738,851,136,7,887,373,378,751,129
2022-02-26,Portugal,2039,1119,127,6,920,399,394,793,121
2022-02-27,Portugal,1893,1016,121,7,877,383,373,756,114
2022-02-28,Portugal,1599,727,134,3,872,361,377,738,131
2022-03-01,Portugal,1499,789,122,5,710,287,301,588,117
2022-03-02,Portugal,1466,749,131,7,717,297,289,586,124
2022-03-03,Portugal,1573,782,118,1,791,336,337,673,117
2022-03-04,Portugal,1765,849,139,4,916,395,382,777,135
2022-03-05,Portugal,2069,1147,123,4,922,402,397,799,119
2022-03-06,Portugal,1841,929,126,6,912,394,392,786,120
2022-03-07,Portugal,1622,757,133,4,865,359,373,732,129
2022-03-08,Portugal,1452,771,103,5,681,279,299,578,98
2022-03-09,Portugal,1452,738,118,7,714,312,284,596,111
2022-03-10,Portugal,1608,809,122,6,799,335,342,677,116
2022-03-11,Portugal,1712,824,136,6,888,378,374,752,130
2022-03-12,Portugal,2036,1118,125,5,918,398,395,793,120
2022-03-13,Portugal,1921,1013,129,3,908,393,386,779,126
2022-03-14,Portugal,1515,710,93,3,805,351,361,712,90
2022-03-15,Portugal,1417,715,91,4,702,302,309,611,87
2022-03-16,Portugal,1538,749,132,5,789,334,323,657,127
2022-03-17,Portugal,1606,796,123,3,810,349,338,687,120
2022-03-18,Portugal,1726,790,138,4,936,397,401,798,134
2022-03-19,Portugal,2096,1132,122,6,964,416,426,842,116
2022-03-20,Portugal,1887,959,128,0,928,404,396,800,128
2022-03-21,Portugal,1644,743,136,1,901,376,389,765,135
2022-03-22,Portugal,1525,792,122,3,733,299,312,611,119
2022-03-23,Portugal,1454,718,134,5,736,310,292,602,129
2022-03-24,Portugal,1596,765,133,8,831,349,349,698,125
2022-03-25,Portugal,1763,816,144,8,947,396,407,803,136
2022-03-26,Portugal,2089,1109,145,9,980,421,414,835,136
2022-03-27,Portugal,2080,972,162,7,1108,481,465,946,155
2022-03-28,Portugal,1778,743,164,6,1035,426,445,871,158
2022-03-29,Portugal,1734,790,165,9,944,382,397,779,156
2022-03-30,Portugal,1751,753,176,9,998,422,400,822,167
2022-03-31,Portugal,1867,829,168,6,1038,431,439,870,162
2022-04-01,Portugal,1937,805,179,6,1132,474,479,953,173
2022-04-02,Portugal,2290,1150,168,5,1140,487,485,972,163
2022-04-03,Portugal,2138,999,162,1,1139,493,484,977,161
2022-04-04,Portugal,1804,698,169,6,1106,461,476,937,163
2022-04-05,Portugal,1755,790,169,5,965,392,404,796,164
2022-04-06,Portugal,1824,797,173,4,1027,432,422,854,169
2022-04-07,Portugal,1936,855,171,6,1081,457,453,910,165
2022-04-08,Portugal,2001,826,172,6,1175,510,493,1003,166
2022-04-09,Portugal,2320,1123,179,8,1197,508,510,1018,171
2022-04-10,Portugal,2072,923,159,2,1149,492,498,990,157
2022-04-11,Portugal,1882,768,179,1,1114,461,474,935,178
2022-04-12,Portugal,1906,878,176,3,1028,427,425,852,173
2022-04-13,Portugal,1933,844,178,11,1089,464,447,911,167
2022-04-14,Portugal,1959,836,176,7,1123,469,478,947,169
2022-04-15,Portugal,1931,789,176,6,1142,483,483,966,170
2022-04-16,Portugal,2268,1074,179,2,1194,506,509,1015,177
2022-04-17,Portugal,2084,918,164,2,1166,502,500,1002,162
2022-04-18,Portugal,2007,836,185,4,1171,491,495,986,181
2022-04-19,Portugal,1913,895,180,7,1018,413,425,838,173
2022-04-20,Portugal,1960,854,181,4,1106,476,449,925,177
2022-04-21,Portugal,2011,890,176,5,1121,471,474,945,171
2022-04-22,Portugal,1991,836,165,1,1155,502,488,990,164
2022-04-23,Portugal,2310,1111,167,3,1199,519,513,1032,164
2022-04-24,Portugal,2145,953,164,1,1192,519,509,1028,163
2022-04-25,Portugal,1973,802,172,8,1171,486,513,999,164
2022-04-26,Portugal,1789,750,166,4,1039,438,435,873,162
2022-04-27,Portugal,1804,727,173,8,1077,456,448,904,165
2022-04-28,Portugal,1847,740,175,10,1107,465,467,932,165
2022-04-29,Portugal,1936,771,179,11,1165,490,496,986,168
2022-04-30,Portugal,2227,1030,170,1,1197,514,513,1027,169
2022-05-01,Portugal,2061,839,166,1,1222,533,523,1056,165
2022-05-02,Portugal,1953,783,177,4,1170,483,510,993,173
2022-05-03,Portugal,1776,728,180,1,1048,429,439,868,179
2022-05-04,Portugal,1888,740,186,6,1148,493,469,962,180
2022-05-05,Portugal,1889,740,183,9,1149,481,485,966,174
2022-05-06,Portugal,1875,699,176,5,1176,507,493,1000,171
2022-05-07,Portugal,2045,861,172,6,1184,510,502,1012,166
2022-05-08,Portugal,1978,781,164,6,1197,514,519,1033,158
2022-05-09,Portugal,1871,683,178,6,1188,499,511,1010,172
2022-05-10,Portugal,1745,721,180,11,1024,418,426,844,169
2022-05-11,Portugal,1803,697,183,5,1106,468,455,923,178
2022-05-12,Portugal,1936,780,193,4,1156,483,480,963,189
2022-05-13,Portugal,1850,681,178,5,1169,500,491,991,173
2022-05-14,Portugal,2051,876,163,4,1175,505,507,1012,159
2022-05-15,Portugal,1991,770,171,1,1221,530,520,1050,170
2022-05-16,Portugal,1910,706,178,5,1204,502,524,1026,173
2022-05-17,Portugal,1772,723,184,9,1049,428,437,865,175
2022-05-18,Portugal,1831,689,184,8,1142,487,471,958,176
2022-05-19,Portugal,1865,700,180,9,1165,501,484,985,171
2022-05-20,Portugal,1836,648,183,7,1188,494,511,1005,176
2022-05-21,Portugal,2059,841,177,3,1218,522,519,1041,174
2022-05-22,Portugal,1945,733,158,7,1212,528,526,1054,151
2022-05-23,Portugal,2144,886,202,14,1258,527,529,1056,188
2022-05-24,Portugal,1991,853,187,9,1138,476,475,951,178
2022-05-25,Portugal,1949,758,193,8,1191,502,496,998,185
2022-05-26,Portugal,1944,729,183,11,1215,518,514,1032,172
2022-05-27,Portugal,1960,739,186,4,1221,515,520,1035,182
2022-05-28,Portugal,2104,879,174,4,1225,520,531,1051,170
2022-05-29,Portugal,2040,793,172,3,1247,543,532,1075,169
2022-05-30,Portugal,1891,644,178,9,1247,525,544,1069,169
2022-05-31,Portugal,1814,668,199,12,1146,477,470,947,187
2022-06-01,Portugal,1767,562,184,7,1205,515,506,1021,177
2022-06-02,Portugal,1996,768,171,7,1228,524,533,1057,164
2022-06-03,Portugal,2001,731,189,9,1270,540,541,1081,180
2022-06-04,Portugal,2170,899,177,3,1271,540,554,1094,174
2022-06-05,Portugal,2059,795,173,5,1264,554,537,1091,168
2022-06-06,Portugal,2033,751,169,8,1282,550,563,1113,161
2022-06-07,Portugal,1893,725,179,4,1168,492,497,989,175
2022-01-01,Romania,1138,890,5,2,248,120,123,243,3
2022-01-02,Romania,1509,1082,35,3,427,192,200,392,32
2022-01-03,Romania,1382,903,48,6,479,217,214,431,42
2022-01-04,Romania,1256,862,34,5,394,181,179,360,29
2022-01-05,Romania,1279,852,54,6,427,185,188,373,48
2022-01-06,Romania,1315,919,46,4,396,175,175,350,42
2022-01-07,Romania,1437,989,48,4,448,198,202,400,44
2022-01-08,Romania,1421,1062,16,0,359,173,170,343,16
2022-01-09,Romania,1467,1037,35,1,430,197,198,395,34
2022-01-10,Romania,1185,859,39,1,326,142,145,287,38
2022-01-11,Romania,1080,796,50,8,284,119,115,234,42
2022-01-12,Romania,1067,769,61,4,298,118,119,237,57
2022-01-13,Romania,1108,805,71,8,303,118,114,232,63
2022-01-14,Romania,1211,871,60,4,340,137,143,280,56
2022-01-15,Romania,1153,912,23,4,241,113,105,218,19
2022-01-16,Romania,1234,945,35,1,289,124,130,254,34
2022-01-17,Romania,1021,739,44,5,282,122,116,238,39
2022-01-18,Romania,977,720,65,13,257,97,95,192,52
2022-01-19,Romania,978,732,57,10,246,90,99,189,47
2022-01-20,Romania,1071,769,88,12,302,108,106,214,76
2022-01-21,Romania,1150,824,64,9,326,131,131,262,55
2022-01-22,Romania,1137,892,28,6,245,113,104,217,22
2022-01-23,Romania,1171,909,36,5,262,110,116,226,31
2022-01-24,Romania,866,607,38,4,259,109,112,221,34
2022-01-25,Romania,796,562,45,10,234,96,93,189,35
2022-01-26,Romania,923,660,64,15,263,98,101,199,49
2022-01-27,Romania,1056,768,78,11,288,109,101,210,67
2022-01-28,Romania,1161,839,62,10,322,125,135,260,52
2022-01-29,Romania,1108,871,25,3,237,106,106,212,22
2022-01-30,Romania,1134,869,41,4,265,113,111,224,37
2022-01-31,Romania,1014,719,52,7,295,119,124,243,45
2022-02-01,Romania,979,707,56,9,272,108,108,216,47
2022-02-02,Romania,984,687,72,12,297,113,112,225,60
2022-02-03,Romania,1095,802,67,8,293,111,115,226,59
2022-02-04,Romania,1163,828,63,8,335,135,137,272,55
2022-02-05,Romania,1147,881,26,8,266,125,115,240,18
2022-02-06,Romania,1144,879,30,4,265,117,118,235,26
2022-02-07,Romania,990,702,50,8,288,122,116,238,42
2022-02-08,Romania,945,685,51,7,260,102,107,209,44
2022-02-09,Romania,987,705,68,11,282,105,109,214,57
2022-02-10,Romania,1118,816,72,10,302,112,118,230,62
2022-02-11,Romania,1252,901,63,9,351,142,146,288,54
2022-02-12,Romania,1187,929,26,6,258,123,109,232,20
2022-02-13,Romania,1265,979,31,4,286,125,130,255,27
2022-02-14,Romania,1207,890,50,8,317,130,137,267,42
2022-02-15,Romania,1188,866,60,14,322,133,129,262,46
2022-02-16,Romania,1126,814,71,18,312,118,123,241,53
2022-02-17,Romania,1201,888,74,12,313,120,119,239,62
2022-02-18,Romania,1292,961,56,6,331,141,134,275,50
2022-02-19,Romania,1374,1099,23,6,275,125,127,252,17
2022-02-20,Romania,1332,1028,28,3,304,136,140,276,25
2022-02-21,Romania,1158,837,53,7,321,135,133,268,46
2022-02-22,Romania,1133,838,73,15,295,109,113,222,58
2022-02-23,Romania,1154,828,84,17,326,124,118,242,67
2022-02-24,Romania,1187,868,65,16,319,123,131,254,49
2022-02-25,Romania,1239,870,66,10,369,148,155,303,56
2022-02-26,Romania,1217,916,25,3,301,140,136,276,22
2022-02-27,Romania,1217,872,38,7,345,151,156,307,31
2022-02-28,Romania,1222,830,68,5,392,162,162,324,63
2022-03-01,Romania,1139,806,50,8,333,137,146,283,42
2022-03-02,Romania,1261,845,66,13,416,175,175,350,53
2022-03-03,Romania,1350,923,67,11,427,184,176,360,56
2022-03-04,Romania,1412,935,64,9,477,204,209,413,55
2022-03-05,Romania,1390,1030,37,12,360,162,161,323,25
2022-03-06,Romania,1389,990,43,7,399,178,178,356,36
2022-03-07,Romania,1315,862,67,12,453,193,193,386,55
2022-03-08,Romania,1185,832,44,11,353,160,149,309,33
2022-03-09,Romania,1238,869,61,8,369,149,159,308,53
2022-03-10,Romania,1284,893,82,21,391,159,150,309,61
2022-03-11,Romania,1359,905,66,13,454,189,199,388,53
2022-03-12,Romania,1249,901,27,7,348,165,156,321,20
2022-03-13,Romania,1303,944,38,5,359,158,163,321,33
2022-03-14,Romania,1243,802,84,17,441,174,183,357,67
2022-03-15,Romania,1210,851,73,14,359,147,139,286,59
2022-03-16,Romania,1198,816,65,13,382,158,159,317,52
2022-03-17,Romania,1301,902,91,11,399,153,155,308,80
2022-03-18,Romania,1396,937,58,7,459,199,202,401,51
2022-03-19,Romania,1324,977,38,10,347,159,150,309,28
2022-03-20,Romania,1358,972,41,7,386,173,172,345,34
2022-03-21,Romania,1263,839,69,15,424,176,179,355,54
2022-03-22,Romania,1136,792,51,9,344,144,149,293,42
2022-03-23,Romania,1231,866,67,16,365,152,146,298,51
2022-03-24,Romania,1329,930,86,14,399,160,153,313,72
2022-03-25,Romania,1395,950,69,11,445,185,191,376,58
2022-03-26,Romania,1391,1039,33,8,352,165,154,319,25
2022-03-27,Romania,1474,1030,44,8,444,200,200,400,36
2022-03-28,Romania,1367,903,58,6,464,204,202,406,52
2022-03-29,Romania,1331,931,67,9,400,164,169,333,58
2022-03-30,Romania,1379,931,81,11,448,181,186,367,70
2022-03-31,Romania,1494,1007,77,9,487,211,199,410,68
2022-04-01,Romania,1600,1081,68,5,519,222,229,451,63
2022-04-02,Romania,1585,1185,34,2,400,185,181,366,32
2022-04-03,Romania,1625,1163,46,7,462,207,209,416,39
2022-04-04,Romania,1468,947,81,14,521,217,223,440,67
2022-04-05,Romania,1429,989,81,19,440,185,174,359,62
2022-04-06,Romania,1475,995,89,19,480,190,201,391,70
2022-04-07,Romania,1621,1099,101,23,522,211,210,421,78
2022-04-08,Romania,1708,1162,84,18,546,231,231,462,66
2022-04-09,Romania,1635,1212,44,5,423,193,186,379,39
2022-04-10,Romania,1643,1185,42,3,458,206,210,416,39
2022-04-11,Romania,1624,1090,89,18,534,223,222,445,71
2022-04-12,Romania,1597,1135,81,11,462,191,190,381,70
2022-04-13,Romania,1574,1059,89,12,515,210,216,426,77
2022-04-14,Romania,1758,1198,86,12,560,240,234,474,74
2022-04-15,Romania,1769,1189,78,11,580,248,254,502,67
2022-04-16,Romania,1685,1223,43,4,462,214,205,419,39
2022-04-17,Romania,1705,1223,36,4,482,222,224,446,32
2022-04-18,Romania,1630,1115,57,10,515,229,229,458,47
2022-04-19,Romania,1605,1119,67,8,486,215,204,419,59
2022-04-20,Romania,1578,1048,78,17,530,222,230,452,61
2022-04-21,Romania,1710,1163,67,9,547,245,235,480,58
2022-04-22,Romania,1698,1165,50,1,533,241,242,483,49
2022-04-23,Romania,1769,1294,31,2,475,220,224,444,29
2022-04-24,Romania,1766,1298,32,2,468,218,218,436,30
2022-04-25,Romania,1596,1063,53,4,533,234,246,480,49
2022-04-26,Romania,1609,1118,57,8,491,218,216,434,49
2022-04-27,Romania,1631,1104,61,10,527,233,233,466,51
2022-04-28,Romania,1712,1154,70,13,558,243,245,488,57
2022-04-29,Romania,1828,1227,67,11,601,267,267,534,56
2022-04-30,Romania,1811,1328,35,4,483,226,222,448,31
2022-05-01,Romania,1863,1326,47,6,537,244,246,490,41
2022-05-02,Romania,1680,1133,64,6,547,239,244,483,58
2022-05-03,Romania,1635,1161,64,14,474,205,205,410,50
2022-05-04,Romania,1690,1172,73,14,518,219,226,445,59
2022-05-05,Romania,1771,1209,88,11,562,240,234,474,77
2022-05-06,Romania,1770,1210,77,12,560,242,241,483,65
2022-05-07,Romania,1767,1324,38,6,443,206,199,405,32
2022-05-08,Romania,1812,1317,49,7,495,221,225,446,42
2022-05-09,Romania,1678,1151,74,8,527,220,233,453,66
2022-05-10,Romania,1624,1175,79,16,449,190,180,370,63
2022-05-11,Romania,1613,1105,89,11,508,203,216,419,78
2022-05-12,Romania,1684,1170,87,13,514,217,210,427,74
2022-05-13,Romania,1807,1222,83,14,585,253,249,502,69
2022-05-14,Romania,1829,1408,34,7,421,197,190,387,27
2022-05-15,Romania,1816,1308,46,5,508,230,232,462,41
2022-05-16,Romania,1697,1158,91,13,539,220,228,448,78
2022-05-17,Romania,1640,1187,76,15,453,190,187,377,61
2022-05-18,Romania,1648,1153,74,8,495,205,216,421,66
2022-05-19,Romania,1732,1199,95,14,533,225,213,438,81
2022-05-20,Romania,1836,1287,88,15,549,229,232,461,73
2022-05-21,Romania,1820,1388,38,11,432,198,196,394,27
2022-05-22,Romania,1832,1324,50,9,508,230,228,458,41
2022-05-23,Romania,1725,1208,73,10,517,223,221,444,63
2022-05-24,Romania,1633,1187,81,16,446,183,182,365,65
2022-05-25,Romania,1795,1290,79,9,505,209,217,426,70
2022-05-26,Romania,1810,1268,97,18,542,229,216,445,79
2022-05-27,Romania,1928,1368,87,17,560,238,235,473,70
2022-05-28,Romania,2005,1566,33,6,439,204,202,406,27
2022-05-29,Romania,2043,1548,42,1,495,224,229,453,41
2022-05-30,Romania,1850,1293,85,15,557,233,239,472,70
2022-05-31,Romania,1865,1397,72,11,468,201,195,396,61
2022-06-01,Romania,1757,1254,71,16,503,214,218,432,55
2022-06-02,Romania,1903,1390,79,9,513,217,217,434,70
2022-06-03,Romania,2053,1486,77,8,567,244,246,490,69
2022-06-04,Romania,2057,1590,36,4,467,219,212,431,32
2022-06-05,Romania,1991,1506,43,4,485,222,220,442,39
2022-06-06,Romania,2040,1501,69,8,539,235,235,470,61
2022-06-07,Romania,1808,1329,79,8,479,198,202,400,71
2022-01-01,Serbia & Montenegro,0,-96,10,0,96,41,45,86,10
2022-01-02,Serbia & Montenegro,0,-220,20,2,220,107,93,200,18
2022-01-03,Serbia & Montenegro,0,-189,19,1,189,82,88,170,18
2022-01-04,Serbia & Montenegro,0,-142,15,0,142,63,64,127,15
2022-01-05,Serbia & Montenegro,0,-158,25,6,158,67,66,133,19
2022-01-06,Serbia & Montenegro,0,-165,19,1,165,72,74,146,18
2022-01-07,Serbia & Montenegro,0,-195,18,0,195,90,87,177,18
2022-01-08,Serbia & Montenegro,0,-166,18,0,166,70,78,148,18
2022-01-09,Serbia & Montenegro,0,-210,18,1,210,93,99,192,17
2022-01-10,Serbia & Montenegro,0,-194,16,0,194,90,88,178,16
2022-01-11,Serbia & Montenegro,0,-138,11,0,138,64,63,127,11
2022-01-12,Serbia & Montenegro,0,-134,14,0,134,62,58,120,14
2022-01-13,Serbia & Montenegro,0,-155,21,3,155,65,69,134,18
2022-01-14,Serbia & Montenegro,0,-196,20,1,196,87,89,176,19
2022-01-15,Serbia & Montenegro,0,-134,20,2,134,55,59,114,18
2022-01-16,Serbia & Montenegro,0,-160,19,2,160,75,66,141,17
2022-01-17,Serbia & Montenegro,0,-170,27,11,170,69,74,143,16
2022-01-18,Serbia & Montenegro,0,-116,16,8,116,51,49,100,8
2022-01-19,Serbia & Montenegro,0,-115,16,5,115,53,46,99,11
2022-01-20,Serbia & Montenegro,0,-153,22,3,153,64,67,131,19
2022-01-21,Serbia & Montenegro,0,-161,21,4,161,70,70,140,17
2022-01-22,Serbia & Montenegro,0,-117,16,0,117,50,51,101,16
2022-01-23,Serbia & Montenegro,0,-154,16,0,154,70,68,138,16
2022-01-24,Serbia & Montenegro,0,-137,17,0,137,58,62,120,17
2022-01-25,Serbia & Montenegro,0,-116,11,2,116,53,52,105,9
2022-01-26,Serbia & Montenegro,0,-114,11,1,114,53,50,103,10
2022-01-27,Serbia & Montenegro,0,-143,21,2,143,60,62,122,19
2022-01-28,Serbia & Montenegro,0,-179,22,4,179,80,77,157,18
2022-01-29,Serbia & Montenegro,0,-123,18,1,123,49,56,105,17
2022-01-30,Serbia & Montenegro,0,-143,18,0,143,65,60,125,18
2022-01-31,Serbia & Montenegro,0,-157,22,8,157,66,69,135,14
2022-02-01,Serbia & Montenegro,0,-117,13,4,117,51,53,104,9
2022-02-02,Serbia & Montenegro,0,-109,17,5,109,47,45,92,12
2022-02-03,Serbia & Montenegro,0,-143,21,5,143,62,60,122,16
2022-02-04,Serbia & Montenegro,0,-176,24,9,176,78,74,152,15
2022-02-05,Serbia & Montenegro,0,-126,16,0,126,56,54,110,16
2022-02-06,Serbia & Montenegro,0,-131,17,3,131,57,57,114,14
2022-02-07,Serbia & Montenegro,0,-140,15,1,140,60,65,125,14
2022-02-08,Serbia & Montenegro,0,-126,19,10,126,53,54,107,9
2022-02-09,Serbia & Montenegro,0,-117,20,9,117,50,47,97,11
2022-02-10,Serbia & Montenegro,0,-172,25,9,172,75,72,147,16
2022-02-11,Serbia & Montenegro,0,-190,28,12,190,84,78,162,16
2022-02-12,Serbia & Montenegro,0,-131,19,1,131,54,58,112,18
2022-02-13,Serbia & Montenegro,0,-137,13,0,137,63,61,124,13
2022-02-14,Serbia & Montenegro,0,-156,16,0,156,66,74,140,16
2022-02-15,Serbia & Montenegro,0,-132,12,0,132,59,61,120,12
2022-02-16,Serbia & Montenegro,0,-121,10,0,121,54,57,111,10
2022-02-17,Serbia & Montenegro,0,-141,22,2,141,60,59,119,20
2022-02-18,Serbia & Montenegro,0,-182,26,10,182,79,77,156,16
2022-02-19,Serbia & Montenegro,0,-132,18,2,132,57,57,114,16
2022-02-20,Serbia & Montenegro,0,-152,15,0,152,70,67,137,15
2022-02-21,Serbia & Montenegro,0,-166,25,9,166,68,73,141,16
2022-02-22,Serbia & Montenegro,0,-134,23,8,134,53,58,111,15
2022-02-23,Serbia & Montenegro,0,-130,17,7,130,56,57,113,10
2022-02-24,Serbia & Montenegro,0,-162,24,8,162,72,66,138,16
2022-02-25,Serbia & Montenegro,0,-181,20,5,181,81,80,161,15
2022-02-26,Serbia & Montenegro,0,-125,15,0,125,50,60,110,15
2022-02-27,Serbia & Montenegro,0,-151,15,0,151,68,68,136,15
2022-02-28,Serbia & Montenegro,0,-151,17,1,151,70,64,134,16
2022-03-01,Serbia & Montenegro,0,-142,19,3,142,57,66,123,16
2022-03-02,Serbia & Montenegro,0,-128,18,5,128,54,56,110,13
2022-03-03,Serbia & Montenegro,0,-175,27,9,175,76,72,148,18
2022-03-04,Serbia & Montenegro,0,-210,24,6,210,95,91,186,18
2022-03-05,Serbia & Montenegro,0,-134,16,3,134,60,58,118,13
2022-03-06,Serbia & Montenegro,0,-159,17,1,159,68,74,142,16
2022-03-07,Serbia & Montenegro,0,-177,17,0,177,81,79,160,17
2022-03-08,Serbia & Montenegro,0,-128,22,11,128,54,52,106,11
2022-03-09,Serbia & Montenegro,0,-134,23,10,134,57,54,111,13
2022-03-10,Serbia & Montenegro,0,-144,21,0,144,61,62,123,21
2022-03-11,Serbia & Montenegro,0,-205,26,6,205,92,87,179,20
2022-03-12,Serbia & Montenegro,0,-130,15,0,130,53,62,115,15
2022-03-13,Serbia & Montenegro,0,-160,21,1,160,72,67,139,20
2022-03-14,Serbia & Montenegro,0,-175,17,1,175,75,83,158,16
2022-03-15,Serbia & Montenegro,0,-131,14,1,131,58,59,117,13
2022-03-16,Serbia & Montenegro,0,-162,20,5,162,76,66,142,15
2022-03-17,Serbia & Montenegro,0,-174,21,1,174,77,76,153,20
2022-03-18,Serbia & Montenegro,0,-199,19,1,199,91,89,180,18
2022-03-19,Serbia & Montenegro,0,-139,14,1,139,59,66,125,13
2022-03-20,Serbia & Montenegro,0,-174,19,0,174,79,76,155,19
2022-03-21,Serbia & Montenegro,0,-182,24,7,182,77,81,158,17
2022-03-22,Serbia & Montenegro,0,-145,24,10,145,58,63,121,14
2022-03-23,Serbia & Montenegro,0,-145,25,9,145,62,58,120,16
2022-03-24,Serbia & Montenegro,0,-182,23,4,182,77,82,159,19
2022-03-25,Serbia & Montenegro,0,-210,28,9,210,92,90,182,19
2022-03-26,Serbia & Montenegro,0,-145,17,1,145,64,64,128,16
2022-03-27,Serbia & Montenegro,0,-183,16,1,183,84,83,167,15
2022-03-28,Serbia & Montenegro,0,-208,29,9,208,90,89,179,20
2022-03-29,Serbia & Montenegro,0,-161,27,10,161,69,65,134,17
2022-03-30,Serbia & Montenegro,0,-157,29,10,157,65,63,128,19
2022-03-31,Serbia & Montenegro,0,-166,16,4,166,77,73,150,12
2022-04-01,Serbia & Montenegro,0,-211,25,4,211,91,95,186,21
2022-04-02,Serbia & Montenegro,0,-148,17,0,148,66,65,131,17
2022-04-03,Serbia & Montenegro,0,-178,14,0,178,81,83,164,14
2022-04-04,Serbia & Montenegro,0,-212,25,10,212,91,96,187,15
2022-04-05,Serbia & Montenegro,0,-139,23,11,139,57,59,116,12
2022-04-06,Serbia & Montenegro,0,-165,27,9,165,74,64,138,18
2022-04-07,Serbia & Montenegro,0,-184,17,2,184,85,82,167,15
2022-04-08,Serbia & Montenegro,0,-245,28,9,245,106,111,217,19
2022-04-09,Serbia & Montenegro,0,-161,19,1,161,73,69,142,18
2022-04-10,Serbia & Montenegro,0,-211,19,0,211,94,98,192,19
2022-04-11,Serbia & Montenegro,0,-248,27,5,248,110,111,221,22
2022-04-12,Serbia & Montenegro,0,-164,25,10,164,71,68,139,15
2022-04-13,Serbia & Montenegro,0,-165,24,7,165,72,69,141,17
2022-04-14,Serbia & Montenegro,0,-215,26,7,215,93,96,189,19
2022-04-15,Serbia & Montenegro,0,-253,29,4,253,111,113,224,25
2022-04-16,Serbia & Montenegro,0,-191,29,2,191,79,83,162,27
2022-04-17,Serbia & Montenegro,0,-192,19,0,192,86,87,173,19
2022-04-18,Serbia & Montenegro,0,-219,23,6,219,103,93,196,17
2022-04-19,Serbia & Montenegro,0,-178,22,6,178,75,81,156,16
2022-04-20,Serbia & Montenegro,0,-166,19,2,166,74,73,147,17
2022-04-21,Serbia & Montenegro,0,-220,26,6,220,99,95,194,20
2022-04-22,Serbia & Montenegro,0,-220,23,3,220,99,98,197,20
2022-04-23,Serbia & Montenegro,0,-200,22,1,200,87,91,178,21
2022-04-24,Serbia & Montenegro,0,-212,15,0,212,95,102,197,15
2022-04-25,Serbia & Montenegro,0,-213,21,1,213,98,94,192,20
2022-04-26,Serbia & Montenegro,0,-179,24,9,179,77,78,155,15
2022-04-27,Serbia & Montenegro,0,-176,26,9,176,75,75,150,17
2022-04-28,Serbia & Montenegro,0,-225,25,1,225,102,98,200,24
2022-04-29,Serbia & Montenegro,0,-254,34,3,254,111,109,220,31
2022-04-30,Serbia & Montenegro,0,-216,22,1,216,96,98,194,21
2022-05-01,Serbia & Montenegro,0,-219,18,0,219,101,100,201,18
2022-05-02,Serbia & Montenegro,0,-217,24,0,217,97,96,193,24
2022-05-03,Serbia & Montenegro,0,-196,22,0,196,86,88,174,22
2022-05-04,Serbia & Montenegro,0,-188,28,7,188,79,81,160,21
2022-05-05,Serbia & Montenegro,0,-235,25,7,235,105,105,210,18
2022-05-06,Serbia & Montenegro,0,-248,24,1,248,113,111,224,23
2022-05-07,Serbia & Montenegro,0,-201,20,0,201,87,94,181,20
2022-05-08,Serbia & Montenegro,0,-211,20,0,211,95,96,191,20
2022-05-09,Serbia & Montenegro,0,-239,35,14,239,103,101,204,21
2022-05-10,Serbia & Montenegro,0,-204,26,11,204,89,89,178,15
2022-05-11,Serbia & Montenegro,0,-200,30,10,200,83,87,170,20
2022-05-12,Serbia & Montenegro,0,-241,32,11,241,110,99,209,21
2022-05-13,Serbia & Montenegro,0,-252,31,7,252,108,113,221,24
2022-05-14,Serbia & Montenegro,0,-200,20,0,200,87,93,180,20
2022-05-15,Serbia & Montenegro,0,-236,24,1,236,109,103,212,23
2022-05-16,Serbia & Montenegro,0,-242,33,10,242,105,104,209,23
2022-05-17,Serbia & Montenegro,0,-209,26,9,209,93,90,183,17
2022-05-18,Serbia & Montenegro,0,-202,30,10,202,84,88,172,20
2022-05-19,Serbia & Montenegro,0,-284,24,7,284,125,135,260,17
2022-05-20,Serbia & Montenegro,0,-280,33,10,280,126,121,247,23
2022-05-21,Serbia & Montenegro,0,-243,25,1,243,107,111,218,24
2022-05-22,Serbia & Montenegro,0,-269,18,0,269,131,120,251,18
2022-05-23,Serbia & Montenegro,0,-234,26,7,234,104,104,208,19
2022-05-24,Serbia & Montenegro,0,-214,17,1,214,99,98,197,16
2022-05-25,Serbia & Montenegro,0,-216,20,3,216,95,101,196,17
2022-05-26,Serbia & Montenegro,0,-268,26,7,268,123,119,242,19
2022-05-27,Serbia & Montenegro,0,-276,33,7,276,123,120,243,26
2022-05-28,Serbia & Montenegro,0,-224,20,0,224,102,102,204,20
2022-05-29,Serbia & Montenegro,0,-256,16,0,256,123,117,240,16
2022-05-30,Serbia & Montenegro,0,-271,31,10,271,117,123,240,21
2022-05-31,Serbia & Montenegro,0,-223,26,10,223,97,100,197,16
2022-06-01,Serbia & Montenegro,2478,2235,33,11,243,102,108,210,22
2022-06-02,Serbia & Montenegro,2629,2336,28,7,293,136,129,265,21
2022-06-03,Serbia & Montenegro,2864,2579,27,5,285,130,128,258,22
2022-06-04,Serbia & Montenegro,3185,2954,24,1,231,103,104,207,23
2022-06-05,Serbia & Montenegro,2982,2713,20,1,269,130,119,249,19
2022-06-06,Serbia & Montenegro,2629,2348,31,11,281,123,127,250,20
2022-06-07,Serbia & Montenegro,2668,2414,30,10,254,108,116,224,20
2022-01-01,Slovakia,645,628,0,0,17,9,8,17,0
2022-01-02,Slovakia,893,839,0,0,54,28,26,54,0
2022-01-03,Slovakia,845,787,0,0,58,29,29,58,0
2022-01-04,Slovakia,691,667,1,0,24,11,12,23,1
2022-01-05,Slovakia,702,670,2,0,32,14,16,30,2
2022-01-06,Slovakia,662,638,0,0,24,13,11,24,0
2022-01-07,Slovakia,817,754,3,1,63,29,31,60,2
2022-01-08,Slovakia,771,739,3,0,32,14,15,29,3
2022-01-09,Slovakia,831,786,0,0,45,22,23,45,0
2022-01-10,Slovakia,685,651,1,0,34,17,16,33,1
2022-01-11,Slovakia,562,529,3,1,33,14,16,30,2
2022-01-12,Slovakia,576,535,8,2,41,15,18,33,6
2022-01-13,Slovakia,611,573,4,0,38,15,19,34,4
2022-01-14,Slovakia,731,689,4,2,42,17,21,38,2
2022-01-15,Slovakia,672,652,2,1,20,11,7,18,1
2022-01-16,Slovakia,656,608,4,0,48,23,21,44,4
2022-01-17,Slovakia,577,543,0,0,34,18,16,34,0
2022-01-18,Slovakia,513,479,12,3,34,10,12,22,9
2022-01-19,Slovakia,518,460,13,6,58,20,25,45,7
2022-01-20,Slovakia,558,525,1,0,33,18,14,32,1
2022-01-21,Slovakia,659,623,2,0,36,17,17,34,2
2022-01-22,Slovakia,573,562,1,0,11,4,6,10,1
2022-01-23,Slovakia,621,587,2,1,34,15,17,32,1
2022-01-24,Slovakia,521,476,8,1,45,19,18,37,7
2022-01-25,Slovakia,407,385,4,1,22,10,8,18,3
2022-01-26,Slovakia,480,443,6,2,37,17,14,31,4
2022-01-27,Slovakia,578,542,7,2,36,15,14,29,5
2022-01-28,Slovakia,674,638,1,0,36,16,19,35,1
2022-01-29,Slovakia,615,598,0,0,17,9,8,17,0
2022-01-30,Slovakia,630,597,0,0,33,16,17,33,0
2022-01-31,Slovakia,621,581,4,2,40,18,18,36,2
2022-02-01,Slovakia,549,524,6,0,25,8,11,19,6
2022-02-02,Slovakia,563,519,4,1,44,21,19,40,3
2022-02-03,Slovakia,574,537,6,3,37,17,14,31,3
2022-02-04,Slovakia,646,610,3,1,36,17,16,33,2
2022-02-05,Slovakia,600,574,0,0,26,12,14,26,0
2022-02-06,Slovakia,619,591,1,0,28,14,13,27,1
2022-02-07,Slovakia,629,575,3,0,54,26,25,51,3
2022-02-08,Slovakia,521,490,6,3,31,11,14,25,3
2022-02-09,Slovakia,585,544,2,0,41,18,21,39,2
2022-02-10,Slovakia,635,593,6,2,42,20,16,36,4
2022-02-11,Slovakia,690,635,6,2,55,24,25,49,4
2022-02-12,Slovakia,644,614,2,2,30,15,13,28,0
2022-02-13,Slovakia,690,648,3,2,42,17,22,39,1
2022-02-14,Slovakia,682,623,2,2,59,31,26,57,0
2022-02-15,Slovakia,605,567,4,2,38,15,19,34,2
2022-02-16,Slovakia,605,533,4,3,72,33,35,68,1
2022-02-17,Slovakia,618,583,0,0,35,20,15,35,0
2022-02-18,Slovakia,740,683,6,0,57,25,26,51,6
2022-02-19,Slovakia,711,671,2,1,40,21,17,38,1
2022-02-20,Slovakia,719,678,1,0,41,20,20,40,1
2022-02-21,Slovakia,646,587,1,0,59,29,29,58,1
2022-02-22,Slovakia,602,560,3,0,42,18,21,39,3
2022-02-23,Slovakia,603,556,4,0,47,22,21,43,4
2022-02-24,Slovakia,800,753,8,6,47,20,19,39,2
2022-02-25,Slovakia,925,843,11,0,82,34,37,71,11
2022-02-26,Slovakia,848,816,2,0,32,16,14,30,2
2022-02-27,Slovakia,834,785,3,0,49,23,23,46,3
2022-02-28,Slovakia,765,716,1,1,49,25,23,48,0
2022-03-01,Slovakia,715,665,12,5,50,15,23,38,7
2022-03-02,Slovakia,784,721,8,4,63,28,27,55,4
2022-03-03,Slovakia,828,778,3,2,50,23,24,47,1
2022-03-04,Slovakia,923,847,6,2,76,37,33,70,4
2022-03-05,Slovakia,896,843,3,2,53,24,26,50,1
2022-03-06,Slovakia,901,852,7,3,49,20,22,42,4
2022-03-07,Slovakia,814,743,8,4,71,31,32,63,4
2022-03-08,Slovakia,765,712,3,1,53,25,25,50,2
2022-03-09,Slovakia,793,719,10,4,74,34,30,64,6
2022-03-10,Slovakia,800,752,11,3,48,19,18,37,8
2022-03-11,Slovakia,914,843,7,4,71,32,32,64,3
2022-03-12,Slovakia,813,787,2,0,26,13,11,24,2
2022-03-13,Slovakia,857,806,1,0,51,21,29,50,1
2022-03-14,Slovakia,774,710,6,1,64,31,27,58,5
2022-03-15,Slovakia,775,731,8,2,44,17,19,36,6
2022-03-16,Slovakia,757,696,4,0,61,24,33,57,4
2022-03-17,Slovakia,807,747,7,2,60,26,27,53,5
2022-03-18,Slovakia,921,857,5,3,64,36,23,59,2
2022-03-19,Slovakia,845,801,2,0,44,20,22,42,2
2022-03-20,Slovakia,868,825,2,1,43,21,20,41,1
2022-03-21,Slovakia,783,722,7,1,61,25,29,54,6
2022-03-22,Slovakia,731,668,8,4,63,29,26,55,4
2022-03-23,Slovakia,756,691,7,2,65,31,27,58,5
2022-03-24,Slovakia,812,749,4,1,63,28,31,59,3
2022-03-25,Slovakia,951,865,5,2,86,42,39,81,3
2022-03-26,Slovakia,910,875,0,0,35,16,19,35,0
2022-03-27,Slovakia,930,870,0,0,60,27,33,60,0
2022-03-28,Slovakia,848,780,13,6,68,30,25,55,7
2022-03-29,Slovakia,894,825,4,4,69,28,37,65,0
2022-03-30,Slovakia,881,788,9,6,93,46,38,84,3
2022-03-31,Slovakia,948,876,3,1,72,35,34,69,2
2022-04-01,Slovakia,1004,933,7,0,71,32,32,64,7
2022-04-02,Slovakia,1077,1049,1,0,28,14,13,27,1
2022-04-03,Slovakia,1056,998,1,0,58,27,30,57,1
2022-04-04,Slovakia,921,854,3,1,67,33,31,64,2
2022-04-05,Slovakia,921,860,2,0,61,29,30,59,2
2022-04-06,Slovakia,934,855,5,1,79,38,36,74,4
2022-04-07,Slovakia,1021,955,6,0,66,32,28,60,6
2022-04-08,Slovakia,1108,1054,1,1,54,27,26,53,0
2022-04-09,Slovakia,1126,1094,1,0,32,15,16,31,1
2022-04-10,Slovakia,1103,1040,1,0,63,31,31,62,1
2022-04-11,Slovakia,1017,951,3,1,66,29,34,63,2
2022-04-12,Slovakia,1059,984,10,3,75,32,33,65,7
2022-04-13,Slovakia,1032,950,5,1,82,40,37,77,4
2022-04-14,Slovakia,1120,1051,4,1,69,34,31,65,3
2022-04-15,Slovakia,1160,1098,2,1,62,30,30,60,1
2022-04-16,Slovakia,1160,1134,2,0,26,12,12,24,2
2022-04-17,Slovakia,1128,1079,1,0,49,23,25,48,1
2022-04-18,Slovakia,1094,1026,4,1,68,32,32,64,3
2022-04-19,Slovakia,1161,1096,4,4,65,30,31,61,0
2022-04-20,Slovakia,1043,977,9,4,66,29,28,57,5
2022-04-21,Slovakia,1106,1046,14,8,60,22,24,46,6
2022-04-22,Slovakia,1122,1051,6,3,71,35,30,65,3
2022-04-23,Slovakia,1231,1180,2,1,51,22,27,49,1
2022-04-24,Slovakia,1254,1168,5,2,86,40,41,81,3
2022-04-25,Slovakia,1053,995,7,3,58,26,25,51,4
2022-04-26,Slovakia,1107,1042,10,4,65,26,29,55,6
2022-04-27,Slovakia,1099,1010,15,6,89,34,40,74,9
2022-04-28,Slovakia,1184,1109,6,3,75,40,29,69,3
2022-04-29,Slovakia,1246,1167,10,2,79,36,33,69,8
2022-04-30,Slovakia,1314,1279,2,1,35,13,20,33,1
2022-05-01,Slovakia,1380,1315,3,1,65,30,32,62,2
2022-05-02,Slovakia,1176,1108,8,3,68,31,29,60,5
2022-05-03,Slovakia,1197,1118,10,3,79,34,35,69,7
2022-05-04,Slovakia,1246,1166,5,2,80,37,38,75,3
2022-05-05,Slovakia,1348,1258,7,4,90,38,45,83,3
2022-05-06,Slovakia,1287,1209,6,0,78,35,37,72,6
2022-05-07,Slovakia,1372,1318,2,0,54,27,25,52,2
2022-05-08,Slovakia,1369,1302,6,0,67,29,32,61,6
2022-05-09,Slovakia,1195,1108,5,2,87,44,38,82,3
2022-05-10,Slovakia,1181,1097,10,3,84,39,35,74,7
2022-05-11,Slovakia,1231,1141,8,4,90,41,41,82,4
2022-05-12,Slovakia,1318,1241,8,2,77,32,37,69,6
2022-05-13,Slovakia,1333,1246,10,2,87,41,36,77,8
2022-05-14,Slovakia,1448,1384,4,0,64,32,28,60,4
2022-05-15,Slovakia,1423,1345,6,1,78,32,40,72,5
2022-05-16,Slovakia,1224,1150,7,6,74,34,33,67,1
2022-05-17,Slovakia,1181,1110,3,1,71,35,33,68,2
2022-05-18,Slovakia,1232,1144,10,5,88,38,40,78,5
2022-05-19,Slovakia,1292,1220,5,4,72,35,32,67,1
2022-05-20,Slovakia,1421,1344,3,0,77,40,34,74,3
2022-05-21,Slovakia,1511,1470,0,0,41,23,18,41,0
2022-05-22,Slovakia,1474,1405,2,0,69,31,36,67,2
2022-05-23,Slovakia,1359,1270,1,0,89,43,45,88,1
2022-05-24,Slovakia,1320,1251,14,7,69,27,28,55,7
2022-05-25,Slovakia,1323,1251,6,4,72,35,31,66,2
2022-05-26,Slovakia,1394,1302,10,3,92,38,44,82,7
2022-05-27,Slovakia,1480,1386,16,7,94,38,40,78,9
2022-05-28,Slovakia,1617,1558,1,0,59,31,27,58,1
2022-05-29,Slovakia,1613,1534,3,1,79,34,42,76,2
2022-05-30,Slovakia,1394,1311,7,3,83,42,34,76,4
2022-05-31,Slovakia,1419,1345,6,5,74,32,36,68,1
2022-06-01,Slovakia,1428,1335,12,5,93,41,40,81,7
2022-06-02,Slovakia,1519,1427,11,3,92,41,40,81,8
2022-06-03,Slovakia,1605,1516,7,5,89,41,41,82,2
2022-06-04,Slovakia,1733,1672,2,0,61,32,27,59,2
2022-06-05,Slovakia,1778,1701,6,0,77,32,39,71,6
2022-06-06,Slovakia,1442,1361,5,3,81,41,35,76,2
2022-06-07,Slovakia,1486,1401,5,3,85,39,41,80,2
2022-01-01,Slovenia,743,730,0,0,13,6,7,13,0
2022-01-02,Slovenia,970,929,0,0,41,19,22,41,0
2022-01-03,Slovenia,884,825,3,0,59,29,27,56,3
2022-01-04,Slovenia,801,762,2,0,39,18,19,37,2
2022-01-05,Slovenia,828,787,0,0,41,21,20,41,0
2022-01-06,Slovenia,800,745,2,2,55,28,25,53,0
2022-01-07,Slovenia,879,819,7,1,60,26,27,53,6
2022-01-08,Slovenia,944,911,2,1,33,15,16,31,1
2022-01-09,Slovenia,955,922,0,0,33,17,16,33,0
2022-01-10,Slovenia,659,616,0,0,43,22,21,43,0
2022-01-11,Slovenia,612,574,4,2,38,17,17,34,2
2022-01-12,Slovenia,557,514,4,1,43,17,22,39,3
2022-01-13,Slovenia,513,470,0,0,43,22,21,43,0
2022-01-14,Slovenia,678,622,5,1,56,25,26,51,4
2022-01-15,Slovenia,696,668,3,3,28,12,13,25,0
2022-01-16,Slovenia,676,641,3,0,35,16,16,32,3
2022-01-17,Slovenia,592,541,4,3,51,25,22,47,1
2022-01-18,Slovenia,482,447,2,0,35,17,16,33,2
2022-01-19,Slovenia,523,465,4,1,58,25,29,54,3
2022-01-20,Slovenia,501,461,3,2,40,19,18,37,1
2022-01-21,Slovenia,675,614,8,2,61,25,28,53,6
2022-01-22,Slovenia,622,599,5,3,23,10,8,18,2
2022-01-23,Slovenia,620,591,0,0,29,15,14,29,0
2022-01-24,Slovenia,521,477,1,0,44,19,24,43,1
2022-01-25,Slovenia,438,397,3,0,41,21,17,38,3
2022-01-26,Slovenia,493,452,1,0,41,20,20,40,1
2022-01-27,Slovenia,482,444,0,0,38,19,19,38,0
2022-01-28,Slovenia,678,628,1,0,50,24,25,49,1
2022-01-29,Slovenia,629,595,2,0,34,15,17,32,2
2022-01-30,Slovenia,589,557,1,1,32,17,14,31,0
2022-01-31,Slovenia,582,537,1,1,45,22,22,44,0
2022-02-01,Slovenia,523,493,3,3,30,13,14,27,0
2022-02-02,Slovenia,499,460,2,2,39,20,17,37,0
2022-02-03,Slovenia,522,471,3,2,51,22,26,48,1
2022-02-04,Slovenia,716,661,0,0,55,28,27,55,0
2022-02-05,Slovenia,730,696,3,1,34,15,16,31,2
2022-02-06,Slovenia,656,619,0,0,37,19,18,37,0
2022-02-07,Slovenia,590,556,1,1,34,19,14,33,0
2022-02-08,Slovenia,521,489,1,1,32,13,18,31,0
2022-02-09,Slovenia,538,486,6,1,52,24,22,46,5
2022-02-10,Slovenia,586,534,2,2,52,27,23,50,0
2022-02-11,Slovenia,739,688,0,0,51,26,25,51,0
2022-02-12,Slovenia,746,715,4,1,31,12,15,27,3
2022-02-13,Slovenia,670,629,0,0,41,20,21,41,0
2022-02-14,Slovenia,590,543,4,3,47,22,21,43,1
2022-02-15,Slovenia,560,513,0,0,47,24,23,47,0
2022-02-16,Slovenia,568,509,4,3,59,26,29,55,1
2022-02-17,Slovenia,573,523,2,1,50,25,23,48,1
2022-02-18,Slovenia,750,687,4,2,63,27,32,59,2
2022-02-19,Slovenia,804,770,0,0,34,16,18,34,0
2022-02-20,Slovenia,751,711,0,0,40,21,19,40,0
2022-02-21,Slovenia,630,593,0,0,37,20,17,37,0
2022-02-22,Slovenia,585,543,9,4,42,18,15,33,5
2022-02-23,Slovenia,606,555,3,1,51,22,26,48,2
2022-02-24,Slovenia,636,585,4,2,51,26,21,47,2
2022-02-25,Slovenia,768,716,1,1,52,23,28,51,0
2022-02-26,Slovenia,760,724,0,0,36,17,19,36,0
2022-02-27,Slovenia,731,692,1,1,39,18,20,38,0
2022-02-28,Slovenia,661,619,1,1,42,20,21,41,0
2022-03-01,Slovenia,660,619,8,1,41,18,15,33,7
2022-03-02,Slovenia,638,576,8,5,62,28,26,54,3
2022-03-03,Slovenia,667,608,9,3,59,26,24,50,6
2022-03-04,Slovenia,865,809,3,2,56,25,28,53,1
2022-03-05,Slovenia,787,760,0,0,27,14,13,27,0
2022-03-06,Slovenia,785,754,1,0,31,14,16,30,1
2022-03-07,Slovenia,730,695,3,1,35,18,14,32,2
2022-03-08,Slovenia,660,616,8,5,44,17,19,36,3
2022-03-09,Slovenia,662,611,1,0,51,26,24,50,1
2022-03-10,Slovenia,689,631,11,2,58,24,23,47,9
2022-03-11,Slovenia,776,712,2,1,64,31,31,62,1
2022-03-12,Slovenia,783,743,0,0,40,19,21,40,0
2022-03-13,Slovenia,788,756,1,1,32,15,16,31,0
2022-03-14,Slovenia,747,701,5,3,46,22,19,41,2
2022-03-15,Slovenia,663,628,2,0,35,18,15,33,2
2022-03-16,Slovenia,690,640,7,6,50,19,24,43,1
2022-03-17,Slovenia,688,632,9,7,56,24,23,47,2
2022-03-18,Slovenia,800,739,4,1,61,28,29,57,3
2022-03-19,Slovenia,813,772,1,0,41,15,25,40,1
2022-03-20,Slovenia,818,782,0,0,36,17,19,36,0
2022-03-21,Slovenia,744,685,5,2,59,29,25,54,3
2022-03-22,Slovenia,627,585,3,1,42,18,21,39,2
2022-03-23,Slovenia,742,682,8,2,60,28,24,52,6
2022-03-24,Slovenia,751,687,4,3,64,32,28,60,1
2022-03-25,Slovenia,892,819,10,2,73,29,34,63,8
2022-03-26,Slovenia,864,821,2,2,43,18,23,41,0
2022-03-27,Slovenia,1157,1097,1,1,60,31,28,59,0
2022-03-28,Slovenia,972,907,1,1,65,30,34,64,0
2022-03-29,Slovenia,862,799,3,1,63,34,26,60,2
2022-03-30,Slovenia,900,846,1,1,54,26,27,53,0
2022-03-31,Slovenia,992,941,0,0,51,26,25,51,0
2022-04-01,Slovenia,1079,1033,0,0,46,23,23,46,0
2022-04-02,Slovenia,1066,1042,0,0,24,11,13,24,0
2022-04-03,Slovenia,1144,1101,0,0,43,20,23,43,0
2022-04-04,Slovenia,999,947,1,1,52,28,23,51,0
2022-04-05,Slovenia,876,828,4,0,48,22,22,44,4
2022-04-06,Slovenia,949,895,2,0,54,24,28,52,2
2022-04-07,Slovenia,1039,963,7,2,76,36,33,69,5
2022-04-08,Slovenia,1254,1187,2,1,67,33,32,65,1
2022-04-09,Slovenia,1371,1340,1,1,31,15,15,30,0
2022-04-10,Slovenia,1337,1283,2,2,54,25,27,52,0
2022-04-11,Slovenia,1087,1029,4,1,58,28,26,54,3
2022-04-12,Slovenia,992,951,1,1,41,22,18,40,0
2022-04-13,Slovenia,1124,1065,3,1,59,27,29,56,2
2022-04-14,Slovenia,1225,1148,5,5,77,36,36,72,0
2022-04-15,Slovenia,1317,1247,6,3,70,30,34,64,3
2022-04-16,Slovenia,1362,1333,0,0,29,15,14,29,0
2022-04-17,Slovenia,1374,1333,2,2,41,19,20,39,0
2022-04-18,Slovenia,1227,1170,2,2,57,29,26,55,0
2022-04-19,Slovenia,1068,1015,4,3,53,24,25,49,1
2022-04-20,Slovenia,1179,1114,5,2,65,31,29,60,3
2022-04-21,Slovenia,1250,1189,5,3,61,29,27,56,2
2022-04-22,Slovenia,1273,1225,0,0,48,23,25,48,0
2022-04-23,Slovenia,1420,1374,2,2,46,23,21,44,0
2022-04-24,Slovenia,1497,1451,1,1,46,22,23,45,0
2022-04-25,Slovenia,1226,1158,5,4,68,32,31,63,1
2022-04-26,Slovenia,1091,1033,1,1,58,31,26,57,0
2022-04-27,Slovenia,1148,1092,3,3,56,26,27,53,0
2022-04-28,Slovenia,1229,1159,3,2,70,33,34,67,1
2022-04-29,Slovenia,1358,1281,2,2,77,36,39,75,0
2022-04-30,Slovenia,1452,1411,6,2,41,15,20,35,4
2022-05-01,Slovenia,1515,1467,0,0,48,26,22,48,0
2022-05-02,Slovenia,1340,1284,1,1,56,27,28,55,0
2022-05-03,Slovenia,1284,1226,3,2,58,27,28,55,1
2022-05-04,Slovenia,1219,1148,9,4,71,31,31,62,5
2022-05-05,Slovenia,1343,1281,5,3,62,29,28,57,2
2022-05-06,Slovenia,1431,1369,0,0,62,32,30,62,0
2022-05-07,Slovenia,1588,1551,2,2,37,16,19,35,0
2022-05-08,Slovenia,1556,1502,3,3,54,25,26,51,0
2022-05-09,Slovenia,1351,1271,12,4,80,32,36,68,8
2022-05-10,Slovenia,1289,1210,8,3,79,36,35,71,5
2022-05-11,Slovenia,1304,1232,12,3,72,30,30,60,9
2022-05-12,Slovenia,1348,1277,4,0,71,33,34,67,4
2022-05-13,Slovenia,1492,1416,4,1,76,37,35,72,3
2022-05-14,Slovenia,1612,1570,1,0,42,19,22,41,1
2022-05-15,Slovenia,1622,1557,1,1,65,30,34,64,0
2022-05-16,Slovenia,1280,1197,6,1,83,43,34,77,5
2022-05-17,Slovenia,1336,1279,5,4,57,26,26,52,1
2022-05-18,Slovenia,1295,1238,6,2,57,25,26,51,4
2022-05-19,Slovenia,1316,1240,7,3,76,32,37,69,4
2022-05-20,Slovenia,1520,1447,2,2,73,34,37,71,0
2022-05-21,Slovenia,1720,1658,1,1,62,32,29,61,0
2022-05-22,Slovenia,1710,1638,5,1,72,32,35,67,4
2022-05-23,Slovenia,1364,1300,2,1,64,33,29,62,1
2022-05-24,Slovenia,1502,1439,0,0,63,30,33,63,0
2022-05-25,Slovenia,1646,1596,0,0,50,28,22,50,0
2022-05-26,Slovenia,1578,1505,3,0,73,33,37,70,3
2022-05-27,Slovenia,1578,1496,6,3,82,38,38,76,3
2022-05-28,Slovenia,1810,1772,0,0,38,18,20,38,0
2022-05-29,Slovenia,1836,1774,1,1,62,30,31,61,0
2022-05-30,Slovenia,1576,1505,4,3,71,36,31,67,1
2022-05-31,Slovenia,1429,1376,6,4,53,22,25,47,2
2022-06-01,Slovenia,1544,1473,7,5,71,31,33,64,2
2022-06-02,Slovenia,1555,1475,8,6,80,37,35,72,2
2022-06-03,Slovenia,1734,1630,5,2,104,52,47,99,3
2022-06-04,Slovenia,1947,1890,2,0,57,29,26,55,2
2022-06-05,Slovenia,1772,1710,1,1,62,28,33,61,0
2022-06-06,Slovenia,1668,1598,6,1,70,36,28,64,5
2022-06-07,Slovenia,1569,1513,4,1,56,25,27,52,3
2022-01-01,Spain,3769,764,728,4,3005,1142,1135,2277,724
2022-01-02,Spain,4596,850,1048,4,3746,1363,1335,2698,1044
2022-01-03,Spain,4275,849,1041,22,3426,1201,1184,2385,1019
2022-01-04,Spain,3897,729,937,20,3168,1113,1118,2231,917
2022-01-05,Spain,3654,672,914,23,2982,1039,1029,2068,891
2022-01-06,Spain,3567,661,831,13,2906,1030,1045,2075,818
2022-01-07,Spain,4019,743,1001,20,3276,1145,1130,2275,981
2022-01-08,Spain,4251,758,920,9,3493,1283,1290,2573,911
2022-01-09,Spain,4400,790,1065,5,3610,1282,1263,2545,1060
2022-01-10,Spain,3421,605,943,26,2816,939,934,1873,917
2022-01-11,Spain,2803,513,799,34,2290,749,742,1491,765
2022-01-12,Spain,2773,474,817,40,2299,736,746,1482,777
2022-01-13,Spain,2742,452,822,38,2290,732,736,1468,784
2022-01-14,Spain,3402,610,960,30,2792,903,929,1832,930
2022-01-15,Spain,3200,562,695,21,2638,982,961,1943,674
2022-01-16,Spain,3474,622,864,20,2852,1005,983,1988,844
2022-01-17,Spain,3034,580,871,51,2454,802,781,1583,820
2022-01-18,Spain,2597,480,794,57,2117,655,668,1323,737
2022-01-19,Spain,2719,468,836,49,2251,690,725,1415,787
2022-01-20,Spain,2774,476,820,51,2298,741,737,1478,769
2022-01-21,Spain,3412,624,991,53,2788,895,902,1797,938
2022-01-22,Spain,3215,580,728,33,2635,961,946,1907,695
2022-01-23,Spain,3425,626,866,23,2799,959,974,1933,843
2022-01-24,Spain,3000,579,869,36,2421,789,763,1552,833
2022-01-25,Spain,2525,467,756,48,2058,645,657,1302,708
2022-01-26,Spain,2703,484,797,45,2219,718,704,1422,752
2022-01-27,Spain,2804,471,842,47,2333,738,753,1491,795
2022-01-28,Spain,3426,639,985,30,2787,886,916,1802,955
2022-01-29,Spain,3162,579,674,10,2583,955,954,1909,664
2022-01-30,Spain,3536,667,888,14,2869,1008,973,1981,874
2022-01-31,Spain,3144,645,876,33,2499,827,796,1623,843
2022-02-01,Spain,2863,501,829,36,2362,761,772,1533,793
2022-02-02,Spain,2991,538,825,34,2453,798,830,1628,791
2022-02-03,Spain,3184,537,919,49,2647,859,869,1728,870
2022-02-04,Spain,3682,670,1060,36,3012,973,979,1952,1024
2022-02-05,Spain,3567,675,718,20,2892,1094,1080,2174,698
2022-02-06,Spain,3772,681,948,17,3091,1083,1060,2143,931
2022-02-07,Spain,3614,817,950,34,2797,928,919,1847,916
2022-02-08,Spain,3058,669,789,30,2389,797,803,1600,759
2022-02-09,Spain,3260,682,889,41,2578,855,834,1689,848
2022-02-10,Spain,3528,762,903,35,2766,925,938,1863,868
2022-02-11,Spain,4154,899,1073,31,3255,1079,1103,2182,1042
2022-02-12,Spain,4130,955,788,21,3175,1184,1203,2387,767
2022-02-13,Spain,4139,878,933,16,3261,1179,1149,2328,917
2022-02-14,Spain,3820,866,942,31,2954,1011,1001,2012,911
2022-02-15,Spain,3337,733,830,45,2604,890,884,1774,785
2022-02-16,Spain,3507,771,897,42,2736,916,923,1839,855
2022-02-17,Spain,3648,816,929,48,2832,953,950,1903,881
2022-02-18,Spain,4185,941,1081,40,3244,1069,1094,2163,1041
2022-02-19,Spain,4346,1086,753,18,3260,1248,1259,2507,735
2022-02-20,Spain,4465,1033,982,23,3432,1241,1209,2450,959
2022-02-21,Spain,3994,976,976,39,3018,1019,1023,2042,937
2022-02-22,Spain,3491,803,858,33,2688,901,929,1830,825
2022-02-23,Spain,3633,809,924,63,2824,954,946,1900,861
2022-02-24,Spain,3907,855,1002,53,3052,1020,1030,2050,949
2022-02-25,Spain,4465,1002,1102,32,3463,1179,1182,2361,1070
2022-02-26,Spain,4493,1037,851,20,3456,1294,1311,2605,831
2022-02-27,Spain,4547,1053,955,24,3494,1280,1259,2539,931
2022-02-28,Spain,4171,1005,1007,39,3166,1089,1070,2159,968
2022-03-01,Spain,3867,855,1019,53,3012,992,1001,1993,966
2022-03-02,Spain,3815,860,978,44,2955,1000,977,1977,934
2022-03-03,Spain,4102,930,1032,41,3172,1072,1068,2140,991
2022-03-04,Spain,4626,1080,1136,38,3546,1201,1209,2410,1098
2022-03-05,Spain,4632,1108,888,17,3524,1309,1327,2636,871
2022-03-06,Spain,4720,1073,1049,22,3647,1302,1296,2598,1027
2022-03-07,Spain,4195,1005,1029,31,3190,1093,1068,2161,998
2022-03-08,Spain,3792,853,919,46,2939,1008,1012,2020,873
2022-03-09,Spain,3841,877,978,48,2964,982,1004,1986,930
2022-03-10,Spain,4166,920,1036,39,3246,1112,1098,2210,997
2022-03-11,Spain,4609,1085,1148,26,3524,1180,1196,2376,1122
2022-03-12,Spain,4574,1070,889,12,3504,1299,1316,2615,877
2022-03-13,Spain,4625,1031,1024,10,3594,1303,1267,2570,1014
2022-03-14,Spain,4148,935,997,22,3213,1115,1101,2216,975
2022-03-15,Spain,3812,846,907,23,2966,1029,1030,2059,884
2022-03-16,Spain,3797,881,924,25,2916,998,994,1992,899
2022-03-17,Spain,4042,883,1007,37,3159,1072,1080,2152,970
2022-03-18,Spain,4618,1059,1138,22,3559,1204,1217,2421,1116
2022-03-19,Spain,4614,1053,880,22,3561,1336,1345,2681,858
2022-03-20,Spain,4702,1037,1016,6,3665,1322,1327,2649,1010
2022-03-21,Spain,4288,1025,1030,29,3263,1131,1102,2233,1001
2022-03-22,Spain,3837,874,932,31,2963,1015,1016,2031,901
2022-03-23,Spain,3816,844,954,27,2972,1007,1011,2018,927
2022-03-24,Spain,4114,906,1012,32,3208,1090,1106,2196,980
2022-03-25,Spain,4675,1083,1131,25,3592,1230,1231,2461,1106
2022-03-26,Spain,4639,1106,862,16,3533,1327,1344,2671,846
2022-03-27,Spain,5320,1205,1061,15,4115,1538,1516,3054,1046
2022-03-28,Spain,5019,1117,1155,49,3902,1382,1365,2747,1106
2022-03-29,Spain,4745,1060,1025,46,3685,1326,1334,2660,979
2022-03-30,Spain,4801,1090,1078,46,3711,1315,1318,2633,1032
2022-03-31,Spain,5091,1191,1124,41,3900,1376,1400,2776,1083
2022-04-01,Spain,5590,1218,1243,29,4372,1558,1571,3129,1214
2022-04-02,Spain,5707,1258,980,19,4449,1728,1741,3469,961
2022-04-03,Spain,5641,1266,1086,28,4375,1656,1633,3289,1058
2022-04-04,Spain,5305,1137,1182,46,4168,1503,1483,2986,1136
2022-04-05,Spain,5069,1033,1117,41,4036,1466,1453,2919,1076
2022-04-06,Spain,5158,1074,1173,59,4084,1436,1475,2911,1114
2022-04-07,Spain,5486,1160,1220,40,4326,1541,1565,3106,1180
2022-04-08,Spain,5885,1212,1299,37,4673,1665,1709,3374,1262
2022-04-09,Spain,6160,1279,1080,18,4881,1896,1905,3801,1062
2022-04-10,Spain,5871,1227,1140,16,4644,1772,1732,3504,1124
2022-04-11,Spain,5431,1130,1176,25,4301,1566,1559,3125,1151
2022-04-12,Spain,5345,1105,1123,29,4240,1542,1575,3117,1094
2022-04-13,Spain,5631,1171,1255,26,4460,1594,1611,3205,1229
2022-04-14,Spain,5774,1241,1199,24,4533,1646,1688,3334,1175
2022-04-15,Spain,5676,1225,1102,16,4451,1663,1686,3349,1086
2022-04-16,Spain,6110,1290,1078,9,4820,1871,1871,3742,1069
2022-04-17,Spain,5916,1285,1194,13,4631,1714,1723,3437,1181
2022-04-18,Spain,5865,1201,1291,34,4664,1729,1644,3373,1257
2022-04-19,Spain,5425,1124,1122,23,4301,1601,1578,3179,1099
2022-04-20,Spain,5350,1157,1139,34,4193,1532,1522,3054,1105
2022-04-21,Spain,5619,1233,1192,34,4386,1594,1600,3194,1158
2022-04-22,Spain,5838,1244,1256,16,4594,1652,1686,3338,1240
2022-04-23,Spain,5962,1320,954,7,4642,1857,1831,3688,947
2022-04-24,Spain,5965,1332,1110,11,4633,1776,1747,3523,1099
2022-04-25,Spain,5660,1240,1234,34,4420,1601,1585,3186,1200
2022-04-26,Spain,5259,1096,1112,30,4163,1532,1519,3051,1082
2022-04-27,Spain,5297,1155,1148,36,4142,1497,1497,2994,1112
2022-04-28,Spain,5577,1180,1189,28,4397,1587,1621,3208,1161
2022-04-29,Spain,5891,1238,1298,27,4653,1662,1693,3355,1271
2022-04-30,Spain,6035,1369,1013,22,4666,1811,1842,3653,991
2022-05-01,Spain,5989,1303,1128,14,4686,1798,1760,3558,1114
2022-05-02,Spain,5696,1222,1160,13,4474,1675,1639,3314,1147
2022-05-03,Spain,5469,1163,1098,15,4306,1607,1601,3208,1083
2022-05-04,Spain,5542,1234,1140,26,4308,1574,1594,3168,1114
2022-05-05,Spain,5847,1259,1258,41,4588,1665,1665,3330,1217
2022-05-06,Spain,6068,1269,1333,46,4799,1714,1752,3466,1287
2022-05-07,Spain,6095,1332,1031,19,4763,1865,1867,3732,1012
2022-05-08,Spain,6008,1354,1120,16,4654,1794,1740,3534,1104
2022-05-09,Spain,5808,1288,1195,25,4520,1666,1659,3325,1170
2022-05-10,Spain,5561,1143,1191,42,4418,1621,1606,3227,1149
2022-05-11,Spain,5531,1208,1185,49,4323,1567,1571,3138,1136
2022-05-12,Spain,5878,1276,1262,58,4602,1652,1688,3340,1204
2022-05-13,Spain,6020,1263,1331,38,4757,1698,1728,3426,1293
2022-05-14,Spain,6105,1305,1023,24,4800,1898,1879,3777,999
2022-05-15,Spain,6037,1378,1135,10,4659,1782,1742,3524,1125
2022-05-16,Spain,5792,1303,1205,26,4489,1644,1640,3284,1179
2022-05-17,Spain,5648,1173,1178,44,4475,1636,1661,3297,1134
2022-05-18,Spain,5688,1202,1249,36,4486,1593,1644,3237,1213
2022-05-19,Spain,6094,1262,1274,47,4832,1799,1759,3558,1227
2022-05-20,Spain,6077,1250,1284,44,4827,1750,1793,3543,1240
2022-05-21,Spain,6194,1339,990,22,4855,1919,1946,3865,968
2022-05-22,Spain,6246,1333,1199,24,4913,1880,1834,3714,1175
2022-05-23,Spain,5947,1305,1226,35,4642,1719,1697,3416,1191
2022-05-24,Spain,5817,1225,1155,42,4592,1734,1703,3437,1113
2022-05-25,Spain,5916,1294,1176,48,4622,1698,1748,3446,1128
2022-05-26,Spain,6163,1331,1247,47,4832,1769,1816,3585,1200
2022-05-27,Spain,6256,1296,1355,31,4960,1790,1815,3605,1324
2022-05-28,Spain,6439,1333,1094,29,5106,2016,1996,4012,1065
2022-05-29,Spain,6472,1367,1158,25,5105,2001,1946,3947,1133
2022-05-30,Spain,6154,1340,1281,35,4814,1776,1757,3533,1246
2022-05-31,Spain,5890,1242,1195,44,4648,1737,1716,3453,1151
2022-06-01,Spain,5867,1186,1215,45,4681,1721,1745,3466,1170
2022-06-02,Spain,6204,1318,1280,51,4886,1795,1811,3606,1229
2022-06-03,Spain,6377,1297,1324,41,5080,1854,1902,3756,1283
2022-06-04,Spain,6442,1363,1047,23,5079,2023,2009,4032,1024
2022-06-05,Spain,6380,1358,1193,18,5022,1929,1900,3829,1175
2022-06-06,Spain,6281,1364,1242,31,4917,1859,1816,3675,1211
2022-06-07,Spain,6032,1264,1190,33,4768,1790,1788,3578,1157
2022-01-01,Sweden,987,669,37,1,318,138,143,281,36
2022-01-02,Sweden,1620,949,185,1,671,240,246,486,184
2022-01-03,Sweden,1604,877,213,10,727,256,258,514,203
2022-01-04,Sweden,1466,808,201,7,658,228,229,457,194
2022-01-05,Sweden,1383,762,182,6,621,218,221,439,176
2022-01-06,Sweden,1290,715,171,11,575,200,204,404,160
2022-01-07,Sweden,1533,851,201,8,682,244,237,481,193
2022-01-08,Sweden,1232,755,69,2,477,207,201,408,67
2022-01-09,Sweden,1509,868,185,3,641,222,234,456,182
2022-01-10,Sweden,1313,622,242,12,691,225,224,449,230
2022-01-11,Sweden,1232,660,215,18,572,179,178,357,197
2022-01-12,Sweden,1189,650,206,13,539,167,166,333,193
2022-01-13,Sweden,1276,677,242,14,599,177,180,357,228
2022-01-14,Sweden,1315,688,217,7,627,206,204,410,210
2022-01-15,Sweden,1007,646,69,4,361,145,147,292,65
2022-01-16,Sweden,1316,781,170,0,535,184,181,365,170
2022-01-17,Sweden,1224,621,245,11,603,180,178,358,234
2022-01-18,Sweden,1114,583,240,12,531,140,151,291,228
2022-01-19,Sweden,1162,651,210,14,511,158,143,301,196
2022-01-20,Sweden,1211,602,261,15,609,168,180,348,246
2022-01-21,Sweden,1323,666,257,20,657,202,198,400,237
2022-01-22,Sweden,980,626,74,7,354,142,138,280,67
2022-01-23,Sweden,1244,749,168,2,495,164,163,327,166
2022-01-24,Sweden,1218,642,221,16,576,177,178,355,205
2022-01-25,Sweden,1066,589,215,18,477,132,130,262,197
2022-01-26,Sweden,1159,612,220,10,547,161,166,327,210
2022-01-27,Sweden,1238,679,231,6,559,163,165,328,225
2022-01-28,Sweden,1274,653,242,14,621,190,189,379,228
2022-01-29,Sweden,979,643,58,2,336,142,136,278,56
2022-01-30,Sweden,1164,669,157,1,495,168,170,338,156
2022-01-31,Sweden,1206,607,243,15,599,176,180,356,228
2022-02-01,Sweden,1116,586,220,10,530,156,154,310,210
2022-02-02,Sweden,1156,623,210,8,533,158,165,323,202
2022-02-03,Sweden,1244,652,258,6,592,169,165,334,252
2022-02-04,Sweden,1343,740,216,10,603,192,195,387,206
2022-02-05,Sweden,1047,660,80,6,387,155,152,307,74
2022-02-06,Sweden,1268,739,182,4,529,173,174,347,178
2022-02-07,Sweden,1233,643,226,19,590,186,178,364,207
2022-02-08,Sweden,1095,604,202,17,491,145,144,289,185
2022-02-09,Sweden,1218,650,224,22,568,167,177,344,202
2022-02-10,Sweden,1299,677,260,20,622,184,178,362,240
2022-02-11,Sweden,1345,692,251,25,653,198,204,402,226
2022-02-12,Sweden,1088,662,75,5,426,172,179,351,70
2022-02-13,Sweden,1302,742,176,4,560,189,195,384,172
2022-02-14,Sweden,1263,664,220,9,599,195,184,379,211
2022-02-15,Sweden,1149,629,213,15,520,152,155,307,198
2022-02-16,Sweden,1270,725,228,19,545,157,160,317,209
2022-02-17,Sweden,1315,696,263,19,619,179,177,356,244
2022-02-18,Sweden,1496,812,264,23,684,212,208,420,241
2022-02-19,Sweden,1179,724,105,4,455,176,174,350,101
2022-02-20,Sweden,1389,806,185,6,583,196,202,398,179
2022-02-21,Sweden,1281,693,214,6,588,184,190,374,208
2022-02-22,Sweden,1216,634,240,17,582,170,172,342,223
2022-02-23,Sweden,1284,692,236,18,592,179,177,356,218
2022-02-24,Sweden,1323,688,265,10,635,190,180,370,255
2022-02-25,Sweden,1513,780,263,20,733,229,241,470,243
2022-02-26,Sweden,1259,734,91,6,525,220,214,434,85
2022-02-27,Sweden,1489,878,193,10,611,214,204,418,183
2022-02-28,Sweden,1348,666,265,16,682,207,210,417,249
2022-03-01,Sweden,1189,619,216,17,570,178,176,354,199
2022-03-02,Sweden,1234,599,236,23,635,200,199,399,213
2022-03-03,Sweden,1231,568,281,17,663,189,193,382,264
2022-03-04,Sweden,1473,729,271,21,744,234,239,473,250
2022-03-05,Sweden,1152,612,80,11,540,227,233,460,69
2022-03-06,Sweden,1310,696,174,9,614,222,218,440,165
2022-03-07,Sweden,1333,629,265,25,704,218,221,439,240
2022-03-08,Sweden,1177,583,221,10,594,186,187,373,211
2022-03-09,Sweden,1245,615,243,27,630,198,189,387,216
2022-03-10,Sweden,1337,671,276,17,666,200,190,390,259
2022-03-11,Sweden,1497,781,272,19,716,216,228,444,253
2022-03-12,Sweden,1094,640,73,9,454,189,192,381,64
2022-03-13,Sweden,1342,735,195,9,607,209,203,412,186
2022-03-14,Sweden,1379,703,256,13,676,215,205,420,243
2022-03-15,Sweden,1242,655,236,20,587,174,177,351,216
2022-03-16,Sweden,1263,608,258,13,655,199,198,397,245
2022-03-17,Sweden,1351,656,289,12,695,203,203,406,277
2022-03-18,Sweden,1461,721,273,14,740,234,233,467,259
2022-03-19,Sweden,1032,591,67,7,441,184,190,374,60
2022-03-20,Sweden,1263,650,194,7,613,207,212,419,187
2022-03-21,Sweden,1355,690,236,14,665,214,215,429,222
2022-03-22,Sweden,1209,596,233,23,613,191,189,380,210
2022-03-23,Sweden,1268,569,290,25,699,203,206,409,265
2022-03-24,Sweden,1348,651,305,20,697,193,199,392,285
2022-03-25,Sweden,1554,789,286,21,765,242,237,479,265
2022-03-26,Sweden,1070,620,78,7,450,183,189,372,71
2022-03-27,Sweden,1516,765,215,7,751,267,269,536,208
2022-03-28,Sweden,1637,771,311,14,866,276,279,555,297
2022-03-29,Sweden,1537,717,321,22,820,250,249,499,299
2022-03-30,Sweden,1557,695,320,14,862,269,273,542,306
2022-03-31,Sweden,1547,683,324,13,864,274,266,540,311
2022-04-01,Sweden,1612,735,317,9,877,281,279,560,308
2022-04-02,Sweden,1103,577,82,8,526,224,220,444,74
2022-04-03,Sweden,1551,813,219,9,738,250,269,519,210
2022-04-04,Sweden,1668,821,299,6,847,277,271,548,293
2022-04-05,Sweden,1538,749,319,20,789,233,237,470,299
2022-04-06,Sweden,1723,858,325,11,865,274,266,540,314
2022-04-07,Sweden,1806,884,322,14,922,297,303,600,308
2022-04-08,Sweden,1878,972,286,15,906,315,305,620,271
2022-04-09,Sweden,1314,750,79,1,564,244,241,485,78
2022-04-10,Sweden,1595,850,204,4,745,265,276,541,200
2022-04-11,Sweden,1664,774,321,26,890,289,280,569,295
2022-04-12,Sweden,1562,742,296,15,820,261,263,524,281
2022-04-13,Sweden,1701,814,334,22,887,279,274,553,312
2022-04-14,Sweden,1654,807,290,13,847,280,277,557,277
2022-04-15,Sweden,1279,673,129,1,606,239,238,477,128
2022-04-16,Sweden,1129,609,81,4,520,217,222,439,77
2022-04-17,Sweden,1456,745,194,4,711,255,262,517,190
2022-04-18,Sweden,1632,783,240,6,849,305,304,609,234
2022-04-19,Sweden,1667,751,331,17,916,290,295,585,314
2022-04-20,Sweden,1709,759,357,17,950,297,296,593,340
2022-04-21,Sweden,1693,727,363,19,966,304,299,603,344
2022-04-22,Sweden,1686,767,326,17,919,299,294,593,309
2022-04-23,Sweden,1190,633,94,0,557,229,234,463,94
2022-04-24,Sweden,1546,761,213,2,785,289,283,572,211
2022-04-25,Sweden,1670,728,323,16,942,308,311,619,307
2022-04-26,Sweden,1613,743,322,20,870,274,274,548,302
2022-04-27,Sweden,1723,781,356,28,942,297,289,586,328
2022-04-28,Sweden,1789,830,354,23,959,306,299,605,331
2022-04-29,Sweden,1825,891,337,24,934,293,304,597,313
2022-04-30,Sweden,1168,641,81,1,527,221,225,446,80
2022-05-01,Sweden,1582,811,208,4,771,278,285,563,204
2022-05-02,Sweden,1820,845,354,22,975,307,314,621,332
2022-05-03,Sweden,1718,792,352,22,926,291,283,574,330
2022-05-04,Sweden,1789,835,365,19,954,293,296,589,346
2022-05-05,Sweden,1876,873,370,23,1003,316,317,633,347
2022-05-06,Sweden,1905,913,350,15,992,325,317,642,335
2022-05-07,Sweden,1293,744,74,2,549,236,239,475,72
2022-05-08,Sweden,1621,807,206,3,814,300,308,608,203
2022-05-09,Sweden,1841,870,345,22,971,316,310,626,323
2022-05-10,Sweden,1760,819,353,29,941,294,294,588,324
2022-05-11,Sweden,1831,874,344,22,957,303,310,613,322
2022-05-12,Sweden,1932,922,344,18,1010,337,329,666,326
2022-05-13,Sweden,1949,928,344,22,1021,338,339,677,322
2022-05-14,Sweden,1348,776,81,7,572,245,246,491,74
2022-05-15,Sweden,1668,847,211,9,821,303,307,610,202
2022-05-16,Sweden,1809,805,351,24,1004,328,325,653,327
2022-05-17,Sweden,1671,742,347,21,929,294,288,582,326
2022-05-18,Sweden,1898,906,369,29,992,312,311,623,340
2022-05-19,Sweden,1963,911,376,24,1052,334,342,676,352
2022-05-20,Sweden,1895,898,318,21,997,344,335,679,297
2022-05-21,Sweden,1428,845,75,0,583,254,254,508,75
2022-05-22,Sweden,1706,896,193,7,810,302,315,617,186
2022-05-23,Sweden,1882,878,357,21,1004,329,318,647,336
2022-05-24,Sweden,1845,848,367,27,997,310,320,630,340
2022-05-25,Sweden,2040,996,363,33,1044,348,333,681,330
2022-05-26,Sweden,1730,919,200,8,811,309,302,611,192
2022-05-27,Sweden,1736,927,231,11,809,285,293,578,220
2022-05-28,Sweden,1418,800,87,5,618,267,264,531,82
2022-05-29,Sweden,1862,959,229,9,903,329,345,674,220
2022-05-30,Sweden,1913,872,360,26,1041,338,343,681,334
2022-05-31,Sweden,1847,839,348,17,1008,336,324,660,331
2022-06-01,Sweden,1939,871,386,24,1068,339,343,682,362
2022-06-02,Sweden,2045,957,366,19,1088,360,362,722,347
2022-06-03,Sweden,2032,959,353,27,1073,357,363,720,326
2022-06-04,Sweden,1401,743,99,5,658,283,276,559,94
2022-06-05,Sweden,1717,912,182,8,805,312,311,623,174
2022-06-06,Sweden,1763,890,227,11,873,320,326,646,216
2022-06-07,Sweden,1942,931,353,30,1011,329,329,658,323
2022-01-01,Switzerland,1965,1128,22,0,837,410,405,815,22
2022-01-02,Switzerland,2865,1521,44,0,1344,643,657,1300,44
2022-01-03,Switzerland,2522,1404,35,1,1118,547,536,1083,34
2022-01-04,Switzerland,2095,1182,38,1,913,446,429,875,37
2022-01-05,Switzerland,1983,1146,24,1,837,400,413,813,23
2022-01-06,Switzerland,1948,1060,45,0,888,421,422,843,45
2022-01-07,Switzerland,2205,1233,32,2,972,465,475,940,30
2022-01-08,Switzerland,2312,1243,38,3,1069,519,512,1031,35
2022-01-09,Switzerland,2520,1347,20,2,1173,579,574,1153,18
2022-01-10,Switzerland,1857,1015,27,1,842,402,413,815,26
2022-01-11,Switzerland,1482,784,33,1,698,333,332,665,32
2022-01-12,Switzerland,1491,798,45,4,693,323,325,648,41
2022-01-13,Switzerland,1611,832,54,2,779,367,358,725,52
2022-01-14,Switzerland,2001,1107,52,2,894,412,430,842,50
2022-01-15,Switzerland,1750,905,51,3,845,398,396,794,48
2022-01-16,Switzerland,1936,1023,19,1,913,445,449,894,18
2022-01-17,Switzerland,1649,880,49,0,769,361,359,720,49
2022-01-18,Switzerland,1457,784,49,2,673,312,312,624,47
2022-01-19,Switzerland,1458,790,50,4,668,314,304,618,46
2022-01-20,Switzerland,1589,843,39,0,746,351,356,707,39
2022-01-21,Switzerland,1965,1037,52,0,928,439,437,876,52
2022-01-22,Switzerland,1723,887,25,1,836,409,402,811,24
2022-01-23,Switzerland,1953,999,40,0,954,459,455,914,40
2022-01-24,Switzerland,1656,837,76,16,819,372,371,743,60
2022-01-25,Switzerland,1308,678,53,6,630,291,286,577,47
2022-01-26,Switzerland,1468,747,54,3,721,334,333,667,51
2022-01-27,Switzerland,1631,804,54,2,827,370,403,773,52
2022-01-28,Switzerland,1912,977,72,4,935,427,436,863,68
2022-01-29,Switzerland,1854,944,45,4,910,434,431,865,41
2022-01-30,Switzerland,2016,1058,23,0,958,482,453,935,23
2022-01-31,Switzerland,1577,830,26,1,747,363,358,721,25
2022-02-01,Switzerland,1449,837,25,0,612,293,294,587,25
2022-02-02,Switzerland,1555,892,35,1,663,309,319,628,34
2022-02-03,Switzerland,1740,856,46,2,884,406,432,838,44
2022-02-04,Switzerland,2019,1085,48,4,934,455,431,886,44
2022-02-05,Switzerland,1930,976,60,4,954,449,445,894,56
2022-02-06,Switzerland,2111,1095,24,0,1016,502,490,992,24
2022-02-07,Switzerland,1869,1066,36,2,803,395,372,767,34
2022-02-08,Switzerland,1659,925,49,3,734,328,357,685,46
2022-02-09,Switzerland,1782,945,52,5,837,399,386,785,47
2022-02-10,Switzerland,2017,1054,64,4,963,444,455,899,60
2022-02-11,Switzerland,2376,1254,55,1,1122,523,544,1067,54
2022-02-12,Switzerland,2478,1208,51,0,1270,594,625,1219,51
2022-02-13,Switzerland,2327,1214,36,0,1113,555,522,1077,36
2022-02-14,Switzerland,1949,1102,37,1,847,405,405,810,36
2022-02-15,Switzerland,1721,935,33,3,786,382,371,753,30
2022-02-16,Switzerland,1730,980,23,0,750,365,362,727,23
2022-02-17,Switzerland,1984,1102,42,4,882,410,430,840,38
2022-02-18,Switzerland,2259,1228,51,4,1031,494,486,980,47
2022-02-19,Switzerland,2564,1287,37,2,1277,627,613,1240,35
2022-02-20,Switzerland,2646,1326,26,0,1320,647,647,1294,26
2022-02-21,Switzerland,2016,1119,34,0,897,440,423,863,34
2022-02-22,Switzerland,1805,999,34,1,806,390,382,772,33
2022-02-23,Switzerland,1936,1076,39,1,860,411,410,821,38
2022-02-24,Switzerland,2069,1095,38,6,974,469,467,936,32
2022-02-25,Switzerland,2489,1356,41,1,1133,542,550,1092,40
2022-02-26,Switzerland,2647,1419,37,1,1228,608,583,1191,36
2022-02-27,Switzerland,2680,1405,54,0,1275,609,612,1221,54
2022-02-28,Switzerland,2280,1288,36,1,992,479,477,956,35
2022-03-01,Switzerland,1978,1133,35,3,845,401,409,810,32
2022-03-02,Switzerland,2140,1154,50,3,986,467,469,936,47
2022-03-03,Switzerland,2202,1142,61,3,1060,498,501,999,58
2022-03-04,Switzerland,2565,1389,77,0,1176,557,542,1099,77
2022-03-05,Switzerland,2517,1354,50,5,1163,554,559,1113,45
2022-03-06,Switzerland,2625,1425,32,2,1200,597,571,1168,30
2022-03-07,Switzerland,2199,1247,40,1,952,457,455,912,39
2022-03-08,Switzerland,1931,1102,32,2,829,393,404,797,30
2022-03-09,Switzerland,2085,1146,52,1,939,451,436,887,51
2022-03-10,Switzerland,2268,1226,43,2,1042,488,511,999,41
2022-03-11,Switzerland,2548,1397,66,3,1151,536,549,1085,63
2022-03-12,Switzerland,2366,1287,33,0,1079,523,523,1046,33
2022-03-13,Switzerland,2532,1372,29,0,1160,578,553,1131,29
2022-03-14,Switzerland,2308,1318,56,3,990,467,467,934,53
2022-03-15,Switzerland,2025,1148,51,5,877,404,422,826,46
2022-03-16,Switzerland,2166,1233,55,3,933,436,442,878,52
2022-03-17,Switzerland,2308,1257,61,5,1051,491,499,990,56
2022-03-18,Switzerland,2527,1418,50,0,1109,528,531,1059,50
2022-03-19,Switzerland,2433,1378,24,0,1055,530,501,1031,24
2022-03-20,Switzerland,2626,1433,28,0,1193,587,578,1165,28
2022-03-21,Switzerland,2188,1258,40,4,930,448,442,890,36
2022-03-22,Switzerland,1947,1111,38,0,836,395,403,798,38
2022-03-23,Switzerland,2099,1173,48,0,926,448,430,878,48
2022-03-24,Switzerland,2279,1226,50,4,1053,497,506,1003,46
2022-03-25,Switzerland,2483,1375,43,2,1108,536,529,1065,41
2022-03-26,Switzerland,2349,1324,34,2,1025,505,486,991,32
2022-03-27,Switzerland,2741,1563,33,1,1178,561,584,1145,32
2022-03-28,Switzerland,2579,1446,58,6,1133,542,533,1075,52
2022-03-29,Switzerland,2397,1427,63,1,970,451,456,907,62
2022-03-30,Switzerland,2378,1385,39,4,993,482,472,954,35
2022-03-31,Switzerland,2581,1497,29,1,1084,526,529,1055,28
2022-04-01,Switzerland,2806,1614,38,0,1192,579,575,1154,38
2022-04-02,Switzerland,2637,1635,26,0,1002,489,487,976,26
2022-04-03,Switzerland,2859,1663,32,0,1196,579,585,1164,32
2022-04-04,Switzerland,2700,1550,57,3,1150,552,541,1093,54
2022-04-05,Switzerland,2390,1442,49,4,948,446,453,899,45
2022-04-06,Switzerland,2597,1512,52,1,1085,517,516,1033,51
2022-04-07,Switzerland,2706,1617,41,1,1089,529,519,1048,40
2022-04-08,Switzerland,2873,1721,36,1,1152,561,555,1116,35
2022-04-09,Switzerland,2936,1821,24,0,1115,546,545,1091,24
2022-04-10,Switzerland,2973,1748,35,0,1225,590,600,1190,35
2022-04-11,Switzerland,2753,1642,47,2,1111,529,535,1064,45
2022-04-12,Switzerland,2624,1568,46,1,1056,502,508,1010,45
2022-04-13,Switzerland,2858,1697,60,2,1161,554,547,1101,58
2022-04-14,Switzerland,3115,1834,46,1,1281,629,606,1235,45
2022-04-15,Switzerland,3015,1819,29,1,1196,596,571,1167,28
2022-04-16,Switzerland,2875,1838,29,0,1037,504,504,1008,29
2022-04-17,Switzerland,2694,1665,21,0,1029,500,508,1008,21
2022-04-18,Switzerland,2929,1745,30,0,1184,574,580,1154,30
2022-04-19,Switzerland,2730,1679,47,2,1051,501,503,1004,45
2022-04-20,Switzerland,2726,1652,38,1,1074,519,517,1036,37
2022-04-21,Switzerland,2830,1738,30,4,1092,530,532,1062,26
2022-04-22,Switzerland,3086,1842,59,2,1244,596,589,1185,57
2022-04-23,Switzerland,2875,1833,31,1,1042,502,509,1011,30
2022-04-24,Switzerland,3067,1906,32,1,1161,552,577,1129,31
2022-04-25,Switzerland,2861,1727,34,1,1134,550,550,1100,33
2022-04-26,Switzerland,2688,1655,46,4,1033,496,491,987,42
2022-04-27,Switzerland,2778,1672,60,2,1106,531,515,1046,58
2022-04-28,Switzerland,2964,1801,57,2,1163,548,558,1106,55
2022-04-29,Switzerland,3201,1940,41,1,1261,616,604,1220,40
2022-04-30,Switzerland,2886,1867,16,1,1019,499,504,1003,15
2022-05-01,Switzerland,3086,1918,33,2,1168,550,585,1135,31
2022-05-02,Switzerland,2988,1810,78,2,1178,561,539,1100,76
2022-05-03,Switzerland,2667,1628,59,0,1039,490,490,980,59
2022-05-04,Switzerland,2864,1760,54,0,1104,527,523,1050,54
2022-05-05,Switzerland,3012,1893,44,4,1119,538,537,1075,40
2022-05-06,Switzerland,3348,2042,59,0,1306,632,615,1247,59
2022-05-07,Switzerland,3051,2028,33,3,1023,500,490,990,30
2022-05-08,Switzerland,3220,2050,36,1,1170,557,577,1134,35
2022-05-09,Switzerland,3009,1866,44,4,1143,556,543,1099,40
2022-05-10,Switzerland,2903,1844,48,0,1059,504,507,1011,48
2022-05-11,Switzerland,3072,1906,49,0,1166,571,546,1117,49
2022-05-12,Switzerland,3163,1994,44,0,1169,565,560,1125,44
2022-05-13,Switzerland,3296,2036,47,2,1260,604,609,1213,45
2022-05-14,Switzerland,3170,2126,33,1,1044,502,509,1011,32
2022-05-15,Switzerland,3186,2023,27,0,1163,558,578,1136,27
2022-05-16,Switzerland,3203,2042,46,1,1161,563,552,1115,45
2022-05-17,Switzerland,2886,1866,35,1,1020,490,495,985,34
2022-05-18,Switzerland,3163,2044,44,0,1119,546,529,1075,44
2022-05-19,Switzerland,3201,2038,40,1,1163,561,562,1123,39
2022-05-20,Switzerland,3314,2102,43,3,1212,591,578,1169,40
2022-05-21,Switzerland,3308,2171,28,1,1137,535,574,1109,27
2022-05-22,Switzerland,3362,1999,27,1,1363,625,711,1336,26
2022-05-23,Switzerland,3101,1767,44,4,1334,625,665,1290,40
2022-05-24,Switzerland,3017,1750,58,3,1267,603,606,1209,55
2022-05-25,Switzerland,3497,1961,59,1,1536,789,688,1477,58
2022-05-26,Switzerland,3362,1988,29,1,1374,720,625,1345,28
2022-05-27,Switzerland,3323,2150,31,2,1173,570,572,1142,29
2022-05-28,Switzerland,3304,2247,41,0,1057,506,510,1016,41
2022-05-29,Switzerland,3759,2372,36,2,1387,634,717,1351,34
2022-05-30,Switzerland,3439,2132,49,1,1307,644,614,1258,48
2022-05-31,Switzerland,3141,2008,61,3,1133,542,530,1072,58
2022-06-01,Switzerland,3205,2002,46,2,1203,580,577,1157,44
2022-06-02,Switzerland,3337,2114,42,0,1223,589,592,1181,42
2022-06-03,Switzerland,3620,2248,51,2,1372,681,640,1321,49
2022-06-04,Switzerland,3403,2294,37,1,1109,538,534,1072,36
2022-06-05,Switzerland,3225,2146,17,2,1079,536,526,1062,15
2022-06-06,Switzerland,3507,2205,33,0,1302,600,669,1269,33
2022-06-07,Switzerland,3279,2136,47,1,1143,555,541,1096,46
2022-01-01,Turkey,2659,965,534,5,1694,588,572,1160,529
2022-01-02,Turkey,3343,1208,697,6,2135,735,703,1438,691
2022-01-03,Turkey,2913,992,679,10,1921,606,636,1242,669
2022-01-04,Turkey,2690,946,582,10,1744,577,585,1162,572
2022-01-05,Turkey,2731,953,594,8,1778,592,592,1184,586
2022-01-06,Turkey,2938,1097,622,6,1841,612,607,1219,616
2022-01-07,Turkey,2994,996,687,12,1998,662,649,1311,675
2022-01-08,Turkey,3075,1158,609,7,1917,650,658,1308,602
2022-01-09,Turkey,3152,1166,651,4,1986,675,660,1335,647
2022-01-10,Turkey,2667,891,630,11,1776,563,583,1146,619
2022-01-11,Turkey,2417,836,525,6,1581,530,526,1056,519
2022-01-12,Turkey,2480,887,513,4,1593,537,543,1080,509
2022-01-13,Turkey,2572,924,566,14,1648,543,539,1082,552
2022-01-14,Turkey,2809,892,706,12,1917,618,593,1211,694
2022-01-15,Turkey,2736,979,609,10,1757,567,581,1148,599
2022-01-16,Turkey,2933,1027,678,7,1906,620,608,1228,671
2022-01-17,Turkey,2508,793,654,9,1715,509,552,1061,645
2022-01-18,Turkey,2240,763,519,6,1477,479,479,958,513
2022-01-19,Turkey,2406,862,533,12,1544,512,499,1011,521
2022-01-20,Turkey,2627,834,702,13,1793,543,548,1091,689
2022-01-21,Turkey,2768,806,803,9,1962,586,573,1159,794
2022-01-22,Turkey,2698,968,625,5,1730,545,560,1105,620
2022-01-23,Turkey,2688,980,559,6,1708,563,586,1149,553
2022-01-24,Turkey,1881,765,474,16,1116,296,346,642,458
2022-01-25,Turkey,1479,758,305,6,721,213,203,416,299
2022-01-26,Turkey,2096,772,562,6,1324,386,376,762,556
2022-01-27,Turkey,2561,888,640,10,1673,539,494,1033,630
2022-01-28,Turkey,2707,807,733,14,1900,599,568,1167,719
2022-01-29,Turkey,2744,942,683,8,1802,551,568,1119,675
2022-01-30,Turkey,2930,970,759,7,1960,608,593,1201,752
2022-01-31,Turkey,2481,766,680,7,1715,505,530,1035,673
2022-02-01,Turkey,2348,767,614,9,1581,492,475,967,605
2022-02-02,Turkey,2426,768,667,12,1658,499,492,991,655
2022-02-03,Turkey,2618,860,693,12,1758,529,536,1065,681
2022-02-04,Turkey,2722,807,770,9,1915,574,571,1145,761
2022-02-05,Turkey,2846,963,732,7,1883,569,582,1151,725
2022-02-06,Turkey,3001,981,809,10,2020,616,595,1211,799
2022-02-07,Turkey,2449,743,693,10,1706,490,523,1013,683
2022-02-08,Turkey,2266,756,577,13,1510,475,458,933,564
2022-02-09,Turkey,2367,786,583,4,1581,502,496,998,579
2022-02-10,Turkey,2631,885,645,9,1746,555,546,1101,636
2022-02-11,Turkey,2768,870,734,19,1898,586,578,1164,715
2022-02-12,Turkey,2806,1008,621,10,1798,583,594,1177,611
2022-02-13,Turkey,2952,1047,693,3,1905,615,597,1212,690
2022-02-14,Turkey,2564,795,685,9,1769,528,556,1084,676
2022-02-15,Turkey,2383,812,564,8,1571,509,498,1007,556
2022-02-16,Turkey,2455,834,605,11,1621,511,505,1016,594
2022-02-17,Turkey,2681,923,667,10,1758,542,549,1091,657
2022-02-18,Turkey,2802,901,702,12,1901,621,578,1199,690
2022-02-19,Turkey,2917,1050,619,8,1867,603,645,1248,611
2022-02-20,Turkey,3080,1098,713,7,1982,649,620,1269,706
2022-02-21,Turkey,2575,831,669,8,1744,530,545,1075,661
2022-02-22,Turkey,2415,846,560,8,1569,502,507,1009,552
2022-02-23,Turkey,2515,862,597,7,1653,527,529,1056,590
2022-02-24,Turkey,2670,899,632,5,1771,577,562,1139,627
2022-02-25,Turkey,2759,869,705,10,1890,592,593,1185,695
2022-02-26,Turkey,2872,1016,626,9,1856,605,625,1230,617
2022-02-27,Turkey,2948,994,715,6,1954,624,615,1239,709
2022-02-28,Turkey,2715,912,682,8,1803,552,569,1121,674
2022-03-01,Turkey,2514,894,565,9,1620,527,528,1055,556
2022-03-02,Turkey,2685,987,604,9,1698,548,546,1094,595
2022-03-03,Turkey,2856,1025,638,10,1831,593,600,1193,628
2022-03-04,Turkey,3056,1024,731,6,2032,658,643,1301,725
2022-03-05,Turkey,3052,1108,637,6,1944,643,664,1307,631
2022-03-06,Turkey,3157,1133,718,9,2024,655,651,1306,709
2022-03-07,Turkey,2807,997,687,7,1810,550,573,1123,680
2022-03-08,Turkey,2483,901,586,5,1582,495,501,996,581
2022-03-09,Turkey,2635,998,599,10,1637,527,511,1038,589
2022-03-10,Turkey,2481,1003,464,6,1478,494,520,1014,458
2022-03-11,Turkey,2440,930,427,4,1510,544,539,1083,423
2022-03-12,Turkey,2219,1044,326,8,1175,439,410,849,318
2022-03-13,Turkey,2743,1010,574,5,1733,573,586,1159,569
2022-03-14,Turkey,2656,901,683,7,1755,543,529,1072,676
2022-03-15,Turkey,2557,958,595,8,1599,502,502,1004,587
2022-03-16,Turkey,2655,1005,627,13,1650,506,517,1023,614
2022-03-17,Turkey,2844,1044,671,9,1800,567,562,1129,662
2022-03-18,Turkey,2840,1035,636,7,1805,583,586,1169,629
2022-03-19,Turkey,2751,1099,469,7,1652,586,597,1183,462
2022-03-20,Turkey,3103,1066,731,5,2037,669,637,1306,726
2022-03-21,Turkey,2787,932,716,5,1855,561,578,1139,711
2022-03-22,Turkey,2480,890,601,6,1590,502,487,989,595
2022-03-23,Turkey,2719,1018,625,9,1701,534,542,1076,616
2022-03-24,Turkey,2953,1078,719,6,1875,583,573,1156,713
2022-03-25,Turkey,3105,1054,774,3,2051,646,631,1277,771
2022-03-26,Turkey,3095,1113,694,5,1982,636,652,1288,689
2022-03-27,Turkey,3361,1134,808,5,2227,711,708,1419,803
2022-03-28,Turkey,3010,1063,699,8,1947,615,633,1248,691
2022-03-29,Turkey,2898,1038,631,8,1860,622,607,1229,623
2022-03-30,Turkey,2973,1097,667,12,1876,599,610,1209,655
2022-03-31,Turkey,3125,1127,669,11,1998,670,659,1329,658
2022-04-01,Turkey,3357,1087,763,6,2270,761,746,1507,757
2022-04-02,Turkey,3344,1181,642,7,2163,751,770,1521,635
2022-04-03,Turkey,3402,1199,689,6,2203,770,744,1514,683
2022-04-04,Turkey,2963,1050,631,6,1913,626,656,1282,625
2022-04-05,Turkey,2835,1014,579,7,1821,623,619,1242,572
2022-04-06,Turkey,2950,1116,588,6,1834,611,635,1246,582
2022-04-07,Turkey,3049,1147,561,9,1902,683,658,1341,552
2022-04-08,Turkey,3482,1123,728,4,2359,835,796,1631,724
2022-04-09,Turkey,3479,1195,638,7,2284,811,835,1646,631
2022-04-10,Turkey,3484,1212,662,6,2272,816,794,1610,656
2022-04-11,Turkey,3143,1123,625,6,2020,690,705,1395,619
2022-04-12,Turkey,2960,1079,559,7,1881,657,665,1322,552
2022-04-13,Turkey,3147,1153,618,10,1994,689,687,1376,608
2022-04-14,Turkey,3332,1211,629,9,2121,750,742,1492,620
2022-04-15,Turkey,3572,1177,744,8,2395,828,823,1651,736
2022-04-16,Turkey,3481,1240,629,9,2241,795,817,1612,620
2022-04-17,Turkey,3590,1242,706,10,2348,832,810,1642,696
2022-04-18,Turkey,3271,1131,623,4,2140,756,761,1517,619
2022-04-19,Turkey,3076,1120,573,5,1956,688,695,1383,568
2022-04-20,Turkey,3169,1164,618,6,2005,695,692,1387,612
2022-04-21,Turkey,3307,1149,634,4,2158,759,765,1524,630
2022-04-22,Turkey,3583,1140,738,8,2443,864,841,1705,730
2022-04-23,Turkey,3627,1253,628,3,2374,865,881,1746,625
2022-04-24,Turkey,3700,1287,707,8,2413,859,847,1706,699
2022-04-25,Turkey,3305,1134,679,2,2171,740,752,1492,677
2022-04-26,Turkey,3148,1095,651,7,2053,700,702,1402,644
2022-04-27,Turkey,3323,1169,689,4,2154,725,740,1465,685
2022-04-28,Turkey,3623,1221,771,6,2402,828,803,1631,765
2022-04-29,Turkey,4063,1174,1046,6,2889,935,908,1843,1040
2022-04-30,Turkey,4281,1295,1067,9,2986,942,977,1919,1058
2022-05-01,Turkey,4136,1320,914,4,2816,963,939,1902,910
2022-05-02,Turkey,3694,1156,821,4,2538,849,868,1717,817
2022-05-03,Turkey,3601,1156,801,6,2445,832,812,1644,795
2022-05-04,Turkey,3654,1130,915,7,2524,795,814,1609,908
2022-05-05,Turkey,3751,1187,825,9,2564,882,857,1739,816
2022-05-06,Turkey,3900,1147,847,3,2753,958,948,1906,844
2022-05-07,Turkey,4175,1219,917,5,2956,1012,1027,2039,912
2022-05-08,Turkey,4197,1279,994,7,2918,960,964,1924,987
2022-05-09,Turkey,3699,1119,868,9,2580,845,867,1712,859
2022-05-10,Turkey,3601,1124,826,6,2477,829,822,1651,820
2022-05-11,Turkey,3660,1165,841,7,2495,825,829,1654,834
2022-05-12,Turkey,3776,1180,860,8,2596,864,872,1736,852
2022-05-13,Turkey,3849,1148,861,6,2701,930,910,1840,855
2022-05-14,Turkey,4041,1222,846,6,2819,979,994,1973,840
2022-05-15,Turkey,4001,1279,821,7,2722,955,946,1901,814
2022-05-16,Turkey,3686,1113,857,7,2573,847,869,1716,850
2022-05-17,Turkey,3551,1099,827,10,2452,821,804,1625,817
2022-05-18,Turkey,3815,1211,904,9,2604,854,846,1700,895
2022-05-19,Turkey,3867,1134,922,4,2733,908,903,1811,918
2022-05-20,Turkey,3934,1159,828,5,2775,983,964,1947,823
2022-05-21,Turkey,4112,1216,822,7,2896,1026,1048,2074,815
2022-05-22,Turkey,4159,1316,901,7,2843,979,963,1942,894
2022-05-23,Turkey,3704,1105,844,5,2599,871,884,1755,839
2022-05-24,Turkey,3706,1115,822,6,2591,894,875,1769,816
2022-05-25,Turkey,3947,1220,868,8,2727,923,936,1859,860
2022-05-26,Turkey,4022,1176,872,6,2846,993,981,1974,866
2022-05-27,Turkey,4089,1185,859,2,2904,1038,1007,2045,857
2022-05-28,Turkey,4187,1231,784,1,2956,1072,1100,2172,783
2022-05-29,Turkey,4163,1272,792,0,2891,1052,1047,2099,792
2022-05-30,Turkey,3913,1155,838,2,2758,936,984,1920,836
2022-05-31,Turkey,3766,1120,791,3,2646,933,922,1855,788
2022-06-01,Turkey,3850,989,861,7,2861,1003,997,2000,854
2022-06-02,Turkey,4117,1209,823,1,2908,1042,1043,2085,822
2022-06-03,Turkey,4280,1184,854,2,3096,1127,1115,2242,852
2022-06-04,Turkey,4418,1258,796,3,3160,1173,1191,2364,793
2022-06-05,Turkey,4256,1231,790,1,3025,1124,1111,2235,789
2022-06-06,Turkey,4176,1174,870,3,3002,1067,1065,2132,867
2022-06-07,Turkey,4083,1196,864,4,2887,1005,1018,2023,860
2022-01-01,Ukraine,501,250,9,0,251,118,124,242,9
2022-01-02,Ukraine,792,300,51,0,492,225,216,441,51
2022-01-03,Ukraine,704,273,53,0,431,192,186,378,53
2022-01-04,Ukraine,621,264,53,0,357,151,153,304,53
2022-01-05,Ukraine,610,214,46,3,396,175,175,350,43
2022-01-06,Ukraine,631,280,43,1,351,155,153,308,42
2022-01-07,Ukraine,650,270,35,0,380,173,172,345,35
2022-01-08,Ukraine,697,328,43,0,369,161,165,326,43
2022-01-09,Ukraine,779,313,44,0,466,207,215,422,44
2022-01-10,Ukraine,635,240,56,1,395,172,167,339,55
2022-01-11,Ukraine,554,243,41,0,311,135,135,270,41
2022-01-12,Ukraine,559,208,52,1,351,146,153,299,51
2022-01-13,Ukraine,572,253,46,3,319,138,135,273,43
2022-01-14,Ukraine,647,245,63,2,402,170,169,339,61
2022-01-15,Ukraine,629,282,43,0,347,151,153,304,43
2022-01-16,Ukraine,659,272,51,0,387,172,164,336,51
2022-01-17,Ukraine,562,187,49,0,375,161,165,326,49
2022-01-18,Ukraine,495,197,40,1,298,125,133,258,39
2022-01-19,Ukraine,500,186,44,0,314,136,134,270,44
2022-01-20,Ukraine,548,228,49,1,320,140,131,271,48
2022-01-21,Ukraine,591,224,50,0,367,158,159,317,50
2022-01-22,Ukraine,581,269,37,2,312,139,136,275,35
2022-01-23,Ukraine,611,247,46,1,364,159,159,318,45
2022-01-24,Ukraine,477,156,47,4,321,139,135,274,43
2022-01-25,Ukraine,411,154,41,0,257,104,112,216,41
2022-01-26,Ukraine,435,154,44,1,281,120,117,237,43
2022-01-27,Ukraine,540,221,45,1,319,135,139,274,44
2022-01-28,Ukraine,588,207,52,0,381,164,165,329,52
2022-01-29,Ukraine,568,260,41,1,308,136,131,267,40
2022-01-30,Ukraine,611,244,49,1,367,157,161,318,48
2022-01-31,Ukraine,530,185,49,0,345,150,146,296,49
2022-02-01,Ukraine,502,196,40,1,306,130,136,266,39
2022-02-02,Ukraine,459,178,39,2,281,123,119,242,37
2022-02-03,Ukraine,524,209,38,1,315,142,135,277,37
2022-02-04,Ukraine,560,204,54,2,356,152,150,302,52
2022-02-05,Ukraine,590,272,32,0,318,145,141,286,32
2022-02-06,Ukraine,592,221,40,1,371,162,169,331,39
2022-02-07,Ukraine,523,195,49,1,328,140,139,279,48
2022-02-08,Ukraine,474,171,45,0,303,127,131,258,45
2022-02-09,Ukraine,458,169,44,1,289,123,122,245,43
2022-02-10,Ukraine,528,218,39,0,310,137,134,271,39
2022-02-11,Ukraine,583,219,57,0,364,151,156,307,57
2022-02-12,Ukraine,535,225,36,0,310,137,137,274,36
2022-02-13,Ukraine,605,196,50,0,409,183,176,359,50
2022-02-14,Ukraine,518,117,52,2,401,185,164,349,50
2022-02-15,Ukraine,446,127,46,2,319,135,138,273,44
2022-02-16,Ukraine,414,117,46,0,297,128,123,251,46
2022-02-17,Ukraine,420,138,38,0,282,129,115,244,38
2022-02-18,Ukraine,482,148,42,2,334,143,149,292,40
2022-02-19,Ukraine,481,198,28,0,283,128,127,255,28
2022-02-20,Ukraine,490,165,34,0,325,146,145,291,34
2022-02-21,Ukraine,401,113,40,0,288,121,127,248,40
2022-02-22,Ukraine,353,118,34,0,235,102,99,201,34
2022-02-23,Ukraine,393,129,40,2,264,112,112,224,38
2022-02-24,Ukraine,22,8,1,1,14,7,6,13,0
2022-02-25,Ukraine,2,2,0,0,0,0,0,0,0
2022-02-26,Ukraine,3,3,0,0,0,0,0,0,0
2022-02-27,Ukraine,5,5,0,0,0,0,0,0,0
2022-02-28,Ukraine,0,0,0,0,0,0,0,0,0
2022-03-01,Ukraine,3,3,0,0,0,0,0,0,0
2022-03-02,Ukraine,2,2,0,0,0,0,0,0,0
2022-03-03,Ukraine,0,0,0,0,0,0,0,0,0
2022-03-04,Ukraine,4,1,0,0,3,0,3,3,0
2022-03-05,Ukraine,2,2,0,0,0,0,0,0,0
2022-03-06,Ukraine,2,2,0,0,0,0,0,0,0
2022-03-07,Ukraine,3,3,0,0,0,0,0,0,0
2022-03-08,Ukraine,2,1,0,0,1,1,0,1,0
2022-03-09,Ukraine,3,3,0,0,0,0,0,0,0
2022-03-10,Ukraine,3,3,0,0,0,0,0,0,0
2022-03-11,Ukraine,3,3,0,0,0,0,0,0,0
2022-03-12,Ukraine,2,2,0,0,0,0,0,0,0
2022-03-13,Ukraine,7,7,0,0,0,0,0,0,0
2022-03-14,Ukraine,2,2,0,0,0,0,0,0,0
2022-03-15,Ukraine,3,3,0,0,0,0,0,0,0
2022-03-16,Ukraine,4,4,0,0,0,0,0,0,0
2022-03-17,Ukraine,3,3,0,0,0,0,0,0,0
2022-03-18,Ukraine,4,4,0,0,0,0,0,0,0
2022-03-19,Ukraine,3,3,0,0,0,0,0,0,0
2022-03-20,Ukraine,2,2,0,0,0,0,0,0,0
2022-03-21,Ukraine,1,1,0,0,0,0,0,0,0
2022-03-22,Ukraine,4,4,0,0,0,0,0,0,0
2022-03-23,Ukraine,3,3,0,0,0,0,0,0,0
2022-03-24,Ukraine,2,2,0,0,0,0,0,0,0
2022-03-25,Ukraine,4,4,0,0,0,0,0,0,0
2022-03-26,Ukraine,2,2,0,0,0,0,0,0,0
2022-03-27,Ukraine,2,2,0,0,0,0,0,0,0
2022-03-28,Ukraine,2,2,0,0,0,0,0,0,0
2022-03-29,Ukraine,3,3,0,0,0,0,0,0,0
2022-03-30,Ukraine,3,3,0,0,0,0,0,0,0
2022-03-31,Ukraine,1,1,0,0,0,0,0,0,0
2022-04-01,Ukraine,1,1,0,0,0,0,0,0,0
2022-04-02,Ukraine,2,2,0,0,0,0,0,0,0
2022-04-03,Ukraine,0,0,0,0,0,0,0,0,0
2022-04-04,Ukraine,2,1,0,0,1,0,1,1,0
2022-04-05,Ukraine,4,4,0,0,0,0,0,0,0
2022-04-06,Ukraine,2,2,0,0,0,0,0,0,0
2022-04-07,Ukraine,2,2,0,0,0,0,0,0,0
2022-04-08,Ukraine,2,0,0,0,2,1,1,2,0
2022-04-09,Ukraine,1,1,0,0,0,0,0,0,0
2022-04-10,Ukraine,1,1,0,0,0,0,0,0,0
2022-04-11,Ukraine,9,6,0,0,3,1,2,3,0
2022-04-12,Ukraine,2,0,0,0,2,1,1,2,0
2022-04-13,Ukraine,2,2,0,0,0,0,0,0,0
2022-04-14,Ukraine,3,3,0,0,0,0,0,0,0
2022-04-15,Ukraine,3,3,0,0,0,0,0,0,0
2022-04-16,Ukraine,0,0,0,0,0,0,0,0,0
2022-04-17,Ukraine,1,1,0,0,0,0,0,0,0
2022-04-18,Ukraine,3,3,0,0,0,0,0,0,0
2022-04-19,Ukraine,1,1,0,0,0,0,0,0,0
2022-04-20,Ukraine,1,1,0,0,0,0,0,0,0
2022-04-21,Ukraine,1,-1,0,0,2,1,1,2,0
2022-04-22,Ukraine,0,0,0,0,0,0,0,0,0
2022-04-23,Ukraine,0,0,0,0,0,0,0,0,0
2022-04-24,Ukraine,1,1,0,0,0,0,0,0,0
2022-04-25,Ukraine,2,2,0,0,0,0,0,0,0
2022-04-26,Ukraine,2,1,0,0,1,0,1,1,0
2022-04-27,Ukraine,0,0,0,0,0,0,0,0,0
2022-04-28,Ukraine,0,-1,0,0,1,0,1,1,0
2022-04-29,Ukraine,3,2,0,0,1,1,0,1,0
2022-04-30,Ukraine,2,2,0,0,0,0,0,0,0
2022-05-01,Ukraine,2,2,0,0,0,0,0,0,0
2022-05-02,Ukraine,0,-1,0,0,1,0,1,1,0
2022-05-03,Ukraine,1,0,0,0,1,0,1,1,0
2022-05-04,Ukraine,1,1,0,0,0,0,0,0,0
2022-05-05,Ukraine,3,2,0,0,1,0,1,1,0
2022-05-06,Ukraine,5,5,0,0,0,0,0,0,0
2022-05-07,Ukraine,1,1,0,0,0,0,0,0,0
2022-05-08,Ukraine,1,1,0,0,0,0,0,0,0
2022-05-09,Ukraine,3,3,0,0,0,0,0,0,0
2022-05-10,Ukraine,3,3,0,0,0,0,0,0,0
2022-05-11,Ukraine,0,0,0,0,0,0,0,0,0
2022-05-12,Ukraine,2,2,0,0,0,0,0,0,0
2022-05-13,Ukraine,2,2,0,0,0,0,0,0,0
2022-05-14,Ukraine,4,4,0,0,0,0,0,0,0
2022-05-15,Ukraine,5,5,0,0,0,0,0,0,0
2022-05-16,Ukraine,3,2,0,0,1,0,1,1,0
2022-05-17,Ukraine,1,1,0,0,0,0,0,0,0
2022-05-18,Ukraine,4,4,0,0,0,0,0,0,0
2022-05-19,Ukraine,0,0,0,0,0,0,0,0,0
2022-05-20,Ukraine,2,1,0,0,1,1,0,1,0
2022-05-21,Ukraine,2,2,0,0,0,0,0,0,0
2022-05-22,Ukraine,3,3,0,0,0,0,0,0,0
2022-05-23,Ukraine,4,4,0,0,0,0,0,0,0
2022-05-24,Ukraine,1,1,0,0,0,0,0,0,0
2022-05-25,Ukraine,3,3,0,0,0,0,0,0,0
2022-05-26,Ukraine,2,2,0,0,0,0,0,0,0
2022-05-27,Ukraine,1,1,0,0,0,0,0,0,0
2022-05-28,Ukraine,2,2,0,0,0,0,0,0,0
2022-05-29,Ukraine,6,6,0,0,0,0,0,0,0
2022-05-30,Ukraine,4,4,0,0,0,0,0,0,0
2022-05-31,Ukraine,3,-1,0,0,4,2,2,4,0
2022-06-01,Ukraine,1,0,0,0,1,0,1,1,0
2022-06-02,Ukraine,4,4,0,0,0,0,0,0,0
2022-06-03,Ukraine,4,4,0,0,0,0,0,0,0
2022-06-04,Ukraine,1,1,0,0,0,0,0,0,0
2022-06-05,Ukraine,3,3,0,0,0,0,0,0,0
2022-06-06,Ukraine,4,2,0,0,2,1,1,2,0
2022-06-07,Ukraine,3,2,0,0,1,1,0,1,0
2022-01-01,United Kingdom,3514,1013,219,0,2501,1132,1150,2282,219
2022-01-02,United Kingdom,4806,1121,510,2,3685,1574,1601,3175,508
2022-01-03,United Kingdom,4885,1140,610,14,3745,1551,1584,3135,596
2022-01-04,United Kingdom,4357,1044,591,14,3313,1355,1367,2722,577
2022-01-05,United Kingdom,4247,1081,633,17,3166,1273,1260,2533,616
2022-01-06,United Kingdom,4197,1084,638,12,3113,1244,1231,2475,626
2022-01-07,United Kingdom,4542,1059,710,15,3483,1366,1407,2773,695
2022-01-08,United Kingdom,4134,1118,359,1,3016,1333,1324,2657,358
2022-01-09,United Kingdom,4528,1063,527,8,3465,1459,1479,2938,519
2022-01-10,United Kingdom,3600,1012,610,25,2588,992,986,1978,585
2022-01-11,United Kingdom,3075,888,550,28,2187,826,811,1637,522
2022-01-12,United Kingdom,3122,969,582,35,2153,786,785,1571,547
2022-01-13,United Kingdom,3384,957,647,34,2427,892,888,1780,613
2022-01-14,United Kingdom,3747,995,687,13,2752,1030,1035,2065,674
2022-01-15,United Kingdom,3321,1009,405,11,2312,946,961,1907,394
2022-01-16,United Kingdom,3714,1033,531,15,2681,1071,1079,2150,516
2022-01-17,United Kingdom,3334,924,625,13,2410,887,898,1785,612
2022-01-18,United Kingdom,2902,865,536,26,2037,754,747,1501,510
2022-01-19,United Kingdom,2935,851,573,33,2084,754,757,1511,540
2022-01-20,United Kingdom,3298,890,635,34,2408,893,880,1773,601
2022-01-21,United Kingdom,3756,955,695,18,2801,1049,1057,2106,677
2022-01-22,United Kingdom,3412,1051,390,14,2361,990,981,1971,376
2022-01-23,United Kingdom,3685,988,521,6,2697,1086,1090,2176,515
2022-01-24,United Kingdom,3308,911,617,26,2397,891,889,1780,591
2022-01-25,United Kingdom,2822,782,559,25,2040,730,751,1481,534
2022-01-26,United Kingdom,2936,843,530,28,2093,794,769,1563,502
2022-01-27,United Kingdom,3265,852,633,22,2413,889,891,1780,611
2022-01-28,United Kingdom,3758,989,684,16,2769,1047,1038,2085,668
2022-01-29,United Kingdom,3212,951,325,6,2261,963,973,1936,319
2022-01-30,United Kingdom,3599,929,508,8,2670,1060,1102,2162,500
2022-01-31,United Kingdom,3289,860,626,8,2429,916,887,1803,618
2022-02-01,United Kingdom,3314,880,550,22,2434,933,951,1884,528
2022-02-02,United Kingdom,3465,885,601,19,2580,1002,977,1979,582
2022-02-03,United Kingdom,3805,957,661,17,2848,1102,1085,2187,644
2022-02-04,United Kingdom,4211,973,720,18,3238,1251,1267,2518,702
2022-02-05,United Kingdom,3834,1072,357,5,2762,1202,1203,2405,352
2022-02-06,United Kingdom,4163,949,553,4,3214,1324,1337,2661,549
2022-02-07,United Kingdom,3990,953,707,14,3037,1159,1171,2330,693
2022-02-08,United Kingdom,3510,872,627,18,2638,1003,1008,2011,609
2022-02-09,United Kingdom,3569,901,599,22,2668,1041,1028,2069,577
2022-02-10,United Kingdom,4306,981,737,23,3325,1281,1307,2588,714
2022-02-11,United Kingdom,5038,1049,802,16,3989,1582,1605,3187,786
2022-02-12,United Kingdom,4711,1109,414,8,3602,1631,1557,3188,406
2022-02-13,United Kingdom,4622,1085,531,5,3537,1498,1508,3006,526
2022-02-14,United Kingdom,4439,1017,755,16,3422,1340,1327,2667,739
2022-02-15,United Kingdom,3877,917,655,17,2960,1137,1168,2305,638
2022-02-16,United Kingdom,3790,911,592,10,2879,1152,1135,2287,582
2022-02-17,United Kingdom,4294,905,760,22,3389,1311,1318,2629,738
2022-02-18,United Kingdom,3881,979,446,6,2902,1228,1228,2456,440
2022-02-19,United Kingdom,4960,1141,511,13,3819,1629,1679,3308,498
2022-02-20,United Kingdom,4748,1005,474,7,3743,1634,1635,3269,467
2022-02-21,United Kingdom,4325,942,695,9,3383,1358,1330,2688,686
2022-02-22,United Kingdom,3975,892,681,21,3083,1210,1192,2402,660
2022-02-23,United Kingdom,3994,928,690,19,3066,1193,1183,2376,671
2022-02-24,United Kingdom,4403,982,765,24,3421,1332,1324,2656,741
2022-02-25,United Kingdom,4963,1100,816,34,3863,1519,1528,3047,782
2022-02-26,United Kingdom,4359,1157,447,25,3202,1364,1391,2755,422
2022-02-27,United Kingdom,4852,1098,599,15,3754,1573,1582,3155,584
2022-02-28,United Kingdom,4697,1038,785,32,3659,1438,1436,2874,753
2022-03-01,United Kingdom,4249,1006,642,31,3243,1318,1283,2601,611
2022-03-02,United Kingdom,4339,1001,722,35,3338,1315,1301,2616,687
2022-03-03,United Kingdom,4683,1042,785,31,3641,1422,1434,2856,754
2022-03-04,United Kingdom,5193,1119,821,30,4074,1620,1633,3253,791
2022-03-05,United Kingdom,4608,1171,445,16,3437,1502,1490,2992,429
2022-03-06,United Kingdom,4940,1135,586,18,3805,1602,1617,3219,568
2022-03-07,United Kingdom,4907,1114,781,22,3793,1508,1504,3012,759
2022-03-08,United Kingdom,4423,1023,731,24,3400,1322,1347,2669,707
2022-03-09,United Kingdom,4376,1009,689,24,3367,1337,1341,2678,665
2022-03-10,United Kingdom,4876,1069,846,40,3807,1486,1475,2961,806
2022-03-11,United Kingdom,5219,1108,813,29,4111,1639,1659,3298,784
2022-03-12,United Kingdom,4564,1111,439,13,3453,1506,1508,3014,426
2022-03-13,United Kingdom,5051,1130,605,15,3921,1658,1658,3316,590
2022-03-14,United Kingdom,5016,1133,822,27,3883,1530,1531,3061,795
2022-03-15,United Kingdom,4494,978,755,26,3516,1378,1383,2761,729
2022-03-16,United Kingdom,4565,1064,727,27,3501,1403,1371,2774,700
2022-03-17,United Kingdom,4891,1049,825,26,3842,1500,1517,3017,799
2022-03-18,United Kingdom,5401,1162,837,21,4239,1708,1694,3402,816
2022-03-19,United Kingdom,4755,1205,460,13,3550,1557,1533,3090,447
2022-03-20,United Kingdom,5163,1250,588,10,3913,1657,1668,3325,578
2022-03-21,United Kingdom,5008,1100,821,32,3908,1529,1558,3087,789
2022-03-22,United Kingdom,4497,1024,769,27,3473,1357,1347,2704,742
2022-03-23,United Kingdom,4616,1063,766,30,3553,1399,1388,2787,736
2022-03-24,United Kingdom,4891,1078,808,31,3813,1489,1516,3005,777
2022-03-25,United Kingdom,5382,1155,831,19,4227,1708,1688,3396,812
2022-03-26,United Kingdom,4747,1174,506,15,3573,1539,1528,3067,491
2022-03-27,United Kingdom,5752,1362,599,13,4390,1895,1896,3791,586
2022-03-28,United Kingdom,6097,1349,894,31,4748,1913,1941,3854,863
2022-03-29,United Kingdom,5880,1302,815,28,4578,1870,1893,3763,787
2022-03-30,United Kingdom,5680,1283,730,17,4397,1836,1831,3667,713
2022-03-31,United Kingdom,5936,1320,782,13,4616,1918,1916,3834,769
2022-04-01,United Kingdom,6257,1341,846,16,4916,2041,2029,4070,830
2022-04-02,United Kingdom,5746,1409,513,13,4337,1924,1900,3824,500
2022-04-03,United Kingdom,5903,1379,617,17,4524,1957,1950,3907,600
2022-04-04,United Kingdom,6167,1332,843,25,4835,1992,2000,3992,818
2022-04-05,United Kingdom,5926,1344,781,24,4582,1899,1902,3801,757
2022-04-06,United Kingdom,6086,1325,840,15,4761,1959,1962,3921,825
2022-04-07,United Kingdom,6254,1380,847,16,4874,2027,2000,4027,831
2022-04-08,United Kingdom,6565,1470,887,36,5095,2102,2106,4208,851
2022-04-09,United Kingdom,6025,1507,520,14,4518,2001,1997,3998,506
2022-04-10,United Kingdom,6237,1519,641,14,4718,2027,2050,4077,627
2022-04-11,United Kingdom,6366,1410,902,25,4956,2024,2030,4054,877
2022-04-12,United Kingdom,6156,1365,826,20,4791,1983,1982,3965,806
2022-04-13,United Kingdom,6141,1389,848,29,4752,1944,1960,3904,819
2022-04-14,United Kingdom,6457,1415,870,26,5042,2100,2072,4172,844
2022-04-15,United Kingdom,6393,1498,779,14,4895,2061,2055,4116,765
2022-04-16,United Kingdom,5797,1488,487,15,4309,1921,1901,3822,472
2022-04-17,United Kingdom,5995,1445,579,15,4550,1976,1995,3971,564
2022-04-18,United Kingdom,6388,1459,750,24,4929,2054,2125,4179,726
2022-04-19,United Kingdom,6261,1341,810,17,4920,2049,2061,4110,793
2022-04-20,United Kingdom,6260,1415,881,28,4845,1989,1975,3964,853
2022-04-21,United Kingdom,6300,1406,829,31,4894,2046,2019,4065,798
2022-04-22,United Kingdom,6539,1420,888,22,5119,2103,2128,4231,866
2022-04-23,United Kingdom,5710,1444,517,7,4266,1875,1874,3749,510
2022-04-24,United Kingdom,6216,1479,648,16,4737,2040,2049,4089,632
2022-04-25,United Kingdom,6439,1483,902,19,4956,2023,2031,4054,883
2022-04-26,United Kingdom,6272,1418,857,22,4854,2000,1997,3997,835
2022-04-27,United Kingdom,6224,1394,831,21,4830,1997,2002,3999,810
2022-04-28,United Kingdom,6489,1429,868,15,5060,2113,2079,4192,853
2022-04-29,United Kingdom,6814,1463,950,26,5351,2201,2200,4401,924
2022-04-30,United Kingdom,5822,1371,572,17,4451,1933,1946,3879,555
2022-05-01,United Kingdom,6333,1463,653,9,4870,2111,2106,4217,644
2022-05-02,United Kingdom,6769,1495,839,19,5274,2188,2247,4435,820
2022-05-03,United Kingdom,6532,1401,812,25,5131,2142,2177,4319,787
2022-05-04,United Kingdom,6500,1402,849,22,5098,2143,2106,4249,827
2022-05-05,United Kingdom,6780,1392,925,22,5388,2230,2233,4463,903
2022-05-06,United Kingdom,7075,1500,965,18,5575,2322,2288,4610,947
2022-05-07,United Kingdom,6226,1551,553,14,4675,2076,2046,4122,539
2022-05-08,United Kingdom,6692,1545,692,13,5147,2221,2234,4455,679
2022-05-09,United Kingdom,6941,1539,928,27,5402,2232,2242,4474,901
2022-05-10,United Kingdom,6692,1499,876,20,5193,2153,2164,4317,856
2022-05-11,United Kingdom,6707,1480,829,21,5227,2183,2215,4398,808
2022-05-12,United Kingdom,6872,1444,937,22,5428,2264,2227,4491,915
2022-05-13,United Kingdom,7164,1528,963,22,5636,2334,2339,4673,941
2022-05-14,United Kingdom,6359,1508,595,13,4851,2132,2124,4256,582
2022-05-15,United Kingdom,6724,1555,677,12,5169,2233,2259,4492,665
2022-05-16,United Kingdom,6901,1484,879,14,5417,2264,2274,4538,865
2022-05-17,United Kingdom,6731,1437,830,18,5294,2236,2228,4464,812
2022-05-18,United Kingdom,6829,1514,848,14,5315,2241,2226,4467,834
2022-05-19,United Kingdom,7040,1500,958,20,5540,2288,2294,4582,938
2022-05-20,United Kingdom,7223,1613,933,9,5610,2345,2332,4677,924
2022-05-21,United Kingdom,6479,1550,601,7,4929,2171,2157,4328,594
2022-05-22,United Kingdom,6949,1640,719,18,5309,2294,2296,4590,701
2022-05-23,United Kingdom,7148,1576,959,19,5572,2303,2310,4613,940
2022-05-24,United Kingdom,6873,1490,844,21,5383,2250,2289,4539,823
2022-05-25,United Kingdom,6978,1448,874,22,5530,2320,2336,4656,852
2022-05-26,United Kingdom,7321,1597,932,32,5724,2386,2406,4792,900
2022-05-27,United Kingdom,7755,1625,997,24,6130,2569,2564,5133,973
2022-05-28,United Kingdom,6956,1569,609,11,5387,2451,2327,4778,598
2022-05-29,United Kingdom,7111,1665,664,10,5446,2389,2393,4782,654
2022-05-30,United Kingdom,7456,1630,947,23,5826,2422,2457,4879,924
2022-05-31,United Kingdom,7032,1510,855,14,5522,2320,2347,4667,841
2022-06-01,United Kingdom,6843,1120,887,16,5723,2416,2420,4836,871
2022-06-02,United Kingdom,7261,1626,825,21,5635,2418,2392,4810,804
2022-06-03,United Kingdom,7252,1640,787,17,5612,2424,2401,4825,770
2022-06-04,United Kingdom,6816,1639,587,10,5177,2286,2304,4590,577
2022-06-05,United Kingdom,7298,1619,689,17,5679,2414,2576,4990,672
2022-06-06,United Kingdom,7721,1751,1015,26,5970,2518,2437,4955,989
2022-06-07,United Kingdom,7293,1594,873,19,5699,2411,2415,4826,854
